"","voting_table_uniq_id","petro","hernandez","invalid_votes","votes_cast"
"1",1000001,7,20,0,27
"2",1000002,72,97,15,184
"3",1000003,57,70,12,139
"4",1000004,55,190,4,249
"5",1000005,44,80,9,133
"6",1000006,127,126,9,262
"7",1000007,204,54,7,265
"8",1000008,54,153,11,218
"9",1000009,169,79,5,253
"10",1000010,38,153,1,192
"11",1000011,25,118,3,146
"12",1000012,45,222,22,289
"13",1000013,174,122,25,321
"14",1000014,156,36,7,199
"15",1000015,35,51,2,88
"16",1000016,48,105,5,158
"17",1000017,102,54,11,167
"18",1000018,111,54,20,185
"19",1000019,139,112,9,260
"20",1000020,176,89,5,270
"21",1000021,13,307,4,324
"22",1000022,158,48,8,214
"23",1000023,21,229,2,252
"24",1000024,130,63,17,210
"25",1000025,109,167,13,289
"26",1000026,263,17,6,286
"27",1000027,40,212,4,256
"28",1000028,74,117,7,198
"29",1000029,79,36,2,117
"30",1000030,132,76,8,216
"31",1000031,163,171,20,354
"32",1000032,47,239,4,290
"33",1000033,35,238,4,277
"34",1000034,94,183,6,283
"35",1000035,149,88,7,244
"36",1000036,148,53,1,202
"37",1000037,76,86,10,172
"38",1000038,192,67,10,269
"39",1000039,57,209,14,280
"40",1000040,146,129,8,283
"41",1000041,8,35,0,43
"42",1000042,60,155,11,226
"43",1000043,165,65,9,239
"44",1000044,126,118,3,247
"45",1000045,24,0,0,24
"46",1000046,17,154,4,175
"47",1000047,90,146,16,252
"48",1000048,160,62,4,226
"49",1000049,66,86,4,156
"50",1000050,54,173,10,237
"51",1000051,169,68,9,246
"52",1000052,129,156,26,311
"53",1000053,73,176,6,255
"54",1000054,263,32,3,298
"55",1000055,41,264,4,309
"56",1000056,103,43,2,148
"57",1000057,54,207,26,287
"58",1000058,71,11,7,89
"59",1000059,26,317,2,345
"60",1000060,76,156,2,234
"61",1000061,78,136,9,223
"62",1000062,17,289,0,306
"63",1000063,92,27,5,124
"64",1000064,52,36,2,90
"65",1000065,3,54,1,58
"66",1000066,97,119,6,222
"67",1000067,143,95,9,247
"68",1000068,12,0,0,12
"69",1000069,62,102,7,171
"70",1000070,65,163,6,234
"71",1000071,149,102,19,270
"72",1000072,200,47,12,259
"73",1000073,114,93,4,211
"74",1000074,17,4,4,25
"75",1000075,106,92,2,200
"76",1000076,189,120,16,325
"77",1000077,120,149,18,287
"78",1000078,157,1,3,161
"79",1000079,43,109,11,163
"80",1000080,93,70,9,172
"81",1000081,203,25,9,237
"82",1000082,134,53,6,193
"83",1000083,71,158,11,240
"84",1000084,36,186,3,225
"85",1000085,51,164,22,237
"86",1000086,112,165,4,281
"87",1000087,66,97,9,172
"88",1000088,48,170,6,224
"89",1000089,167,44,11,222
"90",1000090,132,96,5,233
"91",1000091,100,167,26,293
"92",1000092,235,38,11,284
"93",1000093,90,2,0,92
"94",1000094,190,38,18,246
"95",1000095,139,61,1,201
"96",1000096,14,4,5,23
"97",1000097,51,270,3,324
"98",1000098,104,69,7,180
"99",1000099,61,42,4,107
"100",1000100,84,167,10,261
"101",1000101,146,105,5,256
"102",1000102,2,19,1,22
"103",1000103,150,97,9,256
"104",1000104,35,38,1,74
"105",1000105,191,71,14,276
"106",1000106,45,317,6,368
"107",1000107,214,65,2,281
"108",1000108,88,172,5,265
"109",1000109,63,52,7,122
"110",1000110,116,81,8,205
"111",1000111,129,103,6,238
"112",1000112,136,48,15,199
"113",1000113,93,73,20,186
"114",1000114,118,46,14,178
"115",1000115,67,268,6,341
"116",1000116,81,213,16,310
"117",1000117,34,180,10,224
"118",1000118,146,102,6,254
"119",1000119,26,230,1,257
"120",1000120,45,134,5,184
"121",1000121,54,147,5,206
"122",1000122,81,111,2,194
"123",1000123,210,75,20,305
"124",1000124,127,42,13,182
"125",1000125,23,254,2,279
"126",1000126,215,66,11,292
"127",1000127,97,52,1,150
"128",1000128,149,39,2,190
"129",1000129,138,80,4,222
"130",1000130,178,25,9,212
"131",1000131,93,165,13,271
"132",1000132,90,162,6,258
"133",1000133,30,208,1,239
"134",1000134,92,7,1,100
"135",1000135,52,146,8,206
"136",1000136,234,1,7,242
"137",1000137,17,33,3,53
"138",1000138,226,72,8,306
"139",1000139,39,50,3,92
"140",1000140,183,45,8,236
"141",1000141,228,44,2,274
"142",1000142,123,83,10,216
"143",1000143,81,168,12,261
"144",1000144,58,185,9,252
"145",1000145,60,92,6,158
"146",1000146,13,1,0,14
"147",1000147,109,120,3,232
"148",1000148,61,37,12,110
"149",1000149,248,160,7,415
"150",1000150,199,55,4,258
"151",1000151,36,163,1,200
"152",1000152,103,116,3,222
"153",1000153,19,8,0,27
"154",1000154,63,25,3,91
"155",1000155,178,119,12,309
"156",1000156,1,3,0,4
"157",1000157,181,25,4,210
"158",1000158,93,21,1,115
"159",1000159,221,11,3,235
"160",1000160,52,226,2,280
"161",1000161,221,34,7,262
"162",1000162,104,35,11,150
"163",1000163,173,91,8,272
"164",1000164,52,254,16,322
"165",1000165,150,83,5,238
"166",1000166,47,233,8,288
"167",1000167,48,59,1,108
"168",1000168,131,72,9,212
"169",1000169,255,7,1,263
"170",1000170,23,173,2,198
"171",1000171,51,149,12,212
"172",1000172,106,131,11,248
"173",1000173,128,129,4,261
"174",1000174,96,99,7,202
"175",1000175,84,34,8,126
"176",1000176,254,81,11,346
"177",1000177,179,82,12,273
"178",1000178,66,110,3,179
"179",1000179,107,214,10,331
"180",1000180,135,80,8,223
"181",1000181,43,74,1,118
"182",1000182,11,15,1,27
"183",1000183,33,263,1,297
"184",1000184,206,32,5,243
"185",1000185,80,166,12,258
"186",1000186,9,3,0,12
"187",1000187,175,6,8,189
"188",1000188,223,93,13,329
"189",1000189,109,89,3,201
"190",1000190,187,71,11,269
"191",1000191,91,106,4,201
"192",1000192,94,66,11,171
"193",1000193,71,139,9,219
"194",1000194,114,23,5,142
"195",1000195,91,18,3,112
"196",1000196,74,210,7,291
"197",1000197,119,73,5,197
"198",1000198,60,30,2,92
"199",1000199,57,122,3,182
"200",1000200,46,167,4,217
"201",1000201,157,77,10,244
"202",1000202,127,64,12,203
"203",1000203,59,125,2,186
"204",1000204,221,62,8,291
"205",1000205,118,8,3,129
"206",1000206,13,80,1,94
"207",1000207,243,29,4,276
"208",1000208,11,173,4,188
"209",1000209,218,229,27,474
"210",1000210,206,54,10,270
"211",1000211,36,240,5,281
"212",1000212,85,27,3,115
"213",1000213,147,107,8,262
"214",1000214,48,97,4,149
"215",1000215,10,4,0,14
"216",1000216,49,190,16,255
"217",1000217,46,28,2,76
"218",1000218,32,207,11,250
"219",1000219,16,9,1,26
"220",1000220,67,143,8,218
"221",1000221,5,72,0,77
"222",1000222,36,117,8,161
"223",1000223,96,153,17,266
"224",1000224,79,98,3,180
"225",1000225,198,38,4,240
"226",1000226,77,18,1,96
"227",1000227,157,19,10,186
"228",1000228,80,156,8,244
"229",1000229,89,131,4,224
"230",1000230,79,171,5,255
"231",1000231,146,135,14,295
"232",1000232,178,97,17,292
"233",1000233,106,60,3,169
"234",1000234,122,43,5,170
"235",1000235,120,37,6,163
"236",1000236,131,56,6,193
"237",1000237,71,156,21,248
"238",1000238,54,7,3,64
"239",1000239,54,84,4,142
"240",1000240,159,117,7,283
"241",1000241,42,228,6,276
"242",1000242,65,169,22,256
"243",1000243,45,144,3,192
"244",1000244,102,142,9,253
"245",1000245,116,139,2,257
"246",1000246,171,30,2,203
"247",1000247,50,20,1,71
"248",1000248,208,34,3,245
"249",1000249,2,25,2,29
"250",1000250,162,85,13,260
"251",1000251,129,86,14,229
"252",1000252,123,156,14,293
"253",1000253,100,90,12,202
"254",1000254,147,50,20,217
"255",1000255,71,179,11,261
"256",1000256,106,29,0,135
"257",1000257,162,33,3,198
"258",1000258,80,86,9,175
"259",1000259,162,30,6,198
"260",1000260,139,70,12,221
"261",1000261,119,112,8,239
"262",1000262,93,96,18,207
"263",1000263,21,15,0,36
"264",1000264,65,114,5,184
"265",1000265,159,129,17,305
"266",1000266,196,72,27,295
"267",1000267,40,108,6,154
"268",1000268,120,134,11,265
"269",1000269,79,40,1,120
"270",1000270,60,150,3,213
"271",1000271,176,51,7,234
"272",1000272,164,116,6,286
"273",1000273,93,26,8,127
"274",1000274,80,141,19,240
"275",1000275,189,34,7,230
"276",1000276,74,204,12,290
"277",1000277,85,96,10,191
"278",1000278,156,24,2,182
"279",1000279,78,134,6,218
"280",1000280,159,124,8,291
"281",1000281,5,19,0,24
"282",1000282,48,245,5,298
"283",1000283,92,154,17,263
"284",1000284,49,182,7,238
"285",1000285,32,132,0,164
"286",1000286,120,152,17,289
"287",1000287,247,46,11,304
"288",1000288,43,224,11,278
"289",1000289,140,59,13,212
"290",1000290,224,69,5,298
"291",1000291,96,158,9,263
"292",1000292,31,182,8,221
"293",1000293,119,105,4,228
"294",1000294,51,213,10,274
"295",1000295,100,181,12,293
"296",1000296,22,152,2,176
"297",1000297,264,30,7,301
"298",1000298,33,124,1,158
"299",1000299,115,69,12,196
"300",1000300,145,35,1,181
"301",1000301,127,16,6,149
"302",1000302,114,112,9,235
"303",1000303,104,125,8,237
"304",1000304,100,43,1,144
"305",1000305,134,20,5,159
"306",1000306,70,138,9,217
"307",1000307,225,73,9,307
"308",1000308,72,204,13,289
"309",1000309,91,22,2,115
"310",1000310,38,152,5,195
"311",1000311,184,33,5,222
"312",1000312,113,51,4,168
"313",1000313,69,170,3,242
"314",1000314,55,256,6,317
"315",1000315,131,171,12,314
"316",1000316,109,131,31,271
"317",1000317,57,166,14,237
"318",1000318,74,179,17,270
"319",1000319,28,231,2,261
"320",1000320,13,184,5,202
"321",1000321,93,204,11,308
"322",1000322,86,151,10,247
"323",1000323,186,22,4,212
"324",1000324,11,2,2,15
"325",1000325,169,154,5,328
"326",1000326,154,65,4,223
"327",1000327,232,14,4,250
"328",1000328,116,83,12,211
"329",1000329,102,180,5,287
"330",1000330,114,71,14,199
"331",1000331,180,66,9,255
"332",1000332,259,28,8,295
"333",1000333,79,172,14,265
"334",1000334,201,58,10,269
"335",1000335,76,131,6,213
"336",1000336,135,128,17,280
"337",1000337,66,275,8,349
"338",1000338,107,42,5,154
"339",1000339,108,83,4,195
"340",1000340,58,215,6,279
"341",1000341,49,91,3,143
"342",1000342,61,191,3,255
"343",1000343,174,34,6,214
"344",1000344,179,107,16,302
"345",1000345,49,44,1,94
"346",1000346,201,58,8,267
"347",1000347,52,255,3,310
"348",1000348,89,174,6,269
"349",1000349,7,166,2,175
"350",1000350,281,34,9,324
"351",1000351,122,181,18,321
"352",1000352,100,77,9,186
"353",1000353,84,105,5,194
"354",1000354,136,172,13,321
"355",1000355,131,93,5,229
"356",1000356,86,73,6,165
"357",1000357,159,17,4,180
"358",1000358,39,180,6,225
"359",1000359,276,8,1,285
"360",1000360,106,120,4,230
"361",1000361,79,71,4,154
"362",1000362,110,167,13,290
"363",1000363,105,221,20,346
"364",1000364,42,204,2,248
"365",1000365,223,25,7,255
"366",1000366,310,0,0,310
"367",1000367,130,56,17,203
"368",1000368,160,20,9,189
"369",1000369,131,12,4,147
"370",1000370,24,51,4,79
"371",1000371,112,52,1,165
"372",1000372,118,15,5,138
"373",1000373,104,15,0,119
"374",1000374,169,30,6,205
"375",1000375,89,108,8,205
"376",1000376,113,37,4,154
"377",1000377,104,94,8,206
"378",1000378,62,79,0,141
"379",1000379,5,12,1,18
"380",1000380,227,15,9,251
"381",1000381,91,206,10,307
"382",1000382,97,142,19,258
"383",1000383,126,100,8,234
"384",1000384,85,120,4,209
"385",1000385,91,196,11,298
"386",1000386,55,142,15,212
"387",1000387,109,62,3,174
"388",1000388,9,120,1,130
"389",1000389,191,32,5,228
"390",1000390,6,2,0,8
"391",1000391,76,74,2,152
"392",1000392,181,42,9,232
"393",1000393,77,58,15,150
"394",1000394,115,115,5,235
"395",1000395,141,23,3,167
"396",1000396,121,126,16,263
"397",1000397,96,185,15,296
"398",1000398,3,1,0,4
"399",1000399,25,113,0,138
"400",1000400,43,262,5,310
"401",1000401,22,215,4,241
"402",1000402,158,64,7,229
"403",1000403,68,33,4,105
"404",1000404,129,114,10,253
"405",1000405,79,108,3,190
"406",1000406,74,205,13,292
"407",1000407,57,146,10,213
"408",1000408,42,51,2,95
"409",1000409,176,141,9,326
"410",1000410,231,28,16,275
"411",1000411,104,53,6,163
"412",1000412,171,116,15,302
"413",1000413,179,34,7,220
"414",1000414,167,25,4,196
"415",1000415,112,171,3,286
"416",1000416,26,10,1,37
"417",1000417,150,71,5,226
"418",1000418,47,140,13,200
"419",1000419,177,57,13,247
"420",1000420,47,117,8,172
"421",1000421,51,192,2,245
"422",1000422,128,59,14,201
"423",1000423,163,113,7,283
"424",1000424,96,85,4,185
"425",1000425,60,127,11,198
"426",1000426,102,37,3,142
"427",1000427,68,248,17,333
"428",1000428,57,45,2,104
"429",1000429,86,180,9,275
"430",1000430,130,168,6,304
"431",1000431,183,22,6,211
"432",1000432,54,259,2,315
"433",1000433,67,171,9,247
"434",1000434,42,27,7,76
"435",1000435,77,161,7,245
"436",1000436,145,136,10,291
"437",1000437,170,103,10,283
"438",1000438,5,5,1,11
"439",1000439,199,72,19,290
"440",1000440,154,152,8,314
"441",1000441,152,134,5,291
"442",1000442,180,50,6,236
"443",1000443,15,306,6,327
"444",1000444,186,35,4,225
"445",1000445,110,36,4,150
"446",1000446,153,105,6,264
"447",1000447,36,93,0,129
"448",1000448,159,61,2,222
"449",1000449,42,153,11,206
"450",1000450,105,139,1,245
"451",1000451,18,159,2,179
"452",1000452,183,77,15,275
"453",1000453,22,155,4,181
"454",1000454,130,130,21,281
"455",1000455,131,145,14,290
"456",1000456,185,94,9,288
"457",1000457,151,44,6,201
"458",1000458,37,94,1,132
"459",1000459,94,86,7,187
"460",1000460,143,50,13,206
"461",1000461,85,181,12,278
"462",1000462,151,48,5,204
"463",1000463,84,70,7,161
"464",1000464,42,87,7,136
"465",1000465,166,97,15,278
"466",1000466,151,108,13,272
"467",1000467,224,71,13,308
"468",1000468,83,175,2,260
"469",1000469,182,38,8,228
"470",1000470,153,30,3,186
"471",1000471,85,184,6,275
"472",1000472,70,169,6,245
"473",1000473,34,223,7,264
"474",1000474,2,8,1,11
"475",1000475,45,3,1,49
"476",1000476,96,15,1,112
"477",1000477,135,161,4,300
"478",1000478,58,226,13,297
"479",1000479,90,84,12,186
"480",1000480,118,18,9,145
"481",1000481,202,67,8,277
"482",1000482,118,167,14,299
"483",1000483,111,195,5,311
"484",1000484,358,46,17,421
"485",1000485,234,79,14,327
"486",1000486,62,186,8,256
"487",1000487,41,155,6,202
"488",1000488,42,227,9,278
"489",1000489,134,43,6,183
"490",1000490,35,153,6,194
"491",1000491,93,138,6,237
"492",1000492,173,43,3,219
"493",1000493,184,45,7,236
"494",1000494,97,138,6,241
"495",1000495,187,78,8,273
"496",1000496,109,17,2,128
"497",1000497,105,154,17,276
"498",1000498,16,2,1,19
"499",1000499,201,24,4,229
"500",1000500,82,80,9,171
"501",1000501,155,41,6,202
"502",1000502,65,100,7,172
"503",1000503,66,87,20,173
"504",1000504,24,183,8,215
"505",1000505,155,5,9,169
"506",1000506,144,174,25,343
"507",1000507,125,60,7,192
"508",1000508,48,8,2,58
"509",1000509,165,115,5,285
"510",1000510,93,116,9,218
"511",1000511,13,9,0,22
"512",1000512,152,79,10,241
"513",1000513,89,8,2,99
"514",1000514,152,112,2,266
"515",1000515,83,237,10,330
"516",1000516,25,118,0,143
"517",1000517,164,38,12,214
"518",1000518,91,94,17,202
"519",1000519,83,199,3,285
"520",1000520,57,87,8,152
"521",1000521,34,8,0,42
"522",1000522,48,8,1,57
"523",1000523,201,45,6,252
"524",1000524,72,109,5,186
"525",1000525,65,61,3,129
"526",1000526,24,258,9,291
"527",1000527,30,229,5,264
"528",1000528,200,72,6,278
"529",1000529,53,49,1,103
"530",1000530,58,19,5,82
"531",1000531,38,154,9,201
"532",1000532,47,253,3,303
"533",1000533,51,184,19,254
"534",1000534,140,172,16,328
"535",1000535,171,39,6,216
"536",1000536,159,64,7,230
"537",1000537,34,228,2,264
"538",1000538,131,33,7,171
"539",1000539,104,146,5,255
"540",1000540,14,135,5,154
"541",1000541,109,55,9,173
"542",1000542,9,6,1,16
"543",1000543,135,73,8,216
"544",1000544,104,86,7,197
"545",1000545,168,118,17,303
"546",1000546,145,102,3,250
"547",1000547,135,64,5,204
"548",1000548,10,14,1,25
"549",1000549,18,125,2,145
"550",1000550,146,50,1,197
"551",1000551,58,162,11,231
"552",1000552,98,118,10,226
"553",1000553,63,202,10,275
"554",1000554,106,156,6,268
"555",1000555,63,45,1,109
"556",1000556,46,293,7,346
"557",1000557,121,38,11,170
"558",1000558,82,101,32,215
"559",1000559,170,70,4,244
"560",1000560,70,79,11,160
"561",1000561,39,289,11,339
"562",1000562,81,222,17,320
"563",1000563,194,48,6,248
"564",1000564,109,87,14,210
"565",1000565,202,41,9,252
"566",1000566,120,184,20,324
"567",1000567,124,18,2,144
"568",1000568,88,133,7,228
"569",1000569,126,119,15,260
"570",1000570,122,112,3,237
"571",1000571,105,113,7,225
"572",1000572,127,113,1,241
"573",1000573,134,110,5,249
"574",1000574,34,35,4,73
"575",1000575,111,180,12,303
"576",1000576,96,180,14,290
"577",1000577,183,53,11,247
"578",1000578,232,25,3,260
"579",1000579,72,176,23,271
"580",1000580,28,210,3,241
"581",1000581,160,115,16,291
"582",1000582,83,150,5,238
"583",1000583,215,26,5,246
"584",1000584,96,160,7,263
"585",1000585,11,85,0,96
"586",1000586,136,45,15,196
"587",1000587,147,108,11,266
"588",1000588,144,51,3,198
"589",1000589,65,58,8,131
"590",1000590,63,45,4,112
"591",1000591,37,247,7,291
"592",1000592,78,78,6,162
"593",1000593,150,93,14,257
"594",1000594,37,142,3,182
"595",1000595,141,112,2,255
"596",1000596,217,50,13,280
"597",1000597,129,47,5,181
"598",1000598,22,86,8,116
"599",1000599,48,198,7,253
"600",1000600,106,205,15,326
"601",1000601,192,31,4,227
"602",1000602,101,148,2,251
"603",1000603,80,213,4,297
"604",1000604,115,32,10,157
"605",1000605,214,19,7,240
"606",1000606,29,160,5,194
"607",1000607,133,62,7,202
"608",1000608,139,42,11,192
"609",1000609,145,63,10,218
"610",1000610,139,95,14,248
"611",1000611,79,193,9,281
"612",1000612,76,93,8,177
"613",1000613,16,21,2,39
"614",1000614,127,84,11,222
"615",1000615,186,16,6,208
"616",1000616,170,71,6,247
"617",1000617,151,35,10,196
"618",1000618,112,91,5,208
"619",1000619,58,41,2,101
"620",1000620,127,17,2,146
"621",1000621,69,253,13,335
"622",1000622,43,177,5,225
"623",1000623,123,99,13,235
"624",1000624,101,57,10,168
"625",1000625,69,71,10,150
"626",1000626,156,58,6,220
"627",1000627,86,178,13,277
"628",1000628,19,123,0,142
"629",1000629,105,154,4,263
"630",1000630,68,138,17,223
"631",1000631,81,160,1,242
"632",1000632,150,171,15,336
"633",1000633,124,111,6,241
"634",1000634,47,62,0,109
"635",1000635,91,49,5,145
"636",1000636,74,31,6,111
"637",1000637,73,0,0,73
"638",1000638,140,104,3,247
"639",1000639,25,28,3,56
"640",1000640,92,231,16,339
"641",1000641,82,69,3,154
"642",1000642,125,51,4,180
"643",1000643,33,13,4,50
"644",1000644,24,140,2,166
"645",1000645,85,24,2,111
"646",1000646,90,200,4,294
"647",1000647,45,159,5,209
"648",1000648,128,58,15,201
"649",1000649,127,14,2,143
"650",1000650,227,81,13,321
"651",1000651,131,68,10,209
"652",1000652,164,125,26,315
"653",1000653,201,83,5,289
"654",1000654,67,137,12,216
"655",1000655,27,296,6,329
"656",1000656,62,203,4,269
"657",1000657,10,243,1,254
"658",1000658,31,176,1,208
"659",1000659,114,85,7,206
"660",1000660,170,58,11,239
"661",1000661,154,30,1,185
"662",1000662,97,181,5,283
"663",1000663,247,31,5,283
"664",1000664,200,45,5,250
"665",1000665,37,236,4,277
"666",1000666,190,1,7,198
"667",1000667,163,128,24,315
"668",1000668,196,91,7,294
"669",1000669,149,85,2,236
"670",1000670,173,29,4,206
"671",1000671,106,78,3,187
"672",1000672,100,87,10,197
"673",1000673,221,51,11,283
"674",1000674,47,216,11,274
"675",1000675,97,55,12,164
"676",1000676,21,219,4,244
"677",1000677,172,73,6,251
"678",1000678,92,167,11,270
"679",1000679,91,142,9,242
"680",1000680,167,75,5,247
"681",1000681,97,132,4,233
"682",1000682,122,37,4,163
"683",1000683,60,213,2,275
"684",1000684,166,10,6,182
"685",1000685,142,82,5,229
"686",1000686,8,9,0,17
"687",1000687,94,120,4,218
"688",1000688,42,62,4,108
"689",1000689,200,53,5,258
"690",1000690,146,117,3,266
"691",1000691,106,231,8,345
"692",1000692,119,97,11,227
"693",1000693,193,48,9,250
"694",1000694,62,170,5,237
"695",1000695,193,68,15,276
"696",1000696,127,108,14,249
"697",1000697,216,56,4,276
"698",1000698,48,214,7,269
"699",1000699,50,36,0,86
"700",1000700,88,187,13,288
"701",1000701,56,64,13,133
"702",1000702,137,98,5,240
"703",1000703,20,46,2,68
"704",1000704,71,228,3,302
"705",1000705,190,117,8,315
"706",1000706,163,72,1,236
"707",1000707,89,49,4,142
"708",1000708,122,98,11,231
"709",1000709,117,161,17,295
"710",1000710,201,101,9,311
"711",1000711,96,93,11,200
"712",1000712,100,112,7,219
"713",1000713,155,33,6,194
"714",1000714,50,80,3,133
"715",1000715,246,31,9,286
"716",1000716,82,153,7,242
"717",1000717,197,113,25,335
"718",1000718,104,73,4,181
"719",1000719,47,234,9,290
"720",1000720,93,134,10,237
"721",1000721,82,141,2,225
"722",1000722,119,115,1,235
"723",1000723,160,79,7,246
"724",1000724,102,59,7,168
"725",1000725,45,224,3,272
"726",1000726,156,45,8,209
"727",1000727,29,108,7,144
"728",1000728,205,111,10,326
"729",1000729,162,55,4,221
"730",1000730,78,226,9,313
"731",1000731,59,360,18,437
"732",1000732,178,91,13,282
"733",1000733,61,196,10,267
"734",1000734,278,18,10,306
"735",1000735,118,19,3,140
"736",1000736,148,33,9,190
"737",1000737,82,155,6,243
"738",1000738,37,131,8,176
"739",1000739,87,105,9,201
"740",1000740,110,106,15,231
"741",1000741,97,158,11,266
"742",1000742,4,20,1,25
"743",1000743,44,112,0,156
"744",1000744,111,188,7,306
"745",1000745,144,38,3,185
"746",1000746,86,187,15,288
"747",1000747,130,74,9,213
"748",1000748,2,9,0,11
"749",1000749,24,4,0,28
"750",1000750,131,28,14,173
"751",1000751,107,99,6,212
"752",1000752,40,49,1,90
"753",1000753,12,7,7,26
"754",1000754,16,16,3,35
"755",1000755,31,30,4,65
"756",1000756,59,38,4,101
"757",1000757,34,232,5,271
"758",1000758,193,52,4,249
"759",1000759,178,32,10,220
"760",1000760,219,78,11,308
"761",1000761,95,82,5,182
"762",1000762,85,97,8,190
"763",1000763,43,180,16,239
"764",1000764,47,208,10,265
"765",1000765,151,48,6,205
"766",1000766,201,65,5,271
"767",1000767,152,58,2,212
"768",1000768,54,120,7,181
"769",1000769,74,142,6,222
"770",1000770,10,1,1,12
"771",1000771,119,110,6,235
"772",1000772,184,42,10,236
"773",1000773,193,32,15,240
"774",1000774,43,121,3,167
"775",1000775,175,87,27,289
"776",1000776,26,5,1,32
"777",1000777,65,176,6,247
"778",1000778,177,72,9,258
"779",1000779,63,133,12,208
"780",1000780,3,111,1,115
"781",1000781,34,122,2,158
"782",1000782,137,118,6,261
"783",1000783,127,32,5,164
"784",1000784,47,106,6,159
"785",1000785,174,15,1,190
"786",1000786,57,267,4,328
"787",1000787,25,20,0,45
"788",1000788,99,72,4,175
"789",1000789,125,171,6,302
"790",1000790,108,154,19,281
"791",1000791,54,158,5,217
"792",1000792,69,82,3,154
"793",1000793,79,157,14,250
"794",1000794,7,7,0,14
"795",1000795,120,89,10,219
"796",1000796,223,35,13,271
"797",1000797,175,67,13,255
"798",1000798,100,111,9,220
"799",1000799,70,154,3,227
"800",1000800,157,22,5,184
"801",1000801,167,104,9,280
"802",1000802,109,86,14,209
"803",1000803,42,261,0,303
"804",1000804,22,119,2,143
"805",1000805,141,106,10,257
"806",1000806,7,26,1,34
"807",1000807,250,170,24,444
"808",1000808,70,115,0,185
"809",1000809,39,299,5,343
"810",1000810,58,231,6,295
"811",1000811,177,156,11,344
"812",1000812,34,256,8,298
"813",1000813,54,20,4,78
"814",1000814,179,101,0,280
"815",1000815,124,107,7,238
"816",1000816,90,139,3,232
"817",1000817,19,300,2,321
"818",1000818,117,126,5,248
"819",1000819,86,36,0,122
"820",1000820,84,33,3,120
"821",1000821,92,133,16,241
"822",1000822,13,37,0,50
"823",1000823,54,184,4,242
"824",1000824,104,74,15,193
"825",1000825,192,40,13,245
"826",1000826,4,8,0,12
"827",1000827,42,204,5,251
"828",1000828,180,14,3,197
"829",1000829,218,23,4,245
"830",1000830,59,125,8,192
"831",1000831,27,71,2,100
"832",1000832,101,82,11,194
"833",1000833,139,97,10,246
"834",1000834,12,68,3,83
"835",1000835,48,189,2,239
"836",1000836,189,63,9,261
"837",1000837,14,6,0,20
"838",1000838,60,150,4,214
"839",1000839,121,154,14,289
"840",1000840,36,115,5,156
"841",1000841,127,13,3,143
"842",1000842,59,180,9,248
"843",1000843,49,77,8,134
"844",1000844,179,99,6,284
"845",1000845,71,155,4,230
"846",1000846,184,72,7,263
"847",1000847,125,157,6,288
"848",1000848,42,253,4,299
"849",1000849,166,54,15,235
"850",1000850,132,57,12,201
"851",1000851,74,213,8,295
"852",1000852,232,30,5,267
"853",1000853,136,108,11,255
"854",1000854,207,23,7,237
"855",1000855,233,50,9,292
"856",1000856,90,139,3,232
"857",1000857,114,78,0,192
"858",1000858,203,77,18,298
"859",1000859,58,242,2,302
"860",1000860,135,168,13,316
"861",1000861,95,205,14,314
"862",1000862,59,44,3,106
"863",1000863,195,78,17,290
"864",1000864,133,102,10,245
"865",1000865,52,19,3,74
"866",1000866,31,121,5,157
"867",1000867,190,1,1,192
"868",1000868,129,44,11,184
"869",1000869,45,225,23,293
"870",1000870,111,97,9,217
"871",1000871,54,224,3,281
"872",1000872,134,89,14,237
"873",1000873,119,122,20,261
"874",1000874,208,10,4,222
"875",1000875,85,94,5,184
"876",1000876,31,189,2,222
"877",1000877,85,200,7,292
"878",1000878,241,24,7,272
"879",1000879,105,63,14,182
"880",1000880,83,74,8,165
"881",1000881,59,168,5,232
"882",1000882,39,211,9,259
"883",1000883,133,153,3,289
"884",1000884,69,29,3,101
"885",1000885,112,176,5,293
"886",1000886,153,133,21,307
"887",1000887,167,96,6,269
"888",1000888,40,52,9,101
"889",1000889,107,184,10,301
"890",1000890,141,109,10,260
"891",1000891,135,83,7,225
"892",1000892,73,160,4,237
"893",1000893,45,118,0,163
"894",1000894,144,51,1,196
"895",1000895,117,62,11,190
"896",1000896,50,17,2,69
"897",1000897,77,103,5,185
"898",1000898,144,85,15,244
"899",1000899,29,17,1,47
"900",1000900,146,14,5,165
"901",1000901,90,197,6,293
"902",1000902,125,101,24,250
"903",1000903,58,262,5,325
"904",1000904,147,104,3,254
"905",1000905,5,140,4,149
"906",1000906,250,36,3,289
"907",1000907,57,53,6,116
"908",1000908,214,114,23,351
"909",1000909,183,59,17,259
"910",1000910,61,238,7,306
"911",1000911,142,58,1,201
"912",1000912,164,94,6,264
"913",1000913,54,166,1,221
"914",1000914,64,132,8,204
"915",1000915,42,103,0,145
"916",1000916,94,218,10,322
"917",1000917,20,135,4,159
"918",1000918,20,10,1,31
"919",1000919,10,7,1,18
"920",1000920,85,203,19,307
"921",1000921,19,16,0,35
"922",1000922,24,34,1,59
"923",1000923,178,101,10,289
"924",1000924,164,89,12,265
"925",1000925,57,81,0,138
"926",1000926,2,3,0,5
"927",1000927,147,62,4,213
"928",1000928,156,57,4,217
"929",1000929,16,141,5,162
"930",1000930,172,102,7,281
"931",1000931,47,32,6,85
"932",1000932,200,25,6,231
"933",1000933,156,91,9,256
"934",1000934,21,270,3,294
"935",1000935,70,173,0,243
"936",1000936,201,84,21,306
"937",1000937,165,83,8,256
"938",1000938,192,77,16,285
"939",1000939,109,54,4,167
"940",1000940,227,28,13,268
"941",1000941,146,140,6,292
"942",1000942,76,170,3,249
"943",1000943,155,87,11,253
"944",1000944,108,88,8,204
"945",1000945,19,17,0,36
"946",1000946,88,188,9,285
"947",1000947,212,102,10,324
"948",1000948,206,45,8,259
"949",1000949,7,209,4,220
"950",1000950,32,147,5,184
"951",1000951,183,69,9,261
"952",1000952,138,52,3,193
"953",1000953,65,83,5,153
"954",1000954,45,70,10,125
"955",1000955,57,125,30,212
"956",1000956,119,145,12,276
"957",1000957,73,105,12,190
"958",1000958,105,191,13,309
"959",1000959,229,34,15,278
"960",1000960,97,16,7,120
"961",1000961,151,27,7,185
"962",1000962,112,167,10,289
"963",1000963,218,72,7,297
"964",1000964,256,37,14,307
"965",1000965,86,236,7,329
"966",1000966,25,135,4,164
"967",1000967,109,69,6,184
"968",1000968,61,32,3,96
"969",1000969,49,222,5,276
"970",1000970,157,78,14,249
"971",1000971,210,82,8,300
"972",1000972,132,97,3,232
"973",1000973,130,5,6,141
"974",1000974,132,36,7,175
"975",1000975,125,99,2,226
"976",1000976,189,37,8,234
"977",1000977,84,208,0,292
"978",1000978,77,79,7,163
"979",1000979,6,80,0,86
"980",1000980,153,22,4,179
"981",1000981,75,210,14,299
"982",1000982,151,161,11,323
"983",1000983,136,78,9,223
"984",1000984,138,106,14,258
"985",1000985,134,64,5,203
"986",1000986,60,128,12,200
"987",1000987,106,166,5,277
"988",1000988,235,10,4,249
"989",1000989,154,136,21,311
"990",1000990,197,29,8,234
"991",1000991,186,92,22,300
"992",1000992,34,26,4,64
"993",1000993,57,78,13,148
"994",1000994,77,186,11,274
"995",1000995,140,39,8,187
"996",1000996,43,214,5,262
"997",1000997,13,14,1,28
"998",1000998,66,247,5,318
"999",1000999,200,2,3,205
"1000",1001000,90,65,12,167
"1001",1001001,15,8,2,25
"1002",1001002,83,121,2,206
"1003",1001003,98,191,13,302
"1004",1001004,73,223,4,300
"1005",1001005,46,258,7,311
"1006",1001006,60,105,2,167
"1007",1001007,13,93,3,109
"1008",1001008,27,201,10,238
"1009",1001009,70,38,5,113
"1010",1001010,36,240,6,282
"1011",1001011,74,203,4,281
"1012",1001012,142,22,1,165
"1013",1001013,178,51,8,237
"1014",1001014,229,5,40,274
"1015",1001015,149,70,3,222
"1016",1001016,41,201,10,252
"1017",1001017,206,93,3,302
"1018",1001018,21,93,10,124
"1019",1001019,115,149,2,266
"1020",1001020,173,64,14,251
"1021",1001021,28,45,6,79
"1022",1001022,10,66,2,78
"1023",1001023,128,142,24,294
"1024",1001024,116,170,11,297
"1025",1001025,148,34,12,194
"1026",1001026,211,65,8,284
"1027",1001027,154,57,10,221
"1028",1001028,100,108,4,212
"1029",1001029,173,99,12,284
"1030",1001030,160,81,9,250
"1031",1001031,120,113,2,235
"1032",1001032,102,139,8,249
"1033",1001033,127,59,17,203
"1034",1001034,28,255,6,289
"1035",1001035,52,72,10,134
"1036",1001036,130,109,14,253
"1037",1001037,146,134,13,293
"1038",1001038,59,268,11,338
"1039",1001039,118,67,7,192
"1040",1001040,40,263,3,306
"1041",1001041,120,169,15,304
"1042",1001042,121,42,9,172
"1043",1001043,115,36,7,158
"1044",1001044,47,277,6,330
"1045",1001045,120,130,15,265
"1046",1001046,186,104,20,310
"1047",1001047,125,141,8,274
"1048",1001048,93,0,0,93
"1049",1001049,110,93,7,210
"1050",1001050,18,284,1,303
"1051",1001051,38,102,6,146
"1052",1001052,25,29,5,59
"1053",1001053,190,22,5,217
"1054",1001054,140,127,13,280
"1055",1001055,98,18,5,121
"1056",1001056,118,24,4,146
"1057",1001057,106,21,5,132
"1058",1001058,171,110,4,285
"1059",1001059,145,90,11,246
"1060",1001060,35,250,9,294
"1061",1001061,119,63,3,185
"1062",1001062,147,118,19,284
"1063",1001063,101,59,6,166
"1064",1001064,163,87,5,255
"1065",1001065,67,83,3,153
"1066",1001066,32,274,11,317
"1067",1001067,175,45,3,223
"1068",1001068,36,220,2,258
"1069",1001069,135,20,5,160
"1070",1001070,156,135,17,308
"1071",1001071,18,122,3,143
"1072",1001072,140,84,11,235
"1073",1001073,203,118,9,330
"1074",1001074,112,80,12,204
"1075",1001075,58,252,4,314
"1076",1001076,68,79,12,159
"1077",1001077,119,163,10,292
"1078",1001078,115,54,9,178
"1079",1001079,61,185,4,250
"1080",1001080,93,165,11,269
"1081",1001081,92,221,7,320
"1082",1001082,118,90,12,220
"1083",1001083,122,94,12,228
"1084",1001084,173,59,10,242
"1085",1001085,70,179,5,254
"1086",1001086,53,111,17,181
"1087",1001087,200,68,12,280
"1088",1001088,259,31,6,296
"1089",1001089,189,162,6,357
"1090",1001090,38,157,6,201
"1091",1001091,108,38,5,151
"1092",1001092,101,89,5,195
"1093",1001093,111,130,8,249
"1094",1001094,73,0,1,74
"1095",1001095,102,88,8,198
"1096",1001096,145,121,18,284
"1097",1001097,217,66,12,295
"1098",1001098,196,126,19,341
"1099",1001099,71,100,2,173
"1100",1001100,64,137,7,208
"1101",1001101,150,142,13,305
"1102",1001102,232,59,7,298
"1103",1001103,49,123,11,183
"1104",1001104,42,19,2,63
"1105",1001105,167,109,5,281
"1106",1001106,57,181,25,263
"1107",1001107,128,67,18,213
"1108",1001108,195,63,4,262
"1109",1001109,104,144,4,252
"1110",1001110,32,213,2,247
"1111",1001111,199,44,7,250
"1112",1001112,195,23,4,222
"1113",1001113,187,89,4,280
"1114",1001114,68,184,5,257
"1115",1001115,100,136,13,249
"1116",1001116,312,24,29,365
"1117",1001117,168,100,12,280
"1118",1001118,211,33,8,252
"1119",1001119,143,142,29,314
"1120",1001120,38,235,9,282
"1121",1001121,124,104,5,233
"1122",1001122,24,29,1,54
"1123",1001123,36,270,2,308
"1124",1001124,123,50,6,179
"1125",1001125,122,86,5,213
"1126",1001126,138,44,2,184
"1127",1001127,63,123,3,189
"1128",1001128,50,202,10,262
"1129",1001129,33,175,4,212
"1130",1001130,46,219,1,266
"1131",1001131,119,68,10,197
"1132",1001132,28,227,5,260
"1133",1001133,86,193,10,289
"1134",1001134,77,18,6,101
"1135",1001135,100,37,6,143
"1136",1001136,154,30,6,190
"1137",1001137,158,13,5,176
"1138",1001138,124,41,5,170
"1139",1001139,123,49,4,176
"1140",1001140,51,26,11,88
"1141",1001141,52,180,4,236
"1142",1001142,133,138,12,283
"1143",1001143,133,122,4,259
"1144",1001144,142,33,1,176
"1145",1001145,58,223,0,281
"1146",1001146,135,123,10,268
"1147",1001147,19,208,4,231
"1148",1001148,97,91,8,196
"1149",1001149,28,128,2,158
"1150",1001150,4,3,1,8
"1151",1001151,149,42,17,208
"1152",1001152,220,41,10,271
"1153",1001153,184,120,9,313
"1154",1001154,175,83,9,267
"1155",1001155,34,182,15,231
"1156",1001156,186,32,8,226
"1157",1001157,13,105,6,124
"1158",1001158,86,91,1,178
"1159",1001159,161,68,11,240
"1160",1001160,124,83,5,212
"1161",1001161,60,156,3,219
"1162",1001162,179,44,8,231
"1163",1001163,21,2,8,31
"1164",1001164,86,116,17,219
"1165",1001165,132,157,18,307
"1166",1001166,214,61,8,283
"1167",1001167,90,103,9,202
"1168",1001168,138,52,13,203
"1169",1001169,147,65,4,216
"1170",1001170,14,45,2,61
"1171",1001171,27,178,11,216
"1172",1001172,244,37,28,309
"1173",1001173,210,7,4,221
"1174",1001174,222,37,8,267
"1175",1001175,126,56,4,186
"1176",1001176,68,157,4,229
"1177",1001177,76,70,10,156
"1178",1001178,33,51,2,86
"1179",1001179,46,179,1,226
"1180",1001180,102,59,9,170
"1181",1001181,77,139,2,218
"1182",1001182,158,65,11,234
"1183",1001183,144,142,1,287
"1184",1001184,182,54,11,247
"1185",1001185,175,44,9,228
"1186",1001186,152,128,2,282
"1187",1001187,75,176,32,283
"1188",1001188,124,141,13,278
"1189",1001189,66,110,2,178
"1190",1001190,122,65,9,196
"1191",1001191,106,75,11,192
"1192",1001192,47,191,4,242
"1193",1001193,161,75,16,252
"1194",1001194,120,103,15,238
"1195",1001195,140,81,6,227
"1196",1001196,183,75,22,280
"1197",1001197,279,2,12,293
"1198",1001198,28,237,5,270
"1199",1001199,69,190,9,268
"1200",1001200,123,150,6,279
"1201",1001201,120,140,10,270
"1202",1001202,84,152,16,252
"1203",1001203,122,26,3,151
"1204",1001204,144,62,10,216
"1205",1001205,109,176,18,303
"1206",1001206,70,13,4,87
"1207",1001207,157,131,12,300
"1208",1001208,61,38,2,101
"1209",1001209,139,143,11,293
"1210",1001210,133,143,14,290
"1211",1001211,62,106,5,173
"1212",1001212,9,126,2,137
"1213",1001213,198,85,16,299
"1214",1001214,48,28,4,80
"1215",1001215,49,26,5,80
"1216",1001216,123,149,16,288
"1217",1001217,46,107,13,166
"1218",1001218,113,181,6,300
"1219",1001219,104,84,9,197
"1220",1001220,159,130,8,297
"1221",1001221,72,204,4,280
"1222",1001222,108,41,3,152
"1223",1001223,63,197,2,262
"1224",1001224,105,206,10,321
"1225",1001225,196,18,2,216
"1226",1001226,158,22,1,181
"1227",1001227,223,36,3,262
"1228",1001228,22,143,1,166
"1229",1001229,152,99,9,260
"1230",1001230,63,172,11,246
"1231",1001231,129,97,11,237
"1232",1001232,175,43,22,240
"1233",1001233,143,3,5,151
"1234",1001234,5,48,1,54
"1235",1001235,150,79,13,242
"1236",1001236,97,138,7,242
"1237",1001237,209,52,4,265
"1238",1001238,120,55,12,187
"1239",1001239,139,86,12,237
"1240",1001240,93,130,16,239
"1241",1001241,75,243,9,327
"1242",1001242,60,163,5,228
"1243",1001243,199,47,11,257
"1244",1001244,158,82,12,252
"1245",1001245,184,149,8,341
"1246",1001246,179,81,12,272
"1247",1001247,244,23,11,278
"1248",1001248,75,149,4,228
"1249",1001249,61,156,3,220
"1250",1001250,32,209,6,247
"1251",1001251,36,184,5,225
"1252",1001252,53,104,4,161
"1253",1001253,10,0,1,11
"1254",1001254,186,71,4,261
"1255",1001255,184,99,15,298
"1256",1001256,183,87,8,278
"1257",1001257,106,74,9,189
"1258",1001258,144,115,12,271
"1259",1001259,118,173,18,309
"1260",1001260,150,95,3,248
"1261",1001261,77,62,6,145
"1262",1001262,52,78,3,133
"1263",1001263,125,168,4,297
"1264",1001264,224,4,0,228
"1265",1001265,81,54,12,147
"1266",1001266,15,61,2,78
"1267",1001267,88,43,4,135
"1268",1001268,106,109,32,247
"1269",1001269,213,15,5,233
"1270",1001270,129,100,18,247
"1271",1001271,12,63,1,76
"1272",1001272,123,104,15,242
"1273",1001273,136,146,26,308
"1274",1001274,141,99,13,253
"1275",1001275,174,26,7,207
"1276",1001276,63,145,5,213
"1277",1001277,88,67,7,162
"1278",1001278,78,81,11,170
"1279",1001279,144,42,5,191
"1280",1001280,164,46,6,216
"1281",1001281,39,1,3,43
"1282",1001282,97,150,5,252
"1283",1001283,91,98,5,194
"1284",1001284,91,121,5,217
"1285",1001285,241,43,11,295
"1286",1001286,83,80,3,166
"1287",1001287,190,31,16,237
"1288",1001288,28,272,8,308
"1289",1001289,45,182,9,236
"1290",1001290,153,46,3,202
"1291",1001291,176,66,17,259
"1292",1001292,188,23,6,217
"1293",1001293,94,70,3,167
"1294",1001294,91,179,10,280
"1295",1001295,104,134,13,251
"1296",1001296,80,94,10,184
"1297",1001297,152,107,11,270
"1298",1001298,44,151,6,201
"1299",1001299,21,18,3,42
"1300",1001300,14,6,0,20
"1301",1001301,88,194,10,292
"1302",1001302,154,127,8,289
"1303",1001303,112,81,12,205
"1304",1001304,88,160,8,256
"1305",1001305,107,230,11,348
"1306",1001306,63,180,2,245
"1307",1001307,211,24,12,247
"1308",1001308,162,137,9,308
"1309",1001309,230,48,6,284
"1310",1001310,51,97,3,151
"1311",1001311,152,149,13,314
"1312",1001312,97,3,2,102
"1313",1001313,175,105,6,286
"1314",1001314,205,77,6,288
"1315",1001315,100,153,16,269
"1316",1001316,193,106,10,309
"1317",1001317,47,31,5,83
"1318",1001318,237,46,8,291
"1319",1001319,186,81,5,272
"1320",1001320,166,108,11,285
"1321",1001321,152,73,3,228
"1322",1001322,53,208,6,267
"1323",1001323,231,31,11,273
"1324",1001324,198,50,12,260
"1325",1001325,220,72,12,304
"1326",1001326,130,144,10,284
"1327",1001327,168,97,11,276
"1328",1001328,158,91,9,258
"1329",1001329,170,13,1,184
"1330",1001330,40,51,2,93
"1331",1001331,27,179,12,218
"1332",1001332,63,191,23,277
"1333",1001333,69,95,16,180
"1334",1001334,99,129,11,239
"1335",1001335,99,157,4,260
"1336",1001336,25,159,4,188
"1337",1001337,195,55,10,260
"1338",1001338,95,94,8,197
"1339",1001339,85,89,4,178
"1340",1001340,127,63,5,195
"1341",1001341,17,205,5,227
"1342",1001342,236,18,4,258
"1343",1001343,72,163,7,242
"1344",1001344,32,101,5,138
"1345",1001345,96,76,11,183
"1346",1001346,112,84,4,200
"1347",1001347,126,74,7,207
"1348",1001348,167,67,5,239
"1349",1001349,73,3,1,77
"1350",1001350,65,16,3,84
"1351",1001351,190,68,17,275
"1352",1001352,39,278,5,322
"1353",1001353,119,93,10,222
"1354",1001354,82,86,4,172
"1355",1001355,253,14,1,268
"1356",1001356,215,76,10,301
"1357",1001357,67,1,1,69
"1358",1001358,29,194,2,225
"1359",1001359,43,195,15,253
"1360",1001360,64,19,5,88
"1361",1001361,163,70,13,246
"1362",1001362,100,49,3,152
"1363",1001363,52,94,4,150
"1364",1001364,160,76,6,242
"1365",1001365,143,98,5,246
"1366",1001366,164,32,5,201
"1367",1001367,59,194,4,257
"1368",1001368,141,149,12,302
"1369",1001369,123,90,10,223
"1370",1001370,11,23,0,34
"1371",1001371,112,110,5,227
"1372",1001372,179,67,5,251
"1373",1001373,49,158,7,214
"1374",1001374,76,91,2,169
"1375",1001375,206,70,14,290
"1376",1001376,192,35,6,233
"1377",1001377,82,55,8,145
"1378",1001378,45,168,7,220
"1379",1001379,38,170,2,210
"1380",1001380,86,84,1,171
"1381",1001381,82,141,7,230
"1382",1001382,95,199,4,298
"1383",1001383,192,65,15,272
"1384",1001384,220,86,20,326
"1385",1001385,155,42,8,205
"1386",1001386,214,52,11,277
"1387",1001387,97,173,8,278
"1388",1001388,101,35,10,146
"1389",1001389,125,53,4,182
"1390",1001390,238,24,4,266
"1391",1001391,50,112,5,167
"1392",1001392,24,19,3,46
"1393",1001393,72,269,13,354
"1394",1001394,102,171,12,285
"1395",1001395,9,63,0,72
"1396",1001396,187,44,14,245
"1397",1001397,193,21,8,222
"1398",1001398,100,194,15,309
"1399",1001399,180,24,4,208
"1400",1001400,84,66,1,151
"1401",1001401,149,122,19,290
"1402",1001402,17,195,1,213
"1403",1001403,127,174,4,305
"1404",1001404,105,16,3,124
"1405",1001405,252,21,2,275
"1406",1001406,62,137,9,208
"1407",1001407,139,119,7,265
"1408",1001408,87,206,16,309
"1409",1001409,31,126,6,163
"1410",1001410,92,154,1,247
"1411",1001411,87,85,11,183
"1412",1001412,173,65,8,246
"1413",1001413,58,178,15,251
"1414",1001414,146,123,11,280
"1415",1001415,189,32,9,230
"1416",1001416,189,75,16,280
"1417",1001417,123,30,7,160
"1418",1001418,14,185,8,207
"1419",1001419,178,85,6,269
"1420",1001420,133,96,29,258
"1421",1001421,44,128,7,179
"1422",1001422,153,101,6,260
"1423",1001423,34,221,3,258
"1424",1001424,99,94,3,196
"1425",1001425,29,17,4,50
"1426",1001426,37,13,0,50
"1427",1001427,100,102,14,216
"1428",1001428,88,96,5,189
"1429",1001429,95,158,9,262
"1430",1001430,92,52,10,154
"1431",1001431,105,147,8,260
"1432",1001432,49,1,1,51
"1433",1001433,166,108,12,286
"1434",1001434,123,128,5,256
"1435",1001435,199,30,7,236
"1436",1001436,125,129,17,271
"1437",1001437,55,216,7,278
"1438",1001438,129,68,10,207
"1439",1001439,104,160,7,271
"1440",1001440,105,54,4,163
"1441",1001441,160,104,10,274
"1442",1001442,101,161,15,277
"1443",1001443,112,109,16,237
"1444",1001444,156,53,11,220
"1445",1001445,111,180,17,308
"1446",1001446,65,183,11,259
"1447",1001447,25,243,15,283
"1448",1001448,43,170,6,219
"1449",1001449,177,124,4,305
"1450",1001450,30,219,6,255
"1451",1001451,56,149,3,208
"1452",1001452,23,182,4,209
"1453",1001453,10,3,0,13
"1454",1001454,194,30,6,230
"1455",1001455,158,98,4,260
"1456",1001456,9,5,1,15
"1457",1001457,213,43,7,263
"1458",1001458,149,116,7,272
"1459",1001459,112,72,11,195
"1460",1001460,17,235,6,258
"1461",1001461,134,120,15,269
"1462",1001462,154,112,14,280
"1463",1001463,63,131,11,205
"1464",1001464,12,24,0,36
"1465",1001465,123,55,3,181
"1466",1001466,94,185,7,286
"1467",1001467,25,3,1,29
"1468",1001468,19,70,3,92
"1469",1001469,149,77,7,233
"1470",1001470,57,107,1,165
"1471",1001471,66,40,2,108
"1472",1001472,20,288,0,308
"1473",1001473,39,219,4,262
"1474",1001474,30,231,8,269
"1475",1001475,86,42,3,131
"1476",1001476,61,69,6,136
"1477",1001477,29,195,2,226
"1478",1001478,21,9,4,34
"1479",1001479,46,13,2,61
"1480",1001480,75,100,4,179
"1481",1001481,84,135,20,239
"1482",1001482,85,48,5,138
"1483",1001483,202,74,7,283
"1484",1001484,67,90,1,158
"1485",1001485,138,81,4,223
"1486",1001486,220,93,13,326
"1487",1001487,8,58,2,68
"1488",1001488,56,195,16,267
"1489",1001489,126,119,6,251
"1490",1001490,54,154,6,214
"1491",1001491,72,242,13,327
"1492",1001492,145,137,20,302
"1493",1001493,184,39,3,226
"1494",1001494,71,152,5,228
"1495",1001495,17,120,0,137
"1496",1001496,224,21,11,256
"1497",1001497,94,51,3,148
"1498",1001498,101,32,1,134
"1499",1001499,130,117,11,258
"1500",1001500,58,153,10,221
"1501",1001501,53,212,14,279
"1502",1001502,135,38,6,179
"1503",1001503,73,43,2,118
"1504",1001504,113,177,9,299
"1505",1001505,218,29,12,259
"1506",1001506,14,24,3,41
"1507",1001507,168,75,12,255
"1508",1001508,122,214,7,343
"1509",1001509,122,26,7,155
"1510",1001510,148,104,8,260
"1511",1001511,99,165,6,270
"1512",1001512,56,254,1,311
"1513",1001513,64,24,4,92
"1514",1001514,28,169,2,199
"1515",1001515,207,48,7,262
"1516",1001516,129,86,11,226
"1517",1001517,126,24,2,152
"1518",1001518,116,131,3,250
"1519",1001519,94,201,20,315
"1520",1001520,27,63,6,96
"1521",1001521,190,27,2,219
"1522",1001522,174,76,5,255
"1523",1001523,89,107,7,203
"1524",1001524,102,183,10,295
"1525",1001525,69,150,6,225
"1526",1001526,71,204,6,281
"1527",1001527,132,39,9,180
"1528",1001528,175,101,7,283
"1529",1001529,131,106,11,248
"1530",1001530,182,19,6,207
"1531",1001531,145,50,10,205
"1532",1001532,125,98,5,228
"1533",1001533,238,23,6,267
"1534",1001534,205,14,4,223
"1535",1001535,29,7,1,37
"1536",1001536,58,271,3,332
"1537",1001537,106,155,9,270
"1538",1001538,26,218,9,253
"1539",1001539,140,183,8,331
"1540",1001540,103,116,6,225
"1541",1001541,46,202,8,256
"1542",1001542,69,161,17,247
"1543",1001543,138,185,14,337
"1544",1001544,95,139,19,253
"1545",1001545,54,137,1,192
"1546",1001546,150,163,5,318
"1547",1001547,323,18,4,345
"1548",1001548,12,120,2,134
"1549",1001549,208,18,3,229
"1550",1001550,196,48,6,250
"1551",1001551,155,139,17,311
"1552",1001552,159,37,3,199
"1553",1001553,149,32,1,182
"1554",1001554,62,129,2,193
"1555",1001555,55,235,10,300
"1556",1001556,151,78,18,247
"1557",1001557,149,83,15,247
"1558",1001558,69,60,3,132
"1559",1001559,24,113,3,140
"1560",1001560,85,112,31,228
"1561",1001561,130,133,13,276
"1562",1001562,252,5,24,281
"1563",1001563,147,60,7,214
"1564",1001564,208,98,2,308
"1565",1001565,105,50,7,162
"1566",1001566,71,203,13,287
"1567",1001567,105,135,5,245
"1568",1001568,20,246,6,272
"1569",1001569,17,4,1,22
"1570",1001570,153,222,11,386
"1571",1001571,45,222,3,270
"1572",1001572,227,36,10,273
"1573",1001573,73,106,5,184
"1574",1001574,91,80,5,176
"1575",1001575,178,25,6,209
"1576",1001576,50,195,7,252
"1577",1001577,28,227,9,264
"1578",1001578,48,221,8,277
"1579",1001579,68,154,5,227
"1580",1001580,85,118,9,212
"1581",1001581,109,67,12,188
"1582",1001582,18,254,3,275
"1583",1001583,141,90,18,249
"1584",1001584,84,214,1,299
"1585",1001585,81,134,11,226
"1586",1001586,56,185,5,246
"1587",1001587,155,117,20,292
"1588",1001588,129,92,13,234
"1589",1001589,81,13,1,95
"1590",1001590,66,173,4,243
"1591",1001591,208,51,9,268
"1592",1001592,139,52,11,202
"1593",1001593,18,191,4,213
"1594",1001594,151,86,8,245
"1595",1001595,33,253,5,291
"1596",1001596,150,25,6,181
"1597",1001597,160,100,6,266
"1598",1001598,199,52,8,259
"1599",1001599,94,113,4,211
"1600",1001600,4,30,0,34
"1601",1001601,58,134,8,200
"1602",1001602,140,81,9,230
"1603",1001603,55,118,5,178
"1604",1001604,46,207,4,257
"1605",1001605,66,274,3,343
"1606",1001606,109,146,16,271
"1607",1001607,173,78,12,263
"1608",1001608,93,95,21,209
"1609",1001609,57,200,8,265
"1610",1001610,122,34,8,164
"1611",1001611,107,140,10,257
"1612",1001612,121,83,8,212
"1613",1001613,127,112,6,245
"1614",1001614,101,179,21,301
"1615",1001615,125,133,12,270
"1616",1001616,139,103,19,261
"1617",1001617,113,64,2,179
"1618",1001618,111,107,6,224
"1619",1001619,190,57,10,257
"1620",1001620,43,164,2,209
"1621",1001621,163,147,10,320
"1622",1001622,29,92,5,126
"1623",1001623,128,74,5,207
"1624",1001624,39,46,4,89
"1625",1001625,113,35,0,148
"1626",1001626,178,89,6,273
"1627",1001627,167,24,12,203
"1628",1001628,83,202,15,300
"1629",1001629,63,145,5,213
"1630",1001630,133,84,9,226
"1631",1001631,86,230,10,326
"1632",1001632,14,128,1,143
"1633",1001633,152,81,15,248
"1634",1001634,54,144,6,204
"1635",1001635,28,140,3,171
"1636",1001636,225,5,5,235
"1637",1001637,233,33,6,272
"1638",1001638,148,48,11,207
"1639",1001639,186,127,17,330
"1640",1001640,87,165,3,255
"1641",1001641,19,151,3,173
"1642",1001642,87,26,0,113
"1643",1001643,195,72,17,284
"1644",1001644,157,45,8,210
"1645",1001645,152,19,8,179
"1646",1001646,55,15,1,71
"1647",1001647,110,203,9,322
"1648",1001648,131,50,4,185
"1649",1001649,135,129,15,279
"1650",1001650,77,135,10,222
"1651",1001651,52,178,3,233
"1652",1001652,15,48,3,66
"1653",1001653,115,42,6,163
"1654",1001654,31,67,1,99
"1655",1001655,115,35,5,155
"1656",1001656,51,15,3,69
"1657",1001657,49,242,12,303
"1658",1001658,117,172,9,298
"1659",1001659,19,5,1,25
"1660",1001660,151,108,12,271
"1661",1001661,50,173,14,237
"1662",1001662,85,207,13,305
"1663",1001663,97,100,9,206
"1664",1001664,99,96,8,203
"1665",1001665,182,33,3,218
"1666",1001666,141,126,6,273
"1667",1001667,91,62,11,164
"1668",1001668,153,20,3,176
"1669",1001669,132,74,4,210
"1670",1001670,115,31,2,148
"1671",1001671,135,100,1,236
"1672",1001672,119,173,9,301
"1673",1001673,241,35,5,281
"1674",1001674,39,26,4,69
"1675",1001675,179,119,10,308
"1676",1001676,192,23,4,219
"1677",1001677,184,87,12,283
"1678",1001678,26,283,1,310
"1679",1001679,89,150,5,244
"1680",1001680,125,38,6,169
"1681",1001681,23,236,3,262
"1682",1001682,36,238,15,289
"1683",1001683,54,226,11,291
"1684",1001684,200,24,22,246
"1685",1001685,46,163,14,223
"1686",1001686,184,27,5,216
"1687",1001687,171,62,6,239
"1688",1001688,34,206,1,241
"1689",1001689,183,17,4,204
"1690",1001690,113,120,5,238
"1691",1001691,131,83,8,222
"1692",1001692,129,13,6,148
"1693",1001693,98,168,11,277
"1694",1001694,101,93,6,200
"1695",1001695,58,198,4,260
"1696",1001696,174,45,11,230
"1697",1001697,200,114,14,328
"1698",1001698,18,0,0,18
"1699",1001699,82,143,14,239
"1700",1001700,190,2,1,193
"1701",1001701,120,70,20,210
"1702",1001702,49,298,14,361
"1703",1001703,93,9,0,102
"1704",1001704,77,107,12,196
"1705",1001705,68,43,2,113
"1706",1001706,156,84,6,246
"1707",1001707,59,169,9,237
"1708",1001708,49,213,8,270
"1709",1001709,133,119,6,258
"1710",1001710,27,239,6,272
"1711",1001711,25,325,7,357
"1712",1001712,140,51,0,191
"1713",1001713,38,211,2,251
"1714",1001714,93,33,11,137
"1715",1001715,80,225,14,319
"1716",1001716,66,103,3,172
"1717",1001717,64,160,12,236
"1718",1001718,144,63,7,214
"1719",1001719,12,12,3,27
"1720",1001720,134,38,11,183
"1721",1001721,45,173,11,229
"1722",1001722,70,157,9,236
"1723",1001723,64,65,10,139
"1724",1001724,116,143,15,274
"1725",1001725,62,170,5,237
"1726",1001726,179,34,9,222
"1727",1001727,85,186,5,276
"1728",1001728,19,333,2,354
"1729",1001729,197,34,4,235
"1730",1001730,199,29,4,232
"1731",1001731,111,44,5,160
"1732",1001732,165,55,7,227
"1733",1001733,183,15,5,203
"1734",1001734,0,57,5,62
"1735",1001735,117,12,4,133
"1736",1001736,259,45,15,319
"1737",1001737,176,39,6,221
"1738",1001738,82,177,10,269
"1739",1001739,38,15,0,53
"1740",1001740,84,179,12,275
"1741",1001741,108,95,10,213
"1742",1001742,150,37,9,196
"1743",1001743,168,113,7,288
"1744",1001744,92,120,8,220
"1745",1001745,51,101,4,156
"1746",1001746,93,70,5,168
"1747",1001747,154,57,2,213
"1748",1001748,297,21,3,321
"1749",1001749,139,45,6,190
"1750",1001750,215,36,8,259
"1751",1001751,177,56,10,243
"1752",1001752,171,105,12,288
"1753",1001753,72,11,1,84
"1754",1001754,158,107,9,274
"1755",1001755,213,98,8,319
"1756",1001756,164,66,3,233
"1757",1001757,231,36,14,281
"1758",1001758,54,273,3,330
"1759",1001759,37,23,5,65
"1760",1001760,266,43,13,322
"1761",1001761,51,190,7,248
"1762",1001762,193,47,6,246
"1763",1001763,99,112,10,221
"1764",1001764,203,73,15,291
"1765",1001765,54,36,2,92
"1766",1001766,36,223,9,268
"1767",1001767,4,2,7,13
"1768",1001768,87,104,8,199
"1769",1001769,147,37,7,191
"1770",1001770,65,180,6,251
"1771",1001771,32,276,1,309
"1772",1001772,67,166,10,243
"1773",1001773,104,46,14,164
"1774",1001774,16,265,3,284
"1775",1001775,118,84,2,204
"1776",1001776,192,83,13,288
"1777",1001777,78,109,10,197
"1778",1001778,203,69,12,284
"1779",1001779,55,157,1,213
"1780",1001780,116,66,5,187
"1781",1001781,70,23,3,96
"1782",1001782,126,21,7,154
"1783",1001783,39,213,5,257
"1784",1001784,45,191,2,238
"1785",1001785,43,231,3,277
"1786",1001786,205,98,12,315
"1787",1001787,193,11,7,211
"1788",1001788,64,241,5,310
"1789",1001789,27,61,8,96
"1790",1001790,123,40,4,167
"1791",1001791,114,107,9,230
"1792",1001792,148,18,4,170
"1793",1001793,19,83,4,106
"1794",1001794,154,112,8,274
"1795",1001795,157,120,9,286
"1796",1001796,19,153,6,178
"1797",1001797,81,199,12,292
"1798",1001798,213,54,8,275
"1799",1001799,143,50,5,198
"1800",1001800,28,196,5,229
"1801",1001801,113,194,3,310
"1802",1001802,91,174,6,271
"1803",1001803,125,64,7,196
"1804",1001804,142,160,12,314
"1805",1001805,89,105,2,196
"1806",1001806,131,68,10,209
"1807",1001807,127,87,16,230
"1808",1001808,47,269,2,318
"1809",1001809,130,120,13,263
"1810",1001810,110,229,9,348
"1811",1001811,26,8,1,35
"1812",1001812,107,134,7,248
"1813",1001813,75,244,6,325
"1814",1001814,183,27,7,217
"1815",1001815,153,168,5,326
"1816",1001816,3,6,0,9
"1817",1001817,15,65,2,82
"1818",1001818,93,183,9,285
"1819",1001819,88,169,8,265
"1820",1001820,141,96,7,244
"1821",1001821,155,55,4,214
"1822",1001822,142,19,9,170
"1823",1001823,188,19,7,214
"1824",1001824,61,186,24,271
"1825",1001825,92,188,11,291
"1826",1001826,71,241,2,314
"1827",1001827,53,92,9,154
"1828",1001828,77,132,19,228
"1829",1001829,168,125,7,300
"1830",1001830,52,54,4,110
"1831",1001831,185,36,7,228
"1832",1001832,103,68,7,178
"1833",1001833,49,20,3,72
"1834",1001834,104,77,11,192
"1835",1001835,132,146,6,284
"1836",1001836,143,99,12,254
"1837",1001837,145,3,4,152
"1838",1001838,188,63,11,262
"1839",1001839,183,41,5,229
"1840",1001840,210,17,5,232
"1841",1001841,42,195,14,251
"1842",1001842,92,116,7,215
"1843",1001843,192,40,4,236
"1844",1001844,138,93,8,239
"1845",1001845,45,18,2,65
"1846",1001846,45,96,4,145
"1847",1001847,67,106,4,177
"1848",1001848,129,76,12,217
"1849",1001849,55,256,16,327
"1850",1001850,120,24,7,151
"1851",1001851,226,31,15,272
"1852",1001852,100,137,14,251
"1853",1001853,119,140,8,267
"1854",1001854,98,226,9,333
"1855",1001855,173,63,5,241
"1856",1001856,218,23,12,253
"1857",1001857,124,187,8,319
"1858",1001858,28,227,7,262
"1859",1001859,64,155,12,231
"1860",1001860,89,83,11,183
"1861",1001861,107,89,4,200
"1862",1001862,41,48,3,92
"1863",1001863,80,39,8,127
"1864",1001864,54,171,11,236
"1865",1001865,224,29,7,260
"1866",1001866,80,142,17,239
"1867",1001867,179,2,1,182
"1868",1001868,64,222,10,296
"1869",1001869,199,17,6,222
"1870",1001870,195,33,14,242
"1871",1001871,93,131,4,228
"1872",1001872,156,17,6,179
"1873",1001873,182,24,9,215
"1874",1001874,131,77,13,221
"1875",1001875,34,218,10,262
"1876",1001876,129,110,11,250
"1877",1001877,185,56,8,249
"1878",1001878,154,123,23,300
"1879",1001879,89,163,12,264
"1880",1001880,87,112,21,220
"1881",1001881,57,255,3,315
"1882",1001882,18,282,7,307
"1883",1001883,101,98,9,208
"1884",1001884,114,100,10,224
"1885",1001885,104,167,5,276
"1886",1001886,30,92,3,125
"1887",1001887,44,10,1,55
"1888",1001888,142,121,7,270
"1889",1001889,118,92,8,218
"1890",1001890,76,74,3,153
"1891",1001891,155,44,7,206
"1892",1001892,72,174,8,254
"1893",1001893,163,165,18,346
"1894",1001894,110,99,9,218
"1895",1001895,112,37,6,155
"1896",1001896,80,114,5,199
"1897",1001897,20,193,2,215
"1898",1001898,126,33,8,167
"1899",1001899,117,26,12,155
"1900",1001900,113,78,2,193
"1901",1001901,178,64,11,253
"1902",1001902,169,29,3,201
"1903",1001903,131,65,4,200
"1904",1001904,96,128,8,232
"1905",1001905,52,108,2,162
"1906",1001906,16,2,0,18
"1907",1001907,191,75,19,285
"1908",1001908,238,22,9,269
"1909",1001909,163,108,13,284
"1910",1001910,140,157,9,306
"1911",1001911,94,203,3,300
"1912",1001912,200,28,5,233
"1913",1001913,245,34,6,285
"1914",1001914,192,67,5,264
"1915",1001915,42,48,4,94
"1916",1001916,133,136,8,277
"1917",1001917,191,71,2,264
"1918",1001918,126,167,8,301
"1919",1001919,110,103,11,224
"1920",1001920,101,128,23,252
"1921",1001921,44,136,15,195
"1922",1001922,65,31,7,103
"1923",1001923,121,50,4,175
"1924",1001924,69,175,19,263
"1925",1001925,223,20,2,245
"1926",1001926,97,21,7,125
"1927",1001927,30,252,26,308
"1928",1001928,55,268,6,329
"1929",1001929,209,86,13,308
"1930",1001930,53,73,5,131
"1931",1001931,113,195,11,319
"1932",1001932,6,19,4,29
"1933",1001933,21,186,5,212
"1934",1001934,111,30,12,153
"1935",1001935,136,149,16,301
"1936",1001936,209,30,9,248
"1937",1001937,3,3,0,6
"1938",1001938,216,57,9,282
"1939",1001939,32,36,1,69
"1940",1001940,77,170,14,261
"1941",1001941,25,156,5,186
"1942",1001942,32,8,4,44
"1943",1001943,20,192,5,217
"1944",1001944,119,94,6,219
"1945",1001945,60,229,8,297
"1946",1001946,143,49,5,197
"1947",1001947,137,47,13,197
"1948",1001948,140,142,5,287
"1949",1001949,41,50,0,91
"1950",1001950,15,0,0,15
"1951",1001951,49,207,8,264
"1952",1001952,40,171,4,215
"1953",1001953,186,57,14,257
"1954",1001954,95,185,7,287
"1955",1001955,97,134,4,235
"1956",1001956,158,64,4,226
"1957",1001957,4,2,0,6
"1958",1001958,34,92,6,132
"1959",1001959,162,65,6,233
"1960",1001960,122,72,13,207
"1961",1001961,178,117,13,308
"1962",1001962,115,58,4,177
"1963",1001963,149,56,9,214
"1964",1001964,185,99,11,295
"1965",1001965,263,30,7,300
"1966",1001966,32,90,7,129
"1967",1001967,28,59,7,94
"1968",1001968,89,153,5,247
"1969",1001969,186,99,13,298
"1970",1001970,82,119,6,207
"1971",1001971,90,81,3,174
"1972",1001972,115,172,15,302
"1973",1001973,44,222,9,275
"1974",1001974,176,31,11,218
"1975",1001975,31,128,1,160
"1976",1001976,134,75,12,221
"1977",1001977,232,16,5,253
"1978",1001978,137,85,10,232
"1979",1001979,191,31,6,228
"1980",1001980,2,51,0,53
"1981",1001981,140,20,5,165
"1982",1001982,108,68,14,190
"1983",1001983,101,73,2,176
"1984",1001984,21,22,1,44
"1985",1001985,22,3,3,28
"1986",1001986,145,99,8,252
"1987",1001987,79,73,3,155
"1988",1001988,61,158,4,223
"1989",1001989,174,66,7,247
"1990",1001990,196,29,8,233
"1991",1001991,155,142,28,325
"1992",1001992,135,128,7,270
"1993",1001993,153,47,7,207
"1994",1001994,57,197,8,262
"1995",1001995,192,37,5,234
"1996",1001996,50,139,1,190
"1997",1001997,76,174,13,263
"1998",1001998,53,120,3,176
"1999",1001999,114,67,2,183
"2000",1002000,174,83,16,273
"2001",1002001,119,118,12,249
"2002",1002002,6,67,2,75
"2003",1002003,7,241,3,251
"2004",1002004,51,134,8,193
"2005",1002005,67,172,5,244
"2006",1002006,53,231,9,293
"2007",1002007,106,90,3,199
"2008",1002008,128,18,7,153
"2009",1002009,124,63,10,197
"2010",1002010,145,83,14,242
"2011",1002011,133,165,14,312
"2012",1002012,342,108,24,474
"2013",1002013,104,123,10,237
"2014",1002014,133,90,8,231
"2015",1002015,182,26,10,218
"2016",1002016,190,100,15,305
"2017",1002017,133,119,13,265
"2018",1002018,162,27,11,200
"2019",1002019,142,5,5,152
"2020",1002020,150,37,6,193
"2021",1002021,115,91,12,218
"2022",1002022,130,95,5,230
"2023",1002023,65,191,13,269
"2024",1002024,64,164,21,249
"2025",1002025,27,128,4,159
"2026",1002026,203,31,5,239
"2027",1002027,17,328,4,349
"2028",1002028,61,139,12,212
"2029",1002029,100,171,16,287
"2030",1002030,87,92,15,194
"2031",1002031,189,42,11,242
"2032",1002032,135,161,13,309
"2033",1002033,131,25,9,165
"2034",1002034,81,129,8,218
"2035",1002035,67,118,6,191
"2036",1002036,75,112,14,201
"2037",1002037,162,71,2,235
"2038",1002038,44,246,4,294
"2039",1002039,48,80,7,135
"2040",1002040,129,91,1,221
"2041",1002041,70,163,24,257
"2042",1002042,208,106,15,329
"2043",1002043,50,182,6,238
"2044",1002044,199,26,5,230
"2045",1002045,269,3,12,284
"2046",1002046,85,48,13,146
"2047",1002047,120,134,13,267
"2048",1002048,154,120,10,284
"2049",1002049,154,110,15,279
"2050",1002050,39,255,4,298
"2051",1002051,1,3,0,4
"2052",1002052,158,101,1,260
"2053",1002053,73,174,4,251
"2054",1002054,198,69,11,278
"2055",1002055,136,28,1,165
"2056",1002056,197,57,3,257
"2057",1002057,204,105,14,323
"2058",1002058,127,94,13,234
"2059",1002059,83,85,5,173
"2060",1002060,43,44,4,91
"2061",1002061,22,4,2,28
"2062",1002062,41,150,0,191
"2063",1002063,137,87,13,237
"2064",1002064,84,73,2,159
"2065",1002065,161,50,10,221
"2066",1002066,82,38,10,130
"2067",1002067,4,3,2,9
"2068",1002068,44,181,9,234
"2069",1002069,148,154,13,315
"2070",1002070,41,221,8,270
"2071",1002071,212,0,0,212
"2072",1002072,115,110,0,225
"2073",1002073,124,168,8,300
"2074",1002074,37,158,5,200
"2075",1002075,90,155,25,270
"2076",1002076,6,32,1,39
"2077",1002077,81,120,10,211
"2078",1002078,29,240,10,279
"2079",1002079,186,80,12,278
"2080",1002080,108,124,6,238
"2081",1002081,234,37,8,279
"2082",1002082,47,198,14,259
"2083",1002083,210,28,18,256
"2084",1002084,145,92,0,237
"2085",1002085,47,168,5,220
"2086",1002086,65,181,13,259
"2087",1002087,56,152,5,213
"2088",1002088,25,8,4,37
"2089",1002089,68,135,11,214
"2090",1002090,102,209,6,317
"2091",1002091,280,35,7,322
"2092",1002092,5,3,0,8
"2093",1002093,164,31,4,199
"2094",1002094,76,222,7,305
"2095",1002095,144,168,11,323
"2096",1002096,118,47,4,169
"2097",1002097,50,119,3,172
"2098",1002098,106,109,11,226
"2099",1002099,119,64,10,193
"2100",1002100,146,92,10,248
"2101",1002101,144,50,3,197
"2102",1002102,72,30,5,107
"2103",1002103,170,39,7,216
"2104",1002104,34,246,20,300
"2105",1002105,112,25,2,139
"2106",1002106,77,117,12,206
"2107",1002107,169,113,11,293
"2108",1002108,25,3,1,29
"2109",1002109,125,101,14,240
"2110",1002110,140,98,15,253
"2111",1002111,71,161,6,238
"2112",1002112,235,50,15,300
"2113",1002113,60,42,4,106
"2114",1002114,93,47,4,144
"2115",1002115,96,88,21,205
"2116",1002116,93,138,3,234
"2117",1002117,178,33,8,219
"2118",1002118,71,127,9,207
"2119",1002119,146,25,6,177
"2120",1002120,116,49,4,169
"2121",1002121,187,66,6,259
"2122",1002122,80,189,14,283
"2123",1002123,46,225,8,279
"2124",1002124,153,92,7,252
"2125",1002125,90,195,6,291
"2126",1002126,110,96,25,231
"2127",1002127,21,210,5,236
"2128",1002128,93,124,7,224
"2129",1002129,87,63,5,155
"2130",1002130,136,73,8,217
"2131",1002131,184,87,19,290
"2132",1002132,116,179,9,304
"2133",1002133,167,68,4,239
"2134",1002134,87,109,5,201
"2135",1002135,216,77,11,304
"2136",1002136,64,271,2,337
"2137",1002137,18,52,2,72
"2138",1002138,144,0,0,144
"2139",1002139,122,70,10,202
"2140",1002140,174,89,5,268
"2141",1002141,192,47,11,250
"2142",1002142,153,62,5,220
"2143",1002143,94,202,5,301
"2144",1002144,180,57,4,241
"2145",1002145,132,53,6,191
"2146",1002146,95,148,13,256
"2147",1002147,176,88,10,274
"2148",1002148,146,9,3,158
"2149",1002149,50,190,7,247
"2150",1002150,143,87,11,241
"2151",1002151,124,86,28,238
"2152",1002152,53,47,5,105
"2153",1002153,99,108,20,227
"2154",1002154,56,21,1,78
"2155",1002155,80,165,8,253
"2156",1002156,100,170,10,280
"2157",1002157,188,99,12,299
"2158",1002158,152,91,8,251
"2159",1002159,140,79,6,225
"2160",1002160,60,179,3,242
"2161",1002161,37,175,8,220
"2162",1002162,47,27,4,78
"2163",1002163,145,23,2,170
"2164",1002164,167,64,6,237
"2165",1002165,258,11,9,278
"2166",1002166,111,139,12,262
"2167",1002167,68,232,15,315
"2168",1002168,129,64,10,203
"2169",1002169,159,141,18,318
"2170",1002170,42,103,8,153
"2171",1002171,186,69,9,264
"2172",1002172,110,48,9,167
"2173",1002173,92,141,6,239
"2174",1002174,95,76,6,177
"2175",1002175,46,157,3,206
"2176",1002176,211,40,12,263
"2177",1002177,193,53,15,261
"2178",1002178,159,51,12,222
"2179",1002179,48,12,3,63
"2180",1002180,70,139,9,218
"2181",1002181,104,208,6,318
"2182",1002182,58,202,10,270
"2183",1002183,34,7,0,41
"2184",1002184,49,228,8,285
"2185",1002185,97,168,11,276
"2186",1002186,76,151,14,241
"2187",1002187,53,52,1,106
"2188",1002188,78,67,8,153
"2189",1002189,14,18,2,34
"2190",1002190,47,98,4,149
"2191",1002191,59,204,6,269
"2192",1002192,94,149,2,245
"2193",1002193,74,108,12,194
"2194",1002194,102,131,8,241
"2195",1002195,140,122,9,271
"2196",1002196,59,9,1,69
"2197",1002197,165,14,8,187
"2198",1002198,219,20,12,251
"2199",1002199,160,73,6,239
"2200",1002200,44,134,2,180
"2201",1002201,45,191,5,241
"2202",1002202,50,169,1,220
"2203",1002203,71,78,14,163
"2204",1002204,113,85,5,203
"2205",1002205,69,200,3,272
"2206",1002206,189,29,4,222
"2207",1002207,66,223,5,294
"2208",1002208,61,218,0,279
"2209",1002209,93,71,3,167
"2210",1002210,126,110,17,253
"2211",1002211,101,12,2,115
"2212",1002212,143,32,7,182
"2213",1002213,71,47,5,123
"2214",1002214,74,102,7,183
"2215",1002215,142,66,10,218
"2216",1002216,93,80,11,184
"2217",1002217,149,92,11,252
"2218",1002218,9,14,1,24
"2219",1002219,265,26,6,297
"2220",1002220,75,196,5,276
"2221",1002221,101,134,5,240
"2222",1002222,136,39,5,180
"2223",1002223,11,1,0,12
"2224",1002224,12,139,5,156
"2225",1002225,94,146,12,252
"2226",1002226,62,192,7,261
"2227",1002227,140,61,11,212
"2228",1002228,118,11,2,131
"2229",1002229,106,141,25,272
"2230",1002230,66,181,17,264
"2231",1002231,17,8,2,27
"2232",1002232,40,140,10,190
"2233",1002233,34,199,2,235
"2234",1002234,140,110,11,261
"2235",1002235,119,166,10,295
"2236",1002236,73,253,11,337
"2237",1002237,24,24,1,49
"2238",1002238,139,128,24,291
"2239",1002239,103,40,2,145
"2240",1002240,54,149,4,207
"2241",1002241,129,87,8,224
"2242",1002242,222,35,7,264
"2243",1002243,235,69,16,320
"2244",1002244,65,198,6,269
"2245",1002245,58,145,8,211
"2246",1002246,170,49,3,222
"2247",1002247,221,84,24,329
"2248",1002248,122,159,16,297
"2249",1002249,32,165,8,205
"2250",1002250,15,275,3,293
"2251",1002251,63,139,4,206
"2252",1002252,132,120,13,265
"2253",1002253,112,124,13,249
"2254",1002254,114,95,7,216
"2255",1002255,175,63,6,244
"2256",1002256,48,261,11,320
"2257",1002257,175,89,9,273
"2258",1002258,98,116,26,240
"2259",1002259,182,34,5,221
"2260",1002260,69,62,6,137
"2261",1002261,206,18,7,231
"2262",1002262,247,98,10,355
"2263",1002263,184,16,10,210
"2264",1002264,251,4,19,274
"2265",1002265,181,57,8,246
"2266",1002266,96,223,5,324
"2267",1002267,176,23,6,205
"2268",1002268,35,221,5,261
"2269",1002269,106,17,10,133
"2270",1002270,162,23,3,188
"2271",1002271,31,230,4,265
"2272",1002272,137,125,7,269
"2273",1002273,44,217,5,266
"2274",1002274,4,10,0,14
"2275",1002275,116,69,8,193
"2276",1002276,58,9,5,72
"2277",1002277,245,46,10,301
"2278",1002278,127,28,3,158
"2279",1002279,20,24,1,45
"2280",1002280,39,197,14,250
"2281",1002281,78,184,6,268
"2282",1002282,114,190,14,318
"2283",1002283,171,15,5,191
"2284",1002284,92,72,6,170
"2285",1002285,53,226,8,287
"2286",1002286,156,13,7,176
"2287",1002287,44,224,1,269
"2288",1002288,156,40,7,203
"2289",1002289,47,232,8,287
"2290",1002290,3,36,0,39
"2291",1002291,129,64,1,194
"2292",1002292,78,175,20,273
"2293",1002293,94,173,4,271
"2294",1002294,144,117,6,267
"2295",1002295,177,125,5,307
"2296",1002296,36,46,3,85
"2297",1002297,236,35,12,283
"2298",1002298,179,87,10,276
"2299",1002299,188,88,2,278
"2300",1002300,92,108,2,202
"2301",1002301,88,164,5,257
"2302",1002302,118,64,1,183
"2303",1002303,65,196,0,261
"2304",1002304,137,30,5,172
"2305",1002305,276,34,10,320
"2306",1002306,152,14,5,171
"2307",1002307,111,176,2,289
"2308",1002308,36,63,2,101
"2309",1002309,73,89,5,167
"2310",1002310,109,63,18,190
"2311",1002311,208,50,7,265
"2312",1002312,76,29,2,107
"2313",1002313,20,101,8,129
"2314",1002314,197,97,14,308
"2315",1002315,56,131,8,195
"2316",1002316,105,114,16,235
"2317",1002317,281,48,4,333
"2318",1002318,123,42,11,176
"2319",1002319,194,60,8,262
"2320",1002320,132,151,11,294
"2321",1002321,121,40,3,164
"2322",1002322,86,137,4,227
"2323",1002323,53,135,1,189
"2324",1002324,134,67,8,209
"2325",1002325,134,22,5,161
"2326",1002326,186,71,10,267
"2327",1002327,140,126,20,286
"2328",1002328,98,182,11,291
"2329",1002329,79,91,13,183
"2330",1002330,69,179,13,261
"2331",1002331,220,22,7,249
"2332",1002332,70,62,4,136
"2333",1002333,154,48,5,207
"2334",1002334,144,15,5,164
"2335",1002335,6,9,0,15
"2336",1002336,148,118,6,272
"2337",1002337,6,58,1,65
"2338",1002338,135,148,27,310
"2339",1002339,41,237,19,297
"2340",1002340,45,232,2,279
"2341",1002341,201,79,14,294
"2342",1002342,169,26,6,201
"2343",1002343,198,32,2,232
"2344",1002344,32,278,7,317
"2345",1002345,201,62,8,271
"2346",1002346,193,37,13,243
"2347",1002347,158,12,3,173
"2348",1002348,115,55,2,172
"2349",1002349,81,144,6,231
"2350",1002350,184,105,6,295
"2351",1002351,102,44,6,152
"2352",1002352,205,5,8,218
"2353",1002353,197,54,10,261
"2354",1002354,253,20,4,277
"2355",1002355,9,9,0,18
"2356",1002356,67,163,8,238
"2357",1002357,87,53,12,152
"2358",1002358,86,90,7,183
"2359",1002359,160,16,3,179
"2360",1002360,117,13,4,134
"2361",1002361,183,23,7,213
"2362",1002362,117,67,7,191
"2363",1002363,149,60,9,218
"2364",1002364,55,213,12,280
"2365",1002365,223,86,16,325
"2366",1002366,127,43,7,177
"2367",1002367,162,99,14,275
"2368",1002368,39,241,14,294
"2369",1002369,109,124,4,237
"2370",1002370,230,55,7,292
"2371",1002371,25,8,0,33
"2372",1002372,79,83,8,170
"2373",1002373,67,208,10,285
"2374",1002374,160,61,7,228
"2375",1002375,93,150,6,249
"2376",1002376,94,86,6,186
"2377",1002377,28,100,3,131
"2378",1002378,56,191,4,251
"2379",1002379,157,74,7,238
"2380",1002380,201,124,7,332
"2381",1002381,47,112,3,162
"2382",1002382,92,15,4,111
"2383",1002383,48,177,12,237
"2384",1002384,167,57,7,231
"2385",1002385,83,196,7,286
"2386",1002386,219,81,9,309
"2387",1002387,102,63,8,173
"2388",1002388,23,145,2,170
"2389",1002389,179,2,0,181
"2390",1002390,141,51,7,199
"2391",1002391,50,217,9,276
"2392",1002392,186,17,3,206
"2393",1002393,84,39,2,125
"2394",1002394,145,119,15,279
"2395",1002395,73,96,5,174
"2396",1002396,126,83,9,218
"2397",1002397,217,10,3,230
"2398",1002398,13,83,5,101
"2399",1002399,113,94,10,217
"2400",1002400,177,76,6,259
"2401",1002401,221,32,6,259
"2402",1002402,251,2,17,270
"2403",1002403,31,204,2,237
"2404",1002404,188,49,3,240
"2405",1002405,12,6,0,18
"2406",1002406,95,167,15,277
"2407",1002407,202,40,5,247
"2408",1002408,160,70,5,235
"2409",1002409,99,105,9,213
"2410",1002410,11,4,1,16
"2411",1002411,132,126,2,260
"2412",1002412,139,51,10,200
"2413",1002413,105,177,7,289
"2414",1002414,214,17,8,239
"2415",1002415,121,60,7,188
"2416",1002416,132,117,17,266
"2417",1002417,65,176,15,256
"2418",1002418,67,60,3,130
"2419",1002419,343,3,3,349
"2420",1002420,174,111,13,298
"2421",1002421,41,68,7,116
"2422",1002422,65,183,8,256
"2423",1002423,213,17,4,234
"2424",1002424,55,121,5,181
"2425",1002425,46,57,13,116
"2426",1002426,154,46,4,204
"2427",1002427,175,92,10,277
"2428",1002428,129,73,10,212
"2429",1002429,138,122,8,268
"2430",1002430,36,145,11,192
"2431",1002431,130,138,10,278
"2432",1002432,206,73,27,306
"2433",1002433,34,247,7,288
"2434",1002434,95,138,8,241
"2435",1002435,94,107,7,208
"2436",1002436,161,163,4,328
"2437",1002437,91,110,9,210
"2438",1002438,157,33,5,195
"2439",1002439,95,164,9,268
"2440",1002440,40,131,1,172
"2441",1002441,209,47,8,264
"2442",1002442,127,34,5,166
"2443",1002443,20,155,1,176
"2444",1002444,181,58,2,241
"2445",1002445,169,40,8,217
"2446",1002446,129,144,2,275
"2447",1002447,158,94,12,264
"2448",1002448,32,243,2,277
"2449",1002449,135,64,6,205
"2450",1002450,131,60,5,196
"2451",1002451,26,158,11,195
"2452",1002452,107,145,27,279
"2453",1002453,160,116,8,284
"2454",1002454,87,121,4,212
"2455",1002455,216,45,9,270
"2456",1002456,91,132,10,233
"2457",1002457,6,148,1,155
"2458",1002458,206,43,5,254
"2459",1002459,171,34,9,214
"2460",1002460,208,14,8,230
"2461",1002461,78,158,6,242
"2462",1002462,160,53,9,222
"2463",1002463,174,48,7,229
"2464",1002464,157,81,10,248
"2465",1002465,133,91,12,236
"2466",1002466,77,109,5,191
"2467",1002467,61,175,8,244
"2468",1002468,42,36,1,79
"2469",1002469,173,94,10,277
"2470",1002470,111,37,5,153
"2471",1002471,124,1,3,128
"2472",1002472,191,72,5,268
"2473",1002473,62,199,7,268
"2474",1002474,69,197,17,283
"2475",1002475,94,190,17,301
"2476",1002476,199,163,14,376
"2477",1002477,89,85,15,189
"2478",1002478,82,170,22,274
"2479",1002479,109,123,22,254
"2480",1002480,135,51,3,189
"2481",1002481,95,146,10,251
"2482",1002482,137,46,12,195
"2483",1002483,14,9,2,25
"2484",1002484,89,103,1,193
"2485",1002485,194,106,8,308
"2486",1002486,136,54,4,194
"2487",1002487,153,49,6,208
"2488",1002488,216,41,8,265
"2489",1002489,87,48,1,136
"2490",1002490,145,27,14,186
"2491",1002491,72,150,5,227
"2492",1002492,92,31,13,136
"2493",1002493,182,34,4,220
"2494",1002494,245,64,9,318
"2495",1002495,22,151,2,175
"2496",1002496,36,206,16,258
"2497",1002497,202,23,6,231
"2498",1002498,79,101,9,189
"2499",1002499,79,186,2,267
"2500",1002500,54,120,13,187
"2501",1002501,144,17,8,169
"2502",1002502,135,68,7,210
"2503",1002503,141,108,6,255
"2504",1002504,122,190,20,332
"2505",1002505,110,17,4,131
"2506",1002506,134,79,5,218
"2507",1002507,217,19,7,243
"2508",1002508,46,158,5,209
"2509",1002509,83,127,10,220
"2510",1002510,91,180,18,289
"2511",1002511,84,68,9,161
"2512",1002512,55,193,0,248
"2513",1002513,168,98,24,290
"2514",1002514,190,33,9,232
"2515",1002515,34,276,8,318
"2516",1002516,70,156,5,231
"2517",1002517,90,165,9,264
"2518",1002518,130,74,11,215
"2519",1002519,250,23,4,277
"2520",1002520,147,49,6,202
"2521",1002521,83,245,3,331
"2522",1002522,192,75,4,271
"2523",1002523,171,124,7,302
"2524",1002524,199,37,8,244
"2525",1002525,230,79,10,319
"2526",1002526,136,131,6,273
"2527",1002527,89,151,13,253
"2528",1002528,188,76,10,274
"2529",1002529,121,129,8,258
"2530",1002530,39,103,5,147
"2531",1002531,111,196,9,316
"2532",1002532,164,86,9,259
"2533",1002533,189,59,6,254
"2534",1002534,210,28,2,240
"2535",1002535,145,69,14,228
"2536",1002536,72,209,13,294
"2537",1002537,92,153,22,267
"2538",1002538,37,203,15,255
"2539",1002539,131,7,0,138
"2540",1002540,198,89,17,304
"2541",1002541,87,123,7,217
"2542",1002542,219,40,13,272
"2543",1002543,44,73,6,123
"2544",1002544,72,64,6,142
"2545",1002545,190,39,7,236
"2546",1002546,197,44,9,250
"2547",1002547,99,166,11,276
"2548",1002548,42,238,8,288
"2549",1002549,108,72,4,184
"2550",1002550,91,194,6,291
"2551",1002551,93,102,3,198
"2552",1002552,109,179,5,293
"2553",1002553,114,85,1,200
"2554",1002554,36,44,5,85
"2555",1002555,68,202,13,283
"2556",1002556,23,167,2,192
"2557",1002557,111,57,15,183
"2558",1002558,154,57,5,216
"2559",1002559,91,134,14,239
"2560",1002560,9,5,0,14
"2561",1002561,19,31,2,52
"2562",1002562,60,187,22,269
"2563",1002563,28,191,1,220
"2564",1002564,38,17,9,64
"2565",1002565,106,33,1,140
"2566",1002566,36,105,15,156
"2567",1002567,160,148,12,320
"2568",1002568,189,29,8,226
"2569",1002569,33,170,5,208
"2570",1002570,159,50,2,211
"2571",1002571,43,138,0,181
"2572",1002572,90,173,3,266
"2573",1002573,110,23,3,136
"2574",1002574,136,3,4,143
"2575",1002575,34,196,10,240
"2576",1002576,83,56,5,144
"2577",1002577,168,78,9,255
"2578",1002578,109,63,11,183
"2579",1002579,87,8,0,95
"2580",1002580,159,90,14,263
"2581",1002581,3,7,1,11
"2582",1002582,108,59,4,171
"2583",1002583,168,61,7,236
"2584",1002584,69,177,5,251
"2585",1002585,179,52,5,236
"2586",1002586,71,233,7,311
"2587",1002587,177,91,9,277
"2588",1002588,134,11,6,151
"2589",1002589,56,237,5,298
"2590",1002590,181,94,14,289
"2591",1002591,10,94,0,104
"2592",1002592,89,189,7,285
"2593",1002593,96,154,6,256
"2594",1002594,61,15,1,77
"2595",1002595,104,114,6,224
"2596",1002596,214,30,3,247
"2597",1002597,40,78,3,121
"2598",1002598,156,100,9,265
"2599",1002599,60,190,23,273
"2600",1002600,19,199,11,229
"2601",1002601,201,31,7,239
"2602",1002602,85,135,4,224
"2603",1002603,100,128,1,229
"2604",1002604,112,24,6,142
"2605",1002605,46,95,2,143
"2606",1002606,6,59,3,68
"2607",1002607,118,131,8,257
"2608",1002608,54,247,11,312
"2609",1002609,68,92,8,168
"2610",1002610,80,184,15,279
"2611",1002611,228,28,14,270
"2612",1002612,100,139,4,243
"2613",1002613,128,104,13,245
"2614",1002614,169,26,5,200
"2615",1002615,44,25,4,73
"2616",1002616,11,290,1,302
"2617",1002617,141,144,23,308
"2618",1002618,204,70,15,289
"2619",1002619,202,78,17,297
"2620",1002620,13,9,0,22
"2621",1002621,79,129,1,209
"2622",1002622,39,240,10,289
"2623",1002623,157,90,2,249
"2624",1002624,91,153,8,252
"2625",1002625,79,196,14,289
"2626",1002626,109,79,14,202
"2627",1002627,49,255,2,306
"2628",1002628,166,60,11,237
"2629",1002629,64,48,15,127
"2630",1002630,152,113,5,270
"2631",1002631,108,97,9,214
"2632",1002632,163,96,14,273
"2633",1002633,41,179,6,226
"2634",1002634,55,152,5,212
"2635",1002635,99,163,4,266
"2636",1002636,215,86,12,313
"2637",1002637,169,75,14,258
"2638",1002638,78,177,8,263
"2639",1002639,58,259,7,324
"2640",1002640,57,144,12,213
"2641",1002641,66,163,5,234
"2642",1002642,163,7,3,173
"2643",1002643,180,64,9,253
"2644",1002644,77,126,14,217
"2645",1002645,70,195,2,267
"2646",1002646,171,27,6,204
"2647",1002647,35,69,11,115
"2648",1002648,170,48,10,228
"2649",1002649,9,208,3,220
"2650",1002650,170,36,8,214
"2651",1002651,114,40,5,159
"2652",1002652,49,170,4,223
"2653",1002653,200,39,10,249
"2654",1002654,126,102,9,237
"2655",1002655,97,176,8,281
"2656",1002656,93,136,12,241
"2657",1002657,110,68,14,192
"2658",1002658,7,2,3,12
"2659",1002659,50,264,7,321
"2660",1002660,165,64,13,242
"2661",1002661,69,167,9,245
"2662",1002662,106,152,16,274
"2663",1002663,195,26,4,225
"2664",1002664,204,1,7,212
"2665",1002665,63,161,11,235
"2666",1002666,155,58,14,227
"2667",1002667,25,75,1,101
"2668",1002668,149,129,16,294
"2669",1002669,46,144,2,192
"2670",1002670,82,91,10,183
"2671",1002671,80,56,3,139
"2672",1002672,77,60,8,145
"2673",1002673,113,137,17,267
"2674",1002674,203,55,9,267
"2675",1002675,81,137,3,221
"2676",1002676,35,28,0,63
"2677",1002677,157,97,9,263
"2678",1002678,90,121,10,221
"2679",1002679,160,44,5,209
"2680",1002680,23,35,4,62
"2681",1002681,90,111,10,211
"2682",1002682,143,8,2,153
"2683",1002683,46,192,2,240
"2684",1002684,51,92,9,152
"2685",1002685,73,91,0,164
"2686",1002686,65,177,3,245
"2687",1002687,44,205,8,257
"2688",1002688,141,82,15,238
"2689",1002689,83,210,28,321
"2690",1002690,13,195,1,209
"2691",1002691,234,19,6,259
"2692",1002692,24,79,4,107
"2693",1002693,25,25,3,53
"2694",1002694,51,296,6,353
"2695",1002695,143,112,4,259
"2696",1002696,77,240,3,320
"2697",1002697,189,25,4,218
"2698",1002698,119,134,11,264
"2699",1002699,59,256,5,320
"2700",1002700,86,31,2,119
"2701",1002701,89,188,8,285
"2702",1002702,50,138,6,194
"2703",1002703,188,63,11,262
"2704",1002704,92,185,14,291
"2705",1002705,87,52,7,146
"2706",1002706,210,46,11,267
"2707",1002707,164,117,6,287
"2708",1002708,147,84,9,240
"2709",1002709,113,100,3,216
"2710",1002710,40,216,1,257
"2711",1002711,124,105,12,241
"2712",1002712,89,161,9,259
"2713",1002713,134,30,4,168
"2714",1002714,95,96,3,194
"2715",1002715,36,114,7,157
"2716",1002716,166,80,10,256
"2717",1002717,98,42,1,141
"2718",1002718,156,31,6,193
"2719",1002719,57,75,5,137
"2720",1002720,65,10,5,80
"2721",1002721,141,68,10,219
"2722",1002722,106,45,6,157
"2723",1002723,8,4,2,14
"2724",1002724,166,112,12,290
"2725",1002725,26,202,12,240
"2726",1002726,167,29,23,219
"2727",1002727,215,126,12,353
"2728",1002728,194,48,9,251
"2729",1002729,99,122,7,228
"2730",1002730,125,111,14,250
"2731",1002731,180,86,15,281
"2732",1002732,215,24,8,247
"2733",1002733,95,69,5,169
"2734",1002734,98,170,3,271
"2735",1002735,76,208,6,290
"2736",1002736,113,51,7,171
"2737",1002737,100,157,19,276
"2738",1002738,54,255,9,318
"2739",1002739,37,6,3,46
"2740",1002740,241,6,6,253
"2741",1002741,221,72,21,314
"2742",1002742,209,31,3,243
"2743",1002743,221,30,10,261
"2744",1002744,150,111,8,269
"2745",1002745,85,68,6,159
"2746",1002746,73,179,19,271
"2747",1002747,98,12,6,116
"2748",1002748,56,174,8,238
"2749",1002749,124,127,15,266
"2750",1002750,45,126,11,182
"2751",1002751,181,37,13,231
"2752",1002752,127,53,2,182
"2753",1002753,227,21,8,256
"2754",1002754,66,192,6,264
"2755",1002755,35,155,3,193
"2756",1002756,85,172,12,269
"2757",1002757,17,191,2,210
"2758",1002758,35,206,3,244
"2759",1002759,24,164,3,191
"2760",1002760,176,36,6,218
"2761",1002761,12,190,1,203
"2762",1002762,68,25,3,96
"2763",1002763,68,187,2,257
"2764",1002764,170,20,1,191
"2765",1002765,100,71,9,180
"2766",1002766,33,163,3,199
"2767",1002767,129,45,5,179
"2768",1002768,174,145,9,328
"2769",1002769,14,236,2,252
"2770",1002770,92,90,4,186
"2771",1002771,59,46,4,109
"2772",1002772,162,40,5,207
"2773",1002773,181,111,6,298
"2774",1002774,95,77,8,180
"2775",1002775,112,71,9,192
"2776",1002776,176,44,3,223
"2777",1002777,216,44,8,268
"2778",1002778,13,13,0,26
"2779",1002779,264,39,9,312
"2780",1002780,96,59,5,160
"2781",1002781,129,80,8,217
"2782",1002782,122,84,9,215
"2783",1002783,143,163,10,316
"2784",1002784,109,175,9,293
"2785",1002785,174,37,8,219
"2786",1002786,48,169,2,219
"2787",1002787,102,134,4,240
"2788",1002788,129,97,18,244
"2789",1002789,90,109,14,213
"2790",1002790,68,127,11,206
"2791",1002791,39,136,6,181
"2792",1002792,132,143,14,289
"2793",1002793,55,222,14,291
"2794",1002794,130,155,13,298
"2795",1002795,76,196,9,281
"2796",1002796,49,181,12,242
"2797",1002797,60,169,16,245
"2798",1002798,129,20,6,155
"2799",1002799,187,116,18,321
"2800",1002800,200,61,5,266
"2801",1002801,204,31,7,242
"2802",1002802,33,20,1,54
"2803",1002803,75,164,8,247
"2804",1002804,231,49,21,301
"2805",1002805,28,53,1,82
"2806",1002806,82,21,0,103
"2807",1002807,41,215,10,266
"2808",1002808,2,6,0,8
"2809",1002809,150,117,14,281
"2810",1002810,244,11,9,264
"2811",1002811,155,146,6,307
"2812",1002812,146,81,13,240
"2813",1002813,139,45,10,194
"2814",1002814,86,59,15,160
"2815",1002815,80,47,1,128
"2816",1002816,34,238,4,276
"2817",1002817,53,220,8,281
"2818",1002818,158,58,12,228
"2819",1002819,102,128,6,236
"2820",1002820,47,210,8,265
"2821",1002821,146,104,6,256
"2822",1002822,92,137,5,234
"2823",1002823,55,141,8,204
"2824",1002824,31,149,11,191
"2825",1002825,24,290,3,317
"2826",1002826,25,12,3,40
"2827",1002827,155,79,14,248
"2828",1002828,221,23,5,249
"2829",1002829,230,47,5,282
"2830",1002830,155,46,8,209
"2831",1002831,90,124,13,227
"2832",1002832,200,79,26,305
"2833",1002833,147,50,2,199
"2834",1002834,14,13,0,27
"2835",1002835,211,90,11,312
"2836",1002836,130,78,4,212
"2837",1002837,131,81,8,220
"2838",1002838,42,153,6,201
"2839",1002839,192,75,8,275
"2840",1002840,155,77,18,250
"2841",1002841,94,104,5,203
"2842",1002842,143,101,8,252
"2843",1002843,41,135,6,182
"2844",1002844,130,112,8,250
"2845",1002845,94,171,9,274
"2846",1002846,78,232,10,320
"2847",1002847,43,46,2,91
"2848",1002848,210,48,9,267
"2849",1002849,209,81,11,301
"2850",1002850,18,62,4,84
"2851",1002851,63,217,7,287
"2852",1002852,177,43,8,228
"2853",1002853,187,78,3,268
"2854",1002854,30,114,5,149
"2855",1002855,90,117,12,219
"2856",1002856,72,184,5,261
"2857",1002857,74,115,12,201
"2858",1002858,62,209,7,278
"2859",1002859,38,207,4,249
"2860",1002860,95,143,9,247
"2861",1002861,19,199,2,220
"2862",1002862,87,160,4,251
"2863",1002863,21,226,2,249
"2864",1002864,216,20,6,242
"2865",1002865,205,65,9,279
"2866",1002866,169,128,6,303
"2867",1002867,66,156,11,233
"2868",1002868,47,134,11,192
"2869",1002869,140,139,6,285
"2870",1002870,186,54,6,246
"2871",1002871,71,260,2,333
"2872",1002872,40,18,3,61
"2873",1002873,38,100,6,144
"2874",1002874,39,8,2,49
"2875",1002875,236,12,3,251
"2876",1002876,19,2,1,22
"2877",1002877,32,36,11,79
"2878",1002878,59,110,3,172
"2879",1002879,16,36,3,55
"2880",1002880,14,12,2,28
"2881",1002881,110,14,5,129
"2882",1002882,110,194,8,312
"2883",1002883,93,47,3,143
"2884",1002884,19,76,5,100
"2885",1002885,3,2,0,5
"2886",1002886,204,10,5,219
"2887",1002887,108,131,5,244
"2888",1002888,133,16,8,157
"2889",1002889,88,46,1,135
"2890",1002890,146,54,3,203
"2891",1002891,155,95,12,262
"2892",1002892,119,92,10,221
"2893",1002893,49,107,2,158
"2894",1002894,159,98,23,280
"2895",1002895,44,12,1,57
"2896",1002896,145,40,21,206
"2897",1002897,130,146,11,287
"2898",1002898,188,87,7,282
"2899",1002899,30,156,3,189
"2900",1002900,164,95,4,263
"2901",1002901,81,40,12,133
"2902",1002902,155,61,15,231
"2903",1002903,166,76,11,253
"2904",1002904,73,88,1,162
"2905",1002905,152,55,14,221
"2906",1002906,108,49,11,168
"2907",1002907,60,114,12,186
"2908",1002908,78,116,8,202
"2909",1002909,114,179,10,303
"2910",1002910,60,80,4,144
"2911",1002911,121,173,7,301
"2912",1002912,133,46,3,182
"2913",1002913,66,75,3,144
"2914",1002914,86,209,3,298
"2915",1002915,119,131,8,258
"2916",1002916,29,224,2,255
"2917",1002917,64,98,6,168
"2918",1002918,103,30,14,147
"2919",1002919,215,33,8,256
"2920",1002920,17,1,0,18
"2921",1002921,20,244,4,268
"2922",1002922,133,164,15,312
"2923",1002923,84,189,8,281
"2924",1002924,50,226,10,286
"2925",1002925,104,199,13,316
"2926",1002926,35,32,3,70
"2927",1002927,8,33,0,41
"2928",1002928,112,166,3,281
"2929",1002929,57,196,3,256
"2930",1002930,186,54,20,260
"2931",1002931,132,95,3,230
"2932",1002932,48,129,4,181
"2933",1002933,109,168,13,290
"2934",1002934,116,139,10,265
"2935",1002935,30,108,5,143
"2936",1002936,25,271,0,296
"2937",1002937,138,75,6,219
"2938",1002938,99,31,2,132
"2939",1002939,257,58,9,324
"2940",1002940,94,47,7,148
"2941",1002941,86,154,8,248
"2942",1002942,93,177,9,279
"2943",1002943,65,172,12,249
"2944",1002944,121,129,10,260
"2945",1002945,127,44,4,175
"2946",1002946,69,43,3,115
"2947",1002947,162,97,6,265
"2948",1002948,64,181,10,255
"2949",1002949,72,11,2,85
"2950",1002950,113,149,7,269
"2951",1002951,175,112,15,302
"2952",1002952,185,94,12,291
"2953",1002953,5,13,2,20
"2954",1002954,51,204,6,261
"2955",1002955,145,39,3,187
"2956",1002956,153,53,7,213
"2957",1002957,26,260,0,286
"2958",1002958,31,131,9,171
"2959",1002959,60,191,12,263
"2960",1002960,95,76,8,179
"2961",1002961,79,110,4,193
"2962",1002962,126,25,0,151
"2963",1002963,92,98,5,195
"2964",1002964,120,100,3,223
"2965",1002965,297,9,11,317
"2966",1002966,122,71,9,202
"2967",1002967,53,39,3,95
"2968",1002968,139,114,6,259
"2969",1002969,166,55,6,227
"2970",1002970,134,60,13,207
"2971",1002971,49,223,11,283
"2972",1002972,102,106,4,212
"2973",1002973,158,103,9,270
"2974",1002974,164,59,3,226
"2975",1002975,232,9,7,248
"2976",1002976,128,34,3,165
"2977",1002977,148,160,17,325
"2978",1002978,41,165,9,215
"2979",1002979,20,157,0,177
"2980",1002980,116,109,7,232
"2981",1002981,16,135,0,151
"2982",1002982,214,58,5,277
"2983",1002983,100,225,7,332
"2984",1002984,62,12,4,78
"2985",1002985,108,140,11,259
"2986",1002986,126,92,10,228
"2987",1002987,70,27,6,103
"2988",1002988,162,55,1,218
"2989",1002989,81,184,10,275
"2990",1002990,201,72,8,281
"2991",1002991,8,1,1,10
"2992",1002992,174,97,14,285
"2993",1002993,121,63,5,189
"2994",1002994,186,28,1,215
"2995",1002995,138,77,15,230
"2996",1002996,73,97,13,183
"2997",1002997,95,112,1,208
"2998",1002998,146,82,10,238
"2999",1002999,104,149,2,255
"3000",1003000,25,137,3,165
"3001",1003001,141,20,2,163
"3002",1003002,105,167,11,283
"3003",1003003,226,0,4,230
"3004",1003004,40,171,7,218
"3005",1003005,93,66,3,162
"3006",1003006,42,25,0,67
"3007",1003007,57,220,14,291
"3008",1003008,29,247,5,281
"3009",1003009,128,8,1,137
"3010",1003010,113,130,12,255
"3011",1003011,57,128,12,197
"3012",1003012,191,37,14,242
"3013",1003013,99,217,7,323
"3014",1003014,133,89,8,230
"3015",1003015,101,143,14,258
"3016",1003016,243,15,11,269
"3017",1003017,69,141,4,214
"3018",1003018,225,58,5,288
"3019",1003019,56,46,1,103
"3020",1003020,225,80,12,317
"3021",1003021,122,77,7,206
"3022",1003022,7,61,1,69
"3023",1003023,89,56,12,157
"3024",1003024,35,51,2,88
"3025",1003025,136,81,7,224
"3026",1003026,139,98,9,246
"3027",1003027,175,91,4,270
"3028",1003028,140,168,17,325
"3029",1003029,149,55,5,209
"3030",1003030,154,76,8,238
"3031",1003031,127,91,10,228
"3032",1003032,185,11,7,203
"3033",1003033,99,86,5,190
"3034",1003034,23,236,4,263
"3035",1003035,54,100,2,156
"3036",1003036,79,206,16,301
"3037",1003037,130,102,12,244
"3038",1003038,37,254,9,300
"3039",1003039,112,148,8,268
"3040",1003040,154,39,8,201
"3041",1003041,123,127,8,258
"3042",1003042,234,50,7,291
"3043",1003043,2,9,0,11
"3044",1003044,148,31,4,183
"3045",1003045,173,90,10,273
"3046",1003046,137,124,14,275
"3047",1003047,73,147,10,230
"3048",1003048,46,147,4,197
"3049",1003049,30,234,4,268
"3050",1003050,161,40,6,207
"3051",1003051,61,52,5,118
"3052",1003052,235,43,11,289
"3053",1003053,70,93,4,167
"3054",1003054,194,101,24,319
"3055",1003055,18,62,5,85
"3056",1003056,172,10,3,185
"3057",1003057,185,56,15,256
"3058",1003058,51,204,7,262
"3059",1003059,107,26,4,137
"3060",1003060,59,154,3,216
"3061",1003061,152,58,7,217
"3062",1003062,235,46,13,294
"3063",1003063,72,191,7,270
"3064",1003064,190,45,7,242
"3065",1003065,132,69,4,205
"3066",1003066,31,45,1,77
"3067",1003067,158,130,6,294
"3068",1003068,30,231,3,264
"3069",1003069,180,21,12,213
"3070",1003070,117,134,19,270
"3071",1003071,200,53,4,257
"3072",1003072,83,160,29,272
"3073",1003073,122,67,4,193
"3074",1003074,153,56,1,210
"3075",1003075,133,112,3,248
"3076",1003076,8,3,2,13
"3077",1003077,71,0,2,73
"3078",1003078,130,122,16,268
"3079",1003079,63,31,3,97
"3080",1003080,19,13,4,36
"3081",1003081,33,269,3,305
"3082",1003082,163,51,7,221
"3083",1003083,149,33,0,182
"3084",1003084,59,55,0,114
"3085",1003085,179,47,4,230
"3086",1003086,204,146,8,358
"3087",1003087,115,150,25,290
"3088",1003088,86,189,16,291
"3089",1003089,42,240,7,289
"3090",1003090,37,21,4,62
"3091",1003091,113,129,3,245
"3092",1003092,128,81,3,212
"3093",1003093,98,182,13,293
"3094",1003094,83,71,8,162
"3095",1003095,129,54,8,191
"3096",1003096,117,168,13,298
"3097",1003097,165,115,10,290
"3098",1003098,203,36,8,247
"3099",1003099,151,79,7,237
"3100",1003100,166,159,16,341
"3101",1003101,38,169,6,213
"3102",1003102,172,100,19,291
"3103",1003103,96,45,13,154
"3104",1003104,58,65,5,128
"3105",1003105,171,75,1,247
"3106",1003106,157,33,2,192
"3107",1003107,26,171,8,205
"3108",1003108,46,181,6,233
"3109",1003109,84,42,6,132
"3110",1003110,123,56,6,185
"3111",1003111,154,48,6,208
"3112",1003112,142,115,16,273
"3113",1003113,78,187,13,278
"3114",1003114,94,175,11,280
"3115",1003115,119,38,6,163
"3116",1003116,151,137,12,300
"3117",1003117,203,22,7,232
"3118",1003118,149,85,7,241
"3119",1003119,60,145,9,214
"3120",1003120,131,12,5,148
"3121",1003121,145,99,2,246
"3122",1003122,69,152,9,230
"3123",1003123,242,22,7,271
"3124",1003124,40,242,6,288
"3125",1003125,53,170,2,225
"3126",1003126,73,195,3,271
"3127",1003127,203,107,7,317
"3128",1003128,16,45,7,68
"3129",1003129,82,263,0,345
"3130",1003130,115,210,11,336
"3131",1003131,150,45,11,206
"3132",1003132,65,259,13,337
"3133",1003133,135,47,7,189
"3134",1003134,198,30,3,231
"3135",1003135,88,8,5,101
"3136",1003136,78,203,14,295
"3137",1003137,77,157,13,247
"3138",1003138,197,28,8,233
"3139",1003139,62,164,8,234
"3140",1003140,180,60,16,256
"3141",1003141,176,38,3,217
"3142",1003142,131,37,10,178
"3143",1003143,1,7,0,8
"3144",1003144,144,19,1,164
"3145",1003145,33,238,7,278
"3146",1003146,54,90,5,149
"3147",1003147,78,174,3,255
"3148",1003148,43,139,2,184
"3149",1003149,192,85,7,284
"3150",1003150,127,183,11,321
"3151",1003151,264,57,14,335
"3152",1003152,134,32,6,172
"3153",1003153,57,183,10,250
"3154",1003154,151,74,11,236
"3155",1003155,136,82,6,224
"3156",1003156,67,16,2,85
"3157",1003157,195,33,8,236
"3158",1003158,153,107,16,276
"3159",1003159,28,231,8,267
"3160",1003160,138,63,16,217
"3161",1003161,176,2,28,206
"3162",1003162,18,53,0,71
"3163",1003163,196,69,4,269
"3164",1003164,160,85,17,262
"3165",1003165,66,128,1,195
"3166",1003166,95,16,0,111
"3167",1003167,176,87,2,265
"3168",1003168,74,58,1,133
"3169",1003169,199,89,10,298
"3170",1003170,252,31,5,288
"3171",1003171,164,38,7,209
"3172",1003172,101,188,10,299
"3173",1003173,42,39,2,83
"3174",1003174,164,113,6,283
"3175",1003175,71,81,10,162
"3176",1003176,164,85,7,256
"3177",1003177,145,135,23,303
"3178",1003178,81,46,3,130
"3179",1003179,261,34,10,305
"3180",1003180,17,126,3,146
"3181",1003181,44,262,1,307
"3182",1003182,185,42,7,234
"3183",1003183,102,203,8,313
"3184",1003184,118,49,0,167
"3185",1003185,41,195,3,239
"3186",1003186,67,260,2,329
"3187",1003187,5,16,0,21
"3188",1003188,159,98,3,260
"3189",1003189,201,24,6,231
"3190",1003190,147,84,14,245
"3191",1003191,131,74,5,210
"3192",1003192,289,0,5,294
"3193",1003193,160,58,5,223
"3194",1003194,58,177,4,239
"3195",1003195,14,165,3,182
"3196",1003196,133,148,18,299
"3197",1003197,28,150,7,185
"3198",1003198,51,243,11,305
"3199",1003199,180,90,13,283
"3200",1003200,114,105,5,224
"3201",1003201,3,52,1,56
"3202",1003202,112,8,5,125
"3203",1003203,67,183,4,254
"3204",1003204,59,221,6,286
"3205",1003205,187,79,6,272
"3206",1003206,129,143,19,291
"3207",1003207,104,162,6,272
"3208",1003208,50,88,0,138
"3209",1003209,120,24,4,148
"3210",1003210,66,1,0,67
"3211",1003211,141,67,10,218
"3212",1003212,206,52,3,261
"3213",1003213,108,69,22,199
"3214",1003214,54,228,3,285
"3215",1003215,102,189,16,307
"3216",1003216,83,132,4,219
"3217",1003217,20,238,5,263
"3218",1003218,119,120,15,254
"3219",1003219,102,120,10,232
"3220",1003220,44,163,5,212
"3221",1003221,145,142,9,296
"3222",1003222,192,51,3,246
"3223",1003223,261,13,7,281
"3224",1003224,55,70,2,127
"3225",1003225,27,135,2,164
"3226",1003226,8,3,1,12
"3227",1003227,139,56,15,210
"3228",1003228,111,121,20,252
"3229",1003229,14,32,0,46
"3230",1003230,205,116,3,324
"3231",1003231,10,55,1,66
"3232",1003232,136,26,7,169
"3233",1003233,95,163,7,265
"3234",1003234,178,42,6,226
"3235",1003235,238,48,6,292
"3236",1003236,77,76,6,159
"3237",1003237,191,32,10,233
"3238",1003238,18,54,0,72
"3239",1003239,110,102,15,227
"3240",1003240,110,157,14,281
"3241",1003241,208,33,7,248
"3242",1003242,132,190,5,327
"3243",1003243,168,17,4,189
"3244",1003244,130,163,16,309
"3245",1003245,240,59,3,302
"3246",1003246,83,86,6,175
"3247",1003247,161,41,8,210
"3248",1003248,46,259,4,309
"3249",1003249,186,107,15,308
"3250",1003250,227,27,18,272
"3251",1003251,40,4,1,45
"3252",1003252,139,91,4,234
"3253",1003253,106,149,6,261
"3254",1003254,57,142,23,222
"3255",1003255,103,46,4,153
"3256",1003256,84,0,0,84
"3257",1003257,31,241,6,278
"3258",1003258,153,32,6,191
"3259",1003259,7,7,0,14
"3260",1003260,162,72,4,238
"3261",1003261,122,125,19,266
"3262",1003262,226,49,10,285
"3263",1003263,16,15,0,31
"3264",1003264,8,7,2,17
"3265",1003265,154,10,8,172
"3266",1003266,137,124,9,270
"3267",1003267,67,100,2,169
"3268",1003268,35,265,7,307
"3269",1003269,152,59,5,216
"3270",1003270,90,76,5,171
"3271",1003271,61,215,1,277
"3272",1003272,233,107,9,349
"3273",1003273,140,58,15,213
"3274",1003274,80,94,1,175
"3275",1003275,113,80,1,194
"3276",1003276,90,70,7,167
"3277",1003277,93,159,15,267
"3278",1003278,190,48,13,251
"3279",1003279,29,211,7,247
"3280",1003280,146,46,9,201
"3281",1003281,40,49,4,93
"3282",1003282,110,73,23,206
"3283",1003283,109,126,26,261
"3284",1003284,205,84,14,303
"3285",1003285,35,212,3,250
"3286",1003286,75,182,14,271
"3287",1003287,87,53,3,143
"3288",1003288,70,185,12,267
"3289",1003289,12,200,3,215
"3290",1003290,152,45,7,204
"3291",1003291,43,16,2,61
"3292",1003292,159,22,0,181
"3293",1003293,117,37,7,161
"3294",1003294,86,131,11,228
"3295",1003295,42,153,14,209
"3296",1003296,89,87,4,180
"3297",1003297,78,183,7,268
"3298",1003298,90,174,8,272
"3299",1003299,67,224,9,300
"3300",1003300,129,41,5,175
"3301",1003301,176,63,16,255
"3302",1003302,65,239,4,308
"3303",1003303,126,152,20,298
"3304",1003304,69,116,4,189
"3305",1003305,108,174,6,288
"3306",1003306,27,86,8,121
"3307",1003307,105,165,12,282
"3308",1003308,155,11,3,169
"3309",1003309,213,61,11,285
"3310",1003310,148,132,10,290
"3311",1003311,139,60,5,204
"3312",1003312,67,120,3,190
"3313",1003313,38,23,2,63
"3314",1003314,132,121,6,259
"3315",1003315,41,12,2,55
"3316",1003316,90,19,6,115
"3317",1003317,121,146,23,290
"3318",1003318,79,1,4,84
"3319",1003319,111,122,7,240
"3320",1003320,179,62,2,243
"3321",1003321,66,227,19,312
"3322",1003322,115,146,24,285
"3323",1003323,213,13,2,228
"3324",1003324,169,143,12,324
"3325",1003325,148,16,10,174
"3326",1003326,58,63,7,128
"3327",1003327,21,38,0,59
"3328",1003328,139,16,5,160
"3329",1003329,35,257,9,301
"3330",1003330,148,19,0,167
"3331",1003331,77,67,4,148
"3332",1003332,20,143,6,169
"3333",1003333,73,96,4,173
"3334",1003334,142,102,1,245
"3335",1003335,93,70,3,166
"3336",1003336,53,79,4,136
"3337",1003337,30,3,1,34
"3338",1003338,105,16,3,124
"3339",1003339,47,253,2,302
"3340",1003340,120,154,13,287
"3341",1003341,81,154,7,242
"3342",1003342,195,77,17,289
"3343",1003343,207,106,10,323
"3344",1003344,102,109,1,212
"3345",1003345,134,85,9,228
"3346",1003346,94,141,5,240
"3347",1003347,78,211,6,295
"3348",1003348,75,76,7,158
"3349",1003349,0,0,0,0
"3350",1003350,183,150,15,348
"3351",1003351,185,35,6,226
"3352",1003352,40,216,10,266
"3353",1003353,269,21,4,294
"3354",1003354,196,35,5,236
"3355",1003355,32,236,2,270
"3356",1003356,87,54,6,147
"3357",1003357,60,147,9,216
"3358",1003358,130,115,10,255
"3359",1003359,63,199,5,267
"3360",1003360,115,76,8,199
"3361",1003361,81,125,8,214
"3362",1003362,68,217,9,294
"3363",1003363,138,42,4,184
"3364",1003364,64,254,14,332
"3365",1003365,117,171,13,301
"3366",1003366,187,21,4,212
"3367",1003367,60,112,16,188
"3368",1003368,223,22,4,249
"3369",1003369,31,254,7,292
"3370",1003370,175,44,5,224
"3371",1003371,34,183,6,223
"3372",1003372,79,197,10,286
"3373",1003373,11,66,1,78
"3374",1003374,137,16,3,156
"3375",1003375,149,66,8,223
"3376",1003376,155,56,8,219
"3377",1003377,144,28,11,183
"3378",1003378,190,83,14,287
"3379",1003379,38,65,11,114
"3380",1003380,73,217,6,296
"3381",1003381,207,21,2,230
"3382",1003382,137,88,2,227
"3383",1003383,106,197,17,320
"3384",1003384,175,12,14,201
"3385",1003385,82,49,5,136
"3386",1003386,84,207,6,297
"3387",1003387,103,43,12,158
"3388",1003388,228,26,12,266
"3389",1003389,51,134,1,186
"3390",1003390,148,124,6,278
"3391",1003391,88,76,11,175
"3392",1003392,66,154,8,228
"3393",1003393,87,60,5,152
"3394",1003394,189,45,5,239
"3395",1003395,62,180,12,254
"3396",1003396,141,31,4,176
"3397",1003397,15,105,2,122
"3398",1003398,42,238,2,282
"3399",1003399,5,194,3,202
"3400",1003400,117,158,10,285
"3401",1003401,58,174,19,251
"3402",1003402,95,95,4,194
"3403",1003403,223,109,8,340
"3404",1003404,163,39,5,207
"3405",1003405,85,0,0,85
"3406",1003406,278,39,9,326
"3407",1003407,61,106,5,172
"3408",1003408,167,78,3,248
"3409",1003409,117,180,19,316
"3410",1003410,39,23,1,63
"3411",1003411,87,158,8,253
"3412",1003412,55,64,8,127
"3413",1003413,90,81,4,175
"3414",1003414,153,7,1,161
"3415",1003415,73,241,6,320
"3416",1003416,89,27,1,117
"3417",1003417,53,214,15,282
"3418",1003418,89,166,4,259
"3419",1003419,5,1,0,6
"3420",1003420,168,23,6,197
"3421",1003421,177,91,8,276
"3422",1003422,118,148,8,274
"3423",1003423,134,107,4,245
"3424",1003424,84,56,7,147
"3425",1003425,110,161,1,272
"3426",1003426,48,247,7,302
"3427",1003427,70,10,3,83
"3428",1003428,91,163,9,263
"3429",1003429,75,179,16,270
"3430",1003430,101,20,7,128
"3431",1003431,247,16,17,280
"3432",1003432,161,110,5,276
"3433",1003433,164,83,1,248
"3434",1003434,86,116,5,207
"3435",1003435,209,52,5,266
"3436",1003436,15,34,2,51
"3437",1003437,14,57,1,72
"3438",1003438,180,22,3,205
"3439",1003439,153,94,3,250
"3440",1003440,17,316,4,337
"3441",1003441,131,109,9,249
"3442",1003442,100,32,1,133
"3443",1003443,219,1,2,222
"3444",1003444,28,105,3,136
"3445",1003445,62,250,7,319
"3446",1003446,251,45,27,323
"3447",1003447,154,76,8,238
"3448",1003448,102,128,17,247
"3449",1003449,197,113,15,325
"3450",1003450,159,79,13,251
"3451",1003451,139,185,5,329
"3452",1003452,77,170,5,252
"3453",1003453,50,248,3,301
"3454",1003454,175,19,6,200
"3455",1003455,116,93,13,222
"3456",1003456,159,81,24,264
"3457",1003457,56,271,17,344
"3458",1003458,73,217,7,297
"3459",1003459,3,2,0,5
"3460",1003460,112,135,24,271
"3461",1003461,69,166,5,240
"3462",1003462,59,21,2,82
"3463",1003463,143,16,1,160
"3464",1003464,180,61,3,244
"3465",1003465,132,98,7,237
"3466",1003466,192,61,2,255
"3467",1003467,102,142,2,246
"3468",1003468,77,115,5,197
"3469",1003469,142,85,4,231
"3470",1003470,232,51,4,287
"3471",1003471,155,86,7,248
"3472",1003472,88,4,0,92
"3473",1003473,99,23,6,128
"3474",1003474,83,32,3,118
"3475",1003475,114,104,5,223
"3476",1003476,88,163,7,258
"3477",1003477,137,99,13,249
"3478",1003478,169,74,12,255
"3479",1003479,116,74,4,194
"3480",1003480,210,73,13,296
"3481",1003481,60,220,2,282
"3482",1003482,59,122,6,187
"3483",1003483,54,148,13,215
"3484",1003484,119,113,9,241
"3485",1003485,209,55,8,272
"3486",1003486,154,50,12,216
"3487",1003487,128,100,15,243
"3488",1003488,33,317,8,358
"3489",1003489,161,34,8,203
"3490",1003490,7,7,1,15
"3491",1003491,82,161,9,252
"3492",1003492,48,66,6,120
"3493",1003493,42,6,0,48
"3494",1003494,39,260,6,305
"3495",1003495,35,163,3,201
"3496",1003496,72,159,17,248
"3497",1003497,178,11,8,197
"3498",1003498,76,103,4,183
"3499",1003499,96,173,7,276
"3500",1003500,87,154,13,254
"3501",1003501,222,12,4,238
"3502",1003502,136,118,10,264
"3503",1003503,118,199,3,320
"3504",1003504,72,193,17,282
"3505",1003505,81,161,4,246
"3506",1003506,120,96,3,219
"3507",1003507,146,97,8,251
"3508",1003508,148,127,24,299
"3509",1003509,85,161,2,248
"3510",1003510,243,37,9,289
"3511",1003511,83,133,3,219
"3512",1003512,198,84,15,297
"3513",1003513,202,131,6,339
"3514",1003514,129,145,24,298
"3515",1003515,207,36,7,250
"3516",1003516,37,1,1,39
"3517",1003517,123,127,17,267
"3518",1003518,73,14,0,87
"3519",1003519,133,92,5,230
"3520",1003520,217,48,19,284
"3521",1003521,61,253,1,315
"3522",1003522,225,54,13,292
"3523",1003523,68,63,4,135
"3524",1003524,37,44,6,87
"3525",1003525,57,236,10,303
"3526",1003526,208,22,7,237
"3527",1003527,148,50,7,205
"3528",1003528,96,117,8,221
"3529",1003529,137,178,15,330
"3530",1003530,76,201,5,282
"3531",1003531,48,238,5,291
"3532",1003532,70,167,3,240
"3533",1003533,32,25,7,64
"3534",1003534,126,49,6,181
"3535",1003535,206,36,2,244
"3536",1003536,188,76,17,281
"3537",1003537,21,20,1,42
"3538",1003538,142,132,22,296
"3539",1003539,110,125,8,243
"3540",1003540,80,188,16,284
"3541",1003541,127,151,13,291
"3542",1003542,34,205,5,244
"3543",1003543,57,85,13,155
"3544",1003544,56,149,6,211
"3545",1003545,169,26,4,199
"3546",1003546,198,30,10,238
"3547",1003547,89,166,7,262
"3548",1003548,119,86,6,211
"3549",1003549,101,69,12,182
"3550",1003550,79,9,3,91
"3551",1003551,16,17,4,37
"3552",1003552,165,118,16,299
"3553",1003553,12,182,7,201
"3554",1003554,157,61,6,224
"3555",1003555,158,34,5,197
"3556",1003556,196,33,7,236
"3557",1003557,233,13,3,249
"3558",1003558,57,183,8,248
"3559",1003559,110,52,8,170
"3560",1003560,113,123,2,238
"3561",1003561,159,98,2,259
"3562",1003562,105,51,4,160
"3563",1003563,173,85,12,270
"3564",1003564,163,30,5,198
"3565",1003565,200,32,8,240
"3566",1003566,169,93,20,282
"3567",1003567,192,24,5,221
"3568",1003568,152,96,12,260
"3569",1003569,127,117,4,248
"3570",1003570,46,147,1,194
"3571",1003571,158,116,8,282
"3572",1003572,101,162,13,276
"3573",1003573,24,37,5,66
"3574",1003574,231,18,10,259
"3575",1003575,107,98,14,219
"3576",1003576,163,115,6,284
"3577",1003577,168,73,6,247
"3578",1003578,132,70,6,208
"3579",1003579,122,66,2,190
"3580",1003580,80,48,6,134
"3581",1003581,220,78,11,309
"3582",1003582,107,67,3,177
"3583",1003583,127,37,10,174
"3584",1003584,176,97,6,279
"3585",1003585,176,56,4,236
"3586",1003586,27,36,5,68
"3587",1003587,29,111,2,142
"3588",1003588,137,97,10,244
"3589",1003589,132,87,6,225
"3590",1003590,161,51,11,223
"3591",1003591,178,30,9,217
"3592",1003592,130,94,3,227
"3593",1003593,80,48,1,129
"3594",1003594,120,148,13,281
"3595",1003595,168,14,8,190
"3596",1003596,77,36,6,119
"3597",1003597,82,151,4,237
"3598",1003598,99,116,13,228
"3599",1003599,219,75,6,300
"3600",1003600,78,117,9,204
"3601",1003601,244,82,12,338
"3602",1003602,124,205,12,341
"3603",1003603,2,5,2,9
"3604",1003604,59,265,10,334
"3605",1003605,83,32,1,116
"3606",1003606,138,17,3,158
"3607",1003607,144,5,1,150
"3608",1003608,12,149,5,166
"3609",1003609,55,356,17,428
"3610",1003610,46,81,15,142
"3611",1003611,201,71,12,284
"3612",1003612,129,84,11,224
"3613",1003613,62,137,6,205
"3614",1003614,97,103,11,211
"3615",1003615,150,86,7,243
"3616",1003616,6,139,1,146
"3617",1003617,47,41,3,91
"3618",1003618,73,94,5,172
"3619",1003619,139,45,12,196
"3620",1003620,171,78,8,257
"3621",1003621,104,55,6,165
"3622",1003622,79,168,8,255
"3623",1003623,31,228,9,268
"3624",1003624,114,148,9,271
"3625",1003625,42,42,4,88
"3626",1003626,103,149,7,259
"3627",1003627,93,24,4,121
"3628",1003628,107,67,10,184
"3629",1003629,61,264,1,326
"3630",1003630,211,51,12,274
"3631",1003631,145,106,9,260
"3632",1003632,152,44,3,199
"3633",1003633,54,16,1,71
"3634",1003634,24,48,1,73
"3635",1003635,153,135,3,291
"3636",1003636,38,231,5,274
"3637",1003637,170,9,2,181
"3638",1003638,103,82,22,207
"3639",1003639,83,82,4,169
"3640",1003640,148,78,16,242
"3641",1003641,85,135,15,235
"3642",1003642,114,37,3,154
"3643",1003643,200,37,3,240
"3644",1003644,125,64,11,200
"3645",1003645,15,29,3,47
"3646",1003646,174,22,6,202
"3647",1003647,105,101,3,209
"3648",1003648,66,176,10,252
"3649",1003649,117,120,5,242
"3650",1003650,76,58,2,136
"3651",1003651,181,66,9,256
"3652",1003652,215,42,6,263
"3653",1003653,214,22,5,241
"3654",1003654,53,115,1,169
"3655",1003655,152,93,13,258
"3656",1003656,17,176,3,196
"3657",1003657,91,77,17,185
"3658",1003658,84,178,7,269
"3659",1003659,152,54,6,212
"3660",1003660,61,231,5,297
"3661",1003661,104,201,8,313
"3662",1003662,169,32,10,211
"3663",1003663,256,54,8,318
"3664",1003664,91,32,14,137
"3665",1003665,19,134,1,154
"3666",1003666,24,176,4,204
"3667",1003667,154,139,22,315
"3668",1003668,145,147,11,303
"3669",1003669,190,70,0,260
"3670",1003670,215,13,2,230
"3671",1003671,43,222,2,267
"3672",1003672,36,16,4,56
"3673",1003673,194,46,10,250
"3674",1003674,25,156,4,185
"3675",1003675,48,106,6,160
"3676",1003676,199,53,6,258
"3677",1003677,72,199,5,276
"3678",1003678,64,165,19,248
"3679",1003679,82,162,17,261
"3680",1003680,126,112,4,242
"3681",1003681,157,20,0,177
"3682",1003682,12,46,0,58
"3683",1003683,140,98,8,246
"3684",1003684,79,121,12,212
"3685",1003685,90,137,3,230
"3686",1003686,61,99,4,164
"3687",1003687,66,0,0,66
"3688",1003688,88,138,15,241
"3689",1003689,62,240,4,306
"3690",1003690,118,180,3,301
"3691",1003691,107,188,3,298
"3692",1003692,130,88,7,225
"3693",1003693,30,57,7,94
"3694",1003694,35,153,4,192
"3695",1003695,93,209,14,316
"3696",1003696,147,22,5,174
"3697",1003697,170,27,8,205
"3698",1003698,170,27,6,203
"3699",1003699,239,36,3,278
"3700",1003700,43,201,9,253
"3701",1003701,178,37,6,221
"3702",1003702,95,144,17,256
"3703",1003703,7,28,1,36
"3704",1003704,133,89,8,230
"3705",1003705,75,187,3,265
"3706",1003706,118,136,13,267
"3707",1003707,32,242,5,279
"3708",1003708,201,47,7,255
"3709",1003709,155,189,17,361
"3710",1003710,48,80,8,136
"3711",1003711,96,125,4,225
"3712",1003712,160,111,9,280
"3713",1003713,150,106,9,265
"3714",1003714,142,60,15,217
"3715",1003715,150,135,20,305
"3716",1003716,154,16,5,175
"3717",1003717,187,96,16,299
"3718",1003718,148,67,17,232
"3719",1003719,11,25,2,38
"3720",1003720,66,113,1,180
"3721",1003721,89,91,9,189
"3722",1003722,126,75,7,208
"3723",1003723,41,18,1,60
"3724",1003724,84,81,7,172
"3725",1003725,176,26,5,207
"3726",1003726,198,87,5,290
"3727",1003727,100,98,12,210
"3728",1003728,13,28,1,42
"3729",1003729,86,226,10,322
"3730",1003730,285,2,0,287
"3731",1003731,122,18,8,148
"3732",1003732,149,139,19,307
"3733",1003733,3,6,1,10
"3734",1003734,166,49,5,220
"3735",1003735,130,39,9,178
"3736",1003736,64,238,19,321
"3737",1003737,163,19,9,191
"3738",1003738,185,37,6,228
"3739",1003739,9,16,2,27
"3740",1003740,22,260,2,284
"3741",1003741,178,62,9,249
"3742",1003742,33,60,5,98
"3743",1003743,141,124,3,268
"3744",1003744,150,75,4,229
"3745",1003745,92,56,5,153
"3746",1003746,156,37,4,197
"3747",1003747,77,83,8,168
"3748",1003748,209,29,6,244
"3749",1003749,9,212,0,221
"3750",1003750,158,127,11,296
"3751",1003751,92,67,5,164
"3752",1003752,71,75,3,149
"3753",1003753,20,121,5,146
"3754",1003754,29,113,7,149
"3755",1003755,173,71,14,258
"3756",1003756,95,210,14,319
"3757",1003757,218,69,17,304
"3758",1003758,15,174,2,191
"3759",1003759,83,112,5,200
"3760",1003760,68,237,19,324
"3761",1003761,40,180,4,224
"3762",1003762,88,232,13,333
"3763",1003763,161,86,10,257
"3764",1003764,145,34,10,189
"3765",1003765,16,43,2,61
"3766",1003766,92,162,12,266
"3767",1003767,116,150,9,275
"3768",1003768,187,22,4,213
"3769",1003769,33,199,13,245
"3770",1003770,146,26,8,180
"3771",1003771,159,126,17,302
"3772",1003772,1,4,0,5
"3773",1003773,205,64,14,283
"3774",1003774,76,163,8,247
"3775",1003775,185,28,6,219
"3776",1003776,140,149,10,299
"3777",1003777,65,185,14,264
"3778",1003778,130,69,5,204
"3779",1003779,64,126,6,196
"3780",1003780,149,119,8,276
"3781",1003781,138,227,7,372
"3782",1003782,229,23,9,261
"3783",1003783,226,68,8,302
"3784",1003784,109,77,5,191
"3785",1003785,214,117,23,354
"3786",1003786,178,76,8,262
"3787",1003787,81,171,14,266
"3788",1003788,6,86,5,97
"3789",1003789,96,71,8,175
"3790",1003790,162,103,8,273
"3791",1003791,192,96,17,305
"3792",1003792,19,163,2,184
"3793",1003793,68,195,5,268
"3794",1003794,213,17,7,237
"3795",1003795,108,37,14,159
"3796",1003796,18,25,0,43
"3797",1003797,201,118,19,338
"3798",1003798,198,19,7,224
"3799",1003799,50,28,1,79
"3800",1003800,72,90,0,162
"3801",1003801,35,35,1,71
"3802",1003802,239,33,2,274
"3803",1003803,81,158,9,248
"3804",1003804,97,116,3,216
"3805",1003805,125,148,19,292
"3806",1003806,135,44,8,187
"3807",1003807,123,105,8,236
"3808",1003808,46,37,7,90
"3809",1003809,64,75,15,154
"3810",1003810,45,156,15,216
"3811",1003811,28,103,2,133
"3812",1003812,171,82,3,256
"3813",1003813,116,53,12,181
"3814",1003814,177,51,7,235
"3815",1003815,113,95,10,218
"3816",1003816,63,144,5,212
"3817",1003817,161,80,5,246
"3818",1003818,142,110,8,260
"3819",1003819,111,107,13,231
"3820",1003820,123,51,7,181
"3821",1003821,53,196,21,270
"3822",1003822,48,157,2,207
"3823",1003823,151,46,9,206
"3824",1003824,26,214,2,242
"3825",1003825,105,116,10,231
"3826",1003826,83,161,4,248
"3827",1003827,80,142,13,235
"3828",1003828,105,164,7,276
"3829",1003829,150,61,6,217
"3830",1003830,228,94,30,352
"3831",1003831,133,100,6,239
"3832",1003832,163,98,7,268
"3833",1003833,139,57,6,202
"3834",1003834,11,191,1,203
"3835",1003835,75,82,6,163
"3836",1003836,178,49,5,232
"3837",1003837,59,224,1,284
"3838",1003838,72,144,4,220
"3839",1003839,125,151,3,279
"3840",1003840,81,29,5,115
"3841",1003841,148,80,10,238
"3842",1003842,165,43,4,212
"3843",1003843,4,18,1,23
"3844",1003844,90,186,11,287
"3845",1003845,140,65,10,215
"3846",1003846,214,86,15,315
"3847",1003847,206,7,1,214
"3848",1003848,87,127,10,224
"3849",1003849,168,76,2,246
"3850",1003850,27,9,0,36
"3851",1003851,77,101,5,183
"3852",1003852,44,129,7,180
"3853",1003853,210,26,9,245
"3854",1003854,58,277,7,342
"3855",1003855,7,2,0,9
"3856",1003856,242,36,15,293
"3857",1003857,163,105,10,278
"3858",1003858,43,252,9,304
"3859",1003859,116,86,0,202
"3860",1003860,40,243,8,291
"3861",1003861,147,115,17,279
"3862",1003862,113,56,6,175
"3863",1003863,118,39,22,179
"3864",1003864,57,213,5,275
"3865",1003865,135,67,9,211
"3866",1003866,183,60,12,255
"3867",1003867,131,61,13,205
"3868",1003868,46,237,8,291
"3869",1003869,21,76,3,100
"3870",1003870,286,82,7,375
"3871",1003871,189,31,6,226
"3872",1003872,64,151,6,221
"3873",1003873,102,158,14,274
"3874",1003874,23,80,3,106
"3875",1003875,63,216,5,284
"3876",1003876,93,36,19,148
"3877",1003877,103,138,12,253
"3878",1003878,103,83,11,197
"3879",1003879,160,24,1,185
"3880",1003880,85,60,1,146
"3881",1003881,51,263,3,317
"3882",1003882,60,9,3,72
"3883",1003883,22,194,1,217
"3884",1003884,35,136,6,177
"3885",1003885,161,33,6,200
"3886",1003886,89,82,4,175
"3887",1003887,257,17,3,277
"3888",1003888,122,119,22,263
"3889",1003889,237,11,6,254
"3890",1003890,154,44,6,204
"3891",1003891,23,212,4,239
"3892",1003892,58,147,8,213
"3893",1003893,154,59,26,239
"3894",1003894,190,103,11,304
"3895",1003895,40,188,4,232
"3896",1003896,117,28,3,148
"3897",1003897,42,176,4,222
"3898",1003898,248,35,8,291
"3899",1003899,39,284,3,326
"3900",1003900,135,5,4,144
"3901",1003901,143,70,3,216
"3902",1003902,129,50,9,188
"3903",1003903,88,118,4,210
"3904",1003904,47,199,10,256
"3905",1003905,217,94,9,320
"3906",1003906,238,26,6,270
"3907",1003907,159,21,5,185
"3908",1003908,181,5,1,187
"3909",1003909,157,67,3,227
"3910",1003910,149,73,7,229
"3911",1003911,26,268,1,295
"3912",1003912,160,92,9,261
"3913",1003913,157,68,6,231
"3914",1003914,154,113,9,276
"3915",1003915,185,15,2,202
"3916",1003916,52,164,6,222
"3917",1003917,127,60,5,192
"3918",1003918,126,78,7,211
"3919",1003919,27,100,0,127
"3920",1003920,188,50,10,248
"3921",1003921,66,80,8,154
"3922",1003922,36,185,5,226
"3923",1003923,83,60,6,149
"3924",1003924,60,66,3,129
"3925",1003925,49,157,12,218
"3926",1003926,46,12,3,61
"3927",1003927,176,91,21,288
"3928",1003928,2,6,0,8
"3929",1003929,164,40,15,219
"3930",1003930,135,123,17,275
"3931",1003931,179,41,19,239
"3932",1003932,118,131,4,253
"3933",1003933,132,99,15,246
"3934",1003934,152,85,7,244
"3935",1003935,92,87,4,183
"3936",1003936,100,187,9,296
"3937",1003937,164,65,4,233
"3938",1003938,118,62,9,189
"3939",1003939,68,63,5,136
"3940",1003940,101,105,6,212
"3941",1003941,30,8,2,40
"3942",1003942,88,171,18,277
"3943",1003943,268,22,6,296
"3944",1003944,178,68,14,260
"3945",1003945,215,22,9,246
"3946",1003946,109,81,8,198
"3947",1003947,156,19,7,182
"3948",1003948,42,125,14,181
"3949",1003949,185,54,10,249
"3950",1003950,63,48,8,119
"3951",1003951,126,108,18,252
"3952",1003952,19,170,1,190
"3953",1003953,45,136,3,184
"3954",1003954,86,139,0,225
"3955",1003955,16,55,4,75
"3956",1003956,132,107,8,247
"3957",1003957,158,174,12,344
"3958",1003958,111,62,6,179
"3959",1003959,102,155,10,267
"3960",1003960,159,142,4,305
"3961",1003961,138,159,6,303
"3962",1003962,74,165,19,258
"3963",1003963,69,234,5,308
"3964",1003964,266,47,13,326
"3965",1003965,70,96,7,173
"3966",1003966,188,75,16,279
"3967",1003967,211,45,12,268
"3968",1003968,113,176,10,299
"3969",1003969,104,81,8,193
"3970",1003970,59,181,12,252
"3971",1003971,89,107,19,215
"3972",1003972,164,79,6,249
"3973",1003973,146,57,2,205
"3974",1003974,200,50,8,258
"3975",1003975,128,36,4,168
"3976",1003976,27,81,10,118
"3977",1003977,222,105,14,341
"3978",1003978,2,17,3,22
"3979",1003979,173,38,6,217
"3980",1003980,61,166,5,232
"3981",1003981,6,6,2,14
"3982",1003982,45,22,2,69
"3983",1003983,132,58,5,195
"3984",1003984,87,216,6,309
"3985",1003985,51,243,6,300
"3986",1003986,98,38,6,142
"3987",1003987,237,19,5,261
"3988",1003988,124,229,12,365
"3989",1003989,223,28,8,259
"3990",1003990,2,75,2,79
"3991",1003991,43,219,7,269
"3992",1003992,170,62,8,240
"3993",1003993,59,160,8,227
"3994",1003994,24,109,7,140
"3995",1003995,116,174,9,299
"3996",1003996,167,87,2,256
"3997",1003997,37,202,12,251
"3998",1003998,64,48,3,115
"3999",1003999,301,10,1,312
"4000",1004000,161,65,5,231
"4001",1004001,53,247,6,306
"4002",1004002,169,83,20,272
"4003",1004003,167,65,3,235
"4004",1004004,93,99,1,193
"4005",1004005,143,84,11,238
"4006",1004006,114,60,8,182
"4007",1004007,104,133,11,248
"4008",1004008,4,4,0,8
"4009",1004009,209,73,21,303
"4010",1004010,94,120,7,221
"4011",1004011,57,158,13,228
"4012",1004012,107,30,8,145
"4013",1004013,151,46,11,208
"4014",1004014,75,110,6,191
"4015",1004015,120,137,34,291
"4016",1004016,119,39,3,161
"4017",1004017,123,118,18,259
"4018",1004018,24,247,4,275
"4019",1004019,26,269,9,304
"4020",1004020,170,80,7,257
"4021",1004021,82,210,18,310
"4022",1004022,126,126,1,253
"4023",1004023,138,138,6,282
"4024",1004024,222,22,4,248
"4025",1004025,74,138,8,220
"4026",1004026,38,200,0,238
"4027",1004027,164,65,16,245
"4028",1004028,143,51,6,200
"4029",1004029,164,13,3,180
"4030",1004030,63,105,2,170
"4031",1004031,121,158,11,290
"4032",1004032,158,46,4,208
"4033",1004033,37,271,10,318
"4034",1004034,88,190,17,295
"4035",1004035,82,26,4,112
"4036",1004036,45,93,0,138
"4037",1004037,142,78,8,228
"4038",1004038,111,115,10,236
"4039",1004039,91,150,32,273
"4040",1004040,211,45,7,263
"4041",1004041,142,23,4,169
"4042",1004042,87,179,3,269
"4043",1004043,51,51,2,104
"4044",1004044,149,130,6,285
"4045",1004045,151,44,5,200
"4046",1004046,149,161,13,323
"4047",1004047,134,20,7,161
"4048",1004048,47,260,6,313
"4049",1004049,166,17,9,192
"4050",1004050,179,85,7,271
"4051",1004051,150,102,12,264
"4052",1004052,117,76,7,200
"4053",1004053,115,166,11,292
"4054",1004054,48,160,2,210
"4055",1004055,26,9,2,37
"4056",1004056,25,210,4,239
"4057",1004057,231,71,13,315
"4058",1004058,151,96,10,257
"4059",1004059,40,252,8,300
"4060",1004060,66,149,3,218
"4061",1004061,24,18,1,43
"4062",1004062,44,230,3,277
"4063",1004063,101,205,5,311
"4064",1004064,167,72,10,249
"4065",1004065,18,220,1,239
"4066",1004066,234,17,14,265
"4067",1004067,104,93,3,200
"4068",1004068,108,150,5,263
"4069",1004069,44,131,1,176
"4070",1004070,37,124,6,167
"4071",1004071,102,151,17,270
"4072",1004072,31,262,5,298
"4073",1004073,72,224,7,303
"4074",1004074,11,6,4,21
"4075",1004075,131,78,4,213
"4076",1004076,128,117,4,249
"4077",1004077,134,20,2,156
"4078",1004078,174,48,7,229
"4079",1004079,106,127,16,249
"4080",1004080,139,104,6,249
"4081",1004081,242,236,60,538
"4082",1004082,123,158,17,298
"4083",1004083,54,136,18,208
"4084",1004084,90,130,5,225
"4085",1004085,86,53,8,147
"4086",1004086,48,218,6,272
"4087",1004087,79,122,9,210
"4088",1004088,46,167,3,216
"4089",1004089,121,8,0,129
"4090",1004090,237,28,7,272
"4091",1004091,140,109,8,257
"4092",1004092,119,127,20,266
"4093",1004093,168,157,6,331
"4094",1004094,103,121,4,228
"4095",1004095,35,216,2,253
"4096",1004096,76,177,3,256
"4097",1004097,130,81,13,224
"4098",1004098,70,13,4,87
"4099",1004099,191,19,5,215
"4100",1004100,145,61,14,220
"4101",1004101,67,57,4,128
"4102",1004102,157,32,7,196
"4103",1004103,79,201,15,295
"4104",1004104,160,102,13,275
"4105",1004105,108,40,4,152
"4106",1004106,38,43,6,87
"4107",1004107,54,191,13,258
"4108",1004108,62,262,14,338
"4109",1004109,190,110,18,318
"4110",1004110,68,135,14,217
"4111",1004111,36,113,7,156
"4112",1004112,40,171,2,213
"4113",1004113,100,163,16,279
"4114",1004114,114,108,6,228
"4115",1004115,105,169,8,282
"4116",1004116,183,39,8,230
"4117",1004117,54,207,5,266
"4118",1004118,73,160,9,242
"4119",1004119,154,71,10,235
"4120",1004120,99,96,9,204
"4121",1004121,155,54,14,223
"4122",1004122,86,63,3,152
"4123",1004123,75,10,3,88
"4124",1004124,139,31,5,175
"4125",1004125,112,45,5,162
"4126",1004126,159,48,11,218
"4127",1004127,102,91,7,200
"4128",1004128,132,123,16,271
"4129",1004129,204,7,3,214
"4130",1004130,83,38,0,121
"4131",1004131,193,29,12,234
"4132",1004132,116,159,11,286
"4133",1004133,97,61,6,164
"4134",1004134,111,145,16,272
"4135",1004135,136,40,3,179
"4136",1004136,50,172,5,227
"4137",1004137,86,112,5,203
"4138",1004138,107,135,12,254
"4139",1004139,220,71,9,300
"4140",1004140,215,70,11,296
"4141",1004141,204,99,17,320
"4142",1004142,126,76,21,223
"4143",1004143,142,18,7,167
"4144",1004144,209,1,2,212
"4145",1004145,218,49,8,275
"4146",1004146,87,136,2,225
"4147",1004147,117,84,8,209
"4148",1004148,82,130,3,215
"4149",1004149,231,2,0,233
"4150",1004150,111,118,11,240
"4151",1004151,35,146,7,188
"4152",1004152,82,101,26,209
"4153",1004153,145,93,12,250
"4154",1004154,54,139,11,204
"4155",1004155,126,41,4,171
"4156",1004156,94,140,4,238
"4157",1004157,208,74,13,295
"4158",1004158,194,17,0,211
"4159",1004159,169,52,4,225
"4160",1004160,161,15,7,183
"4161",1004161,112,88,12,212
"4162",1004162,62,98,6,166
"4163",1004163,123,91,9,223
"4164",1004164,89,112,20,221
"4165",1004165,86,147,20,253
"4166",1004166,211,27,10,248
"4167",1004167,129,105,21,255
"4168",1004168,26,43,2,71
"4169",1004169,197,159,18,374
"4170",1004170,71,186,4,261
"4171",1004171,11,91,0,102
"4172",1004172,41,260,3,304
"4173",1004173,143,80,9,232
"4174",1004174,16,45,1,62
"4175",1004175,49,206,5,260
"4176",1004176,52,216,3,271
"4177",1004177,74,27,2,103
"4178",1004178,140,158,22,320
"4179",1004179,33,291,2,326
"4180",1004180,193,74,8,275
"4181",1004181,140,78,6,224
"4182",1004182,63,162,15,240
"4183",1004183,143,59,9,211
"4184",1004184,70,115,12,197
"4185",1004185,113,33,7,153
"4186",1004186,110,27,2,139
"4187",1004187,36,202,8,246
"4188",1004188,27,285,7,319
"4189",1004189,244,53,7,304
"4190",1004190,162,75,1,238
"4191",1004191,205,63,9,277
"4192",1004192,135,87,11,233
"4193",1004193,154,47,11,212
"4194",1004194,58,26,4,88
"4195",1004195,20,142,2,164
"4196",1004196,181,35,6,222
"4197",1004197,170,95,22,287
"4198",1004198,59,137,9,205
"4199",1004199,177,138,4,319
"4200",1004200,78,109,1,188
"4201",1004201,245,48,6,299
"4202",1004202,31,232,2,265
"4203",1004203,154,51,5,210
"4204",1004204,228,16,12,256
"4205",1004205,215,34,6,255
"4206",1004206,176,68,6,250
"4207",1004207,106,34,5,145
"4208",1004208,65,255,10,330
"4209",1004209,125,125,20,270
"4210",1004210,154,100,4,258
"4211",1004211,115,103,8,226
"4212",1004212,58,35,12,105
"4213",1004213,91,50,4,145
"4214",1004214,267,112,10,389
"4215",1004215,103,199,12,314
"4216",1004216,176,16,7,199
"4217",1004217,105,192,14,311
"4218",1004218,86,164,3,253
"4219",1004219,142,41,7,190
"4220",1004220,139,84,5,228
"4221",1004221,207,22,7,236
"4222",1004222,220,28,11,259
"4223",1004223,136,147,6,289
"4224",1004224,14,161,7,182
"4225",1004225,63,113,18,194
"4226",1004226,77,193,2,272
"4227",1004227,83,37,3,123
"4228",1004228,85,216,2,303
"4229",1004229,268,47,9,324
"4230",1004230,147,64,4,215
"4231",1004231,227,20,8,255
"4232",1004232,154,168,5,327
"4233",1004233,177,55,8,240
"4234",1004234,46,182,14,242
"4235",1004235,29,227,8,264
"4236",1004236,3,45,0,48
"4237",1004237,56,232,1,289
"4238",1004238,208,41,16,265
"4239",1004239,68,169,8,245
"4240",1004240,84,216,9,309
"4241",1004241,47,198,3,248
"4242",1004242,113,139,6,258
"4243",1004243,111,71,5,187
"4244",1004244,153,49,18,220
"4245",1004245,192,52,11,255
"4246",1004246,45,17,3,65
"4247",1004247,9,104,2,115
"4248",1004248,118,76,10,204
"4249",1004249,228,40,3,271
"4250",1004250,59,154,8,221
"4251",1004251,20,182,3,205
"4252",1004252,170,61,6,237
"4253",1004253,50,156,14,220
"4254",1004254,234,31,7,272
"4255",1004255,55,194,11,260
"4256",1004256,138,41,7,186
"4257",1004257,66,113,2,181
"4258",1004258,213,32,9,254
"4259",1004259,183,23,6,212
"4260",1004260,185,52,5,242
"4261",1004261,144,41,2,187
"4262",1004262,61,158,1,220
"4263",1004263,39,235,2,276
"4264",1004264,90,32,9,131
"4265",1004265,62,196,14,272
"4266",1004266,166,76,7,249
"4267",1004267,31,234,3,268
"4268",1004268,220,34,11,265
"4269",1004269,99,49,11,159
"4270",1004270,161,55,7,223
"4271",1004271,112,2,2,116
"4272",1004272,107,109,10,226
"4273",1004273,188,36,9,233
"4274",1004274,73,127,7,207
"4275",1004275,115,138,13,266
"4276",1004276,139,64,7,210
"4277",1004277,145,105,6,256
"4278",1004278,180,32,12,224
"4279",1004279,168,48,12,228
"4280",1004280,71,190,9,270
"4281",1004281,111,117,10,238
"4282",1004282,127,150,11,288
"4283",1004283,214,22,4,240
"4284",1004284,100,104,4,208
"4285",1004285,30,33,5,68
"4286",1004286,35,183,2,220
"4287",1004287,33,285,8,326
"4288",1004288,155,84,11,250
"4289",1004289,55,193,7,255
"4290",1004290,105,99,8,212
"4291",1004291,52,251,3,306
"4292",1004292,128,34,2,164
"4293",1004293,99,142,10,251
"4294",1004294,89,100,12,201
"4295",1004295,18,164,1,183
"4296",1004296,103,63,6,172
"4297",1004297,111,126,9,246
"4298",1004298,100,42,4,146
"4299",1004299,112,112,13,237
"4300",1004300,287,78,6,371
"4301",1004301,13,20,1,34
"4302",1004302,53,158,9,220
"4303",1004303,203,23,8,234
"4304",1004304,99,60,2,161
"4305",1004305,39,222,6,267
"4306",1004306,141,156,8,305
"4307",1004307,47,50,4,101
"4308",1004308,217,33,3,253
"4309",1004309,41,126,1,168
"4310",1004310,61,56,3,120
"4311",1004311,63,184,8,255
"4312",1004312,208,34,9,251
"4313",1004313,170,47,10,227
"4314",1004314,51,259,4,314
"4315",1004315,169,44,12,225
"4316",1004316,219,65,4,288
"4317",1004317,42,132,4,178
"4318",1004318,136,81,9,226
"4319",1004319,16,97,0,113
"4320",1004320,198,71,24,293
"4321",1004321,29,0,3,32
"4322",1004322,101,157,11,269
"4323",1004323,147,25,3,175
"4324",1004324,378,62,44,484
"4325",1004325,139,81,6,226
"4326",1004326,135,72,6,213
"4327",1004327,144,114,18,276
"4328",1004328,113,131,6,250
"4329",1004329,103,115,12,230
"4330",1004330,215,33,1,249
"4331",1004331,10,20,0,30
"4332",1004332,88,81,9,178
"4333",1004333,77,110,4,191
"4334",1004334,2,26,1,29
"4335",1004335,82,43,0,125
"4336",1004336,210,33,14,257
"4337",1004337,86,54,15,155
"4338",1004338,58,204,14,276
"4339",1004339,139,126,12,277
"4340",1004340,52,154,4,210
"4341",1004341,96,60,8,164
"4342",1004342,107,128,13,248
"4343",1004343,227,49,29,305
"4344",1004344,88,98,4,190
"4345",1004345,64,60,7,131
"4346",1004346,73,10,3,86
"4347",1004347,113,110,10,233
"4348",1004348,95,22,6,123
"4349",1004349,46,250,7,303
"4350",1004350,112,55,2,169
"4351",1004351,70,168,4,242
"4352",1004352,121,30,15,166
"4353",1004353,102,162,6,270
"4354",1004354,146,72,6,224
"4355",1004355,170,70,18,258
"4356",1004356,103,202,8,313
"4357",1004357,36,241,3,280
"4358",1004358,149,40,7,196
"4359",1004359,244,37,12,293
"4360",1004360,108,59,21,188
"4361",1004361,104,107,22,233
"4362",1004362,169,106,12,287
"4363",1004363,157,125,8,290
"4364",1004364,44,182,1,227
"4365",1004365,94,72,14,180
"4366",1004366,64,202,10,276
"4367",1004367,117,43,4,164
"4368",1004368,93,107,5,205
"4369",1004369,60,198,22,280
"4370",1004370,180,52,7,239
"4371",1004371,47,257,6,310
"4372",1004372,196,109,3,308
"4373",1004373,73,177,10,260
"4374",1004374,139,35,6,180
"4375",1004375,140,94,15,249
"4376",1004376,145,204,20,369
"4377",1004377,86,39,2,127
"4378",1004378,234,41,22,297
"4379",1004379,51,265,9,325
"4380",1004380,24,190,3,217
"4381",1004381,147,88,4,239
"4382",1004382,101,227,9,337
"4383",1004383,65,232,15,312
"4384",1004384,203,42,5,250
"4385",1004385,62,240,8,310
"4386",1004386,229,73,20,322
"4387",1004387,147,3,3,153
"4388",1004388,124,23,7,154
"4389",1004389,22,283,2,307
"4390",1004390,53,194,21,268
"4391",1004391,100,57,4,161
"4392",1004392,194,31,7,232
"4393",1004393,85,47,7,139
"4394",1004394,81,145,18,244
"4395",1004395,134,170,16,320
"4396",1004396,163,75,18,256
"4397",1004397,134,93,9,236
"4398",1004398,76,165,14,255
"4399",1004399,117,22,6,145
"4400",1004400,230,12,7,249
"4401",1004401,104,114,11,229
"4402",1004402,65,77,8,150
"4403",1004403,109,182,8,299
"4404",1004404,118,104,10,232
"4405",1004405,22,204,3,229
"4406",1004406,65,169,20,254
"4407",1004407,81,74,3,158
"4408",1004408,57,217,22,296
"4409",1004409,52,140,6,198
"4410",1004410,10,108,3,121
"4411",1004411,91,150,9,250
"4412",1004412,168,66,11,245
"4413",1004413,109,7,1,117
"4414",1004414,139,197,11,347
"4415",1004415,75,214,4,293
"4416",1004416,145,140,4,289
"4417",1004417,105,41,3,149
"4418",1004418,32,152,0,184
"4419",1004419,1,4,1,6
"4420",1004420,108,169,16,293
"4421",1004421,125,55,29,209
"4422",1004422,10,87,1,98
"4423",1004423,168,67,12,247
"4424",1004424,43,239,7,289
"4425",1004425,131,92,6,229
"4426",1004426,68,146,12,226
"4427",1004427,90,109,15,214
"4428",1004428,151,68,9,228
"4429",1004429,22,263,3,288
"4430",1004430,111,177,11,299
"4431",1004431,14,17,1,32
"4432",1004432,156,88,10,254
"4433",1004433,38,235,10,283
"4434",1004434,81,100,5,186
"4435",1004435,111,96,11,218
"4436",1004436,54,213,6,273
"4437",1004437,258,55,17,330
"4438",1004438,201,54,8,263
"4439",1004439,50,48,1,99
"4440",1004440,31,198,6,235
"4441",1004441,168,141,15,324
"4442",1004442,218,20,1,239
"4443",1004443,66,197,13,276
"4444",1004444,241,54,6,301
"4445",1004445,30,106,2,138
"4446",1004446,116,52,3,171
"4447",1004447,89,11,5,105
"4448",1004448,138,155,3,296
"4449",1004449,123,69,12,204
"4450",1004450,85,29,5,119
"4451",1004451,143,36,4,183
"4452",1004452,152,68,9,229
"4453",1004453,104,104,2,210
"4454",1004454,72,178,15,265
"4455",1004455,37,164,12,213
"4456",1004456,73,80,5,158
"4457",1004457,104,211,3,318
"4458",1004458,126,52,3,181
"4459",1004459,155,114,5,274
"4460",1004460,105,32,3,140
"4461",1004461,4,59,1,64
"4462",1004462,18,158,1,177
"4463",1004463,171,52,6,229
"4464",1004464,158,27,4,189
"4465",1004465,1,6,0,7
"4466",1004466,140,13,4,157
"4467",1004467,58,189,12,259
"4468",1004468,111,108,6,225
"4469",1004469,15,168,2,185
"4470",1004470,139,154,8,301
"4471",1004471,135,61,6,202
"4472",1004472,57,207,14,278
"4473",1004473,142,105,9,256
"4474",1004474,127,86,8,221
"4475",1004475,71,231,3,305
"4476",1004476,112,156,10,278
"4477",1004477,11,23,1,35
"4478",1004478,20,9,1,30
"4479",1004479,55,57,1,113
"4480",1004480,213,72,14,299
"4481",1004481,101,148,15,264
"4482",1004482,77,235,12,324
"4483",1004483,69,78,2,149
"4484",1004484,219,30,4,253
"4485",1004485,43,107,2,152
"4486",1004486,57,54,12,123
"4487",1004487,296,11,13,320
"4488",1004488,136,33,3,172
"4489",1004489,88,176,5,269
"4490",1004490,103,86,4,193
"4491",1004491,112,181,3,296
"4492",1004492,79,243,4,326
"4493",1004493,196,58,13,267
"4494",1004494,138,112,16,266
"4495",1004495,123,135,12,270
"4496",1004496,33,62,1,96
"4497",1004497,15,230,5,250
"4498",1004498,157,83,6,246
"4499",1004499,54,185,7,246
"4500",1004500,141,46,9,196
"4501",1004501,99,132,5,236
"4502",1004502,39,242,0,281
"4503",1004503,226,55,5,286
"4504",1004504,199,68,8,275
"4505",1004505,89,164,7,260
"4506",1004506,50,256,9,315
"4507",1004507,209,41,6,256
"4508",1004508,71,17,6,94
"4509",1004509,113,150,8,271
"4510",1004510,180,61,1,242
"4511",1004511,165,116,1,282
"4512",1004512,33,248,2,283
"4513",1004513,74,107,4,185
"4514",1004514,133,66,13,212
"4515",1004515,122,22,6,150
"4516",1004516,41,76,3,120
"4517",1004517,41,113,8,162
"4518",1004518,297,20,12,329
"4519",1004519,192,72,19,283
"4520",1004520,77,196,3,276
"4521",1004521,59,253,10,322
"4522",1004522,7,1,1,9
"4523",1004523,29,28,1,58
"4524",1004524,200,57,13,270
"4525",1004525,89,168,12,269
"4526",1004526,103,82,9,194
"4527",1004527,92,106,14,212
"4528",1004528,108,28,5,141
"4529",1004529,30,54,3,87
"4530",1004530,87,12,3,102
"4531",1004531,245,21,7,273
"4532",1004532,187,121,14,322
"4533",1004533,50,9,1,60
"4534",1004534,67,249,7,323
"4535",1004535,85,261,13,359
"4536",1004536,34,53,3,90
"4537",1004537,24,23,0,47
"4538",1004538,155,71,13,239
"4539",1004539,68,167,8,243
"4540",1004540,158,21,6,185
"4541",1004541,114,55,16,185
"4542",1004542,37,212,2,251
"4543",1004543,110,98,8,216
"4544",1004544,255,44,8,307
"4545",1004545,78,168,9,255
"4546",1004546,75,158,15,248
"4547",1004547,157,148,8,313
"4548",1004548,217,53,7,277
"4549",1004549,103,143,6,252
"4550",1004550,196,65,10,271
"4551",1004551,91,171,8,270
"4552",1004552,128,105,6,239
"4553",1004553,44,232,4,280
"4554",1004554,40,41,2,83
"4555",1004555,53,2,0,55
"4556",1004556,46,37,2,85
"4557",1004557,164,68,8,240
"4558",1004558,198,23,4,225
"4559",1004559,8,2,2,12
"4560",1004560,175,35,8,218
"4561",1004561,131,40,1,172
"4562",1004562,78,242,10,330
"4563",1004563,149,69,4,222
"4564",1004564,89,79,6,174
"4565",1004565,147,73,2,222
"4566",1004566,83,80,9,172
"4567",1004567,121,57,15,193
"4568",1004568,79,194,10,283
"4569",1004569,87,174,3,264
"4570",1004570,172,87,15,274
"4571",1004571,209,22,9,240
"4572",1004572,173,111,14,298
"4573",1004573,39,232,8,279
"4574",1004574,59,118,6,183
"4575",1004575,189,7,5,201
"4576",1004576,58,7,1,66
"4577",1004577,36,183,5,224
"4578",1004578,137,141,15,293
"4579",1004579,12,9,0,21
"4580",1004580,150,68,12,230
"4581",1004581,186,64,8,258
"4582",1004582,187,63,7,257
"4583",1004583,51,270,3,324
"4584",1004584,117,83,6,206
"4585",1004585,134,123,8,265
"4586",1004586,33,192,5,230
"4587",1004587,4,20,0,24
"4588",1004588,133,48,1,182
"4589",1004589,165,30,3,198
"4590",1004590,105,78,3,186
"4591",1004591,59,167,8,234
"4592",1004592,85,71,5,161
"4593",1004593,117,139,10,266
"4594",1004594,126,31,5,162
"4595",1004595,160,49,9,218
"4596",1004596,45,243,4,292
"4597",1004597,75,90,3,168
"4598",1004598,226,45,6,277
"4599",1004599,135,149,14,298
"4600",1004600,67,26,1,94
"4601",1004601,140,115,4,259
"4602",1004602,180,24,3,207
"4603",1004603,39,165,6,210
"4604",1004604,11,100,0,111
"4605",1004605,136,133,8,277
"4606",1004606,141,88,22,251
"4607",1004607,21,9,4,34
"4608",1004608,173,61,8,242
"4609",1004609,151,54,5,210
"4610",1004610,55,27,4,86
"4611",1004611,57,221,12,290
"4612",1004612,92,140,7,239
"4613",1004613,113,100,8,221
"4614",1004614,34,181,9,224
"4615",1004615,91,143,5,239
"4616",1004616,53,42,3,98
"4617",1004617,43,200,3,246
"4618",1004618,142,67,8,217
"4619",1004619,83,190,4,277
"4620",1004620,38,71,8,117
"4621",1004621,121,69,6,196
"4622",1004622,171,32,6,209
"4623",1004623,60,200,7,267
"4624",1004624,44,211,6,261
"4625",1004625,79,115,2,196
"4626",1004626,241,39,7,287
"4627",1004627,163,18,3,184
"4628",1004628,86,33,3,122
"4629",1004629,114,112,11,237
"4630",1004630,71,182,10,263
"4631",1004631,97,53,9,159
"4632",1004632,136,123,15,274
"4633",1004633,171,79,3,253
"4634",1004634,140,9,1,150
"4635",1004635,23,11,4,38
"4636",1004636,38,231,10,279
"4637",1004637,155,44,6,205
"4638",1004638,58,6,0,64
"4639",1004639,119,127,3,249
"4640",1004640,27,219,7,253
"4641",1004641,45,233,10,288
"4642",1004642,71,75,5,151
"4643",1004643,116,96,6,218
"4644",1004644,70,220,4,294
"4645",1004645,144,66,8,218
"4646",1004646,8,31,1,40
"4647",1004647,76,124,2,202
"4648",1004648,151,44,4,199
"4649",1004649,169,140,18,327
"4650",1004650,159,9,1,169
"4651",1004651,12,235,8,255
"4652",1004652,208,39,10,257
"4653",1004653,8,295,0,303
"4654",1004654,164,94,4,262
"4655",1004655,11,4,4,19
"4656",1004656,96,139,7,242
"4657",1004657,42,180,6,228
"4658",1004658,153,78,7,238
"4659",1004659,175,84,8,267
"4660",1004660,27,162,1,190
"4661",1004661,154,63,13,230
"4662",1004662,53,40,4,97
"4663",1004663,151,67,3,221
"4664",1004664,78,197,2,277
"4665",1004665,207,38,10,255
"4666",1004666,104,110,3,217
"4667",1004667,116,126,7,249
"4668",1004668,94,33,8,135
"4669",1004669,101,97,13,211
"4670",1004670,102,41,1,144
"4671",1004671,213,49,8,270
"4672",1004672,187,105,5,297
"4673",1004673,117,55,9,181
"4674",1004674,157,74,5,236
"4675",1004675,132,64,5,201
"4676",1004676,113,175,19,307
"4677",1004677,245,6,0,251
"4678",1004678,43,193,6,242
"4679",1004679,37,230,11,278
"4680",1004680,142,138,11,291
"4681",1004681,143,105,9,257
"4682",1004682,208,36,7,251
"4683",1004683,26,87,4,117
"4684",1004684,100,148,14,262
"4685",1004685,167,35,13,215
"4686",1004686,17,247,5,269
"4687",1004687,91,98,7,196
"4688",1004688,45,160,6,211
"4689",1004689,31,130,14,175
"4690",1004690,100,171,12,283
"4691",1004691,192,72,7,271
"4692",1004692,122,84,6,212
"4693",1004693,5,1,0,6
"4694",1004694,51,187,5,243
"4695",1004695,96,36,9,141
"4696",1004696,89,171,18,278
"4697",1004697,63,226,7,296
"4698",1004698,24,186,13,223
"4699",1004699,167,31,8,206
"4700",1004700,33,15,1,49
"4701",1004701,26,361,6,393
"4702",1004702,240,41,5,286
"4703",1004703,103,7,5,115
"4704",1004704,71,147,2,220
"4705",1004705,161,64,8,233
"4706",1004706,149,38,12,199
"4707",1004707,89,101,6,196
"4708",1004708,37,176,5,218
"4709",1004709,120,24,14,158
"4710",1004710,123,161,2,286
"4711",1004711,91,38,2,131
"4712",1004712,86,162,9,257
"4713",1004713,187,23,7,217
"4714",1004714,116,127,15,258
"4715",1004715,91,118,5,214
"4716",1004716,115,129,11,255
"4717",1004717,106,93,7,206
"4718",1004718,226,74,4,304
"4719",1004719,125,111,18,254
"4720",1004720,44,20,2,66
"4721",1004721,107,80,12,199
"4722",1004722,9,0,0,9
"4723",1004723,147,76,10,233
"4724",1004724,105,60,4,169
"4725",1004725,56,267,17,340
"4726",1004726,45,224,4,273
"4727",1004727,156,139,10,305
"4728",1004728,112,149,23,284
"4729",1004729,217,57,4,278
"4730",1004730,222,31,8,261
"4731",1004731,25,235,10,270
"4732",1004732,20,203,2,225
"4733",1004733,38,263,13,314
"4734",1004734,15,3,0,18
"4735",1004735,192,126,14,332
"4736",1004736,129,23,6,158
"4737",1004737,22,202,5,229
"4738",1004738,103,101,8,212
"4739",1004739,52,183,8,243
"4740",1004740,136,95,9,240
"4741",1004741,187,74,9,270
"4742",1004742,23,15,3,41
"4743",1004743,89,189,2,280
"4744",1004744,6,3,0,9
"4745",1004745,87,207,16,310
"4746",1004746,148,81,4,233
"4747",1004747,109,165,13,287
"4748",1004748,62,218,15,295
"4749",1004749,173,49,6,228
"4750",1004750,151,43,5,199
"4751",1004751,67,254,7,328
"4752",1004752,11,3,0,14
"4753",1004753,171,23,10,204
"4754",1004754,117,47,3,167
"4755",1004755,163,30,5,198
"4756",1004756,155,83,6,244
"4757",1004757,204,21,4,229
"4758",1004758,73,210,14,297
"4759",1004759,61,116,13,190
"4760",1004760,173,67,14,254
"4761",1004761,195,92,13,300
"4762",1004762,126,95,3,224
"4763",1004763,133,148,20,301
"4764",1004764,49,226,8,283
"4765",1004765,57,239,6,302
"4766",1004766,47,214,8,269
"4767",1004767,161,19,7,187
"4768",1004768,192,10,4,206
"4769",1004769,46,213,20,279
"4770",1004770,119,32,6,157
"4771",1004771,216,27,9,252
"4772",1004772,54,174,5,233
"4773",1004773,69,118,0,187
"4774",1004774,142,87,4,233
"4775",1004775,21,199,4,224
"4776",1004776,124,20,5,149
"4777",1004777,107,123,8,238
"4778",1004778,59,191,9,259
"4779",1004779,149,132,27,308
"4780",1004780,232,36,2,270
"4781",1004781,154,73,17,244
"4782",1004782,32,42,4,78
"4783",1004783,55,173,1,229
"4784",1004784,136,171,4,311
"4785",1004785,12,8,1,21
"4786",1004786,51,260,8,319
"4787",1004787,219,57,4,280
"4788",1004788,117,199,21,337
"4789",1004789,117,52,10,179
"4790",1004790,149,101,6,256
"4791",1004791,117,111,8,236
"4792",1004792,92,21,4,117
"4793",1004793,157,29,7,193
"4794",1004794,54,83,7,144
"4795",1004795,138,95,8,241
"4796",1004796,147,77,6,230
"4797",1004797,84,63,12,159
"4798",1004798,198,29,13,240
"4799",1004799,73,163,8,244
"4800",1004800,36,17,3,56
"4801",1004801,23,175,2,200
"4802",1004802,155,169,12,336
"4803",1004803,23,111,3,137
"4804",1004804,188,135,9,332
"4805",1004805,2,5,2,9
"4806",1004806,59,149,12,220
"4807",1004807,32,257,7,296
"4808",1004808,30,213,6,249
"4809",1004809,125,124,6,255
"4810",1004810,107,70,3,180
"4811",1004811,12,9,0,21
"4812",1004812,146,18,8,172
"4813",1004813,80,210,8,298
"4814",1004814,59,173,6,238
"4815",1004815,76,34,0,110
"4816",1004816,179,75,5,259
"4817",1004817,49,216,6,271
"4818",1004818,102,175,4,281
"4819",1004819,178,110,14,302
"4820",1004820,114,39,6,159
"4821",1004821,43,181,9,233
"4822",1004822,100,112,11,223
"4823",1004823,154,78,3,235
"4824",1004824,144,47,7,198
"4825",1004825,116,22,2,140
"4826",1004826,102,26,2,130
"4827",1004827,46,76,3,125
"4828",1004828,148,34,2,184
"4829",1004829,54,221,12,287
"4830",1004830,62,18,6,86
"4831",1004831,130,71,10,211
"4832",1004832,126,49,10,185
"4833",1004833,139,156,14,309
"4834",1004834,66,54,9,129
"4835",1004835,136,159,15,310
"4836",1004836,76,81,7,164
"4837",1004837,11,176,1,188
"4838",1004838,160,16,4,180
"4839",1004839,183,72,6,261
"4840",1004840,101,148,7,256
"4841",1004841,145,104,11,260
"4842",1004842,115,132,17,264
"4843",1004843,97,55,11,163
"4844",1004844,90,164,11,265
"4845",1004845,47,31,2,80
"4846",1004846,203,41,6,250
"4847",1004847,188,9,6,203
"4848",1004848,91,194,9,294
"4849",1004849,132,28,8,168
"4850",1004850,194,98,7,299
"4851",1004851,68,119,3,190
"4852",1004852,73,185,15,273
"4853",1004853,45,229,4,278
"4854",1004854,188,52,23,263
"4855",1004855,20,0,3,23
"4856",1004856,47,280,3,330
"4857",1004857,42,18,1,61
"4858",1004858,89,171,9,269
"4859",1004859,112,96,8,216
"4860",1004860,137,189,7,333
"4861",1004861,188,9,7,204
"4862",1004862,100,155,22,277
"4863",1004863,117,64,9,190
"4864",1004864,87,90,4,181
"4865",1004865,45,32,6,83
"4866",1004866,189,70,16,275
"4867",1004867,107,149,16,272
"4868",1004868,46,248,5,299
"4869",1004869,92,71,7,170
"4870",1004870,117,161,9,287
"4871",1004871,173,63,14,250
"4872",1004872,17,103,2,122
"4873",1004873,34,209,3,246
"4874",1004874,65,134,4,203
"4875",1004875,168,21,7,196
"4876",1004876,8,213,3,224
"4877",1004877,81,140,11,232
"4878",1004878,54,199,4,257
"4879",1004879,39,191,5,235
"4880",1004880,78,195,22,295
"4881",1004881,149,74,8,231
"4882",1004882,17,219,1,237
"4883",1004883,180,65,5,250
"4884",1004884,35,81,0,116
"4885",1004885,139,61,21,221
"4886",1004886,206,37,7,250
"4887",1004887,168,100,5,273
"4888",1004888,80,214,11,305
"4889",1004889,77,122,2,201
"4890",1004890,94,89,12,195
"4891",1004891,114,106,6,226
"4892",1004892,146,142,9,297
"4893",1004893,135,40,13,188
"4894",1004894,76,241,14,331
"4895",1004895,157,43,8,208
"4896",1004896,121,135,12,268
"4897",1004897,70,81,10,161
"4898",1004898,175,36,8,219
"4899",1004899,125,67,4,196
"4900",1004900,113,71,18,202
"4901",1004901,128,11,2,141
"4902",1004902,54,187,1,242
"4903",1004903,283,18,6,307
"4904",1004904,62,33,2,97
"4905",1004905,145,65,10,220
"4906",1004906,178,71,8,257
"4907",1004907,63,212,0,275
"4908",1004908,90,141,6,237
"4909",1004909,56,103,3,162
"4910",1004910,68,210,8,286
"4911",1004911,234,78,12,324
"4912",1004912,47,180,10,237
"4913",1004913,69,146,1,216
"4914",1004914,51,81,1,133
"4915",1004915,81,127,18,226
"4916",1004916,135,98,7,240
"4917",1004917,198,32,8,238
"4918",1004918,18,15,0,33
"4919",1004919,87,212,3,302
"4920",1004920,27,10,1,38
"4921",1004921,224,6,10,240
"4922",1004922,55,43,5,103
"4923",1004923,184,31,4,219
"4924",1004924,127,120,10,257
"4925",1004925,28,66,2,96
"4926",1004926,91,224,10,325
"4927",1004927,154,190,10,354
"4928",1004928,143,139,8,290
"4929",1004929,145,37,0,182
"4930",1004930,152,69,2,223
"4931",1004931,109,17,4,130
"4932",1004932,186,41,9,236
"4933",1004933,70,26,9,105
"4934",1004934,249,41,8,298
"4935",1004935,48,1,2,51
"4936",1004936,128,91,6,225
"4937",1004937,89,111,11,211
"4938",1004938,223,8,2,233
"4939",1004939,147,71,8,226
"4940",1004940,146,100,7,253
"4941",1004941,187,97,16,300
"4942",1004942,161,72,6,239
"4943",1004943,82,55,4,141
"4944",1004944,132,46,2,180
"4945",1004945,100,83,1,184
"4946",1004946,156,122,2,280
"4947",1004947,115,193,3,311
"4948",1004948,86,152,8,246
"4949",1004949,49,110,7,166
"4950",1004950,188,13,7,208
"4951",1004951,108,45,8,161
"4952",1004952,140,90,8,238
"4953",1004953,18,17,2,37
"4954",1004954,52,266,3,321
"4955",1004955,129,80,3,212
"4956",1004956,142,120,2,264
"4957",1004957,86,189,11,286
"4958",1004958,127,41,7,175
"4959",1004959,59,103,11,173
"4960",1004960,75,154,5,234
"4961",1004961,111,90,10,211
"4962",1004962,90,130,4,224
"4963",1004963,39,248,20,307
"4964",1004964,13,161,3,177
"4965",1004965,61,118,3,182
"4966",1004966,107,209,14,330
"4967",1004967,76,222,5,303
"4968",1004968,117,131,7,255
"4969",1004969,109,210,6,325
"4970",1004970,241,19,14,274
"4971",1004971,83,108,10,201
"4972",1004972,174,100,25,299
"4973",1004973,100,75,2,177
"4974",1004974,39,202,15,256
"4975",1004975,145,55,4,204
"4976",1004976,43,137,6,186
"4977",1004977,173,154,9,336
"4978",1004978,96,111,12,219
"4979",1004979,193,22,5,220
"4980",1004980,12,0,0,12
"4981",1004981,7,21,0,28
"4982",1004982,68,149,3,220
"4983",1004983,152,96,5,253
"4984",1004984,133,19,6,158
"4985",1004985,233,48,13,294
"4986",1004986,26,197,4,227
"4987",1004987,86,198,10,294
"4988",1004988,75,54,7,136
"4989",1004989,166,81,5,252
"4990",1004990,150,38,7,195
"4991",1004991,124,43,6,173
"4992",1004992,78,228,4,310
"4993",1004993,131,141,9,281
"4994",1004994,55,163,8,226
"4995",1004995,27,67,2,96
"4996",1004996,241,61,16,318
"4997",1004997,96,97,6,199
"4998",1004998,138,122,10,270
"4999",1004999,94,71,10,175
"5000",1005000,126,23,3,152
"5001",1005001,23,127,2,152
"5002",1005002,162,137,6,305
"5003",1005003,102,28,9,139
"5004",1005004,169,75,10,254
"5005",1005005,102,77,4,183
"5006",1005006,37,253,2,292
"5007",1005007,283,7,3,293
"5008",1005008,56,12,1,69
"5009",1005009,106,160,16,282
"5010",1005010,118,179,11,308
"5011",1005011,74,180,10,264
"5012",1005012,184,85,5,274
"5013",1005013,110,33,3,146
"5014",1005014,13,51,0,64
"5015",1005015,69,155,7,231
"5016",1005016,64,212,4,280
"5017",1005017,69,145,5,219
"5018",1005018,162,91,16,269
"5019",1005019,183,43,8,234
"5020",1005020,154,53,1,208
"5021",1005021,36,179,1,216
"5022",1005022,208,96,1,305
"5023",1005023,96,48,5,149
"5024",1005024,117,122,3,242
"5025",1005025,61,224,2,287
"5026",1005026,178,23,6,207
"5027",1005027,86,154,10,250
"5028",1005028,35,215,2,252
"5029",1005029,138,89,12,239
"5030",1005030,79,116,5,200
"5031",1005031,230,52,8,290
"5032",1005032,141,77,7,225
"5033",1005033,48,12,2,62
"5034",1005034,146,139,9,294
"5035",1005035,85,11,3,99
"5036",1005036,168,55,15,238
"5037",1005037,164,87,4,255
"5038",1005038,118,16,8,142
"5039",1005039,149,53,14,216
"5040",1005040,48,216,1,265
"5041",1005041,125,154,5,284
"5042",1005042,149,51,7,207
"5043",1005043,163,27,14,204
"5044",1005044,17,194,2,213
"5045",1005045,31,89,1,121
"5046",1005046,184,18,5,207
"5047",1005047,89,63,15,167
"5048",1005048,111,165,11,287
"5049",1005049,138,98,10,246
"5050",1005050,224,21,1,246
"5051",1005051,30,14,2,46
"5052",1005052,206,82,20,308
"5053",1005053,208,6,3,217
"5054",1005054,119,90,5,214
"5055",1005055,130,173,14,317
"5056",1005056,61,231,11,303
"5057",1005057,10,91,2,103
"5058",1005058,91,90,11,192
"5059",1005059,65,128,14,207
"5060",1005060,76,242,4,322
"5061",1005061,102,163,12,277
"5062",1005062,159,53,0,212
"5063",1005063,113,84,8,205
"5064",1005064,124,51,1,176
"5065",1005065,24,32,2,58
"5066",1005066,127,136,2,265
"5067",1005067,155,42,5,202
"5068",1005068,34,73,4,111
"5069",1005069,200,57,7,264
"5070",1005070,101,111,9,221
"5071",1005071,70,93,3,166
"5072",1005072,86,157,16,259
"5073",1005073,135,127,7,269
"5074",1005074,88,50,8,146
"5075",1005075,170,81,3,254
"5076",1005076,62,31,6,99
"5077",1005077,90,126,8,224
"5078",1005078,128,149,14,291
"5079",1005079,222,23,12,257
"5080",1005080,232,21,9,262
"5081",1005081,56,75,6,137
"5082",1005082,131,74,11,216
"5083",1005083,44,161,1,206
"5084",1005084,45,213,1,259
"5085",1005085,13,6,1,20
"5086",1005086,136,109,5,250
"5087",1005087,10,240,7,257
"5088",1005088,153,93,10,256
"5089",1005089,75,128,6,209
"5090",1005090,263,20,3,286
"5091",1005091,127,110,13,250
"5092",1005092,37,186,6,229
"5093",1005093,44,211,6,261
"5094",1005094,266,42,15,323
"5095",1005095,148,59,3,210
"5096",1005096,187,111,11,309
"5097",1005097,213,48,3,264
"5098",1005098,152,0,0,152
"5099",1005099,59,189,4,252
"5100",1005100,53,175,8,236
"5101",1005101,14,119,2,135
"5102",1005102,68,166,27,261
"5103",1005103,138,100,8,246
"5104",1005104,220,60,19,299
"5105",1005105,101,47,2,150
"5106",1005106,161,25,1,187
"5107",1005107,84,204,12,300
"5108",1005108,118,40,8,166
"5109",1005109,54,137,5,196
"5110",1005110,29,3,2,34
"5111",1005111,120,156,7,283
"5112",1005112,29,49,0,78
"5113",1005113,82,223,5,310
"5114",1005114,102,84,13,199
"5115",1005115,32,24,2,58
"5116",1005116,225,65,9,299
"5117",1005117,60,279,7,346
"5118",1005118,138,129,6,273
"5119",1005119,74,249,9,332
"5120",1005120,50,166,4,220
"5121",1005121,77,70,12,159
"5122",1005122,4,24,3,31
"5123",1005123,192,41,6,239
"5124",1005124,33,235,5,273
"5125",1005125,87,130,12,229
"5126",1005126,111,64,2,177
"5127",1005127,146,74,5,225
"5128",1005128,93,177,20,290
"5129",1005129,142,55,9,206
"5130",1005130,149,12,3,164
"5131",1005131,118,77,19,214
"5132",1005132,149,26,4,179
"5133",1005133,155,84,8,247
"5134",1005134,82,198,6,286
"5135",1005135,164,77,15,256
"5136",1005136,173,121,14,308
"5137",1005137,125,36,9,170
"5138",1005138,82,207,8,297
"5139",1005139,95,145,7,247
"5140",1005140,138,82,10,230
"5141",1005141,134,37,29,200
"5142",1005142,70,169,3,242
"5143",1005143,119,94,7,220
"5144",1005144,74,389,21,484
"5145",1005145,111,204,15,330
"5146",1005146,24,197,3,224
"5147",1005147,155,55,10,220
"5148",1005148,52,199,10,261
"5149",1005149,132,131,26,289
"5150",1005150,184,49,23,256
"5151",1005151,56,2,5,63
"5152",1005152,195,36,12,243
"5153",1005153,35,23,4,62
"5154",1005154,46,213,1,260
"5155",1005155,212,94,9,315
"5156",1005156,111,210,8,329
"5157",1005157,175,36,5,216
"5158",1005158,97,45,13,155
"5159",1005159,215,51,8,274
"5160",1005160,161,98,10,269
"5161",1005161,176,24,6,206
"5162",1005162,202,79,12,293
"5163",1005163,48,95,14,157
"5164",1005164,140,106,17,263
"5165",1005165,168,85,13,266
"5166",1005166,76,109,2,187
"5167",1005167,176,83,10,269
"5168",1005168,145,29,11,185
"5169",1005169,94,29,3,126
"5170",1005170,71,123,13,207
"5171",1005171,51,190,9,250
"5172",1005172,143,131,13,287
"5173",1005173,60,254,8,322
"5174",1005174,44,14,1,59
"5175",1005175,108,98,12,218
"5176",1005176,137,33,14,184
"5177",1005177,64,223,23,310
"5178",1005178,170,107,14,291
"5179",1005179,73,128,11,212
"5180",1005180,105,185,9,299
"5181",1005181,62,92,11,165
"5182",1005182,55,219,17,291
"5183",1005183,4,3,0,7
"5184",1005184,60,113,3,176
"5185",1005185,188,167,14,369
"5186",1005186,68,246,19,333
"5187",1005187,121,115,12,248
"5188",1005188,131,61,9,201
"5189",1005189,163,59,2,224
"5190",1005190,0,0,0,0
"5191",1005191,121,3,6,130
"5192",1005192,58,156,5,219
"5193",1005193,47,223,10,280
"5194",1005194,41,10,0,51
"5195",1005195,101,115,6,222
"5196",1005196,104,37,11,152
"5197",1005197,43,24,1,68
"5198",1005198,167,54,11,232
"5199",1005199,165,24,7,196
"5200",1005200,40,32,0,72
"5201",1005201,146,21,3,170
"5202",1005202,116,87,5,208
"5203",1005203,126,174,28,328
"5204",1005204,21,153,1,175
"5205",1005205,75,175,23,273
"5206",1005206,46,34,8,88
"5207",1005207,52,250,6,308
"5208",1005208,137,64,8,209
"5209",1005209,131,172,10,313
"5210",1005210,16,148,7,171
"5211",1005211,137,73,8,218
"5212",1005212,36,200,1,237
"5213",1005213,127,161,17,305
"5214",1005214,194,53,14,261
"5215",1005215,116,49,10,175
"5216",1005216,194,7,4,205
"5217",1005217,27,187,5,219
"5218",1005218,129,84,10,223
"5219",1005219,81,123,9,213
"5220",1005220,64,60,2,126
"5221",1005221,110,26,4,140
"5222",1005222,204,2,1,207
"5223",1005223,186,37,5,228
"5224",1005224,269,21,6,296
"5225",1005225,168,75,4,247
"5226",1005226,79,59,0,138
"5227",1005227,68,248,6,322
"5228",1005228,35,35,4,74
"5229",1005229,108,132,17,257
"5230",1005230,124,71,6,201
"5231",1005231,180,95,11,286
"5232",1005232,41,179,7,227
"5233",1005233,66,195,12,273
"5234",1005234,89,115,9,213
"5235",1005235,147,13,3,163
"5236",1005236,91,12,3,106
"5237",1005237,23,121,4,148
"5238",1005238,34,38,3,75
"5239",1005239,160,21,13,194
"5240",1005240,124,30,8,162
"5241",1005241,112,127,12,251
"5242",1005242,143,60,5,208
"5243",1005243,89,99,1,189
"5244",1005244,26,190,1,217
"5245",1005245,53,167,7,227
"5246",1005246,58,181,4,243
"5247",1005247,152,94,7,253
"5248",1005248,151,34,6,191
"5249",1005249,45,21,1,67
"5250",1005250,108,40,4,152
"5251",1005251,87,183,13,283
"5252",1005252,36,255,2,293
"5253",1005253,192,77,10,279
"5254",1005254,183,86,5,274
"5255",1005255,63,240,4,307
"5256",1005256,188,25,10,223
"5257",1005257,96,163,6,265
"5258",1005258,47,0,0,47
"5259",1005259,39,184,11,234
"5260",1005260,86,114,21,221
"5261",1005261,51,66,5,122
"5262",1005262,37,172,5,214
"5263",1005263,71,177,6,254
"5264",1005264,171,73,8,252
"5265",1005265,54,26,4,84
"5266",1005266,106,139,15,260
"5267",1005267,91,50,4,145
"5268",1005268,48,168,3,219
"5269",1005269,86,135,14,235
"5270",1005270,185,40,9,234
"5271",1005271,157,64,3,224
"5272",1005272,8,8,1,17
"5273",1005273,182,124,10,316
"5274",1005274,69,188,16,273
"5275",1005275,59,3,0,62
"5276",1005276,50,214,20,284
"5277",1005277,71,89,5,165
"5278",1005278,208,33,13,254
"5279",1005279,86,56,5,147
"5280",1005280,64,181,10,255
"5281",1005281,186,28,7,221
"5282",1005282,66,83,6,155
"5283",1005283,153,63,9,225
"5284",1005284,62,178,10,250
"5285",1005285,102,110,12,224
"5286",1005286,80,178,9,267
"5287",1005287,136,112,11,259
"5288",1005288,180,68,6,254
"5289",1005289,40,11,3,54
"5290",1005290,199,51,8,258
"5291",1005291,188,76,6,270
"5292",1005292,121,69,13,203
"5293",1005293,37,12,1,50
"5294",1005294,111,99,6,216
"5295",1005295,10,1,0,11
"5296",1005296,57,240,8,305
"5297",1005297,156,33,8,197
"5298",1005298,27,134,4,165
"5299",1005299,211,39,8,258
"5300",1005300,53,58,3,114
"5301",1005301,44,194,6,244
"5302",1005302,88,177,6,271
"5303",1005303,50,237,4,291
"5304",1005304,189,54,18,261
"5305",1005305,97,172,14,283
"5306",1005306,110,78,11,199
"5307",1005307,119,76,9,204
"5308",1005308,84,109,5,198
"5309",1005309,303,82,10,395
"5310",1005310,156,88,14,258
"5311",1005311,128,160,18,306
"5312",1005312,223,26,8,257
"5313",1005313,45,25,1,71
"5314",1005314,15,131,1,147
"5315",1005315,163,96,6,265
"5316",1005316,227,17,8,252
"5317",1005317,166,3,6,175
"5318",1005318,168,94,9,271
"5319",1005319,141,128,16,285
"5320",1005320,1,4,0,5
"5321",1005321,134,56,7,197
"5322",1005322,123,51,3,177
"5323",1005323,40,269,3,312
"5324",1005324,99,85,9,193
"5325",1005325,80,15,1,96
"5326",1005326,74,60,6,140
"5327",1005327,201,90,8,299
"5328",1005328,104,159,12,275
"5329",1005329,71,140,9,220
"5330",1005330,51,244,5,300
"5331",1005331,83,29,2,114
"5332",1005332,48,101,7,156
"5333",1005333,94,83,6,183
"5334",1005334,71,193,13,277
"5335",1005335,158,58,1,217
"5336",1005336,114,144,11,269
"5337",1005337,135,99,5,239
"5338",1005338,165,74,13,252
"5339",1005339,39,116,5,160
"5340",1005340,131,105,12,248
"5341",1005341,85,117,15,217
"5342",1005342,74,143,12,229
"5343",1005343,38,198,5,241
"5344",1005344,21,222,2,245
"5345",1005345,121,256,13,390
"5346",1005346,168,97,27,292
"5347",1005347,130,19,8,157
"5348",1005348,136,116,6,258
"5349",1005349,250,75,1,326
"5350",1005350,209,51,8,268
"5351",1005351,148,73,23,244
"5352",1005352,195,63,12,270
"5353",1005353,135,60,7,202
"5354",1005354,12,32,3,47
"5355",1005355,86,138,3,227
"5356",1005356,77,111,7,195
"5357",1005357,141,39,6,186
"5358",1005358,14,11,0,25
"5359",1005359,87,16,3,106
"5360",1005360,71,124,13,208
"5361",1005361,148,49,8,205
"5362",1005362,55,137,9,201
"5363",1005363,158,54,6,218
"5364",1005364,203,66,17,286
"5365",1005365,5,10,0,15
"5366",1005366,157,49,6,212
"5367",1005367,182,27,7,216
"5368",1005368,211,32,4,247
"5369",1005369,56,11,5,72
"5370",1005370,229,65,10,304
"5371",1005371,152,66,13,231
"5372",1005372,140,95,10,245
"5373",1005373,34,197,8,239
"5374",1005374,90,107,4,201
"5375",1005375,89,178,5,272
"5376",1005376,89,148,11,248
"5377",1005377,55,176,5,236
"5378",1005378,72,131,4,207
"5379",1005379,75,186,15,276
"5380",1005380,138,29,12,179
"5381",1005381,96,83,10,189
"5382",1005382,121,107,12,240
"5383",1005383,134,64,7,205
"5384",1005384,23,84,3,110
"5385",1005385,101,38,2,141
"5386",1005386,233,39,9,281
"5387",1005387,90,200,16,306
"5388",1005388,239,74,6,319
"5389",1005389,139,155,9,303
"5390",1005390,119,48,10,177
"5391",1005391,26,46,3,75
"5392",1005392,39,6,4,49
"5393",1005393,116,85,19,220
"5394",1005394,47,54,12,113
"5395",1005395,160,127,6,293
"5396",1005396,143,70,5,218
"5397",1005397,50,154,11,215
"5398",1005398,170,123,8,301
"5399",1005399,76,227,6,309
"5400",1005400,31,8,1,40
"5401",1005401,179,49,9,237
"5402",1005402,6,72,1,79
"5403",1005403,105,123,16,244
"5404",1005404,79,104,4,187
"5405",1005405,35,228,5,268
"5406",1005406,78,117,0,195
"5407",1005407,109,137,6,252
"5408",1005408,222,103,15,340
"5409",1005409,43,23,2,68
"5410",1005410,70,170,13,253
"5411",1005411,145,126,9,280
"5412",1005412,119,67,14,200
"5413",1005413,15,0,0,15
"5414",1005414,182,12,5,199
"5415",1005415,102,143,11,256
"5416",1005416,114,55,7,176
"5417",1005417,43,253,9,305
"5418",1005418,83,255,3,341
"5419",1005419,183,84,10,277
"5420",1005420,73,133,16,222
"5421",1005421,167,82,14,263
"5422",1005422,96,64,5,165
"5423",1005423,174,22,0,196
"5424",1005424,118,92,4,214
"5425",1005425,174,91,22,287
"5426",1005426,41,58,8,107
"5427",1005427,16,97,5,118
"5428",1005428,159,61,10,230
"5429",1005429,168,38,8,214
"5430",1005430,163,33,7,203
"5431",1005431,148,116,9,273
"5432",1005432,48,200,1,249
"5433",1005433,123,182,16,321
"5434",1005434,49,130,5,184
"5435",1005435,28,140,2,170
"5436",1005436,96,15,8,119
"5437",1005437,13,240,1,254
"5438",1005438,148,7,1,156
"5439",1005439,70,181,17,268
"5440",1005440,123,94,10,227
"5441",1005441,196,57,13,266
"5442",1005442,40,8,0,48
"5443",1005443,79,183,11,273
"5444",1005444,125,155,12,292
"5445",1005445,51,185,3,239
"5446",1005446,131,34,5,170
"5447",1005447,107,231,6,344
"5448",1005448,154,21,8,183
"5449",1005449,50,229,5,284
"5450",1005450,32,249,11,292
"5451",1005451,121,18,9,148
"5452",1005452,65,248,5,318
"5453",1005453,114,50,4,168
"5454",1005454,112,162,27,301
"5455",1005455,81,194,18,293
"5456",1005456,122,121,12,255
"5457",1005457,42,104,7,153
"5458",1005458,42,134,6,182
"5459",1005459,82,62,4,148
"5460",1005460,41,178,11,230
"5461",1005461,150,53,13,216
"5462",1005462,46,211,15,272
"5463",1005463,158,22,4,184
"5464",1005464,105,127,11,243
"5465",1005465,103,113,13,229
"5466",1005466,122,115,6,243
"5467",1005467,86,202,11,299
"5468",1005468,141,36,2,179
"5469",1005469,129,120,8,257
"5470",1005470,47,200,7,254
"5471",1005471,105,64,4,173
"5472",1005472,205,67,28,300
"5473",1005473,121,173,3,297
"5474",1005474,154,11,10,175
"5475",1005475,116,127,19,262
"5476",1005476,58,69,1,128
"5477",1005477,60,71,4,135
"5478",1005478,154,14,5,173
"5479",1005479,133,58,10,201
"5480",1005480,112,39,3,154
"5481",1005481,47,11,5,63
"5482",1005482,172,101,17,290
"5483",1005483,118,175,28,321
"5484",1005484,73,185,3,261
"5485",1005485,54,128,4,186
"5486",1005486,39,208,5,252
"5487",1005487,7,171,2,180
"5488",1005488,177,38,5,220
"5489",1005489,36,200,5,241
"5490",1005490,45,234,7,286
"5491",1005491,84,13,3,100
"5492",1005492,86,9,1,96
"5493",1005493,18,11,1,30
"5494",1005494,101,152,14,267
"5495",1005495,159,62,11,232
"5496",1005496,122,106,6,234
"5497",1005497,182,52,8,242
"5498",1005498,136,66,12,214
"5499",1005499,96,115,0,211
"5500",1005500,48,239,4,291
"5501",1005501,158,88,2,248
"5502",1005502,181,70,6,257
"5503",1005503,133,139,5,277
"5504",1005504,101,151,4,256
"5505",1005505,210,12,5,227
"5506",1005506,144,79,8,231
"5507",1005507,148,36,4,188
"5508",1005508,56,181,19,256
"5509",1005509,146,30,2,178
"5510",1005510,102,17,6,125
"5511",1005511,16,256,2,274
"5512",1005512,26,292,6,324
"5513",1005513,156,68,7,231
"5514",1005514,131,51,5,187
"5515",1005515,63,276,6,345
"5516",1005516,182,27,8,217
"5517",1005517,141,89,4,234
"5518",1005518,109,81,6,196
"5519",1005519,256,18,4,278
"5520",1005520,33,37,5,75
"5521",1005521,78,194,12,284
"5522",1005522,125,170,21,316
"5523",1005523,84,178,16,278
"5524",1005524,41,259,6,306
"5525",1005525,96,81,13,190
"5526",1005526,44,228,8,280
"5527",1005527,19,226,6,251
"5528",1005528,105,49,12,166
"5529",1005529,127,63,9,199
"5530",1005530,108,95,7,210
"5531",1005531,184,70,14,268
"5532",1005532,76,155,12,243
"5533",1005533,40,179,8,227
"5534",1005534,26,241,10,277
"5535",1005535,113,153,9,275
"5536",1005536,135,33,5,173
"5537",1005537,75,89,20,184
"5538",1005538,172,15,7,194
"5539",1005539,104,53,2,159
"5540",1005540,72,206,9,287
"5541",1005541,64,169,7,240
"5542",1005542,63,200,2,265
"5543",1005543,6,33,1,40
"5544",1005544,111,13,5,129
"5545",1005545,1,0,0,1
"5546",1005546,236,16,8,260
"5547",1005547,128,40,6,174
"5548",1005548,19,0,0,19
"5549",1005549,161,112,18,291
"5550",1005550,117,62,1,180
"5551",1005551,28,268,4,300
"5552",1005552,80,52,1,133
"5553",1005553,117,157,12,286
"5554",1005554,20,41,6,67
"5555",1005555,6,51,1,58
"5556",1005556,215,48,0,263
"5557",1005557,181,53,14,248
"5558",1005558,59,189,1,249
"5559",1005559,123,70,11,204
"5560",1005560,161,68,4,233
"5561",1005561,62,203,11,276
"5562",1005562,159,56,2,217
"5563",1005563,145,89,8,242
"5564",1005564,182,66,10,258
"5565",1005565,204,12,4,220
"5566",1005566,66,26,2,94
"5567",1005567,159,110,14,283
"5568",1005568,95,94,6,195
"5569",1005569,136,124,10,270
"5570",1005570,42,246,5,293
"5571",1005571,80,189,9,278
"5572",1005572,47,98,7,152
"5573",1005573,137,132,20,289
"5574",1005574,131,42,4,177
"5575",1005575,36,256,1,293
"5576",1005576,60,248,5,313
"5577",1005577,43,170,4,217
"5578",1005578,213,113,20,346
"5579",1005579,166,60,11,237
"5580",1005580,119,184,3,306
"5581",1005581,105,19,1,125
"5582",1005582,51,145,4,200
"5583",1005583,179,29,7,215
"5584",1005584,97,36,5,138
"5585",1005585,182,40,3,225
"5586",1005586,98,82,8,188
"5587",1005587,44,268,4,316
"5588",1005588,89,108,10,207
"5589",1005589,158,43,4,205
"5590",1005590,82,159,9,250
"5591",1005591,259,13,1,273
"5592",1005592,5,80,2,87
"5593",1005593,40,225,3,268
"5594",1005594,49,30,3,82
"5595",1005595,131,81,6,218
"5596",1005596,183,117,29,329
"5597",1005597,110,159,9,278
"5598",1005598,79,104,5,188
"5599",1005599,11,65,4,80
"5600",1005600,109,16,0,125
"5601",1005601,88,149,1,238
"5602",1005602,146,106,8,260
"5603",1005603,93,147,4,244
"5604",1005604,132,68,5,205
"5605",1005605,140,112,8,260
"5606",1005606,124,128,9,261
"5607",1005607,50,191,3,244
"5608",1005608,48,200,7,255
"5609",1005609,170,53,3,226
"5610",1005610,139,117,9,265
"5611",1005611,15,90,4,109
"5612",1005612,115,59,2,176
"5613",1005613,150,14,6,170
"5614",1005614,135,85,9,229
"5615",1005615,95,110,10,215
"5616",1005616,113,69,7,189
"5617",1005617,88,81,13,182
"5618",1005618,191,112,12,315
"5619",1005619,119,96,4,219
"5620",1005620,139,108,7,254
"5621",1005621,26,151,3,180
"5622",1005622,39,157,10,206
"5623",1005623,78,183,7,268
"5624",1005624,169,75,5,249
"5625",1005625,13,8,2,23
"5626",1005626,114,9,6,129
"5627",1005627,181,102,10,293
"5628",1005628,119,130,14,263
"5629",1005629,144,113,13,270
"5630",1005630,179,94,25,298
"5631",1005631,110,109,9,228
"5632",1005632,118,89,3,210
"5633",1005633,127,171,7,305
"5634",1005634,224,73,17,314
"5635",1005635,63,83,3,149
"5636",1005636,146,92,8,246
"5637",1005637,80,151,4,235
"5638",1005638,75,182,9,266
"5639",1005639,140,31,2,173
"5640",1005640,125,59,5,189
"5641",1005641,127,168,9,304
"5642",1005642,156,94,9,259
"5643",1005643,221,50,4,275
"5644",1005644,103,145,6,254
"5645",1005645,86,106,11,203
"5646",1005646,41,183,7,231
"5647",1005647,135,61,8,204
"5648",1005648,213,9,6,228
"5649",1005649,104,85,10,199
"5650",1005650,159,53,6,218
"5651",1005651,121,84,10,215
"5652",1005652,189,21,4,214
"5653",1005653,149,55,13,217
"5654",1005654,154,107,10,271
"5655",1005655,60,65,7,132
"5656",1005656,60,224,11,295
"5657",1005657,112,172,19,303
"5658",1005658,8,44,0,52
"5659",1005659,57,24,5,86
"5660",1005660,29,207,9,245
"5661",1005661,151,71,4,226
"5662",1005662,151,62,8,221
"5663",1005663,118,15,3,136
"5664",1005664,6,45,0,51
"5665",1005665,137,9,1,147
"5666",1005666,81,120,12,213
"5667",1005667,64,199,7,270
"5668",1005668,99,189,6,294
"5669",1005669,180,58,9,247
"5670",1005670,136,92,9,237
"5671",1005671,172,49,7,228
"5672",1005672,90,194,3,287
"5673",1005673,260,21,10,291
"5674",1005674,211,58,17,286
"5675",1005675,130,147,22,299
"5676",1005676,131,18,2,151
"5677",1005677,229,47,16,292
"5678",1005678,167,72,8,247
"5679",1005679,142,42,14,198
"5680",1005680,123,42,11,176
"5681",1005681,118,75,11,204
"5682",1005682,232,97,15,344
"5683",1005683,92,45,7,144
"5684",1005684,46,254,9,309
"5685",1005685,174,19,9,202
"5686",1005686,74,43,8,125
"5687",1005687,190,62,5,257
"5688",1005688,91,159,13,263
"5689",1005689,82,118,10,210
"5690",1005690,130,130,10,270
"5691",1005691,172,20,8,200
"5692",1005692,61,233,3,297
"5693",1005693,95,95,19,209
"5694",1005694,144,151,29,324
"5695",1005695,246,37,14,297
"5696",1005696,88,196,8,292
"5697",1005697,19,192,1,212
"5698",1005698,80,22,3,105
"5699",1005699,136,146,14,296
"5700",1005700,39,9,3,51
"5701",1005701,130,44,14,188
"5702",1005702,110,167,9,286
"5703",1005703,56,169,1,226
"5704",1005704,213,63,11,287
"5705",1005705,103,92,7,202
"5706",1005706,205,67,9,281
"5707",1005707,50,77,3,130
"5708",1005708,184,98,7,289
"5709",1005709,226,35,7,268
"5710",1005710,109,214,11,334
"5711",1005711,40,227,10,277
"5712",1005712,287,4,20,311
"5713",1005713,77,174,6,257
"5714",1005714,190,35,8,233
"5715",1005715,78,67,8,153
"5716",1005716,207,26,8,241
"5717",1005717,55,82,4,141
"5718",1005718,184,44,4,232
"5719",1005719,235,46,7,288
"5720",1005720,41,107,7,155
"5721",1005721,34,255,14,303
"5722",1005722,197,21,4,222
"5723",1005723,143,11,6,160
"5724",1005724,134,39,2,175
"5725",1005725,90,102,6,198
"5726",1005726,12,7,3,22
"5727",1005727,75,55,1,131
"5728",1005728,31,179,10,220
"5729",1005729,154,168,5,327
"5730",1005730,50,81,21,152
"5731",1005731,165,105,5,275
"5732",1005732,155,119,17,291
"5733",1005733,71,80,6,157
"5734",1005734,56,174,5,235
"5735",1005735,24,23,4,51
"5736",1005736,163,16,3,182
"5737",1005737,44,303,7,354
"5738",1005738,63,49,1,113
"5739",1005739,148,67,11,226
"5740",1005740,165,92,13,270
"5741",1005741,118,201,8,327
"5742",1005742,145,34,8,187
"5743",1005743,5,144,2,151
"5744",1005744,35,253,3,291
"5745",1005745,89,92,5,186
"5746",1005746,99,36,4,139
"5747",1005747,39,187,4,230
"5748",1005748,55,84,3,142
"5749",1005749,98,247,2,347
"5750",1005750,136,47,7,190
"5751",1005751,63,112,9,184
"5752",1005752,93,59,3,155
"5753",1005753,176,105,9,290
"5754",1005754,54,139,8,201
"5755",1005755,177,65,10,252
"5756",1005756,72,70,1,143
"5757",1005757,136,87,15,238
"5758",1005758,128,186,20,334
"5759",1005759,31,132,4,167
"5760",1005760,75,83,0,158
"5761",1005761,138,151,15,304
"5762",1005762,156,101,10,267
"5763",1005763,39,259,2,300
"5764",1005764,189,97,14,300
"5765",1005765,151,81,3,235
"5766",1005766,85,181,5,271
"5767",1005767,32,175,8,215
"5768",1005768,125,44,9,178
"5769",1005769,175,71,23,269
"5770",1005770,98,132,2,232
"5771",1005771,98,105,15,218
"5772",1005772,199,95,7,301
"5773",1005773,84,225,13,322
"5774",1005774,139,148,15,302
"5775",1005775,92,59,7,158
"5776",1005776,201,18,4,223
"5777",1005777,41,199,11,251
"5778",1005778,158,121,16,295
"5779",1005779,257,22,8,287
"5780",1005780,145,148,10,303
"5781",1005781,165,147,17,329
"5782",1005782,175,146,10,331
"5783",1005783,114,128,3,245
"5784",1005784,154,119,17,290
"5785",1005785,123,127,6,256
"5786",1005786,124,56,3,183
"5787",1005787,38,189,6,233
"5788",1005788,154,28,4,186
"5789",1005789,138,73,15,226
"5790",1005790,145,177,15,337
"5791",1005791,285,9,8,302
"5792",1005792,18,48,2,68
"5793",1005793,45,25,8,78
"5794",1005794,133,58,1,192
"5795",1005795,92,227,17,336
"5796",1005796,72,191,18,281
"5797",1005797,87,116,12,215
"5798",1005798,1,1,0,2
"5799",1005799,94,75,6,175
"5800",1005800,17,29,0,46
"5801",1005801,89,166,6,261
"5802",1005802,108,45,5,158
"5803",1005803,141,84,11,236
"5804",1005804,85,17,3,105
"5805",1005805,188,109,15,312
"5806",1005806,144,68,10,222
"5807",1005807,130,103,6,239
"5808",1005808,63,102,3,168
"5809",1005809,76,142,3,221
"5810",1005810,151,24,1,176
"5811",1005811,59,145,9,213
"5812",1005812,98,157,5,260
"5813",1005813,173,98,12,283
"5814",1005814,142,70,12,224
"5815",1005815,10,37,1,48
"5816",1005816,165,117,10,292
"5817",1005817,157,94,2,253
"5818",1005818,121,114,9,244
"5819",1005819,59,181,1,241
"5820",1005820,244,16,9,269
"5821",1005821,14,43,2,59
"5822",1005822,71,27,3,101
"5823",1005823,67,101,0,168
"5824",1005824,33,252,6,291
"5825",1005825,208,9,14,231
"5826",1005826,31,12,1,44
"5827",1005827,154,98,17,269
"5828",1005828,225,38,9,272
"5829",1005829,163,71,2,236
"5830",1005830,53,231,2,286
"5831",1005831,41,132,2,175
"5832",1005832,142,17,4,163
"5833",1005833,85,236,14,335
"5834",1005834,100,161,11,272
"5835",1005835,40,186,11,237
"5836",1005836,64,105,21,190
"5837",1005837,291,62,5,358
"5838",1005838,55,11,5,71
"5839",1005839,213,37,7,257
"5840",1005840,237,244,46,527
"5841",1005841,79,218,9,306
"5842",1005842,151,43,5,199
"5843",1005843,96,118,5,219
"5844",1005844,125,119,3,247
"5845",1005845,30,232,2,264
"5846",1005846,47,104,8,159
"5847",1005847,164,49,14,227
"5848",1005848,203,116,20,339
"5849",1005849,146,119,9,274
"5850",1005850,2,95,0,97
"5851",1005851,47,91,1,139
"5852",1005852,128,104,8,240
"5853",1005853,146,96,15,257
"5854",1005854,132,30,6,168
"5855",1005855,69,111,4,184
"5856",1005856,75,78,5,158
"5857",1005857,164,33,14,211
"5858",1005858,148,89,10,247
"5859",1005859,155,20,4,179
"5860",1005860,100,135,9,244
"5861",1005861,156,68,12,236
"5862",1005862,109,150,10,269
"5863",1005863,29,87,4,120
"5864",1005864,95,180,15,290
"5865",1005865,44,266,4,314
"5866",1005866,124,152,9,285
"5867",1005867,31,135,4,170
"5868",1005868,18,73,2,93
"5869",1005869,100,128,27,255
"5870",1005870,148,40,5,193
"5871",1005871,109,190,6,305
"5872",1005872,129,27,1,157
"5873",1005873,6,60,1,67
"5874",1005874,153,51,7,211
"5875",1005875,13,57,0,70
"5876",1005876,44,230,13,287
"5877",1005877,43,262,10,315
"5878",1005878,148,87,8,243
"5879",1005879,111,22,7,140
"5880",1005880,153,139,6,298
"5881",1005881,134,12,6,152
"5882",1005882,147,49,12,208
"5883",1005883,56,35,3,94
"5884",1005884,120,93,2,215
"5885",1005885,46,205,2,253
"5886",1005886,119,50,2,171
"5887",1005887,122,121,5,248
"5888",1005888,230,25,3,258
"5889",1005889,210,18,6,234
"5890",1005890,92,103,13,208
"5891",1005891,4,3,2,9
"5892",1005892,12,67,1,80
"5893",1005893,24,205,5,234
"5894",1005894,11,23,1,35
"5895",1005895,129,46,4,179
"5896",1005896,130,80,0,210
"5897",1005897,109,93,8,210
"5898",1005898,155,83,7,245
"5899",1005899,65,165,5,235
"5900",1005900,167,46,6,219
"5901",1005901,6,43,1,50
"5902",1005902,20,247,4,271
"5903",1005903,83,145,11,239
"5904",1005904,196,14,5,215
"5905",1005905,151,41,3,195
"5906",1005906,157,73,13,243
"5907",1005907,261,19,3,283
"5908",1005908,20,47,1,68
"5909",1005909,86,150,12,248
"5910",1005910,162,25,10,197
"5911",1005911,67,13,4,84
"5912",1005912,109,97,2,208
"5913",1005913,183,31,8,222
"5914",1005914,49,267,10,326
"5915",1005915,77,73,5,155
"5916",1005916,85,50,8,143
"5917",1005917,34,391,9,434
"5918",1005918,142,142,9,293
"5919",1005919,110,221,9,340
"5920",1005920,190,46,8,244
"5921",1005921,184,74,12,270
"5922",1005922,211,39,12,262
"5923",1005923,63,209,20,292
"5924",1005924,50,203,17,270
"5925",1005925,99,97,9,205
"5926",1005926,115,73,3,191
"5927",1005927,173,22,4,199
"5928",1005928,84,197,12,293
"5929",1005929,200,15,13,228
"5930",1005930,49,90,15,154
"5931",1005931,87,165,11,263
"5932",1005932,116,168,9,293
"5933",1005933,120,108,7,235
"5934",1005934,209,46,6,261
"5935",1005935,129,60,5,194
"5936",1005936,125,107,8,240
"5937",1005937,50,186,7,243
"5938",1005938,199,79,19,297
"5939",1005939,168,63,11,242
"5940",1005940,32,155,4,191
"5941",1005941,175,80,8,263
"5942",1005942,68,60,11,139
"5943",1005943,73,1,1,75
"5944",1005944,127,20,3,150
"5945",1005945,127,89,1,217
"5946",1005946,145,110,8,263
"5947",1005947,81,67,5,153
"5948",1005948,311,3,3,317
"5949",1005949,97,113,4,214
"5950",1005950,116,104,5,225
"5951",1005951,127,56,8,191
"5952",1005952,135,87,15,237
"5953",1005953,105,119,10,234
"5954",1005954,39,151,4,194
"5955",1005955,73,202,7,282
"5956",1005956,158,107,9,274
"5957",1005957,80,26,3,109
"5958",1005958,77,170,19,266
"5959",1005959,177,76,3,256
"5960",1005960,10,19,0,29
"5961",1005961,148,76,20,244
"5962",1005962,43,143,5,191
"5963",1005963,61,268,7,336
"5964",1005964,176,16,10,202
"5965",1005965,84,160,26,270
"5966",1005966,190,23,5,218
"5967",1005967,94,36,6,136
"5968",1005968,73,110,10,193
"5969",1005969,210,33,6,249
"5970",1005970,107,8,1,116
"5971",1005971,79,220,18,317
"5972",1005972,106,65,4,175
"5973",1005973,108,114,10,232
"5974",1005974,167,61,16,244
"5975",1005975,70,123,6,199
"5976",1005976,161,90,8,259
"5977",1005977,99,33,6,138
"5978",1005978,12,149,2,163
"5979",1005979,62,143,9,214
"5980",1005980,153,102,5,260
"5981",1005981,203,88,15,306
"5982",1005982,102,37,6,145
"5983",1005983,208,73,15,296
"5984",1005984,131,59,3,193
"5985",1005985,221,31,10,262
"5986",1005986,139,120,7,266
"5987",1005987,96,100,3,199
"5988",1005988,79,191,10,280
"5989",1005989,227,21,12,260
"5990",1005990,181,71,12,264
"5991",1005991,53,86,2,141
"5992",1005992,47,136,12,195
"5993",1005993,55,48,4,107
"5994",1005994,120,134,7,261
"5995",1005995,31,247,3,281
"5996",1005996,111,21,7,139
"5997",1005997,38,235,3,276
"5998",1005998,92,162,6,260
"5999",1005999,73,181,2,256
"6000",1006000,149,31,8,188
"6001",1006001,33,252,7,292
"6002",1006002,181,29,7,217
"6003",1006003,128,65,8,201
"6004",1006004,89,182,10,281
"6005",1006005,136,101,19,256
"6006",1006006,26,125,6,157
"6007",1006007,154,37,2,193
"6008",1006008,38,149,9,196
"6009",1006009,44,169,8,221
"6010",1006010,72,72,13,157
"6011",1006011,79,101,5,185
"6012",1006012,19,6,3,28
"6013",1006013,133,59,8,200
"6014",1006014,82,174,8,264
"6015",1006015,68,87,5,160
"6016",1006016,172,67,25,264
"6017",1006017,95,9,3,107
"6018",1006018,77,17,6,100
"6019",1006019,56,12,2,70
"6020",1006020,165,32,6,203
"6021",1006021,53,252,6,311
"6022",1006022,14,60,1,75
"6023",1006023,23,20,0,43
"6024",1006024,144,184,17,345
"6025",1006025,175,109,3,287
"6026",1006026,88,100,4,192
"6027",1006027,226,4,2,232
"6028",1006028,182,32,10,224
"6029",1006029,162,78,5,245
"6030",1006030,117,81,10,208
"6031",1006031,167,85,6,258
"6032",1006032,196,87,3,286
"6033",1006033,5,8,1,14
"6034",1006034,161,111,9,281
"6035",1006035,88,126,5,219
"6036",1006036,106,82,3,191
"6037",1006037,56,288,3,347
"6038",1006038,63,27,4,94
"6039",1006039,110,147,4,261
"6040",1006040,81,154,35,270
"6041",1006041,169,42,10,221
"6042",1006042,150,60,12,222
"6043",1006043,165,70,4,239
"6044",1006044,93,89,5,187
"6045",1006045,4,4,1,9
"6046",1006046,121,62,2,185
"6047",1006047,107,156,19,282
"6048",1006048,157,86,5,248
"6049",1006049,146,131,20,297
"6050",1006050,158,71,10,239
"6051",1006051,42,224,7,273
"6052",1006052,11,67,4,82
"6053",1006053,53,36,5,94
"6054",1006054,216,49,5,270
"6055",1006055,83,168,7,258
"6056",1006056,51,13,4,68
"6057",1006057,26,80,8,114
"6058",1006058,61,147,8,216
"6059",1006059,209,105,14,328
"6060",1006060,89,152,15,256
"6061",1006061,155,32,13,200
"6062",1006062,18,114,5,137
"6063",1006063,204,25,3,232
"6064",1006064,129,51,6,186
"6065",1006065,149,50,2,201
"6066",1006066,176,16,7,199
"6067",1006067,114,100,14,228
"6068",1006068,112,54,13,179
"6069",1006069,157,122,9,288
"6070",1006070,122,116,40,278
"6071",1006071,51,32,4,87
"6072",1006072,65,1,1,67
"6073",1006073,24,30,3,57
"6074",1006074,30,170,5,205
"6075",1006075,96,102,12,210
"6076",1006076,85,24,6,115
"6077",1006077,34,163,7,204
"6078",1006078,218,17,7,242
"6079",1006079,158,19,5,182
"6080",1006080,91,154,17,262
"6081",1006081,113,163,12,288
"6082",1006082,85,78,3,166
"6083",1006083,144,42,18,204
"6084",1006084,191,46,10,247
"6085",1006085,90,83,3,176
"6086",1006086,62,18,1,81
"6087",1006087,93,116,15,224
"6088",1006088,94,93,15,202
"6089",1006089,138,113,15,266
"6090",1006090,109,164,24,297
"6091",1006091,138,48,1,187
"6092",1006092,60,195,17,272
"6093",1006093,61,229,6,296
"6094",1006094,69,188,10,267
"6095",1006095,187,73,19,279
"6096",1006096,232,61,11,304
"6097",1006097,81,173,12,266
"6098",1006098,210,38,1,249
"6099",1006099,167,26,6,199
"6100",1006100,60,162,4,226
"6101",1006101,13,21,1,35
"6102",1006102,141,31,3,175
"6103",1006103,39,139,4,182
"6104",1006104,25,87,4,116
"6105",1006105,146,109,15,270
"6106",1006106,37,11,1,49
"6107",1006107,157,140,14,311
"6108",1006108,114,43,6,163
"6109",1006109,26,234,6,266
"6110",1006110,110,88,2,200
"6111",1006111,71,183,9,263
"6112",1006112,73,180,7,260
"6113",1006113,86,195,10,291
"6114",1006114,101,200,8,309
"6115",1006115,132,39,2,173
"6116",1006116,194,42,8,244
"6117",1006117,203,65,15,283
"6118",1006118,137,57,3,197
"6119",1006119,157,56,10,223
"6120",1006120,182,90,4,276
"6121",1006121,160,52,10,222
"6122",1006122,105,80,3,188
"6123",1006123,79,173,18,270
"6124",1006124,165,65,9,239
"6125",1006125,111,18,6,135
"6126",1006126,32,146,2,180
"6127",1006127,169,23,6,198
"6128",1006128,35,52,1,88
"6129",1006129,28,227,3,258
"6130",1006130,88,210,5,303
"6131",1006131,153,129,11,293
"6132",1006132,149,82,5,236
"6133",1006133,67,226,5,298
"6134",1006134,53,54,2,109
"6135",1006135,33,122,7,162
"6136",1006136,254,42,11,307
"6137",1006137,139,134,20,293
"6138",1006138,33,15,4,52
"6139",1006139,48,203,22,273
"6140",1006140,155,130,7,292
"6141",1006141,162,92,14,268
"6142",1006142,164,52,6,222
"6143",1006143,6,245,3,254
"6144",1006144,89,62,13,164
"6145",1006145,149,29,10,188
"6146",1006146,101,58,5,164
"6147",1006147,130,102,8,240
"6148",1006148,3,19,0,22
"6149",1006149,85,100,16,201
"6150",1006150,129,100,13,242
"6151",1006151,15,21,0,36
"6152",1006152,98,171,22,291
"6153",1006153,61,173,3,237
"6154",1006154,167,40,13,220
"6155",1006155,129,43,3,175
"6156",1006156,108,198,9,315
"6157",1006157,135,80,6,221
"6158",1006158,55,230,1,286
"6159",1006159,112,36,6,154
"6160",1006160,179,14,3,196
"6161",1006161,121,47,11,179
"6162",1006162,65,250,4,319
"6163",1006163,41,30,5,76
"6164",1006164,211,51,10,272
"6165",1006165,111,159,9,279
"6166",1006166,239,56,7,302
"6167",1006167,180,71,5,256
"6168",1006168,38,99,5,142
"6169",1006169,3,17,2,22
"6170",1006170,6,108,1,115
"6171",1006171,128,41,5,174
"6172",1006172,74,194,18,286
"6173",1006173,156,54,5,215
"6174",1006174,126,184,7,317
"6175",1006175,149,76,6,231
"6176",1006176,42,101,5,148
"6177",1006177,82,22,3,107
"6178",1006178,46,242,6,294
"6179",1006179,62,184,2,248
"6180",1006180,78,147,10,235
"6181",1006181,115,27,3,145
"6182",1006182,89,317,7,413
"6183",1006183,126,76,14,216
"6184",1006184,135,12,1,148
"6185",1006185,140,40,8,188
"6186",1006186,97,143,20,260
"6187",1006187,111,41,10,162
"6188",1006188,114,189,13,316
"6189",1006189,121,40,11,172
"6190",1006190,126,89,12,227
"6191",1006191,23,116,14,153
"6192",1006192,200,28,5,233
"6193",1006193,199,40,5,244
"6194",1006194,80,109,5,194
"6195",1006195,91,75,12,178
"6196",1006196,73,19,1,93
"6197",1006197,47,199,9,255
"6198",1006198,85,94,6,185
"6199",1006199,19,138,7,164
"6200",1006200,106,129,11,246
"6201",1006201,135,148,3,286
"6202",1006202,65,0,9,74
"6203",1006203,156,70,11,237
"6204",1006204,59,203,16,278
"6205",1006205,70,112,8,190
"6206",1006206,126,55,2,183
"6207",1006207,99,118,13,230
"6208",1006208,95,103,2,200
"6209",1006209,88,37,3,128
"6210",1006210,114,45,7,166
"6211",1006211,114,79,3,196
"6212",1006212,123,97,13,233
"6213",1006213,67,25,4,96
"6214",1006214,39,213,3,255
"6215",1006215,101,157,14,272
"6216",1006216,20,20,4,44
"6217",1006217,8,248,6,262
"6218",1006218,168,27,5,200
"6219",1006219,70,24,3,97
"6220",1006220,70,182,5,257
"6221",1006221,107,38,5,150
"6222",1006222,187,95,18,300
"6223",1006223,6,103,3,112
"6224",1006224,46,265,4,315
"6225",1006225,123,141,8,272
"6226",1006226,238,286,42,566
"6227",1006227,112,6,2,120
"6228",1006228,0,85,0,85
"6229",1006229,6,3,2,11
"6230",1006230,242,47,14,303
"6231",1006231,58,151,3,212
"6232",1006232,87,33,2,122
"6233",1006233,19,187,3,209
"6234",1006234,200,17,4,221
"6235",1006235,49,260,6,315
"6236",1006236,84,119,13,216
"6237",1006237,44,198,6,248
"6238",1006238,143,19,2,164
"6239",1006239,26,200,2,228
"6240",1006240,106,150,4,260
"6241",1006241,46,235,8,289
"6242",1006242,170,91,12,273
"6243",1006243,146,36,4,186
"6244",1006244,84,86,9,179
"6245",1006245,63,269,6,338
"6246",1006246,59,229,2,290
"6247",1006247,3,4,0,7
"6248",1006248,90,66,13,169
"6249",1006249,121,250,17,388
"6250",1006250,47,47,2,96
"6251",1006251,104,187,6,297
"6252",1006252,76,27,6,109
"6253",1006253,102,169,4,275
"6254",1006254,96,180,13,289
"6255",1006255,42,176,7,225
"6256",1006256,28,188,5,221
"6257",1006257,135,35,9,179
"6258",1006258,207,49,11,267
"6259",1006259,63,184,4,251
"6260",1006260,5,5,1,11
"6261",1006261,39,151,2,192
"6262",1006262,249,47,8,304
"6263",1006263,185,98,7,290
"6264",1006264,127,71,4,202
"6265",1006265,194,58,4,256
"6266",1006266,34,13,4,51
"6267",1006267,115,60,6,181
"6268",1006268,198,38,15,251
"6269",1006269,162,66,12,240
"6270",1006270,154,109,5,268
"6271",1006271,37,91,1,129
"6272",1006272,28,34,2,64
"6273",1006273,202,120,17,339
"6274",1006274,258,30,8,296
"6275",1006275,105,63,5,173
"6276",1006276,25,12,1,38
"6277",1006277,148,73,2,223
"6278",1006278,190,77,13,280
"6279",1006279,39,239,17,295
"6280",1006280,192,59,8,259
"6281",1006281,24,161,7,192
"6282",1006282,75,241,8,324
"6283",1006283,113,91,12,216
"6284",1006284,62,154,2,218
"6285",1006285,65,214,7,286
"6286",1006286,46,187,8,241
"6287",1006287,167,124,5,296
"6288",1006288,75,148,8,231
"6289",1006289,136,128,8,272
"6290",1006290,170,126,17,313
"6291",1006291,8,218,4,230
"6292",1006292,40,189,2,231
"6293",1006293,177,38,11,226
"6294",1006294,144,90,10,244
"6295",1006295,89,184,14,287
"6296",1006296,75,35,12,122
"6297",1006297,243,12,5,260
"6298",1006298,141,57,7,205
"6299",1006299,49,174,18,241
"6300",1006300,74,127,10,211
"6301",1006301,56,237,5,298
"6302",1006302,147,60,1,208
"6303",1006303,114,26,10,150
"6304",1006304,149,14,15,178
"6305",1006305,188,56,3,247
"6306",1006306,160,68,12,240
"6307",1006307,68,37,2,107
"6308",1006308,50,164,11,225
"6309",1006309,2,7,0,9
"6310",1006310,6,46,1,53
"6311",1006311,113,151,6,270
"6312",1006312,160,70,5,235
"6313",1006313,166,150,16,332
"6314",1006314,205,10,7,222
"6315",1006315,52,174,11,237
"6316",1006316,32,79,3,114
"6317",1006317,87,121,5,213
"6318",1006318,64,167,8,239
"6319",1006319,44,137,13,194
"6320",1006320,108,81,7,196
"6321",1006321,91,147,8,246
"6322",1006322,32,78,1,111
"6323",1006323,167,95,6,268
"6324",1006324,72,185,3,260
"6325",1006325,164,30,2,196
"6326",1006326,156,110,10,276
"6327",1006327,39,146,5,190
"6328",1006328,50,150,11,211
"6329",1006329,50,88,4,142
"6330",1006330,273,63,25,361
"6331",1006331,101,54,1,156
"6332",1006332,96,119,11,226
"6333",1006333,110,105,4,219
"6334",1006334,49,224,6,279
"6335",1006335,144,96,9,249
"6336",1006336,85,170,9,264
"6337",1006337,79,83,15,177
"6338",1006338,48,204,3,255
"6339",1006339,108,43,0,151
"6340",1006340,223,50,12,285
"6341",1006341,119,90,5,214
"6342",1006342,147,87,14,248
"6343",1006343,110,152,21,283
"6344",1006344,202,16,1,219
"6345",1006345,208,78,18,304
"6346",1006346,35,264,9,308
"6347",1006347,157,68,15,240
"6348",1006348,136,125,14,275
"6349",1006349,233,23,10,266
"6350",1006350,52,141,14,207
"6351",1006351,147,61,7,215
"6352",1006352,97,46,8,151
"6353",1006353,133,39,6,178
"6354",1006354,25,47,0,72
"6355",1006355,65,182,21,268
"6356",1006356,104,148,7,259
"6357",1006357,87,193,15,295
"6358",1006358,16,155,0,171
"6359",1006359,140,74,8,222
"6360",1006360,120,327,24,471
"6361",1006361,94,116,11,221
"6362",1006362,37,302,9,348
"6363",1006363,163,58,21,242
"6364",1006364,25,279,3,307
"6365",1006365,182,20,6,208
"6366",1006366,111,127,11,249
"6367",1006367,24,233,6,263
"6368",1006368,72,225,12,309
"6369",1006369,284,14,2,300
"6370",1006370,104,52,10,166
"6371",1006371,72,153,8,233
"6372",1006372,53,0,2,55
"6373",1006373,109,59,8,176
"6374",1006374,199,36,9,244
"6375",1006375,80,12,2,94
"6376",1006376,184,28,7,219
"6377",1006377,100,156,7,263
"6378",1006378,139,3,4,146
"6379",1006379,31,27,4,62
"6380",1006380,39,169,5,213
"6381",1006381,169,162,22,353
"6382",1006382,32,251,5,288
"6383",1006383,60,58,2,120
"6384",1006384,149,32,4,185
"6385",1006385,32,164,5,201
"6386",1006386,94,166,9,269
"6387",1006387,92,227,8,327
"6388",1006388,73,170,16,259
"6389",1006389,99,166,14,279
"6390",1006390,162,25,3,190
"6391",1006391,170,85,10,265
"6392",1006392,193,39,3,235
"6393",1006393,170,63,6,239
"6394",1006394,175,41,4,220
"6395",1006395,208,108,10,326
"6396",1006396,46,283,8,337
"6397",1006397,74,23,0,97
"6398",1006398,69,16,1,86
"6399",1006399,178,50,11,239
"6400",1006400,71,95,19,185
"6401",1006401,144,23,8,175
"6402",1006402,71,48,13,132
"6403",1006403,109,94,3,206
"6404",1006404,91,23,1,115
"6405",1006405,138,33,3,174
"6406",1006406,159,76,8,243
"6407",1006407,24,248,4,276
"6408",1006408,43,147,9,199
"6409",1006409,26,17,4,47
"6410",1006410,151,87,8,246
"6411",1006411,117,143,3,263
"6412",1006412,53,195,8,256
"6413",1006413,25,15,2,42
"6414",1006414,186,109,6,301
"6415",1006415,82,37,3,122
"6416",1006416,59,145,9,213
"6417",1006417,145,39,4,188
"6418",1006418,16,135,4,155
"6419",1006419,108,13,5,126
"6420",1006420,122,59,9,190
"6421",1006421,183,65,10,258
"6422",1006422,13,25,2,40
"6423",1006423,123,75,11,209
"6424",1006424,173,62,8,243
"6425",1006425,124,56,4,184
"6426",1006426,43,123,3,169
"6427",1006427,29,262,8,299
"6428",1006428,59,218,5,282
"6429",1006429,114,128,7,249
"6430",1006430,208,34,15,257
"6431",1006431,26,168,6,200
"6432",1006432,199,41,6,246
"6433",1006433,188,89,8,285
"6434",1006434,165,119,5,289
"6435",1006435,214,55,10,279
"6436",1006436,104,75,12,191
"6437",1006437,207,17,4,228
"6438",1006438,101,144,10,255
"6439",1006439,141,132,4,277
"6440",1006440,129,181,4,314
"6441",1006441,38,208,4,250
"6442",1006442,129,190,4,323
"6443",1006443,169,18,7,194
"6444",1006444,51,200,10,261
"6445",1006445,184,37,4,225
"6446",1006446,200,103,10,313
"6447",1006447,205,54,7,266
"6448",1006448,68,208,2,278
"6449",1006449,62,167,4,233
"6450",1006450,180,104,5,289
"6451",1006451,45,28,2,75
"6452",1006452,141,110,8,259
"6453",1006453,138,39,10,187
"6454",1006454,155,39,3,197
"6455",1006455,59,107,13,179
"6456",1006456,169,53,11,233
"6457",1006457,153,4,0,157
"6458",1006458,143,154,3,300
"6459",1006459,49,249,4,302
"6460",1006460,65,13,0,78
"6461",1006461,38,194,5,237
"6462",1006462,118,132,14,264
"6463",1006463,26,4,1,31
"6464",1006464,46,231,10,287
"6465",1006465,212,39,7,258
"6466",1006466,191,105,4,300
"6467",1006467,141,50,2,193
"6468",1006468,10,42,3,55
"6469",1006469,160,87,17,264
"6470",1006470,52,259,7,318
"6471",1006471,20,187,12,219
"6472",1006472,26,136,4,166
"6473",1006473,32,4,0,36
"6474",1006474,203,25,3,231
"6475",1006475,140,77,3,220
"6476",1006476,29,15,2,46
"6477",1006477,145,138,13,296
"6478",1006478,87,60,8,155
"6479",1006479,129,162,19,310
"6480",1006480,39,172,5,216
"6481",1006481,85,56,10,151
"6482",1006482,153,46,9,208
"6483",1006483,42,169,2,213
"6484",1006484,201,60,11,272
"6485",1006485,114,56,3,173
"6486",1006486,64,142,4,210
"6487",1006487,137,31,6,174
"6488",1006488,155,30,23,208
"6489",1006489,32,21,1,54
"6490",1006490,190,34,12,236
"6491",1006491,193,124,9,326
"6492",1006492,44,29,4,77
"6493",1006493,182,60,3,245
"6494",1006494,67,190,25,282
"6495",1006495,169,142,2,313
"6496",1006496,196,89,15,300
"6497",1006497,22,177,3,202
"6498",1006498,39,49,1,89
"6499",1006499,103,164,11,278
"6500",1006500,34,238,4,276
"6501",1006501,100,198,4,302
"6502",1006502,159,65,23,247
"6503",1006503,152,62,4,218
"6504",1006504,135,118,12,265
"6505",1006505,166,64,5,235
"6506",1006506,125,104,1,230
"6507",1006507,104,135,9,248
"6508",1006508,208,14,1,223
"6509",1006509,172,47,11,230
"6510",1006510,214,16,7,237
"6511",1006511,80,29,7,116
"6512",1006512,195,17,6,218
"6513",1006513,141,59,4,204
"6514",1006514,170,30,4,204
"6515",1006515,218,23,4,245
"6516",1006516,154,144,7,305
"6517",1006517,233,46,14,293
"6518",1006518,88,159,12,259
"6519",1006519,63,129,10,202
"6520",1006520,140,17,3,160
"6521",1006521,85,123,17,225
"6522",1006522,171,152,23,346
"6523",1006523,159,23,3,185
"6524",1006524,133,82,8,223
"6525",1006525,145,114,14,273
"6526",1006526,99,79,5,183
"6527",1006527,220,26,11,257
"6528",1006528,5,114,0,119
"6529",1006529,158,135,17,310
"6530",1006530,107,66,9,182
"6531",1006531,72,197,3,272
"6532",1006532,171,132,6,309
"6533",1006533,251,58,12,321
"6534",1006534,70,152,5,227
"6535",1006535,218,22,16,256
"6536",1006536,136,68,6,210
"6537",1006537,13,253,4,270
"6538",1006538,186,33,7,226
"6539",1006539,141,37,7,185
"6540",1006540,169,78,9,256
"6541",1006541,102,77,5,184
"6542",1006542,176,29,3,208
"6543",1006543,137,72,13,222
"6544",1006544,166,68,10,244
"6545",1006545,139,96,9,244
"6546",1006546,27,146,4,177
"6547",1006547,157,133,7,297
"6548",1006548,50,231,13,294
"6549",1006549,178,58,5,241
"6550",1006550,66,153,6,225
"6551",1006551,89,154,14,257
"6552",1006552,124,148,15,287
"6553",1006553,103,89,6,198
"6554",1006554,118,147,5,270
"6555",1006555,194,17,5,216
"6556",1006556,18,210,6,234
"6557",1006557,48,36,1,85
"6558",1006558,85,67,1,153
"6559",1006559,43,100,15,158
"6560",1006560,140,68,7,215
"6561",1006561,12,199,1,212
"6562",1006562,55,212,8,275
"6563",1006563,145,131,26,302
"6564",1006564,235,42,12,289
"6565",1006565,61,206,5,272
"6566",1006566,53,174,5,232
"6567",1006567,75,124,4,203
"6568",1006568,168,47,13,228
"6569",1006569,59,170,2,231
"6570",1006570,127,124,3,254
"6571",1006571,138,153,15,306
"6572",1006572,153,105,12,270
"6573",1006573,151,75,1,227
"6574",1006574,136,99,13,248
"6575",1006575,94,195,18,307
"6576",1006576,11,321,6,338
"6577",1006577,128,79,13,220
"6578",1006578,146,139,30,315
"6579",1006579,59,84,13,156
"6580",1006580,164,102,18,284
"6581",1006581,103,171,10,284
"6582",1006582,150,9,6,165
"6583",1006583,165,73,23,261
"6584",1006584,123,84,1,208
"6585",1006585,158,50,5,213
"6586",1006586,36,238,6,280
"6587",1006587,152,138,13,303
"6588",1006588,34,24,0,58
"6589",1006589,116,135,7,258
"6590",1006590,47,69,9,125
"6591",1006591,254,12,3,269
"6592",1006592,45,194,8,247
"6593",1006593,129,41,7,177
"6594",1006594,114,176,9,299
"6595",1006595,7,30,2,39
"6596",1006596,82,130,12,224
"6597",1006597,89,66,6,161
"6598",1006598,96,185,10,291
"6599",1006599,151,70,7,228
"6600",1006600,148,57,8,213
"6601",1006601,92,140,5,237
"6602",1006602,50,98,3,151
"6603",1006603,76,193,6,275
"6604",1006604,10,120,1,131
"6605",1006605,250,25,3,278
"6606",1006606,77,187,2,266
"6607",1006607,180,3,1,184
"6608",1006608,64,159,6,229
"6609",1006609,129,176,7,312
"6610",1006610,49,128,3,180
"6611",1006611,68,216,10,294
"6612",1006612,140,132,11,283
"6613",1006613,54,90,9,153
"6614",1006614,225,42,7,274
"6615",1006615,134,53,10,197
"6616",1006616,3,0,1,4
"6617",1006617,154,68,3,225
"6618",1006618,54,25,6,85
"6619",1006619,217,15,6,238
"6620",1006620,94,93,3,190
"6621",1006621,76,214,17,307
"6622",1006622,117,195,12,324
"6623",1006623,151,16,7,174
"6624",1006624,176,107,17,300
"6625",1006625,224,59,16,299
"6626",1006626,170,61,5,236
"6627",1006627,105,53,6,164
"6628",1006628,101,209,11,321
"6629",1006629,208,82,18,308
"6630",1006630,67,100,6,173
"6631",1006631,97,106,11,214
"6632",1006632,27,370,1,398
"6633",1006633,138,95,4,237
"6634",1006634,45,65,6,116
"6635",1006635,35,279,14,328
"6636",1006636,12,5,0,17
"6637",1006637,160,79,6,245
"6638",1006638,121,104,15,240
"6639",1006639,57,148,4,209
"6640",1006640,29,270,7,306
"6641",1006641,58,225,11,294
"6642",1006642,180,24,14,218
"6643",1006643,142,23,2,167
"6644",1006644,27,91,6,124
"6645",1006645,43,27,5,75
"6646",1006646,44,148,2,194
"6647",1006647,131,27,3,161
"6648",1006648,187,67,6,260
"6649",1006649,141,144,7,292
"6650",1006650,68,160,6,234
"6651",1006651,142,18,1,161
"6652",1006652,116,52,6,174
"6653",1006653,98,167,5,270
"6654",1006654,91,30,4,125
"6655",1006655,95,107,10,212
"6656",1006656,30,87,0,117
"6657",1006657,52,100,1,153
"6658",1006658,102,65,7,174
"6659",1006659,115,11,11,137
"6660",1006660,119,0,0,119
"6661",1006661,123,4,2,129
"6662",1006662,98,117,10,225
"6663",1006663,180,23,16,219
"6664",1006664,45,271,4,320
"6665",1006665,73,186,4,263
"6666",1006666,61,92,10,163
"6667",1006667,20,98,3,121
"6668",1006668,83,106,8,197
"6669",1006669,137,50,11,198
"6670",1006670,191,34,8,233
"6671",1006671,50,222,4,276
"6672",1006672,67,250,3,320
"6673",1006673,40,129,9,178
"6674",1006674,84,132,10,226
"6675",1006675,124,52,6,182
"6676",1006676,90,36,2,128
"6677",1006677,53,148,5,206
"6678",1006678,252,169,2,423
"6679",1006679,85,209,9,303
"6680",1006680,53,32,2,87
"6681",1006681,167,13,10,190
"6682",1006682,93,184,10,287
"6683",1006683,111,63,5,179
"6684",1006684,25,80,3,108
"6685",1006685,135,114,6,255
"6686",1006686,162,44,6,212
"6687",1006687,153,72,22,247
"6688",1006688,58,150,15,223
"6689",1006689,27,185,4,216
"6690",1006690,224,18,6,248
"6691",1006691,81,255,8,344
"6692",1006692,42,108,6,156
"6693",1006693,96,201,20,317
"6694",1006694,3,14,0,17
"6695",1006695,171,27,5,203
"6696",1006696,184,30,7,221
"6697",1006697,56,32,6,94
"6698",1006698,181,69,9,259
"6699",1006699,70,161,8,239
"6700",1006700,126,43,6,175
"6701",1006701,150,66,6,222
"6702",1006702,199,44,7,250
"6703",1006703,104,95,12,211
"6704",1006704,72,188,7,267
"6705",1006705,198,126,14,338
"6706",1006706,114,43,3,160
"6707",1006707,82,98,7,187
"6708",1006708,162,69,7,238
"6709",1006709,89,128,7,224
"6710",1006710,119,83,6,208
"6711",1006711,176,47,15,238
"6712",1006712,128,122,8,258
"6713",1006713,36,16,1,53
"6714",1006714,54,229,1,284
"6715",1006715,74,155,10,239
"6716",1006716,196,19,5,220
"6717",1006717,85,40,5,130
"6718",1006718,177,116,7,300
"6719",1006719,191,106,16,313
"6720",1006720,84,203,5,292
"6721",1006721,240,72,15,327
"6722",1006722,61,86,6,153
"6723",1006723,9,11,0,20
"6724",1006724,100,70,5,175
"6725",1006725,47,261,6,314
"6726",1006726,56,162,5,223
"6727",1006727,96,91,1,188
"6728",1006728,5,7,0,12
"6729",1006729,168,83,3,254
"6730",1006730,212,62,7,281
"6731",1006731,51,48,10,109
"6732",1006732,78,163,23,264
"6733",1006733,113,77,3,193
"6734",1006734,103,51,5,159
"6735",1006735,96,275,12,383
"6736",1006736,38,141,3,182
"6737",1006737,24,15,0,39
"6738",1006738,26,108,4,138
"6739",1006739,172,57,9,238
"6740",1006740,44,77,7,128
"6741",1006741,107,195,8,310
"6742",1006742,34,213,13,260
"6743",1006743,115,139,3,257
"6744",1006744,110,107,2,219
"6745",1006745,46,283,6,335
"6746",1006746,149,78,13,240
"6747",1006747,63,11,5,79
"6748",1006748,150,96,11,257
"6749",1006749,277,13,2,292
"6750",1006750,76,159,14,249
"6751",1006751,77,34,7,118
"6752",1006752,22,18,2,42
"6753",1006753,209,29,4,242
"6754",1006754,24,24,1,49
"6755",1006755,97,97,7,201
"6756",1006756,36,102,5,143
"6757",1006757,104,172,7,283
"6758",1006758,143,70,9,222
"6759",1006759,81,141,12,234
"6760",1006760,108,51,7,166
"6761",1006761,148,134,13,295
"6762",1006762,77,193,5,275
"6763",1006763,24,13,0,37
"6764",1006764,128,89,4,221
"6765",1006765,60,148,6,214
"6766",1006766,98,97,11,206
"6767",1006767,193,63,8,264
"6768",1006768,69,94,10,173
"6769",1006769,112,14,5,131
"6770",1006770,35,150,7,192
"6771",1006771,105,68,6,179
"6772",1006772,193,14,4,211
"6773",1006773,174,14,5,193
"6774",1006774,154,144,16,314
"6775",1006775,11,30,3,44
"6776",1006776,126,31,2,159
"6777",1006777,57,46,1,104
"6778",1006778,181,116,14,311
"6779",1006779,171,30,2,203
"6780",1006780,111,123,11,245
"6781",1006781,71,112,5,188
"6782",1006782,117,41,7,165
"6783",1006783,68,145,8,221
"6784",1006784,156,128,8,292
"6785",1006785,203,30,8,241
"6786",1006786,108,47,4,159
"6787",1006787,172,77,13,262
"6788",1006788,96,64,4,164
"6789",1006789,34,97,3,134
"6790",1006790,128,70,2,200
"6791",1006791,127,80,10,217
"6792",1006792,160,16,6,182
"6793",1006793,122,147,7,276
"6794",1006794,213,55,12,280
"6795",1006795,105,210,17,332
"6796",1006796,124,53,5,182
"6797",1006797,66,210,6,282
"6798",1006798,157,12,4,173
"6799",1006799,119,89,10,218
"6800",1006800,97,18,2,117
"6801",1006801,119,184,19,322
"6802",1006802,115,45,4,164
"6803",1006803,75,111,15,201
"6804",1006804,239,36,2,277
"6805",1006805,42,182,8,232
"6806",1006806,162,52,6,220
"6807",1006807,114,93,0,207
"6808",1006808,123,12,3,138
"6809",1006809,48,162,7,217
"6810",1006810,42,250,6,298
"6811",1006811,92,154,9,255
"6812",1006812,180,100,14,294
"6813",1006813,68,193,8,269
"6814",1006814,107,54,17,178
"6815",1006815,208,58,21,287
"6816",1006816,126,45,9,180
"6817",1006817,146,55,8,209
"6818",1006818,17,6,0,23
"6819",1006819,96,3,0,99
"6820",1006820,157,75,5,237
"6821",1006821,200,16,8,224
"6822",1006822,173,29,9,211
"6823",1006823,16,6,1,23
"6824",1006824,264,5,10,279
"6825",1006825,44,175,9,228
"6826",1006826,121,71,4,196
"6827",1006827,121,150,6,277
"6828",1006828,12,90,1,103
"6829",1006829,200,36,9,245
"6830",1006830,1,20,0,21
"6831",1006831,88,104,5,197
"6832",1006832,172,132,27,331
"6833",1006833,158,84,14,256
"6834",1006834,71,120,16,207
"6835",1006835,197,76,12,285
"6836",1006836,249,11,3,263
"6837",1006837,132,75,5,212
"6838",1006838,61,189,1,251
"6839",1006839,56,197,6,259
"6840",1006840,68,109,14,191
"6841",1006841,78,145,4,227
"6842",1006842,8,33,3,44
"6843",1006843,21,329,3,353
"6844",1006844,42,272,4,318
"6845",1006845,37,229,0,266
"6846",1006846,117,127,15,259
"6847",1006847,35,231,6,272
"6848",1006848,50,16,2,68
"6849",1006849,104,134,4,242
"6850",1006850,50,42,3,95
"6851",1006851,131,112,3,246
"6852",1006852,185,35,6,226
"6853",1006853,87,119,9,215
"6854",1006854,123,87,16,226
"6855",1006855,202,36,14,252
"6856",1006856,155,82,11,248
"6857",1006857,178,84,17,279
"6858",1006858,69,169,4,242
"6859",1006859,64,147,3,214
"6860",1006860,154,53,0,207
"6861",1006861,108,56,15,179
"6862",1006862,95,109,2,206
"6863",1006863,296,22,12,330
"6864",1006864,47,165,3,215
"6865",1006865,11,82,1,94
"6866",1006866,12,39,4,55
"6867",1006867,46,247,3,296
"6868",1006868,128,170,15,313
"6869",1006869,92,87,10,189
"6870",1006870,41,221,7,269
"6871",1006871,151,133,13,297
"6872",1006872,146,68,6,220
"6873",1006873,160,165,11,336
"6874",1006874,112,17,1,130
"6875",1006875,170,49,4,223
"6876",1006876,163,33,15,211
"6877",1006877,186,50,12,248
"6878",1006878,179,90,4,273
"6879",1006879,126,156,2,284
"6880",1006880,199,59,16,274
"6881",1006881,191,25,3,219
"6882",1006882,184,42,6,232
"6883",1006883,124,117,7,248
"6884",1006884,111,172,12,295
"6885",1006885,82,101,10,193
"6886",1006886,116,42,4,162
"6887",1006887,73,218,11,302
"6888",1006888,252,45,19,316
"6889",1006889,209,92,25,326
"6890",1006890,99,154,7,260
"6891",1006891,117,70,6,193
"6892",1006892,206,24,4,234
"6893",1006893,92,200,15,307
"6894",1006894,83,155,8,246
"6895",1006895,117,103,8,228
"6896",1006896,23,191,6,220
"6897",1006897,169,64,6,239
"6898",1006898,209,52,12,273
"6899",1006899,26,206,9,241
"6900",1006900,106,125,9,240
"6901",1006901,153,100,7,260
"6902",1006902,88,119,2,209
"6903",1006903,140,63,19,222
"6904",1006904,42,247,4,293
"6905",1006905,214,108,13,335
"6906",1006906,91,64,5,160
"6907",1006907,85,187,2,274
"6908",1006908,115,39,1,155
"6909",1006909,5,185,7,197
"6910",1006910,33,210,4,247
"6911",1006911,47,72,2,121
"6912",1006912,204,13,9,226
"6913",1006913,55,253,5,313
"6914",1006914,44,215,3,262
"6915",1006915,36,46,0,82
"6916",1006916,21,41,4,66
"6917",1006917,34,184,5,223
"6918",1006918,82,251,6,339
"6919",1006919,91,127,8,226
"6920",1006920,137,85,9,231
"6921",1006921,50,183,2,235
"6922",1006922,48,9,1,58
"6923",1006923,49,4,0,53
"6924",1006924,99,94,5,198
"6925",1006925,165,107,8,280
"6926",1006926,102,123,9,234
"6927",1006927,72,102,8,182
"6928",1006928,20,2,1,23
"6929",1006929,62,156,5,223
"6930",1006930,124,62,8,194
"6931",1006931,1,9,0,10
"6932",1006932,84,199,2,285
"6933",1006933,184,28,7,219
"6934",1006934,56,174,16,246
"6935",1006935,37,179,3,219
"6936",1006936,29,214,2,245
"6937",1006937,115,35,4,154
"6938",1006938,137,40,8,185
"6939",1006939,171,52,11,234
"6940",1006940,41,113,8,162
"6941",1006941,36,263,1,300
"6942",1006942,108,61,8,177
"6943",1006943,175,94,9,278
"6944",1006944,72,153,7,232
"6945",1006945,262,28,16,306
"6946",1006946,81,116,18,215
"6947",1006947,203,48,13,264
"6948",1006948,108,202,6,316
"6949",1006949,29,240,6,275
"6950",1006950,31,7,3,41
"6951",1006951,49,222,5,276
"6952",1006952,54,256,5,315
"6953",1006953,150,38,10,198
"6954",1006954,231,78,10,319
"6955",1006955,123,4,5,132
"6956",1006956,100,55,4,159
"6957",1006957,118,59,12,189
"6958",1006958,3,11,0,14
"6959",1006959,44,173,4,221
"6960",1006960,44,12,4,60
"6961",1006961,196,37,6,239
"6962",1006962,28,21,4,53
"6963",1006963,147,108,8,263
"6964",1006964,127,112,6,245
"6965",1006965,85,163,11,259
"6966",1006966,156,101,7,264
"6967",1006967,100,54,8,162
"6968",1006968,70,127,7,204
"6969",1006969,127,51,3,181
"6970",1006970,131,21,12,164
"6971",1006971,123,83,10,216
"6972",1006972,56,222,3,281
"6973",1006973,21,16,0,37
"6974",1006974,74,184,7,265
"6975",1006975,115,105,3,223
"6976",1006976,80,183,7,270
"6977",1006977,99,209,6,314
"6978",1006978,136,35,6,177
"6979",1006979,116,157,11,284
"6980",1006980,43,42,4,89
"6981",1006981,0,2,0,2
"6982",1006982,186,67,9,262
"6983",1006983,58,80,3,141
"6984",1006984,70,192,17,279
"6985",1006985,117,158,13,288
"6986",1006986,109,50,6,165
"6987",1006987,190,86,12,288
"6988",1006988,168,98,5,271
"6989",1006989,78,186,4,268
"6990",1006990,91,135,2,228
"6991",1006991,158,10,5,173
"6992",1006992,128,61,5,194
"6993",1006993,125,151,6,282
"6994",1006994,163,15,3,181
"6995",1006995,83,153,4,240
"6996",1006996,146,121,20,287
"6997",1006997,31,8,0,39
"6998",1006998,10,0,1,11
"6999",1006999,124,58,12,194
"7000",1007000,43,189,5,237
"7001",1007001,23,157,2,182
"7002",1007002,94,110,7,211
"7003",1007003,38,224,4,266
"7004",1007004,45,112,5,162
"7005",1007005,67,86,3,156
"7006",1007006,57,237,9,303
"7007",1007007,157,5,0,162
"7008",1007008,10,101,0,111
"7009",1007009,179,127,22,328
"7010",1007010,80,173,9,262
"7011",1007011,124,106,5,235
"7012",1007012,107,199,6,312
"7013",1007013,79,222,12,313
"7014",1007014,111,34,3,148
"7015",1007015,176,98,11,285
"7016",1007016,100,197,15,312
"7017",1007017,236,20,6,262
"7018",1007018,82,200,7,289
"7019",1007019,104,141,13,258
"7020",1007020,168,146,13,327
"7021",1007021,35,170,0,205
"7022",1007022,88,48,6,142
"7023",1007023,163,42,8,213
"7024",1007024,231,19,10,260
"7025",1007025,177,12,4,193
"7026",1007026,135,127,29,291
"7027",1007027,39,44,4,87
"7028",1007028,177,43,8,228
"7029",1007029,125,36,8,169
"7030",1007030,34,50,1,85
"7031",1007031,178,30,7,215
"7032",1007032,192,98,15,305
"7033",1007033,123,28,8,159
"7034",1007034,75,70,6,151
"7035",1007035,131,135,13,279
"7036",1007036,154,82,14,250
"7037",1007037,186,105,8,299
"7038",1007038,140,78,6,224
"7039",1007039,218,23,3,244
"7040",1007040,91,223,11,325
"7041",1007041,147,72,11,230
"7042",1007042,183,124,15,322
"7043",1007043,165,99,10,274
"7044",1007044,96,9,9,114
"7045",1007045,60,126,10,196
"7046",1007046,208,16,6,230
"7047",1007047,157,134,16,307
"7048",1007048,128,135,11,274
"7049",1007049,146,68,15,229
"7050",1007050,115,72,2,189
"7051",1007051,71,158,9,238
"7052",1007052,51,140,11,202
"7053",1007053,78,184,14,276
"7054",1007054,66,260,8,334
"7055",1007055,55,24,2,81
"7056",1007056,182,45,12,239
"7057",1007057,30,212,7,249
"7058",1007058,220,101,15,336
"7059",1007059,247,16,6,269
"7060",1007060,77,196,7,280
"7061",1007061,91,142,6,239
"7062",1007062,171,92,13,276
"7063",1007063,61,159,14,234
"7064",1007064,157,21,7,185
"7065",1007065,60,196,3,259
"7066",1007066,20,165,4,189
"7067",1007067,55,125,8,188
"7068",1007068,133,118,5,256
"7069",1007069,143,62,3,208
"7070",1007070,46,214,5,265
"7071",1007071,54,123,1,178
"7072",1007072,69,28,7,104
"7073",1007073,214,84,10,308
"7074",1007074,120,116,4,240
"7075",1007075,79,184,3,266
"7076",1007076,94,48,7,149
"7077",1007077,148,45,9,202
"7078",1007078,27,218,4,249
"7079",1007079,141,28,8,177
"7080",1007080,104,13,10,127
"7081",1007081,202,282,21,505
"7082",1007082,99,86,8,193
"7083",1007083,33,229,7,269
"7084",1007084,69,69,1,139
"7085",1007085,58,55,0,113
"7086",1007086,56,184,8,248
"7087",1007087,151,45,9,205
"7088",1007088,183,0,0,183
"7089",1007089,45,128,7,180
"7090",1007090,88,3,3,94
"7091",1007091,86,10,4,100
"7092",1007092,68,165,3,236
"7093",1007093,150,73,7,230
"7094",1007094,26,125,2,153
"7095",1007095,170,93,3,266
"7096",1007096,225,55,9,289
"7097",1007097,62,204,4,270
"7098",1007098,78,164,5,247
"7099",1007099,62,117,3,182
"7100",1007100,9,3,0,12
"7101",1007101,206,96,12,314
"7102",1007102,39,157,5,201
"7103",1007103,128,125,5,258
"7104",1007104,41,265,8,314
"7105",1007105,61,108,7,176
"7106",1007106,31,114,0,145
"7107",1007107,88,132,12,232
"7108",1007108,70,187,10,267
"7109",1007109,84,55,9,148
"7110",1007110,67,201,12,280
"7111",1007111,10,21,1,32
"7112",1007112,83,187,6,276
"7113",1007113,160,31,8,199
"7114",1007114,169,21,10,200
"7115",1007115,47,265,7,319
"7116",1007116,121,77,13,211
"7117",1007117,15,24,2,41
"7118",1007118,102,164,12,278
"7119",1007119,2,16,1,19
"7120",1007120,183,62,5,250
"7121",1007121,199,108,14,321
"7122",1007122,78,191,7,276
"7123",1007123,48,63,3,114
"7124",1007124,104,56,5,165
"7125",1007125,147,14,4,165
"7126",1007126,46,254,7,307
"7127",1007127,136,6,3,145
"7128",1007128,163,38,4,205
"7129",1007129,135,44,4,183
"7130",1007130,76,71,4,151
"7131",1007131,209,70,16,295
"7132",1007132,123,138,17,278
"7133",1007133,127,60,8,195
"7134",1007134,91,122,5,218
"7135",1007135,64,176,5,245
"7136",1007136,22,14,2,38
"7137",1007137,111,178,16,305
"7138",1007138,59,202,13,274
"7139",1007139,77,174,16,267
"7140",1007140,6,141,2,149
"7141",1007141,64,250,8,322
"7142",1007142,167,91,15,273
"7143",1007143,67,114,1,182
"7144",1007144,46,111,7,164
"7145",1007145,143,56,8,207
"7146",1007146,23,4,1,28
"7147",1007147,146,76,6,228
"7148",1007148,194,47,5,246
"7149",1007149,70,113,10,193
"7150",1007150,18,71,2,91
"7151",1007151,176,124,16,316
"7152",1007152,8,1,0,9
"7153",1007153,45,274,7,326
"7154",1007154,143,193,9,345
"7155",1007155,84,197,2,283
"7156",1007156,37,213,4,254
"7157",1007157,74,233,14,321
"7158",1007158,80,105,6,191
"7159",1007159,63,182,4,249
"7160",1007160,17,224,4,245
"7161",1007161,218,48,6,272
"7162",1007162,190,75,13,278
"7163",1007163,100,146,20,266
"7164",1007164,107,87,3,197
"7165",1007165,84,86,16,186
"7166",1007166,24,161,1,186
"7167",1007167,89,81,7,177
"7168",1007168,237,23,9,269
"7169",1007169,123,151,7,281
"7170",1007170,240,20,1,261
"7171",1007171,205,33,11,249
"7172",1007172,82,111,12,205
"7173",1007173,24,71,3,98
"7174",1007174,157,92,10,259
"7175",1007175,114,41,17,172
"7176",1007176,131,89,1,221
"7177",1007177,254,16,27,297
"7178",1007178,167,33,11,211
"7179",1007179,78,195,13,286
"7180",1007180,140,62,14,216
"7181",1007181,107,148,16,271
"7182",1007182,186,100,5,291
"7183",1007183,145,44,14,203
"7184",1007184,179,43,7,229
"7185",1007185,132,129,27,288
"7186",1007186,103,177,10,290
"7187",1007187,61,167,8,236
"7188",1007188,60,145,10,215
"7189",1007189,126,88,7,221
"7190",1007190,64,168,6,238
"7191",1007191,38,107,3,148
"7192",1007192,122,67,9,198
"7193",1007193,131,110,9,250
"7194",1007194,90,155,13,258
"7195",1007195,212,13,5,230
"7196",1007196,81,151,12,244
"7197",1007197,108,47,1,156
"7198",1007198,13,278,1,292
"7199",1007199,128,96,11,235
"7200",1007200,145,72,8,225
"7201",1007201,85,134,17,236
"7202",1007202,61,123,15,199
"7203",1007203,34,223,5,262
"7204",1007204,159,103,14,276
"7205",1007205,128,94,8,230
"7206",1007206,81,107,20,208
"7207",1007207,134,44,10,188
"7208",1007208,122,57,12,191
"7209",1007209,114,113,4,231
"7210",1007210,29,3,0,32
"7211",1007211,197,77,7,281
"7212",1007212,171,29,5,205
"7213",1007213,180,51,15,246
"7214",1007214,92,66,11,169
"7215",1007215,148,84,4,236
"7216",1007216,168,103,15,286
"7217",1007217,76,63,5,144
"7218",1007218,36,240,5,281
"7219",1007219,149,14,3,166
"7220",1007220,149,76,5,230
"7221",1007221,22,6,0,28
"7222",1007222,193,91,22,306
"7223",1007223,78,203,8,289
"7224",1007224,42,196,13,251
"7225",1007225,162,14,4,180
"7226",1007226,107,109,7,223
"7227",1007227,19,30,0,49
"7228",1007228,215,12,7,234
"7229",1007229,120,180,9,309
"7230",1007230,228,40,15,283
"7231",1007231,146,35,6,187
"7232",1007232,68,33,2,103
"7233",1007233,66,44,1,111
"7234",1007234,33,241,5,279
"7235",1007235,201,41,6,248
"7236",1007236,70,185,10,265
"7237",1007237,124,42,7,173
"7238",1007238,71,224,15,310
"7239",1007239,198,29,9,236
"7240",1007240,73,28,2,103
"7241",1007241,153,141,11,305
"7242",1007242,163,99,8,270
"7243",1007243,36,169,11,216
"7244",1007244,121,103,10,234
"7245",1007245,138,176,10,324
"7246",1007246,90,190,11,291
"7247",1007247,126,65,3,194
"7248",1007248,133,19,2,154
"7249",1007249,145,138,2,285
"7250",1007250,185,43,10,238
"7251",1007251,40,266,8,314
"7252",1007252,159,63,17,239
"7253",1007253,122,29,9,160
"7254",1007254,15,300,6,321
"7255",1007255,183,9,9,201
"7256",1007256,93,168,21,282
"7257",1007257,90,47,8,145
"7258",1007258,51,6,2,59
"7259",1007259,190,72,10,272
"7260",1007260,212,102,10,324
"7261",1007261,115,90,7,212
"7262",1007262,212,36,11,259
"7263",1007263,134,66,14,214
"7264",1007264,250,26,6,282
"7265",1007265,67,97,2,166
"7266",1007266,76,142,6,224
"7267",1007267,112,133,5,250
"7268",1007268,90,8,9,107
"7269",1007269,110,263,2,375
"7270",1007270,199,101,9,309
"7271",1007271,52,253,31,336
"7272",1007272,17,208,5,230
"7273",1007273,126,65,15,206
"7274",1007274,152,77,13,242
"7275",1007275,114,102,6,222
"7276",1007276,165,118,8,291
"7277",1007277,167,34,4,205
"7278",1007278,140,73,2,215
"7279",1007279,238,54,11,303
"7280",1007280,23,15,1,39
"7281",1007281,109,122,18,249
"7282",1007282,172,38,8,218
"7283",1007283,72,110,0,182
"7284",1007284,171,48,10,229
"7285",1007285,142,72,6,220
"7286",1007286,44,146,0,190
"7287",1007287,117,65,8,190
"7288",1007288,92,29,10,131
"7289",1007289,163,77,7,247
"7290",1007290,95,135,1,231
"7291",1007291,259,16,6,281
"7292",1007292,86,95,10,191
"7293",1007293,196,52,8,256
"7294",1007294,52,212,4,268
"7295",1007295,129,25,3,157
"7296",1007296,91,169,9,269
"7297",1007297,37,21,3,61
"7298",1007298,168,124,7,299
"7299",1007299,72,48,8,128
"7300",1007300,16,97,1,114
"7301",1007301,128,14,2,144
"7302",1007302,91,56,11,158
"7303",1007303,110,85,6,201
"7304",1007304,92,58,3,153
"7305",1007305,91,79,9,179
"7306",1007306,138,133,7,278
"7307",1007307,134,23,8,165
"7308",1007308,75,16,3,94
"7309",1007309,76,163,7,246
"7310",1007310,31,184,5,220
"7311",1007311,25,173,10,208
"7312",1007312,70,128,7,205
"7313",1007313,193,76,19,288
"7314",1007314,140,115,15,270
"7315",1007315,173,21,4,198
"7316",1007316,182,52,8,242
"7317",1007317,168,120,15,303
"7318",1007318,126,16,4,146
"7319",1007319,142,49,2,193
"7320",1007320,178,19,7,204
"7321",1007321,16,7,0,23
"7322",1007322,38,39,2,79
"7323",1007323,92,81,2,175
"7324",1007324,134,22,4,160
"7325",1007325,74,127,14,215
"7326",1007326,56,24,0,80
"7327",1007327,50,229,2,281
"7328",1007328,87,65,2,154
"7329",1007329,216,33,9,258
"7330",1007330,208,63,10,281
"7331",1007331,165,98,8,271
"7332",1007332,31,60,5,96
"7333",1007333,9,5,0,14
"7334",1007334,61,11,1,73
"7335",1007335,4,130,1,135
"7336",1007336,275,29,9,313
"7337",1007337,190,26,6,222
"7338",1007338,27,302,5,334
"7339",1007339,50,175,20,245
"7340",1007340,39,185,8,232
"7341",1007341,128,9,4,141
"7342",1007342,66,167,4,237
"7343",1007343,37,198,8,243
"7344",1007344,167,71,5,243
"7345",1007345,136,43,10,189
"7346",1007346,30,128,1,159
"7347",1007347,29,135,8,172
"7348",1007348,44,5,3,52
"7349",1007349,76,96,17,189
"7350",1007350,184,33,8,225
"7351",1007351,133,130,4,267
"7352",1007352,59,253,6,318
"7353",1007353,125,123,7,255
"7354",1007354,89,118,6,213
"7355",1007355,32,20,1,53
"7356",1007356,151,68,2,221
"7357",1007357,126,55,5,186
"7358",1007358,114,93,2,209
"7359",1007359,103,143,10,256
"7360",1007360,203,40,7,250
"7361",1007361,208,47,5,260
"7362",1007362,66,76,3,145
"7363",1007363,157,70,11,238
"7364",1007364,126,122,5,253
"7365",1007365,64,108,14,186
"7366",1007366,110,66,12,188
"7367",1007367,85,206,10,301
"7368",1007368,263,8,1,272
"7369",1007369,87,5,2,94
"7370",1007370,65,231,10,306
"7371",1007371,57,179,11,247
"7372",1007372,21,6,1,28
"7373",1007373,98,166,21,285
"7374",1007374,151,78,15,244
"7375",1007375,104,109,5,218
"7376",1007376,60,243,5,308
"7377",1007377,200,41,9,250
"7378",1007378,73,76,3,152
"7379",1007379,140,36,9,185
"7380",1007380,80,192,16,288
"7381",1007381,149,89,17,255
"7382",1007382,153,85,8,246
"7383",1007383,101,152,16,269
"7384",1007384,139,105,6,250
"7385",1007385,126,83,2,211
"7386",1007386,149,55,6,210
"7387",1007387,73,124,10,207
"7388",1007388,61,195,7,263
"7389",1007389,119,187,8,314
"7390",1007390,11,28,1,40
"7391",1007391,67,194,12,273
"7392",1007392,91,75,2,168
"7393",1007393,199,45,17,261
"7394",1007394,111,136,10,257
"7395",1007395,221,37,10,268
"7396",1007396,241,18,7,266
"7397",1007397,7,48,1,56
"7398",1007398,193,23,3,219
"7399",1007399,165,50,9,224
"7400",1007400,51,133,21,205
"7401",1007401,52,185,8,245
"7402",1007402,39,79,9,127
"7403",1007403,175,52,8,235
"7404",1007404,46,104,3,153
"7405",1007405,96,146,4,246
"7406",1007406,112,141,3,256
"7407",1007407,82,158,7,247
"7408",1007408,51,242,0,293
"7409",1007409,170,94,18,282
"7410",1007410,29,295,4,328
"7411",1007411,66,19,5,90
"7412",1007412,21,23,4,48
"7413",1007413,186,97,14,297
"7414",1007414,128,3,0,131
"7415",1007415,92,140,21,253
"7416",1007416,114,58,5,177
"7417",1007417,117,107,20,244
"7418",1007418,56,206,16,278
"7419",1007419,87,136,26,249
"7420",1007420,168,57,9,234
"7421",1007421,231,12,5,248
"7422",1007422,115,80,10,205
"7423",1007423,183,92,4,279
"7424",1007424,218,38,13,269
"7425",1007425,162,43,9,214
"7426",1007426,2,40,3,45
"7427",1007427,121,192,20,333
"7428",1007428,218,62,9,289
"7429",1007429,44,59,7,110
"7430",1007430,236,42,6,284
"7431",1007431,50,28,4,82
"7432",1007432,131,98,11,240
"7433",1007433,1,12,1,14
"7434",1007434,170,78,10,258
"7435",1007435,136,30,0,166
"7436",1007436,77,74,4,155
"7437",1007437,7,35,0,42
"7438",1007438,228,36,6,270
"7439",1007439,214,53,10,277
"7440",1007440,66,204,15,285
"7441",1007441,64,11,2,77
"7442",1007442,196,69,20,285
"7443",1007443,148,25,5,178
"7444",1007444,163,131,24,318
"7445",1007445,94,162,9,265
"7446",1007446,107,62,5,174
"7447",1007447,51,174,5,230
"7448",1007448,46,260,2,308
"7449",1007449,113,192,7,312
"7450",1007450,139,43,5,187
"7451",1007451,164,38,7,209
"7452",1007452,111,169,9,289
"7453",1007453,99,114,2,215
"7454",1007454,200,28,3,231
"7455",1007455,84,54,5,143
"7456",1007456,50,191,4,245
"7457",1007457,148,46,6,200
"7458",1007458,154,117,22,293
"7459",1007459,131,87,8,226
"7460",1007460,193,35,10,238
"7461",1007461,62,196,6,264
"7462",1007462,171,109,3,283
"7463",1007463,196,3,1,200
"7464",1007464,111,124,17,252
"7465",1007465,165,23,5,193
"7466",1007466,59,86,5,150
"7467",1007467,131,68,15,214
"7468",1007468,113,134,4,251
"7469",1007469,195,40,7,242
"7470",1007470,37,271,9,317
"7471",1007471,71,127,7,205
"7472",1007472,79,39,5,123
"7473",1007473,118,27,2,147
"7474",1007474,138,58,2,198
"7475",1007475,161,43,6,210
"7476",1007476,51,283,2,336
"7477",1007477,7,0,0,7
"7478",1007478,80,137,5,222
"7479",1007479,19,148,3,170
"7480",1007480,71,200,11,282
"7481",1007481,112,175,11,298
"7482",1007482,100,20,1,121
"7483",1007483,84,138,1,223
"7484",1007484,138,106,7,251
"7485",1007485,140,18,2,160
"7486",1007486,126,61,11,198
"7487",1007487,61,140,9,210
"7488",1007488,166,74,17,257
"7489",1007489,35,263,9,307
"7490",1007490,176,70,20,266
"7491",1007491,142,82,2,226
"7492",1007492,112,145,2,259
"7493",1007493,70,180,5,255
"7494",1007494,113,34,4,151
"7495",1007495,175,30,4,209
"7496",1007496,63,139,12,214
"7497",1007497,99,81,11,191
"7498",1007498,56,151,7,214
"7499",1007499,163,74,19,256
"7500",1007500,147,98,12,257
"7501",1007501,197,88,2,287
"7502",1007502,206,19,4,229
"7503",1007503,207,72,13,292
"7504",1007504,203,52,5,260
"7505",1007505,78,175,7,260
"7506",1007506,167,61,21,249
"7507",1007507,166,74,9,249
"7508",1007508,84,144,23,251
"7509",1007509,52,52,7,111
"7510",1007510,32,128,7,167
"7511",1007511,119,58,9,186
"7512",1007512,89,23,3,115
"7513",1007513,48,199,4,251
"7514",1007514,60,210,6,276
"7515",1007515,51,35,2,88
"7516",1007516,164,32,9,205
"7517",1007517,106,86,7,199
"7518",1007518,38,110,8,156
"7519",1007519,33,210,4,247
"7520",1007520,186,117,12,315
"7521",1007521,106,135,4,245
"7522",1007522,141,92,0,233
"7523",1007523,5,106,1,112
"7524",1007524,40,5,2,47
"7525",1007525,56,96,2,154
"7526",1007526,75,133,11,219
"7527",1007527,59,124,7,190
"7528",1007528,51,260,11,322
"7529",1007529,243,58,5,306
"7530",1007530,24,7,1,32
"7531",1007531,124,49,9,182
"7532",1007532,148,95,11,254
"7533",1007533,3,13,1,17
"7534",1007534,35,181,7,223
"7535",1007535,180,57,2,239
"7536",1007536,48,204,7,259
"7537",1007537,141,97,9,247
"7538",1007538,54,10,5,69
"7539",1007539,90,53,2,145
"7540",1007540,111,114,16,241
"7541",1007541,2,74,2,78
"7542",1007542,57,229,5,291
"7543",1007543,79,0,0,79
"7544",1007544,42,9,1,52
"7545",1007545,166,54,18,238
"7546",1007546,147,153,5,305
"7547",1007547,122,153,13,288
"7548",1007548,196,51,3,250
"7549",1007549,49,135,12,196
"7550",1007550,156,37,6,199
"7551",1007551,129,60,6,195
"7552",1007552,27,36,6,69
"7553",1007553,147,95,16,258
"7554",1007554,164,32,8,204
"7555",1007555,183,43,11,237
"7556",1007556,96,109,19,224
"7557",1007557,144,131,11,286
"7558",1007558,94,94,7,195
"7559",1007559,172,37,3,212
"7560",1007560,55,178,15,248
"7561",1007561,103,114,27,244
"7562",1007562,131,114,5,250
"7563",1007563,37,147,2,186
"7564",1007564,38,57,3,98
"7565",1007565,91,183,15,289
"7566",1007566,172,117,17,306
"7567",1007567,96,200,11,307
"7568",1007568,131,97,10,238
"7569",1007569,118,179,9,306
"7570",1007570,52,137,6,195
"7571",1007571,168,117,17,302
"7572",1007572,95,138,9,242
"7573",1007573,9,34,1,44
"7574",1007574,210,77,11,298
"7575",1007575,98,35,2,135
"7576",1007576,173,108,11,292
"7577",1007577,63,3,3,69
"7578",1007578,44,192,2,238
"7579",1007579,140,94,15,249
"7580",1007580,34,203,14,251
"7581",1007581,124,78,3,205
"7582",1007582,157,38,7,202
"7583",1007583,17,257,3,277
"7584",1007584,54,110,11,175
"7585",1007585,6,45,1,52
"7586",1007586,160,45,3,208
"7587",1007587,78,162,12,252
"7588",1007588,86,122,6,214
"7589",1007589,68,29,5,102
"7590",1007590,9,108,2,119
"7591",1007591,72,22,2,96
"7592",1007592,174,13,3,190
"7593",1007593,114,47,5,166
"7594",1007594,25,15,0,40
"7595",1007595,192,82,7,281
"7596",1007596,195,73,10,278
"7597",1007597,160,15,4,179
"7598",1007598,66,228,1,295
"7599",1007599,122,164,16,302
"7600",1007600,116,83,12,211
"7601",1007601,87,77,15,179
"7602",1007602,70,71,12,153
"7603",1007603,103,47,5,155
"7604",1007604,30,59,2,91
"7605",1007605,185,94,15,294
"7606",1007606,55,164,4,223
"7607",1007607,111,123,9,243
"7608",1007608,213,16,8,237
"7609",1007609,9,18,0,27
"7610",1007610,195,42,7,244
"7611",1007611,76,132,7,215
"7612",1007612,67,180,12,259
"7613",1007613,81,37,5,123
"7614",1007614,144,36,3,183
"7615",1007615,99,92,2,193
"7616",1007616,134,176,10,320
"7617",1007617,109,178,17,304
"7618",1007618,47,242,2,291
"7619",1007619,4,69,0,73
"7620",1007620,108,44,7,159
"7621",1007621,166,120,10,296
"7622",1007622,127,20,1,148
"7623",1007623,94,28,4,126
"7624",1007624,149,165,9,323
"7625",1007625,118,139,5,262
"7626",1007626,102,131,7,240
"7627",1007627,249,39,10,298
"7628",1007628,69,29,4,102
"7629",1007629,21,9,4,34
"7630",1007630,148,19,1,168
"7631",1007631,34,265,6,305
"7632",1007632,35,231,3,269
"7633",1007633,96,179,7,282
"7634",1007634,131,98,13,242
"7635",1007635,56,157,9,222
"7636",1007636,51,204,18,273
"7637",1007637,74,103,2,179
"7638",1007638,94,103,8,205
"7639",1007639,20,20,5,45
"7640",1007640,32,126,5,163
"7641",1007641,21,55,0,76
"7642",1007642,90,153,9,252
"7643",1007643,169,89,1,259
"7644",1007644,234,28,11,273
"7645",1007645,10,5,0,15
"7646",1007646,58,234,10,302
"7647",1007647,104,39,5,148
"7648",1007648,105,14,4,123
"7649",1007649,63,31,5,99
"7650",1007650,48,172,7,227
"7651",1007651,135,49,3,187
"7652",1007652,36,165,3,204
"7653",1007653,24,7,2,33
"7654",1007654,72,39,14,125
"7655",1007655,100,136,9,245
"7656",1007656,84,83,5,172
"7657",1007657,152,23,4,179
"7658",1007658,142,179,7,328
"7659",1007659,59,49,2,110
"7660",1007660,122,117,18,257
"7661",1007661,116,102,4,222
"7662",1007662,150,157,27,334
"7663",1007663,206,25,10,241
"7664",1007664,181,64,21,266
"7665",1007665,220,75,25,320
"7666",1007666,160,77,7,244
"7667",1007667,184,53,14,251
"7668",1007668,155,55,22,232
"7669",1007669,121,111,20,252
"7670",1007670,62,192,16,270
"7671",1007671,236,63,12,311
"7672",1007672,186,25,5,216
"7673",1007673,302,25,14,341
"7674",1007674,172,64,7,243
"7675",1007675,134,79,11,224
"7676",1007676,33,32,5,70
"7677",1007677,189,79,9,277
"7678",1007678,149,29,5,183
"7679",1007679,148,64,11,223
"7680",1007680,176,74,7,257
"7681",1007681,106,185,13,304
"7682",1007682,148,137,5,290
"7683",1007683,122,20,0,142
"7684",1007684,76,181,11,268
"7685",1007685,192,54,7,253
"7686",1007686,64,62,7,133
"7687",1007687,66,204,8,278
"7688",1007688,67,77,14,158
"7689",1007689,26,116,3,145
"7690",1007690,137,52,4,193
"7691",1007691,141,80,9,230
"7692",1007692,134,97,13,244
"7693",1007693,197,56,14,267
"7694",1007694,114,29,6,149
"7695",1007695,35,208,10,253
"7696",1007696,48,226,4,278
"7697",1007697,137,17,2,156
"7698",1007698,94,255,10,359
"7699",1007699,170,39,10,219
"7700",1007700,94,150,8,252
"7701",1007701,146,79,8,233
"7702",1007702,181,58,13,252
"7703",1007703,90,44,5,139
"7704",1007704,152,42,9,203
"7705",1007705,29,160,6,195
"7706",1007706,83,199,9,291
"7707",1007707,208,67,11,286
"7708",1007708,246,15,3,264
"7709",1007709,48,42,3,93
"7710",1007710,248,35,12,295
"7711",1007711,98,162,6,266
"7712",1007712,71,62,12,145
"7713",1007713,173,89,6,268
"7714",1007714,118,118,11,247
"7715",1007715,183,103,14,300
"7716",1007716,117,53,9,179
"7717",1007717,101,120,16,237
"7718",1007718,143,105,7,255
"7719",1007719,140,117,8,265
"7720",1007720,138,47,4,189
"7721",1007721,138,109,9,256
"7722",1007722,199,53,7,259
"7723",1007723,125,80,12,217
"7724",1007724,30,146,1,177
"7725",1007725,230,30,4,264
"7726",1007726,125,57,8,190
"7727",1007727,95,225,13,333
"7728",1007728,63,1,0,64
"7729",1007729,3,6,0,9
"7730",1007730,25,371,1,397
"7731",1007731,52,157,8,217
"7732",1007732,134,95,5,234
"7733",1007733,101,158,21,280
"7734",1007734,32,135,9,176
"7735",1007735,61,216,2,279
"7736",1007736,19,84,15,118
"7737",1007737,122,37,7,166
"7738",1007738,97,123,10,230
"7739",1007739,161,85,8,254
"7740",1007740,64,84,6,154
"7741",1007741,152,82,7,241
"7742",1007742,123,151,19,293
"7743",1007743,142,59,12,213
"7744",1007744,137,157,19,313
"7745",1007745,89,194,10,293
"7746",1007746,163,143,22,328
"7747",1007747,125,93,5,223
"7748",1007748,90,171,16,277
"7749",1007749,72,213,9,294
"7750",1007750,47,101,1,149
"7751",1007751,92,133,11,236
"7752",1007752,168,144,12,324
"7753",1007753,154,48,14,216
"7754",1007754,213,40,9,262
"7755",1007755,83,214,13,310
"7756",1007756,122,36,4,162
"7757",1007757,81,61,3,145
"7758",1007758,156,38,7,201
"7759",1007759,80,69,9,158
"7760",1007760,199,44,8,251
"7761",1007761,103,38,4,145
"7762",1007762,208,50,8,266
"7763",1007763,132,119,11,262
"7764",1007764,22,21,0,43
"7765",1007765,53,55,1,109
"7766",1007766,88,28,5,121
"7767",1007767,71,194,3,268
"7768",1007768,96,64,5,165
"7769",1007769,209,81,10,300
"7770",1007770,222,92,21,335
"7771",1007771,82,117,6,205
"7772",1007772,89,5,1,95
"7773",1007773,48,250,6,304
"7774",1007774,60,189,7,256
"7775",1007775,216,21,11,248
"7776",1007776,87,191,4,282
"7777",1007777,48,137,6,191
"7778",1007778,5,1,0,6
"7779",1007779,93,152,10,255
"7780",1007780,53,122,12,187
"7781",1007781,100,118,11,229
"7782",1007782,184,44,4,232
"7783",1007783,125,142,11,278
"7784",1007784,210,103,16,329
"7785",1007785,100,99,11,210
"7786",1007786,185,83,19,287
"7787",1007787,114,144,3,261
"7788",1007788,152,12,6,170
"7789",1007789,58,48,8,114
"7790",1007790,149,63,9,221
"7791",1007791,176,125,13,314
"7792",1007792,34,133,6,173
"7793",1007793,161,74,10,245
"7794",1007794,62,228,4,294
"7795",1007795,132,20,4,156
"7796",1007796,180,39,6,225
"7797",1007797,248,18,3,269
"7798",1007798,39,69,12,120
"7799",1007799,158,44,6,208
"7800",1007800,49,268,3,320
"7801",1007801,174,43,7,224
"7802",1007802,222,38,7,267
"7803",1007803,190,46,2,238
"7804",1007804,150,53,3,206
"7805",1007805,174,44,8,226
"7806",1007806,36,253,3,292
"7807",1007807,83,38,6,127
"7808",1007808,94,121,9,224
"7809",1007809,67,140,0,207
"7810",1007810,91,84,2,177
"7811",1007811,44,199,14,257
"7812",1007812,75,50,5,130
"7813",1007813,18,23,1,42
"7814",1007814,54,225,9,288
"7815",1007815,92,146,6,244
"7816",1007816,75,209,22,306
"7817",1007817,35,46,1,82
"7818",1007818,115,117,9,241
"7819",1007819,170,77,2,249
"7820",1007820,88,186,3,277
"7821",1007821,208,124,10,342
"7822",1007822,21,24,7,52
"7823",1007823,103,27,3,133
"7824",1007824,54,133,11,198
"7825",1007825,159,52,6,217
"7826",1007826,161,101,8,270
"7827",1007827,99,211,11,321
"7828",1007828,85,90,2,177
"7829",1007829,226,57,10,293
"7830",1007830,170,78,11,259
"7831",1007831,92,152,9,253
"7832",1007832,91,89,4,184
"7833",1007833,88,158,8,254
"7834",1007834,83,91,9,183
"7835",1007835,107,22,6,135
"7836",1007836,25,246,5,276
"7837",1007837,90,200,4,294
"7838",1007838,143,54,5,202
"7839",1007839,149,54,13,216
"7840",1007840,133,17,2,152
"7841",1007841,75,38,2,115
"7842",1007842,162,83,7,252
"7843",1007843,55,159,3,217
"7844",1007844,172,93,16,281
"7845",1007845,118,188,11,317
"7846",1007846,56,138,6,200
"7847",1007847,5,2,0,7
"7848",1007848,192,101,15,308
"7849",1007849,57,133,11,201
"7850",1007850,116,115,15,246
"7851",1007851,110,124,15,249
"7852",1007852,187,96,9,292
"7853",1007853,208,20,7,235
"7854",1007854,2,3,0,5
"7855",1007855,148,53,5,206
"7856",1007856,93,108,8,209
"7857",1007857,58,124,5,187
"7858",1007858,49,184,6,239
"7859",1007859,149,85,16,250
"7860",1007860,27,25,3,55
"7861",1007861,32,93,4,129
"7862",1007862,157,57,4,218
"7863",1007863,152,125,15,292
"7864",1007864,93,192,9,294
"7865",1007865,79,203,5,287
"7866",1007866,122,40,3,165
"7867",1007867,186,18,3,207
"7868",1007868,135,12,3,150
"7869",1007869,42,204,8,254
"7870",1007870,204,73,5,282
"7871",1007871,68,169,5,242
"7872",1007872,108,27,5,140
"7873",1007873,63,214,5,282
"7874",1007874,60,141,1,202
"7875",1007875,118,33,2,153
"7876",1007876,38,237,5,280
"7877",1007877,26,117,3,146
"7878",1007878,66,234,8,308
"7879",1007879,31,284,8,323
"7880",1007880,146,37,12,195
"7881",1007881,50,166,13,229
"7882",1007882,72,78,6,156
"7883",1007883,71,77,7,155
"7884",1007884,60,250,5,315
"7885",1007885,14,6,1,21
"7886",1007886,26,187,5,218
"7887",1007887,139,51,7,197
"7888",1007888,99,52,1,152
"7889",1007889,93,173,7,273
"7890",1007890,137,21,12,170
"7891",1007891,35,279,6,320
"7892",1007892,143,44,2,189
"7893",1007893,157,86,6,249
"7894",1007894,84,35,10,129
"7895",1007895,115,142,5,262
"7896",1007896,123,122,19,264
"7897",1007897,354,38,19,411
"7898",1007898,34,189,9,232
"7899",1007899,6,9,0,15
"7900",1007900,20,107,4,131
"7901",1007901,173,124,16,313
"7902",1007902,186,24,1,211
"7903",1007903,164,67,9,240
"7904",1007904,221,35,7,263
"7905",1007905,114,90,3,207
"7906",1007906,98,207,7,312
"7907",1007907,121,144,14,279
"7908",1007908,144,120,13,277
"7909",1007909,142,63,11,216
"7910",1007910,35,127,10,172
"7911",1007911,74,86,5,165
"7912",1007912,70,3,1,74
"7913",1007913,150,88,8,246
"7914",1007914,134,59,1,194
"7915",1007915,66,75,4,145
"7916",1007916,87,96,5,188
"7917",1007917,132,132,13,277
"7918",1007918,149,137,26,312
"7919",1007919,40,125,9,174
"7920",1007920,65,144,8,217
"7921",1007921,16,142,0,158
"7922",1007922,207,77,3,287
"7923",1007923,76,219,4,299
"7924",1007924,44,202,3,249
"7925",1007925,138,78,0,216
"7926",1007926,99,116,5,220
"7927",1007927,47,108,5,160
"7928",1007928,126,58,11,195
"7929",1007929,170,30,4,204
"7930",1007930,42,129,10,181
"7931",1007931,183,77,12,272
"7932",1007932,58,183,21,262
"7933",1007933,204,34,9,247
"7934",1007934,223,34,7,264
"7935",1007935,16,79,1,96
"7936",1007936,157,58,4,219
"7937",1007937,81,184,20,285
"7938",1007938,145,91,14,250
"7939",1007939,146,53,8,207
"7940",1007940,78,145,9,232
"7941",1007941,22,265,2,289
"7942",1007942,191,86,10,287
"7943",1007943,102,144,3,249
"7944",1007944,168,63,5,236
"7945",1007945,177,142,9,328
"7946",1007946,166,45,8,219
"7947",1007947,144,56,12,212
"7948",1007948,135,152,15,302
"7949",1007949,11,19,0,30
"7950",1007950,27,227,7,261
"7951",1007951,61,197,9,267
"7952",1007952,256,49,10,315
"7953",1007953,36,254,4,294
"7954",1007954,120,65,8,193
"7955",1007955,133,120,30,283
"7956",1007956,190,56,15,261
"7957",1007957,36,6,2,44
"7958",1007958,85,163,10,258
"7959",1007959,41,42,2,85
"7960",1007960,73,42,0,115
"7961",1007961,71,122,11,204
"7962",1007962,63,125,12,200
"7963",1007963,106,162,3,271
"7964",1007964,145,76,3,224
"7965",1007965,120,145,14,279
"7966",1007966,107,97,4,208
"7967",1007967,65,201,8,274
"7968",1007968,124,125,5,254
"7969",1007969,136,54,6,196
"7970",1007970,56,216,3,275
"7971",1007971,134,55,8,197
"7972",1007972,246,46,6,298
"7973",1007973,15,204,3,222
"7974",1007974,116,52,8,176
"7975",1007975,245,37,9,291
"7976",1007976,228,9,7,244
"7977",1007977,146,45,10,201
"7978",1007978,137,96,8,241
"7979",1007979,50,57,1,108
"7980",1007980,49,64,5,118
"7981",1007981,138,115,13,266
"7982",1007982,64,256,5,325
"7983",1007983,181,89,8,278
"7984",1007984,39,83,2,124
"7985",1007985,167,16,5,188
"7986",1007986,47,155,6,208
"7987",1007987,149,150,16,315
"7988",1007988,60,222,9,291
"7989",1007989,117,12,3,132
"7990",1007990,160,12,7,179
"7991",1007991,97,102,13,212
"7992",1007992,33,126,11,170
"7993",1007993,113,92,7,212
"7994",1007994,42,251,2,295
"7995",1007995,108,171,15,294
"7996",1007996,155,101,10,266
"7997",1007997,207,66,9,282
"7998",1007998,41,146,5,192
"7999",1007999,119,77,10,206
"8000",1008000,82,110,2,194
"8001",1008001,78,207,10,295
"8002",1008002,26,100,1,127
"8003",1008003,117,123,6,246
"8004",1008004,163,22,4,189
"8005",1008005,98,203,10,311
"8006",1008006,61,245,4,310
"8007",1008007,146,41,11,198
"8008",1008008,193,148,13,354
"8009",1008009,114,143,7,264
"8010",1008010,87,22,8,117
"8011",1008011,92,80,6,178
"8012",1008012,32,19,3,54
"8013",1008013,130,109,7,246
"8014",1008014,80,170,10,260
"8015",1008015,98,106,15,219
"8016",1008016,86,167,11,264
"8017",1008017,130,106,14,250
"8018",1008018,3,4,1,8
"8019",1008019,81,148,3,232
"8020",1008020,81,190,4,275
"8021",1008021,174,27,9,210
"8022",1008022,97,64,9,170
"8023",1008023,152,148,16,316
"8024",1008024,227,29,4,260
"8025",1008025,141,59,18,218
"8026",1008026,178,105,25,308
"8027",1008027,0,0,0,0
"8028",1008028,36,266,5,307
"8029",1008029,117,115,10,242
"8030",1008030,195,101,25,321
"8031",1008031,63,118,4,185
"8032",1008032,129,39,3,171
"8033",1008033,28,45,2,75
"8034",1008034,80,234,6,320
"8035",1008035,67,210,14,291
"8036",1008036,115,212,16,343
"8037",1008037,42,206,6,254
"8038",1008038,161,147,21,329
"8039",1008039,115,27,1,143
"8040",1008040,120,149,2,271
"8041",1008041,150,32,9,191
"8042",1008042,203,45,13,261
"8043",1008043,50,145,5,200
"8044",1008044,67,202,6,275
"8045",1008045,45,156,7,208
"8046",1008046,195,22,5,222
"8047",1008047,97,173,6,276
"8048",1008048,5,163,3,171
"8049",1008049,141,79,3,223
"8050",1008050,85,223,4,312
"8051",1008051,59,23,1,83
"8052",1008052,277,8,6,291
"8053",1008053,119,57,8,184
"8054",1008054,114,99,2,215
"8055",1008055,173,96,10,279
"8056",1008056,53,11,0,64
"8057",1008057,276,60,8,344
"8058",1008058,205,33,6,244
"8059",1008059,209,59,6,274
"8060",1008060,51,163,7,221
"8061",1008061,151,67,3,221
"8062",1008062,121,142,15,278
"8063",1008063,167,110,7,284
"8064",1008064,157,13,5,175
"8065",1008065,1,17,0,18
"8066",1008066,162,101,16,279
"8067",1008067,97,16,2,115
"8068",1008068,139,151,11,301
"8069",1008069,41,22,2,65
"8070",1008070,158,43,2,203
"8071",1008071,222,51,15,288
"8072",1008072,162,53,4,219
"8073",1008073,153,146,16,315
"8074",1008074,99,57,6,162
"8075",1008075,232,21,10,263
"8076",1008076,57,197,9,263
"8077",1008077,47,184,15,246
"8078",1008078,12,103,2,117
"8079",1008079,49,50,4,103
"8080",1008080,82,143,7,232
"8081",1008081,130,62,7,199
"8082",1008082,109,195,5,309
"8083",1008083,167,92,18,277
"8084",1008084,101,91,0,192
"8085",1008085,77,141,3,221
"8086",1008086,95,60,9,164
"8087",1008087,73,185,7,265
"8088",1008088,74,147,16,237
"8089",1008089,121,105,6,232
"8090",1008090,141,58,4,203
"8091",1008091,110,225,30,365
"8092",1008092,226,60,10,296
"8093",1008093,42,33,3,78
"8094",1008094,29,237,8,274
"8095",1008095,182,39,12,233
"8096",1008096,113,37,10,160
"8097",1008097,62,92,4,158
"8098",1008098,78,93,9,180
"8099",1008099,129,129,6,264
"8100",1008100,72,51,3,126
"8101",1008101,87,8,1,96
"8102",1008102,113,133,9,255
"8103",1008103,119,104,5,228
"8104",1008104,174,119,18,311
"8105",1008105,100,66,3,169
"8106",1008106,119,95,3,217
"8107",1008107,17,24,4,45
"8108",1008108,64,47,3,114
"8109",1008109,188,87,14,289
"8110",1008110,63,159,13,235
"8111",1008111,179,16,4,199
"8112",1008112,52,88,5,145
"8113",1008113,35,54,2,91
"8114",1008114,50,208,10,268
"8115",1008115,158,55,3,216
"8116",1008116,166,94,4,264
"8117",1008117,78,86,7,171
"8118",1008118,0,0,0,0
"8119",1008119,11,16,0,27
"8120",1008120,85,102,12,199
"8121",1008121,172,68,11,251
"8122",1008122,120,115,1,236
"8123",1008123,194,38,1,233
"8124",1008124,77,118,6,201
"8125",1008125,187,64,2,253
"8126",1008126,26,209,6,241
"8127",1008127,131,93,2,226
"8128",1008128,69,2,1,72
"8129",1008129,26,250,1,277
"8130",1008130,148,106,5,259
"8131",1008131,127,100,8,235
"8132",1008132,126,192,11,329
"8133",1008133,180,58,18,256
"8134",1008134,140,71,14,225
"8135",1008135,92,38,3,133
"8136",1008136,114,142,14,270
"8137",1008137,138,130,12,280
"8138",1008138,107,25,9,141
"8139",1008139,56,169,4,229
"8140",1008140,80,19,4,103
"8141",1008141,74,98,15,187
"8142",1008142,54,202,2,258
"8143",1008143,120,68,4,192
"8144",1008144,36,133,4,173
"8145",1008145,207,51,4,262
"8146",1008146,96,42,4,142
"8147",1008147,97,134,11,242
"8148",1008148,89,67,4,160
"8149",1008149,89,122,20,231
"8150",1008150,79,199,15,293
"8151",1008151,147,79,11,237
"8152",1008152,80,83,8,171
"8153",1008153,110,92,4,206
"8154",1008154,182,88,4,274
"8155",1008155,187,76,6,269
"8156",1008156,41,163,6,210
"8157",1008157,174,108,13,295
"8158",1008158,15,149,9,173
"8159",1008159,20,40,1,61
"8160",1008160,191,57,4,252
"8161",1008161,112,106,8,226
"8162",1008162,121,85,8,214
"8163",1008163,147,104,6,257
"8164",1008164,60,323,5,388
"8165",1008165,45,83,4,132
"8166",1008166,39,5,0,44
"8167",1008167,120,141,13,274
"8168",1008168,137,101,8,246
"8169",1008169,124,83,9,216
"8170",1008170,148,31,11,190
"8171",1008171,134,125,6,265
"8172",1008172,151,19,6,176
"8173",1008173,182,46,12,240
"8174",1008174,186,66,11,263
"8175",1008175,147,50,6,203
"8176",1008176,175,18,15,208
"8177",1008177,56,212,13,281
"8178",1008178,82,66,4,152
"8179",1008179,190,26,6,222
"8180",1008180,94,81,1,176
"8181",1008181,88,106,10,204
"8182",1008182,60,59,6,125
"8183",1008183,149,76,6,231
"8184",1008184,39,188,5,232
"8185",1008185,12,175,2,189
"8186",1008186,103,127,19,249
"8187",1008187,95,75,3,173
"8188",1008188,195,52,6,253
"8189",1008189,125,157,7,289
"8190",1008190,80,150,7,237
"8191",1008191,33,13,2,48
"8192",1008192,220,60,12,292
"8193",1008193,216,56,8,280
"8194",1008194,56,249,11,316
"8195",1008195,224,21,5,250
"8196",1008196,43,183,7,233
"8197",1008197,23,4,1,28
"8198",1008198,32,206,5,243
"8199",1008199,87,162,3,252
"8200",1008200,74,209,8,291
"8201",1008201,269,152,8,429
"8202",1008202,39,156,3,198
"8203",1008203,4,1,0,5
"8204",1008204,59,163,3,225
"8205",1008205,169,93,8,270
"8206",1008206,102,71,9,182
"8207",1008207,92,99,13,204
"8208",1008208,18,207,3,228
"8209",1008209,54,175,4,233
"8210",1008210,105,200,2,307
"8211",1008211,165,113,12,290
"8212",1008212,29,212,2,243
"8213",1008213,38,155,3,196
"8214",1008214,102,103,10,215
"8215",1008215,176,64,13,253
"8216",1008216,69,139,3,211
"8217",1008217,74,209,14,297
"8218",1008218,23,240,1,264
"8219",1008219,91,119,2,212
"8220",1008220,36,122,5,163
"8221",1008221,104,146,8,258
"8222",1008222,143,162,12,317
"8223",1008223,9,9,0,18
"8224",1008224,143,54,16,213
"8225",1008225,30,173,9,212
"8226",1008226,50,164,13,227
"8227",1008227,97,186,5,288
"8228",1008228,257,16,3,276
"8229",1008229,119,38,5,162
"8230",1008230,88,200,20,308
"8231",1008231,177,29,5,211
"8232",1008232,153,85,6,244
"8233",1008233,166,56,3,225
"8234",1008234,118,56,9,183
"8235",1008235,70,246,1,317
"8236",1008236,139,109,7,255
"8237",1008237,177,107,15,299
"8238",1008238,175,130,6,311
"8239",1008239,158,44,9,211
"8240",1008240,155,91,5,251
"8241",1008241,111,29,2,142
"8242",1008242,128,64,8,200
"8243",1008243,127,29,2,158
"8244",1008244,200,23,3,226
"8245",1008245,19,63,0,82
"8246",1008246,39,12,0,51
"8247",1008247,74,38,2,114
"8248",1008248,107,115,14,236
"8249",1008249,217,28,10,255
"8250",1008250,131,118,15,264
"8251",1008251,155,41,4,200
"8252",1008252,47,38,3,88
"8253",1008253,54,121,7,182
"8254",1008254,200,60,1,261
"8255",1008255,76,209,6,291
"8256",1008256,95,142,14,251
"8257",1008257,105,215,12,332
"8258",1008258,186,46,7,239
"8259",1008259,126,186,15,327
"8260",1008260,178,127,3,308
"8261",1008261,138,19,4,161
"8262",1008262,117,4,3,124
"8263",1008263,123,97,7,227
"8264",1008264,76,10,3,89
"8265",1008265,18,173,7,198
"8266",1008266,122,106,9,237
"8267",1008267,51,222,18,291
"8268",1008268,106,203,4,313
"8269",1008269,109,142,19,270
"8270",1008270,76,223,11,310
"8271",1008271,178,51,22,251
"8272",1008272,73,172,15,260
"8273",1008273,97,24,8,129
"8274",1008274,94,224,3,321
"8275",1008275,167,63,5,235
"8276",1008276,41,144,15,200
"8277",1008277,21,242,7,270
"8278",1008278,44,51,5,100
"8279",1008279,88,118,16,222
"8280",1008280,35,154,5,194
"8281",1008281,109,151,6,266
"8282",1008282,148,28,9,185
"8283",1008283,82,67,2,151
"8284",1008284,37,227,1,265
"8285",1008285,17,139,3,159
"8286",1008286,110,52,3,165
"8287",1008287,108,156,13,277
"8288",1008288,73,166,15,254
"8289",1008289,100,80,10,190
"8290",1008290,17,138,1,156
"8291",1008291,8,31,0,39
"8292",1008292,69,241,14,324
"8293",1008293,139,58,4,201
"8294",1008294,151,102,2,255
"8295",1008295,148,94,20,262
"8296",1008296,29,253,3,285
"8297",1008297,192,20,3,215
"8298",1008298,141,34,3,178
"8299",1008299,80,184,10,274
"8300",1008300,185,32,5,222
"8301",1008301,149,84,10,243
"8302",1008302,138,62,13,213
"8303",1008303,87,114,10,211
"8304",1008304,162,127,16,305
"8305",1008305,205,44,7,256
"8306",1008306,22,56,4,82
"8307",1008307,182,73,14,269
"8308",1008308,91,106,8,205
"8309",1008309,138,54,1,193
"8310",1008310,64,137,4,205
"8311",1008311,174,99,12,285
"8312",1008312,74,166,11,251
"8313",1008313,77,222,7,306
"8314",1008314,124,142,5,271
"8315",1008315,132,45,6,183
"8316",1008316,88,148,11,247
"8317",1008317,46,224,3,273
"8318",1008318,173,35,8,216
"8319",1008319,34,15,4,53
"8320",1008320,47,140,4,191
"8321",1008321,160,80,5,245
"8322",1008322,250,21,2,273
"8323",1008323,182,131,21,334
"8324",1008324,124,80,10,214
"8325",1008325,62,150,3,215
"8326",1008326,42,57,2,101
"8327",1008327,136,90,14,240
"8328",1008328,91,27,4,122
"8329",1008329,124,81,11,216
"8330",1008330,135,90,7,232
"8331",1008331,69,98,5,172
"8332",1008332,175,121,26,322
"8333",1008333,77,183,11,271
"8334",1008334,119,96,8,223
"8335",1008335,97,162,18,277
"8336",1008336,148,122,6,276
"8337",1008337,194,83,16,293
"8338",1008338,97,64,10,171
"8339",1008339,95,20,5,120
"8340",1008340,34,5,4,43
"8341",1008341,48,103,2,153
"8342",1008342,30,86,7,123
"8343",1008343,205,56,17,278
"8344",1008344,65,162,27,254
"8345",1008345,192,94,2,288
"8346",1008346,235,50,13,298
"8347",1008347,48,58,6,112
"8348",1008348,53,225,6,284
"8349",1008349,112,173,11,296
"8350",1008350,57,258,11,326
"8351",1008351,79,230,9,318
"8352",1008352,56,108,8,172
"8353",1008353,136,116,10,262
"8354",1008354,103,70,3,176
"8355",1008355,161,131,11,303
"8356",1008356,180,111,10,301
"8357",1008357,58,112,7,177
"8358",1008358,71,179,16,266
"8359",1008359,166,38,7,211
"8360",1008360,137,103,16,256
"8361",1008361,230,90,7,327
"8362",1008362,62,251,3,316
"8363",1008363,167,117,10,294
"8364",1008364,110,34,12,156
"8365",1008365,100,17,3,120
"8366",1008366,31,181,8,220
"8367",1008367,98,112,18,228
"8368",1008368,133,157,18,308
"8369",1008369,97,46,4,147
"8370",1008370,163,81,7,251
"8371",1008371,94,48,8,150
"8372",1008372,152,55,8,215
"8373",1008373,6,2,0,8
"8374",1008374,76,150,12,238
"8375",1008375,53,198,3,254
"8376",1008376,127,34,5,166
"8377",1008377,83,54,2,139
"8378",1008378,143,78,13,234
"8379",1008379,23,269,3,295
"8380",1008380,56,156,4,216
"8381",1008381,100,35,3,138
"8382",1008382,109,84,5,198
"8383",1008383,31,223,3,257
"8384",1008384,160,42,5,207
"8385",1008385,142,61,7,210
"8386",1008386,70,151,10,231
"8387",1008387,46,188,7,241
"8388",1008388,42,150,7,199
"8389",1008389,102,167,11,280
"8390",1008390,110,47,1,158
"8391",1008391,85,92,8,185
"8392",1008392,86,145,6,237
"8393",1008393,182,148,25,355
"8394",1008394,55,184,2,241
"8395",1008395,59,92,4,155
"8396",1008396,95,127,4,226
"8397",1008397,130,131,18,279
"8398",1008398,81,130,31,242
"8399",1008399,62,244,19,325
"8400",1008400,235,33,16,284
"8401",1008401,23,103,6,132
"8402",1008402,167,62,3,232
"8403",1008403,139,138,7,284
"8404",1008404,18,16,1,35
"8405",1008405,139,93,3,235
"8406",1008406,15,136,7,158
"8407",1008407,24,169,5,198
"8408",1008408,37,196,15,248
"8409",1008409,62,244,5,311
"8410",1008410,96,125,10,231
"8411",1008411,101,211,11,323
"8412",1008412,179,24,4,207
"8413",1008413,199,41,13,253
"8414",1008414,198,68,10,276
"8415",1008415,86,140,8,234
"8416",1008416,214,27,6,247
"8417",1008417,146,58,6,210
"8418",1008418,133,72,2,207
"8419",1008419,32,266,2,300
"8420",1008420,73,63,5,141
"8421",1008421,91,47,3,141
"8422",1008422,104,133,5,242
"8423",1008423,51,137,0,188
"8424",1008424,149,140,7,296
"8425",1008425,87,82,3,172
"8426",1008426,75,199,7,281
"8427",1008427,83,195,17,295
"8428",1008428,166,81,11,258
"8429",1008429,84,68,4,156
"8430",1008430,110,179,4,293
"8431",1008431,168,101,22,291
"8432",1008432,164,110,6,280
"8433",1008433,122,87,10,219
"8434",1008434,18,15,0,33
"8435",1008435,116,96,8,220
"8436",1008436,78,83,12,173
"8437",1008437,189,62,10,261
"8438",1008438,166,117,11,294
"8439",1008439,60,111,16,187
"8440",1008440,122,135,25,282
"8441",1008441,70,215,4,289
"8442",1008442,202,71,7,280
"8443",1008443,141,99,16,256
"8444",1008444,126,93,7,226
"8445",1008445,122,45,4,171
"8446",1008446,63,155,10,228
"8447",1008447,72,86,3,161
"8448",1008448,173,142,4,319
"8449",1008449,156,23,1,180
"8450",1008450,129,100,3,232
"8451",1008451,81,150,25,256
"8452",1008452,177,76,12,265
"8453",1008453,169,69,11,249
"8454",1008454,174,102,11,287
"8455",1008455,50,77,7,134
"8456",1008456,177,82,7,266
"8457",1008457,26,289,6,321
"8458",1008458,152,28,9,189
"8459",1008459,104,250,10,364
"8460",1008460,147,64,6,217
"8461",1008461,50,193,8,251
"8462",1008462,60,64,2,126
"8463",1008463,178,109,13,300
"8464",1008464,73,178,11,262
"8465",1008465,57,140,13,210
"8466",1008466,196,20,3,219
"8467",1008467,99,5,6,110
"8468",1008468,137,62,3,202
"8469",1008469,137,110,6,253
"8470",1008470,233,24,7,264
"8471",1008471,20,24,0,44
"8472",1008472,248,44,10,302
"8473",1008473,126,75,25,226
"8474",1008474,282,6,6,294
"8475",1008475,146,101,18,265
"8476",1008476,98,249,6,353
"8477",1008477,10,59,1,70
"8478",1008478,102,185,8,295
"8479",1008479,155,68,14,237
"8480",1008480,152,51,7,210
"8481",1008481,82,157,4,243
"8482",1008482,94,13,4,111
"8483",1008483,70,218,8,296
"8484",1008484,190,70,11,271
"8485",1008485,108,129,4,241
"8486",1008486,58,17,2,77
"8487",1008487,139,74,10,223
"8488",1008488,176,94,3,273
"8489",1008489,152,90,10,252
"8490",1008490,70,113,8,191
"8491",1008491,43,217,8,268
"8492",1008492,190,64,6,260
"8493",1008493,195,52,9,256
"8494",1008494,62,209,8,279
"8495",1008495,193,79,14,286
"8496",1008496,50,34,7,91
"8497",1008497,200,49,14,263
"8498",1008498,184,43,17,244
"8499",1008499,176,112,21,309
"8500",1008500,46,103,5,154
"8501",1008501,73,90,9,172
"8502",1008502,208,71,6,285
"8503",1008503,94,90,13,197
"8504",1008504,182,65,10,257
"8505",1008505,202,47,31,280
"8506",1008506,158,85,10,253
"8507",1008507,150,106,11,267
"8508",1008508,79,214,6,299
"8509",1008509,55,172,6,233
"8510",1008510,129,97,5,231
"8511",1008511,142,110,2,254
"8512",1008512,49,197,4,250
"8513",1008513,223,63,15,301
"8514",1008514,188,78,5,271
"8515",1008515,141,39,5,185
"8516",1008516,42,4,1,47
"8517",1008517,135,173,13,321
"8518",1008518,94,136,7,237
"8519",1008519,4,48,0,52
"8520",1008520,161,109,18,288
"8521",1008521,92,144,3,239
"8522",1008522,92,200,1,293
"8523",1008523,138,106,7,251
"8524",1008524,55,64,11,130
"8525",1008525,133,93,1,227
"8526",1008526,123,20,9,152
"8527",1008527,171,131,16,318
"8528",1008528,125,129,5,259
"8529",1008529,167,145,21,333
"8530",1008530,200,62,13,275
"8531",1008531,166,115,16,297
"8532",1008532,270,7,24,301
"8533",1008533,47,157,1,205
"8534",1008534,142,127,11,280
"8535",1008535,170,93,12,275
"8536",1008536,161,29,7,197
"8537",1008537,66,117,8,191
"8538",1008538,201,45,4,250
"8539",1008539,164,100,7,271
"8540",1008540,56,43,4,103
"8541",1008541,218,89,20,327
"8542",1008542,146,106,9,261
"8543",1008543,157,133,14,304
"8544",1008544,85,176,2,263
"8545",1008545,68,149,27,244
"8546",1008546,116,96,9,221
"8547",1008547,114,78,11,203
"8548",1008548,93,108,4,205
"8549",1008549,288,12,9,309
"8550",1008550,46,245,2,293
"8551",1008551,41,186,9,236
"8552",1008552,162,61,8,231
"8553",1008553,41,221,7,269
"8554",1008554,110,160,25,295
"8555",1008555,69,180,21,270
"8556",1008556,149,92,1,242
"8557",1008557,10,6,1,17
"8558",1008558,181,32,5,218
"8559",1008559,41,34,5,80
"8560",1008560,53,184,5,242
"8561",1008561,62,244,6,312
"8562",1008562,242,52,3,297
"8563",1008563,113,41,3,157
"8564",1008564,81,224,13,318
"8565",1008565,121,103,11,235
"8566",1008566,135,119,13,267
"8567",1008567,162,100,7,269
"8568",1008568,48,167,3,218
"8569",1008569,148,80,1,229
"8570",1008570,39,143,3,185
"8571",1008571,54,234,9,297
"8572",1008572,150,83,15,248
"8573",1008573,167,31,5,203
"8574",1008574,108,174,4,286
"8575",1008575,82,167,12,261
"8576",1008576,153,131,26,310
"8577",1008577,80,170,4,254
"8578",1008578,69,47,1,117
"8579",1008579,100,111,15,226
"8580",1008580,131,71,14,216
"8581",1008581,52,142,9,203
"8582",1008582,132,167,15,314
"8583",1008583,76,71,4,151
"8584",1008584,205,89,18,312
"8585",1008585,192,19,2,213
"8586",1008586,24,200,2,226
"8587",1008587,70,74,3,147
"8588",1008588,195,90,4,289
"8589",1008589,152,7,2,161
"8590",1008590,55,189,5,249
"8591",1008591,33,23,1,57
"8592",1008592,70,95,1,166
"8593",1008593,90,165,15,270
"8594",1008594,218,38,7,263
"8595",1008595,53,48,1,102
"8596",1008596,150,103,8,261
"8597",1008597,116,56,6,178
"8598",1008598,6,6,2,14
"8599",1008599,26,101,2,129
"8600",1008600,65,236,12,313
"8601",1008601,148,135,20,303
"8602",1008602,145,52,18,215
"8603",1008603,86,136,15,237
"8604",1008604,7,15,1,23
"8605",1008605,100,128,12,240
"8606",1008606,112,180,6,298
"8607",1008607,80,183,14,277
"8608",1008608,102,241,10,353
"8609",1008609,112,57,13,182
"8610",1008610,110,134,1,245
"8611",1008611,69,1,1,71
"8612",1008612,47,262,1,310
"8613",1008613,110,167,15,292
"8614",1008614,138,59,23,220
"8615",1008615,154,124,15,293
"8616",1008616,168,69,13,250
"8617",1008617,175,68,12,255
"8618",1008618,136,126,10,272
"8619",1008619,139,154,4,297
"8620",1008620,120,135,15,270
"8621",1008621,73,89,4,166
"8622",1008622,123,39,12,174
"8623",1008623,69,21,2,92
"8624",1008624,162,62,0,224
"8625",1008625,222,59,8,289
"8626",1008626,189,24,4,217
"8627",1008627,123,46,7,176
"8628",1008628,63,259,12,334
"8629",1008629,94,132,7,233
"8630",1008630,209,2,2,213
"8631",1008631,163,53,13,229
"8632",1008632,91,44,4,139
"8633",1008633,51,240,3,294
"8634",1008634,105,192,3,300
"8635",1008635,40,187,6,233
"8636",1008636,77,176,13,266
"8637",1008637,25,149,8,182
"8638",1008638,211,19,5,235
"8639",1008639,77,130,10,217
"8640",1008640,125,170,11,306
"8641",1008641,23,57,0,80
"8642",1008642,162,46,11,219
"8643",1008643,42,229,1,272
"8644",1008644,85,190,23,298
"8645",1008645,79,85,2,166
"8646",1008646,110,11,2,123
"8647",1008647,141,125,20,286
"8648",1008648,155,28,10,193
"8649",1008649,26,196,3,225
"8650",1008650,64,67,4,135
"8651",1008651,18,126,1,145
"8652",1008652,269,95,14,378
"8653",1008653,94,96,4,194
"8654",1008654,104,43,10,157
"8655",1008655,182,28,9,219
"8656",1008656,14,30,1,45
"8657",1008657,82,165,7,254
"8658",1008658,133,107,3,243
"8659",1008659,47,234,9,290
"8660",1008660,97,158,10,265
"8661",1008661,189,28,5,222
"8662",1008662,175,140,8,323
"8663",1008663,61,114,1,176
"8664",1008664,84,64,2,150
"8665",1008665,133,81,6,220
"8666",1008666,21,266,5,292
"8667",1008667,169,30,4,203
"8668",1008668,197,13,6,216
"8669",1008669,172,60,5,237
"8670",1008670,39,207,5,251
"8671",1008671,86,88,10,184
"8672",1008672,160,68,17,245
"8673",1008673,35,166,5,206
"8674",1008674,77,158,15,250
"8675",1008675,36,125,2,163
"8676",1008676,133,112,8,253
"8677",1008677,149,26,8,183
"8678",1008678,176,47,9,232
"8679",1008679,149,34,4,187
"8680",1008680,61,60,4,125
"8681",1008681,104,103,16,223
"8682",1008682,130,54,7,191
"8683",1008683,195,34,5,234
"8684",1008684,94,2,2,98
"8685",1008685,108,93,9,210
"8686",1008686,177,77,20,274
"8687",1008687,137,65,0,202
"8688",1008688,168,8,4,180
"8689",1008689,87,216,4,307
"8690",1008690,180,52,10,242
"8691",1008691,49,189,14,252
"8692",1008692,34,187,2,223
"8693",1008693,114,67,9,190
"8694",1008694,69,31,2,102
"8695",1008695,174,124,14,312
"8696",1008696,75,22,1,98
"8697",1008697,172,94,10,276
"8698",1008698,168,62,4,234
"8699",1008699,109,115,11,235
"8700",1008700,117,141,11,269
"8701",1008701,88,124,25,237
"8702",1008702,53,251,6,310
"8703",1008703,67,233,8,308
"8704",1008704,106,141,4,251
"8705",1008705,234,81,13,328
"8706",1008706,46,91,4,141
"8707",1008707,43,124,10,177
"8708",1008708,171,81,1,253
"8709",1008709,7,185,8,200
"8710",1008710,52,165,6,223
"8711",1008711,147,66,4,217
"8712",1008712,72,56,2,130
"8713",1008713,73,216,8,297
"8714",1008714,105,46,8,159
"8715",1008715,115,86,8,209
"8716",1008716,39,268,2,309
"8717",1008717,71,205,4,280
"8718",1008718,82,73,8,163
"8719",1008719,246,22,8,276
"8720",1008720,100,103,12,215
"8721",1008721,66,176,5,247
"8722",1008722,136,92,13,241
"8723",1008723,244,63,21,328
"8724",1008724,94,36,2,132
"8725",1008725,37,94,5,136
"8726",1008726,78,360,12,450
"8727",1008727,149,39,5,193
"8728",1008728,130,54,5,189
"8729",1008729,26,220,1,247
"8730",1008730,20,17,3,40
"8731",1008731,107,47,7,161
"8732",1008732,67,183,3,253
"8733",1008733,69,156,3,228
"8734",1008734,110,100,11,221
"8735",1008735,15,7,0,22
"8736",1008736,13,28,0,41
"8737",1008737,82,214,10,306
"8738",1008738,117,172,14,303
"8739",1008739,67,38,2,107
"8740",1008740,126,134,6,266
"8741",1008741,93,186,3,282
"8742",1008742,146,30,4,180
"8743",1008743,124,74,9,207
"8744",1008744,57,92,3,152
"8745",1008745,26,22,2,50
"8746",1008746,120,75,2,197
"8747",1008747,35,133,5,173
"8748",1008748,65,27,0,92
"8749",1008749,37,246,7,290
"8750",1008750,86,128,20,234
"8751",1008751,101,158,11,270
"8752",1008752,207,43,6,256
"8753",1008753,51,0,0,51
"8754",1008754,129,115,18,262
"8755",1008755,137,107,17,261
"8756",1008756,112,160,6,278
"8757",1008757,196,80,6,282
"8758",1008758,106,176,15,297
"8759",1008759,92,69,7,168
"8760",1008760,174,1,0,175
"8761",1008761,74,128,17,219
"8762",1008762,55,81,8,144
"8763",1008763,76,172,11,259
"8764",1008764,84,134,4,222
"8765",1008765,202,90,20,312
"8766",1008766,218,79,13,310
"8767",1008767,37,198,0,235
"8768",1008768,7,4,2,13
"8769",1008769,168,35,2,205
"8770",1008770,121,87,14,222
"8771",1008771,142,86,6,234
"8772",1008772,212,51,11,274
"8773",1008773,158,98,1,257
"8774",1008774,200,57,4,261
"8775",1008775,187,93,13,293
"8776",1008776,138,81,13,232
"8777",1008777,83,58,5,146
"8778",1008778,155,32,4,191
"8779",1008779,133,59,4,196
"8780",1008780,86,165,6,257
"8781",1008781,54,195,8,257
"8782",1008782,60,136,4,200
"8783",1008783,4,31,1,36
"8784",1008784,169,133,13,315
"8785",1008785,104,49,5,158
"8786",1008786,89,88,6,183
"8787",1008787,59,167,4,230
"8788",1008788,96,99,8,203
"8789",1008789,109,32,20,161
"8790",1008790,54,192,9,255
"8791",1008791,27,2,3,32
"8792",1008792,13,40,1,54
"8793",1008793,88,44,2,134
"8794",1008794,60,166,15,241
"8795",1008795,63,59,0,122
"8796",1008796,191,23,12,226
"8797",1008797,7,19,3,29
"8798",1008798,118,173,13,304
"8799",1008799,230,152,11,393
"8800",1008800,122,159,11,292
"8801",1008801,126,74,14,214
"8802",1008802,128,52,4,184
"8803",1008803,145,35,7,187
"8804",1008804,144,6,8,158
"8805",1008805,91,20,2,113
"8806",1008806,164,53,9,226
"8807",1008807,178,93,9,280
"8808",1008808,100,120,3,223
"8809",1008809,89,136,22,247
"8810",1008810,48,192,8,248
"8811",1008811,29,87,4,120
"8812",1008812,166,82,12,260
"8813",1008813,51,235,8,294
"8814",1008814,75,162,6,243
"8815",1008815,53,195,1,249
"8816",1008816,11,88,1,100
"8817",1008817,132,111,2,245
"8818",1008818,11,178,3,192
"8819",1008819,112,107,11,230
"8820",1008820,195,23,5,223
"8821",1008821,56,207,8,271
"8822",1008822,66,204,20,290
"8823",1008823,155,98,5,258
"8824",1008824,45,257,2,304
"8825",1008825,64,168,4,236
"8826",1008826,29,184,5,218
"8827",1008827,133,15,3,151
"8828",1008828,175,91,12,278
"8829",1008829,186,14,5,205
"8830",1008830,127,58,9,194
"8831",1008831,38,107,15,160
"8832",1008832,144,38,5,187
"8833",1008833,101,80,3,184
"8834",1008834,82,105,14,201
"8835",1008835,202,37,4,243
"8836",1008836,179,81,8,268
"8837",1008837,95,244,8,347
"8838",1008838,75,153,9,237
"8839",1008839,87,169,6,262
"8840",1008840,69,172,32,273
"8841",1008841,164,90,10,264
"8842",1008842,114,19,0,133
"8843",1008843,82,142,9,233
"8844",1008844,74,174,11,259
"8845",1008845,77,82,4,163
"8846",1008846,114,80,19,213
"8847",1008847,10,62,1,73
"8848",1008848,82,19,6,107
"8849",1008849,203,100,13,316
"8850",1008850,54,263,3,320
"8851",1008851,170,76,13,259
"8852",1008852,233,98,12,343
"8853",1008853,153,16,4,173
"8854",1008854,124,103,5,232
"8855",1008855,4,14,0,18
"8856",1008856,81,131,6,218
"8857",1008857,54,80,5,139
"8858",1008858,135,15,5,155
"8859",1008859,99,42,2,143
"8860",1008860,88,119,11,218
"8861",1008861,64,15,5,84
"8862",1008862,146,91,2,239
"8863",1008863,50,157,7,214
"8864",1008864,123,94,7,224
"8865",1008865,99,151,7,257
"8866",1008866,207,49,12,268
"8867",1008867,212,21,19,252
"8868",1008868,93,178,10,281
"8869",1008869,13,98,2,113
"8870",1008870,23,259,4,286
"8871",1008871,100,51,8,159
"8872",1008872,14,13,1,28
"8873",1008873,104,58,5,167
"8874",1008874,159,120,8,287
"8875",1008875,57,184,12,253
"8876",1008876,76,205,7,288
"8877",1008877,65,23,3,91
"8878",1008878,22,31,2,55
"8879",1008879,151,37,4,192
"8880",1008880,203,61,16,280
"8881",1008881,173,49,5,227
"8882",1008882,85,116,3,204
"8883",1008883,6,18,0,24
"8884",1008884,103,181,12,296
"8885",1008885,170,43,13,226
"8886",1008886,255,205,38,498
"8887",1008887,211,124,12,347
"8888",1008888,114,157,10,281
"8889",1008889,100,12,4,116
"8890",1008890,99,107,16,222
"8891",1008891,95,57,15,167
"8892",1008892,21,266,5,292
"8893",1008893,50,115,9,174
"8894",1008894,72,163,5,240
"8895",1008895,62,187,6,255
"8896",1008896,133,49,5,187
"8897",1008897,102,129,2,233
"8898",1008898,114,137,15,266
"8899",1008899,196,67,6,269
"8900",1008900,230,59,16,305
"8901",1008901,90,152,20,262
"8902",1008902,33,231,2,266
"8903",1008903,42,128,0,170
"8904",1008904,97,32,6,135
"8905",1008905,64,109,3,176
"8906",1008906,170,33,4,207
"8907",1008907,113,32,4,149
"8908",1008908,161,67,8,236
"8909",1008909,160,240,27,427
"8910",1008910,9,4,0,13
"8911",1008911,99,188,12,299
"8912",1008912,71,188,26,285
"8913",1008913,52,178,6,236
"8914",1008914,111,189,13,313
"8915",1008915,110,171,3,284
"8916",1008916,46,246,3,295
"8917",1008917,26,29,6,61
"8918",1008918,117,71,2,190
"8919",1008919,18,74,2,94
"8920",1008920,195,104,17,316
"8921",1008921,57,121,8,186
"8922",1008922,59,106,9,174
"8923",1008923,25,47,0,72
"8924",1008924,120,147,7,274
"8925",1008925,161,112,18,291
"8926",1008926,153,64,4,221
"8927",1008927,123,105,7,235
"8928",1008928,72,33,10,115
"8929",1008929,18,14,2,34
"8930",1008930,85,36,4,125
"8931",1008931,108,151,23,282
"8932",1008932,196,45,8,249
"8933",1008933,134,19,6,159
"8934",1008934,6,131,2,139
"8935",1008935,26,28,3,57
"8936",1008936,54,141,2,197
"8937",1008937,57,237,3,297
"8938",1008938,129,88,7,224
"8939",1008939,56,139,8,203
"8940",1008940,151,109,13,273
"8941",1008941,65,12,1,78
"8942",1008942,31,155,1,187
"8943",1008943,43,236,12,291
"8944",1008944,144,48,13,205
"8945",1008945,156,16,0,172
"8946",1008946,102,160,8,270
"8947",1008947,127,188,13,328
"8948",1008948,79,197,3,279
"8949",1008949,79,150,6,235
"8950",1008950,152,88,9,249
"8951",1008951,136,91,10,237
"8952",1008952,81,59,1,141
"8953",1008953,133,150,14,297
"8954",1008954,1,11,1,13
"8955",1008955,176,51,12,239
"8956",1008956,37,6,3,46
"8957",1008957,53,148,8,209
"8958",1008958,142,84,6,232
"8959",1008959,178,167,12,357
"8960",1008960,106,53,2,161
"8961",1008961,129,105,11,245
"8962",1008962,79,111,12,202
"8963",1008963,171,105,5,281
"8964",1008964,63,87,3,153
"8965",1008965,83,34,1,118
"8966",1008966,119,30,2,151
"8967",1008967,96,156,17,269
"8968",1008968,238,19,10,267
"8969",1008969,57,264,1,322
"8970",1008970,136,103,10,249
"8971",1008971,61,255,5,321
"8972",1008972,44,292,6,342
"8973",1008973,25,133,13,171
"8974",1008974,156,23,0,179
"8975",1008975,98,115,6,219
"8976",1008976,109,127,12,248
"8977",1008977,38,1,3,42
"8978",1008978,136,90,5,231
"8979",1008979,139,130,19,288
"8980",1008980,79,141,8,228
"8981",1008981,139,24,7,170
"8982",1008982,139,175,15,329
"8983",1008983,96,83,6,185
"8984",1008984,112,28,8,148
"8985",1008985,178,104,17,299
"8986",1008986,71,223,7,301
"8987",1008987,72,206,17,295
"8988",1008988,161,37,9,207
"8989",1008989,36,54,0,90
"8990",1008990,87,165,9,261
"8991",1008991,90,148,4,242
"8992",1008992,222,90,18,330
"8993",1008993,139,182,7,328
"8994",1008994,116,94,12,222
"8995",1008995,150,181,17,348
"8996",1008996,182,50,9,241
"8997",1008997,48,283,2,333
"8998",1008998,189,105,13,307
"8999",1008999,97,156,6,259
"9000",1009000,174,95,4,273
"9001",1009001,67,171,11,249
"9002",1009002,41,261,8,310
"9003",1009003,11,75,3,89
"9004",1009004,103,122,10,235
"9005",1009005,196,55,9,260
"9006",1009006,77,176,13,266
"9007",1009007,51,212,19,282
"9008",1009008,5,10,3,18
"9009",1009009,80,212,7,299
"9010",1009010,181,81,13,275
"9011",1009011,152,72,7,231
"9012",1009012,151,44,8,203
"9013",1009013,126,171,16,313
"9014",1009014,187,109,16,312
"9015",1009015,5,3,0,8
"9016",1009016,87,145,9,241
"9017",1009017,180,15,11,206
"9018",1009018,179,85,4,268
"9019",1009019,157,54,6,217
"9020",1009020,145,27,28,200
"9021",1009021,32,23,1,56
"9022",1009022,68,181,15,264
"9023",1009023,81,62,10,153
"9024",1009024,88,138,4,230
"9025",1009025,154,155,7,316
"9026",1009026,46,26,8,80
"9027",1009027,62,177,14,253
"9028",1009028,111,56,6,173
"9029",1009029,210,26,3,239
"9030",1009030,137,23,8,168
"9031",1009031,152,23,8,183
"9032",1009032,118,87,3,208
"9033",1009033,100,132,17,249
"9034",1009034,91,196,6,293
"9035",1009035,58,40,3,101
"9036",1009036,138,79,5,222
"9037",1009037,84,150,5,239
"9038",1009038,28,237,4,269
"9039",1009039,144,93,12,249
"9040",1009040,191,24,13,228
"9041",1009041,58,145,2,205
"9042",1009042,176,76,11,263
"9043",1009043,147,55,12,214
"9044",1009044,19,162,4,185
"9045",1009045,35,6,2,43
"9046",1009046,186,115,16,317
"9047",1009047,103,81,1,185
"9048",1009048,239,50,9,298
"9049",1009049,167,73,12,252
"9050",1009050,33,223,5,261
"9051",1009051,108,84,8,200
"9052",1009052,64,115,5,184
"9053",1009053,49,253,8,310
"9054",1009054,161,30,1,192
"9055",1009055,297,21,9,327
"9056",1009056,160,55,10,225
"9057",1009057,147,119,10,276
"9058",1009058,33,278,8,319
"9059",1009059,112,83,4,199
"9060",1009060,142,41,2,185
"9061",1009061,81,129,9,219
"9062",1009062,106,180,18,304
"9063",1009063,150,105,5,260
"9064",1009064,28,159,5,192
"9065",1009065,195,72,10,277
"9066",1009066,134,49,5,188
"9067",1009067,231,20,5,256
"9068",1009068,145,72,7,224
"9069",1009069,176,69,4,249
"9070",1009070,7,127,0,134
"9071",1009071,62,48,7,117
"9072",1009072,135,148,21,304
"9073",1009073,158,43,3,204
"9074",1009074,132,94,7,233
"9075",1009075,105,163,8,276
"9076",1009076,151,110,9,270
"9077",1009077,160,74,10,244
"9078",1009078,136,23,2,161
"9079",1009079,179,27,2,208
"9080",1009080,43,204,5,252
"9081",1009081,95,147,16,258
"9082",1009082,112,127,11,250
"9083",1009083,126,111,15,252
"9084",1009084,10,41,2,53
"9085",1009085,220,49,6,275
"9086",1009086,101,34,4,139
"9087",1009087,72,6,2,80
"9088",1009088,166,104,19,289
"9089",1009089,159,53,9,221
"9090",1009090,86,140,9,235
"9091",1009091,71,52,2,125
"9092",1009092,104,12,1,117
"9093",1009093,182,29,8,219
"9094",1009094,132,180,14,326
"9095",1009095,124,70,18,212
"9096",1009096,208,39,12,259
"9097",1009097,53,250,6,309
"9098",1009098,162,105,6,273
"9099",1009099,78,209,14,301
"9100",1009100,157,61,4,222
"9101",1009101,11,2,3,16
"9102",1009102,23,46,3,72
"9103",1009103,199,100,17,316
"9104",1009104,171,86,14,271
"9105",1009105,172,87,4,263
"9106",1009106,110,148,36,294
"9107",1009107,41,159,11,211
"9108",1009108,111,28,14,153
"9109",1009109,194,83,9,286
"9110",1009110,46,38,1,85
"9111",1009111,70,157,7,234
"9112",1009112,130,113,5,248
"9113",1009113,90,94,11,195
"9114",1009114,51,201,14,266
"9115",1009115,141,37,10,188
"9116",1009116,241,17,5,263
"9117",1009117,101,30,4,135
"9118",1009118,158,78,13,249
"9119",1009119,165,11,7,183
"9120",1009120,78,161,1,240
"9121",1009121,178,76,7,261
"9122",1009122,39,18,2,59
"9123",1009123,32,75,3,110
"9124",1009124,171,132,24,327
"9125",1009125,199,21,6,226
"9126",1009126,109,34,2,145
"9127",1009127,123,142,11,276
"9128",1009128,52,142,24,218
"9129",1009129,111,81,2,194
"9130",1009130,65,166,15,246
"9131",1009131,126,110,12,248
"9132",1009132,133,11,5,149
"9133",1009133,200,90,8,298
"9134",1009134,56,129,9,194
"9135",1009135,166,18,6,190
"9136",1009136,82,137,8,227
"9137",1009137,92,129,12,233
"9138",1009138,41,51,5,97
"9139",1009139,132,35,1,168
"9140",1009140,62,205,6,273
"9141",1009141,208,67,3,278
"9142",1009142,14,153,1,168
"9143",1009143,195,73,6,274
"9144",1009144,57,142,0,199
"9145",1009145,88,69,3,160
"9146",1009146,187,45,6,238
"9147",1009147,27,158,5,190
"9148",1009148,126,96,15,237
"9149",1009149,213,57,10,280
"9150",1009150,97,120,6,223
"9151",1009151,157,85,7,249
"9152",1009152,56,249,10,315
"9153",1009153,125,347,13,485
"9154",1009154,73,8,2,83
"9155",1009155,142,38,12,192
"9156",1009156,194,45,7,246
"9157",1009157,115,178,5,298
"9158",1009158,137,130,9,276
"9159",1009159,228,42,4,274
"9160",1009160,26,153,10,189
"9161",1009161,205,68,10,283
"9162",1009162,125,99,7,231
"9163",1009163,26,219,1,246
"9164",1009164,197,29,8,234
"9165",1009165,122,51,9,182
"9166",1009166,35,167,3,205
"9167",1009167,190,83,16,289
"9168",1009168,112,41,6,159
"9169",1009169,128,104,10,242
"9170",1009170,149,73,17,239
"9171",1009171,50,230,1,281
"9172",1009172,200,27,9,236
"9173",1009173,183,40,9,232
"9174",1009174,177,44,14,235
"9175",1009175,92,139,7,238
"9176",1009176,145,168,6,319
"9177",1009177,53,257,3,313
"9178",1009178,167,65,30,262
"9179",1009179,133,15,5,153
"9180",1009180,133,64,2,199
"9181",1009181,169,66,6,241
"9182",1009182,89,79,14,182
"9183",1009183,184,19,5,208
"9184",1009184,90,184,13,287
"9185",1009185,151,85,8,244
"9186",1009186,127,117,8,252
"9187",1009187,150,39,9,198
"9188",1009188,113,61,2,176
"9189",1009189,23,219,17,259
"9190",1009190,51,177,5,233
"9191",1009191,97,91,12,200
"9192",1009192,197,78,16,291
"9193",1009193,128,77,2,207
"9194",1009194,47,225,17,289
"9195",1009195,52,2,1,55
"9196",1009196,13,26,1,40
"9197",1009197,125,170,4,299
"9198",1009198,73,138,3,214
"9199",1009199,105,207,17,329
"9200",1009200,39,47,5,91
"9201",1009201,75,146,3,224
"9202",1009202,145,75,11,231
"9203",1009203,49,10,0,59
"9204",1009204,132,98,12,242
"9205",1009205,129,17,2,148
"9206",1009206,52,233,6,291
"9207",1009207,65,23,6,94
"9208",1009208,87,30,4,121
"9209",1009209,47,275,5,327
"9210",1009210,65,248,8,321
"9211",1009211,100,36,4,140
"9212",1009212,92,147,10,249
"9213",1009213,104,113,16,233
"9214",1009214,122,40,5,167
"9215",1009215,38,26,0,64
"9216",1009216,178,17,6,201
"9217",1009217,102,38,7,147
"9218",1009218,213,56,3,272
"9219",1009219,87,222,11,320
"9220",1009220,105,99,8,212
"9221",1009221,87,188,29,304
"9222",1009222,30,48,5,83
"9223",1009223,153,8,5,166
"9224",1009224,167,42,8,217
"9225",1009225,23,50,0,73
"9226",1009226,47,170,13,230
"9227",1009227,16,2,1,19
"9228",1009228,35,19,1,55
"9229",1009229,19,228,5,252
"9230",1009230,21,15,1,37
"9231",1009231,130,33,5,168
"9232",1009232,61,200,3,264
"9233",1009233,89,48,4,141
"9234",1009234,47,236,7,290
"9235",1009235,227,18,10,255
"9236",1009236,68,172,18,258
"9237",1009237,80,182,14,276
"9238",1009238,127,110,2,239
"9239",1009239,162,89,4,255
"9240",1009240,34,239,5,278
"9241",1009241,223,36,9,268
"9242",1009242,223,40,7,270
"9243",1009243,83,188,2,273
"9244",1009244,192,80,27,299
"9245",1009245,32,232,12,276
"9246",1009246,121,65,4,190
"9247",1009247,159,76,14,249
"9248",1009248,82,109,8,199
"9249",1009249,21,9,1,31
"9250",1009250,125,120,5,250
"9251",1009251,79,131,3,213
"9252",1009252,194,40,8,242
"9253",1009253,161,75,8,244
"9254",1009254,121,57,6,184
"9255",1009255,105,122,2,229
"9256",1009256,79,186,23,288
"9257",1009257,52,177,3,232
"9258",1009258,3,57,0,60
"9259",1009259,189,79,7,275
"9260",1009260,151,116,25,292
"9261",1009261,167,34,4,205
"9262",1009262,135,65,7,207
"9263",1009263,33,218,13,264
"9264",1009264,187,30,12,229
"9265",1009265,44,181,10,235
"9266",1009266,81,54,3,138
"9267",1009267,121,130,16,267
"9268",1009268,147,104,17,268
"9269",1009269,202,71,3,276
"9270",1009270,184,73,13,270
"9271",1009271,137,80,17,234
"9272",1009272,41,213,5,259
"9273",1009273,150,51,11,212
"9274",1009274,62,180,23,265
"9275",1009275,205,68,1,274
"9276",1009276,114,90,5,209
"9277",1009277,44,162,7,213
"9278",1009278,124,179,15,318
"9279",1009279,138,169,9,316
"9280",1009280,114,28,5,147
"9281",1009281,31,60,6,97
"9282",1009282,63,116,10,189
"9283",1009283,37,4,0,41
"9284",1009284,51,187,5,243
"9285",1009285,88,196,11,295
"9286",1009286,70,232,10,312
"9287",1009287,43,49,11,103
"9288",1009288,199,29,12,240
"9289",1009289,83,189,6,278
"9290",1009290,186,71,12,269
"9291",1009291,241,15,5,261
"9292",1009292,28,132,2,162
"9293",1009293,126,84,18,228
"9294",1009294,245,20,9,274
"9295",1009295,123,106,3,232
"9296",1009296,188,86,4,278
"9297",1009297,201,69,13,283
"9298",1009298,49,103,7,159
"9299",1009299,51,87,10,148
"9300",1009300,279,93,32,404
"9301",1009301,190,37,10,237
"9302",1009302,17,29,0,46
"9303",1009303,164,106,10,280
"9304",1009304,36,160,6,202
"9305",1009305,134,67,21,222
"9306",1009306,140,41,12,193
"9307",1009307,46,182,4,232
"9308",1009308,68,169,5,242
"9309",1009309,174,88,11,273
"9310",1009310,171,57,16,244
"9311",1009311,87,171,6,264
"9312",1009312,113,128,14,255
"9313",1009313,181,97,7,285
"9314",1009314,132,78,9,219
"9315",1009315,126,61,6,193
"9316",1009316,163,50,3,216
"9317",1009317,125,30,0,155
"9318",1009318,145,103,16,264
"9319",1009319,81,192,6,279
"9320",1009320,158,99,5,262
"9321",1009321,118,162,11,291
"9322",1009322,106,123,10,239
"9323",1009323,70,115,14,199
"9324",1009324,167,133,25,325
"9325",1009325,137,99,13,249
"9326",1009326,66,57,15,138
"9327",1009327,57,158,1,216
"9328",1009328,56,106,6,168
"9329",1009329,8,71,0,79
"9330",1009330,21,226,1,248
"9331",1009331,17,5,1,23
"9332",1009332,254,1,0,255
"9333",1009333,187,10,3,200
"9334",1009334,100,189,9,298
"9335",1009335,46,181,6,233
"9336",1009336,59,201,4,264
"9337",1009337,286,6,4,296
"9338",1009338,71,110,6,187
"9339",1009339,51,123,15,189
"9340",1009340,24,77,2,103
"9341",1009341,11,4,0,15
"9342",1009342,137,84,13,234
"9343",1009343,91,215,6,312
"9344",1009344,111,160,9,280
"9345",1009345,174,50,23,247
"9346",1009346,139,62,10,211
"9347",1009347,65,120,13,198
"9348",1009348,94,62,2,158
"9349",1009349,79,138,3,220
"9350",1009350,105,94,4,203
"9351",1009351,70,197,8,275
"9352",1009352,125,29,4,158
"9353",1009353,208,59,10,277
"9354",1009354,145,65,12,222
"9355",1009355,130,108,15,253
"9356",1009356,90,163,12,265
"9357",1009357,160,108,11,279
"9358",1009358,69,97,0,166
"9359",1009359,87,180,11,278
"9360",1009360,80,168,8,256
"9361",1009361,122,169,17,308
"9362",1009362,83,182,15,280
"9363",1009363,135,18,2,155
"9364",1009364,106,117,8,231
"9365",1009365,62,186,3,251
"9366",1009366,265,15,3,283
"9367",1009367,14,0,0,14
"9368",1009368,88,74,4,166
"9369",1009369,249,33,2,284
"9370",1009370,290,17,17,324
"9371",1009371,116,41,3,160
"9372",1009372,99,5,1,105
"9373",1009373,63,129,5,197
"9374",1009374,24,164,8,196
"9375",1009375,152,63,13,228
"9376",1009376,35,1,0,36
"9377",1009377,56,37,4,97
"9378",1009378,32,262,3,297
"9379",1009379,164,119,6,289
"9380",1009380,71,1,1,73
"9381",1009381,234,19,5,258
"9382",1009382,87,21,6,114
"9383",1009383,135,22,2,159
"9384",1009384,51,275,3,329
"9385",1009385,20,313,7,340
"9386",1009386,75,160,24,259
"9387",1009387,48,95,10,153
"9388",1009388,103,21,2,126
"9389",1009389,106,46,5,157
"9390",1009390,75,82,12,169
"9391",1009391,140,100,7,247
"9392",1009392,34,290,10,334
"9393",1009393,85,70,13,168
"9394",1009394,16,283,3,302
"9395",1009395,211,30,6,247
"9396",1009396,36,228,7,271
"9397",1009397,228,93,15,336
"9398",1009398,80,182,11,273
"9399",1009399,98,36,5,139
"9400",1009400,99,173,6,278
"9401",1009401,199,14,2,215
"9402",1009402,86,144,4,234
"9403",1009403,118,81,2,201
"9404",1009404,130,39,13,182
"9405",1009405,119,223,10,352
"9406",1009406,131,117,11,259
"9407",1009407,128,122,9,259
"9408",1009408,68,114,14,196
"9409",1009409,43,120,3,166
"9410",1009410,33,115,6,154
"9411",1009411,59,203,4,266
"9412",1009412,59,261,4,324
"9413",1009413,133,172,6,311
"9414",1009414,36,156,9,201
"9415",1009415,160,37,4,201
"9416",1009416,131,32,5,168
"9417",1009417,129,133,13,275
"9418",1009418,96,64,5,165
"9419",1009419,145,95,7,247
"9420",1009420,101,181,4,286
"9421",1009421,214,56,10,280
"9422",1009422,227,33,13,273
"9423",1009423,106,67,6,179
"9424",1009424,168,80,7,255
"9425",1009425,65,169,11,245
"9426",1009426,47,137,2,186
"9427",1009427,219,103,16,338
"9428",1009428,103,180,10,293
"9429",1009429,36,177,1,214
"9430",1009430,184,57,8,249
"9431",1009431,129,76,3,208
"9432",1009432,51,246,10,307
"9433",1009433,71,162,10,243
"9434",1009434,150,87,14,251
"9435",1009435,82,151,6,239
"9436",1009436,154,96,9,259
"9437",1009437,35,225,1,261
"9438",1009438,73,115,14,202
"9439",1009439,22,110,8,140
"9440",1009440,101,84,11,196
"9441",1009441,144,175,9,328
"9442",1009442,149,58,2,209
"9443",1009443,215,31,9,255
"9444",1009444,180,27,1,208
"9445",1009445,156,109,8,273
"9446",1009446,146,55,8,209
"9447",1009447,154,59,17,230
"9448",1009448,89,175,5,269
"9449",1009449,37,177,6,220
"9450",1009450,126,21,1,148
"9451",1009451,67,183,9,259
"9452",1009452,24,233,6,263
"9453",1009453,167,56,10,233
"9454",1009454,97,89,10,196
"9455",1009455,82,19,5,106
"9456",1009456,84,164,6,254
"9457",1009457,145,44,4,193
"9458",1009458,85,178,29,292
"9459",1009459,181,19,7,207
"9460",1009460,123,162,12,297
"9461",1009461,45,106,1,152
"9462",1009462,28,211,1,240
"9463",1009463,175,111,17,303
"9464",1009464,81,97,8,186
"9465",1009465,81,141,10,232
"9466",1009466,81,207,12,300
"9467",1009467,118,114,12,244
"9468",1009468,182,74,18,274
"9469",1009469,81,89,0,170
"9470",1009470,158,174,35,367
"9471",1009471,70,47,3,120
"9472",1009472,30,6,0,36
"9473",1009473,41,152,23,216
"9474",1009474,50,206,7,263
"9475",1009475,223,18,7,248
"9476",1009476,218,33,14,265
"9477",1009477,30,154,5,189
"9478",1009478,195,26,6,227
"9479",1009479,133,139,11,283
"9480",1009480,48,89,9,146
"9481",1009481,207,101,11,319
"9482",1009482,127,123,17,267
"9483",1009483,11,274,0,285
"9484",1009484,30,23,0,53
"9485",1009485,46,178,9,233
"9486",1009486,113,89,11,213
"9487",1009487,36,253,3,292
"9488",1009488,149,28,3,180
"9489",1009489,129,41,17,187
"9490",1009490,109,37,16,162
"9491",1009491,150,31,9,190
"9492",1009492,160,57,13,230
"9493",1009493,15,60,0,75
"9494",1009494,159,55,14,228
"9495",1009495,105,150,8,263
"9496",1009496,64,38,5,107
"9497",1009497,38,13,0,51
"9498",1009498,66,191,6,263
"9499",1009499,52,219,9,280
"9500",1009500,187,87,7,281
"9501",1009501,152,64,10,226
"9502",1009502,60,207,15,282
"9503",1009503,67,195,0,262
"9504",1009504,6,8,0,14
"9505",1009505,100,142,11,253
"9506",1009506,137,103,11,251
"9507",1009507,92,192,15,299
"9508",1009508,92,64,12,168
"9509",1009509,11,212,1,224
"9510",1009510,66,190,12,268
"9511",1009511,138,98,11,247
"9512",1009512,213,23,8,244
"9513",1009513,163,58,10,231
"9514",1009514,36,314,1,351
"9515",1009515,207,44,9,260
"9516",1009516,79,37,2,118
"9517",1009517,205,78,23,306
"9518",1009518,56,248,3,307
"9519",1009519,200,102,17,319
"9520",1009520,193,64,19,276
"9521",1009521,211,31,13,255
"9522",1009522,112,337,4,453
"9523",1009523,100,51,2,153
"9524",1009524,35,261,1,297
"9525",1009525,143,75,6,224
"9526",1009526,96,154,26,276
"9527",1009527,79,153,7,239
"9528",1009528,119,35,4,158
"9529",1009529,71,159,14,244
"9530",1009530,159,46,4,209
"9531",1009531,170,77,10,257
"9532",1009532,100,139,5,244
"9533",1009533,77,172,13,262
"9534",1009534,88,129,2,219
"9535",1009535,135,68,7,210
"9536",1009536,213,103,15,331
"9537",1009537,157,65,11,233
"9538",1009538,147,102,13,262
"9539",1009539,140,100,2,242
"9540",1009540,192,132,9,333
"9541",1009541,55,178,9,242
"9542",1009542,119,69,4,192
"9543",1009543,262,52,20,334
"9544",1009544,61,210,17,288
"9545",1009545,58,243,3,304
"9546",1009546,11,1,0,12
"9547",1009547,88,74,5,167
"9548",1009548,156,31,2,189
"9549",1009549,123,55,11,189
"9550",1009550,69,145,2,216
"9551",1009551,66,29,4,99
"9552",1009552,52,224,4,280
"9553",1009553,32,265,9,306
"9554",1009554,179,62,13,254
"9555",1009555,44,162,7,213
"9556",1009556,122,70,4,196
"9557",1009557,52,233,5,290
"9558",1009558,127,28,5,160
"9559",1009559,141,97,21,259
"9560",1009560,125,98,5,228
"9561",1009561,104,177,14,295
"9562",1009562,30,188,2,220
"9563",1009563,23,54,2,79
"9564",1009564,83,209,4,296
"9565",1009565,155,122,13,290
"9566",1009566,12,246,2,260
"9567",1009567,56,146,4,206
"9568",1009568,158,57,4,219
"9569",1009569,99,44,10,153
"9570",1009570,18,22,1,41
"9571",1009571,148,31,9,188
"9572",1009572,140,32,16,188
"9573",1009573,113,35,4,152
"9574",1009574,173,61,8,242
"9575",1009575,103,29,1,133
"9576",1009576,132,87,24,243
"9577",1009577,39,190,16,245
"9578",1009578,81,151,4,236
"9579",1009579,198,96,12,306
"9580",1009580,199,60,12,271
"9581",1009581,68,144,10,222
"9582",1009582,30,263,4,297
"9583",1009583,73,207,18,298
"9584",1009584,62,185,4,251
"9585",1009585,192,31,7,230
"9586",1009586,182,31,5,218
"9587",1009587,90,116,10,216
"9588",1009588,142,94,24,260
"9589",1009589,51,173,10,234
"9590",1009590,181,75,7,263
"9591",1009591,31,261,3,295
"9592",1009592,167,41,5,213
"9593",1009593,147,34,7,188
"9594",1009594,98,185,14,297
"9595",1009595,74,171,8,253
"9596",1009596,47,96,4,147
"9597",1009597,9,7,0,16
"9598",1009598,93,163,5,261
"9599",1009599,56,186,7,249
"9600",1009600,242,14,0,256
"9601",1009601,207,69,14,290
"9602",1009602,194,50,7,251
"9603",1009603,247,29,6,282
"9604",1009604,219,50,15,284
"9605",1009605,65,215,8,288
"9606",1009606,131,48,18,197
"9607",1009607,160,83,7,250
"9608",1009608,229,58,14,301
"9609",1009609,96,188,28,312
"9610",1009610,66,71,2,139
"9611",1009611,137,94,13,244
"9612",1009612,133,103,11,247
"9613",1009613,22,110,6,138
"9614",1009614,27,269,4,300
"9615",1009615,121,80,5,206
"9616",1009616,211,75,12,298
"9617",1009617,97,182,16,295
"9618",1009618,101,40,0,141
"9619",1009619,46,68,4,118
"9620",1009620,151,116,27,294
"9621",1009621,162,65,17,244
"9622",1009622,134,95,19,248
"9623",1009623,24,6,1,31
"9624",1009624,90,74,4,168
"9625",1009625,29,177,2,208
"9626",1009626,163,29,10,202
"9627",1009627,184,29,4,217
"9628",1009628,133,57,5,195
"9629",1009629,149,75,9,233
"9630",1009630,140,41,7,188
"9631",1009631,51,27,6,84
"9632",1009632,228,21,6,255
"9633",1009633,144,102,2,248
"9634",1009634,89,167,7,263
"9635",1009635,68,45,4,117
"9636",1009636,193,60,9,262
"9637",1009637,123,55,13,191
"9638",1009638,150,79,12,241
"9639",1009639,189,81,14,284
"9640",1009640,61,188,16,265
"9641",1009641,66,226,9,301
"9642",1009642,194,18,2,214
"9643",1009643,164,111,20,295
"9644",1009644,182,130,22,334
"9645",1009645,123,176,5,304
"9646",1009646,33,162,8,203
"9647",1009647,100,96,8,204
"9648",1009648,222,25,8,255
"9649",1009649,235,2,1,238
"9650",1009650,177,83,6,266
"9651",1009651,31,212,3,246
"9652",1009652,39,39,3,81
"9653",1009653,129,35,4,168
"9654",1009654,215,60,4,279
"9655",1009655,318,90,20,428
"9656",1009656,101,99,13,213
"9657",1009657,57,19,4,80
"9658",1009658,56,191,4,251
"9659",1009659,68,40,1,109
"9660",1009660,172,91,7,270
"9661",1009661,185,77,12,274
"9662",1009662,82,225,10,317
"9663",1009663,110,210,13,333
"9664",1009664,88,28,1,117
"9665",1009665,58,60,5,123
"9666",1009666,119,81,17,217
"9667",1009667,58,53,3,114
"9668",1009668,232,13,3,248
"9669",1009669,49,77,5,131
"9670",1009670,166,124,15,305
"9671",1009671,4,3,0,7
"9672",1009672,171,17,3,191
"9673",1009673,130,27,6,163
"9674",1009674,137,57,12,206
"9675",1009675,75,141,6,222
"9676",1009676,128,18,1,147
"9677",1009677,23,231,5,259
"9678",1009678,43,87,0,130
"9679",1009679,118,119,17,254
"9680",1009680,111,54,10,175
"9681",1009681,19,176,0,195
"9682",1009682,129,26,5,160
"9683",1009683,21,70,6,97
"9684",1009684,184,47,13,244
"9685",1009685,196,18,18,232
"9686",1009686,104,22,3,129
"9687",1009687,125,107,5,237
"9688",1009688,33,247,3,283
"9689",1009689,4,9,1,14
"9690",1009690,63,234,13,310
"9691",1009691,172,135,6,313
"9692",1009692,11,164,5,180
"9693",1009693,205,31,4,240
"9694",1009694,100,82,5,187
"9695",1009695,76,57,9,142
"9696",1009696,104,163,8,275
"9697",1009697,147,62,11,220
"9698",1009698,144,38,4,186
"9699",1009699,21,277,2,300
"9700",1009700,124,33,7,164
"9701",1009701,55,107,5,167
"9702",1009702,130,141,7,278
"9703",1009703,105,159,20,284
"9704",1009704,197,30,7,234
"9705",1009705,95,119,9,223
"9706",1009706,252,39,3,294
"9707",1009707,29,33,2,64
"9708",1009708,0,6,0,6
"9709",1009709,130,54,3,187
"9710",1009710,90,98,14,202
"9711",1009711,55,143,16,214
"9712",1009712,142,142,9,293
"9713",1009713,170,14,4,188
"9714",1009714,101,147,6,254
"9715",1009715,33,204,9,246
"9716",1009716,239,20,6,265
"9717",1009717,48,172,8,228
"9718",1009718,161,58,6,225
"9719",1009719,46,4,4,54
"9720",1009720,155,91,5,251
"9721",1009721,143,159,14,316
"9722",1009722,26,46,3,75
"9723",1009723,25,152,3,180
"9724",1009724,226,40,8,274
"9725",1009725,155,117,3,275
"9726",1009726,184,93,7,284
"9727",1009727,16,21,1,38
"9728",1009728,13,222,0,235
"9729",1009729,19,149,2,170
"9730",1009730,107,202,9,318
"9731",1009731,187,20,4,211
"9732",1009732,128,25,7,160
"9733",1009733,214,31,8,253
"9734",1009734,71,241,9,321
"9735",1009735,3,9,0,12
"9736",1009736,132,26,2,160
"9737",1009737,129,176,13,318
"9738",1009738,174,98,7,279
"9739",1009739,131,182,17,330
"9740",1009740,118,116,1,235
"9741",1009741,10,76,6,92
"9742",1009742,17,45,2,64
"9743",1009743,199,80,9,288
"9744",1009744,131,57,13,201
"9745",1009745,138,20,6,164
"9746",1009746,122,72,2,196
"9747",1009747,139,123,22,284
"9748",1009748,78,120,7,205
"9749",1009749,188,27,3,218
"9750",1009750,12,29,1,42
"9751",1009751,109,33,4,146
"9752",1009752,162,89,15,266
"9753",1009753,34,137,2,173
"9754",1009754,71,83,18,172
"9755",1009755,20,12,1,33
"9756",1009756,132,9,4,145
"9757",1009757,17,191,8,216
"9758",1009758,4,59,3,66
"9759",1009759,167,47,8,222
"9760",1009760,101,44,15,160
"9761",1009761,12,6,1,19
"9762",1009762,76,179,8,263
"9763",1009763,134,65,14,213
"9764",1009764,38,250,9,297
"9765",1009765,160,105,12,277
"9766",1009766,69,112,4,185
"9767",1009767,155,13,2,170
"9768",1009768,55,133,25,213
"9769",1009769,192,71,5,268
"9770",1009770,70,174,9,253
"9771",1009771,194,59,9,262
"9772",1009772,140,45,8,193
"9773",1009773,131,97,11,239
"9774",1009774,122,36,4,162
"9775",1009775,92,65,10,167
"9776",1009776,66,178,3,247
"9777",1009777,179,15,9,203
"9778",1009778,148,27,3,178
"9779",1009779,248,13,3,264
"9780",1009780,184,54,4,242
"9781",1009781,171,81,4,256
"9782",1009782,148,138,5,291
"9783",1009783,37,241,12,290
"9784",1009784,105,112,4,221
"9785",1009785,184,42,3,229
"9786",1009786,54,116,13,183
"9787",1009787,7,16,1,24
"9788",1009788,63,173,10,246
"9789",1009789,35,247,6,288
"9790",1009790,103,63,9,175
"9791",1009791,272,20,3,295
"9792",1009792,202,40,11,253
"9793",1009793,153,136,8,297
"9794",1009794,184,29,4,217
"9795",1009795,205,80,7,292
"9796",1009796,193,62,5,260
"9797",1009797,148,57,7,212
"9798",1009798,147,104,20,271
"9799",1009799,152,9,4,165
"9800",1009800,55,54,3,112
"9801",1009801,65,95,7,167
"9802",1009802,34,41,6,81
"9803",1009803,58,235,5,298
"9804",1009804,18,233,5,256
"9805",1009805,25,61,7,93
"9806",1009806,155,107,5,267
"9807",1009807,5,6,0,11
"9808",1009808,155,132,16,303
"9809",1009809,129,158,23,310
"9810",1009810,146,172,13,331
"9811",1009811,56,274,10,340
"9812",1009812,182,81,8,271
"9813",1009813,161,124,1,286
"9814",1009814,65,201,9,275
"9815",1009815,88,59,9,156
"9816",1009816,52,90,6,148
"9817",1009817,112,139,7,258
"9818",1009818,89,61,7,157
"9819",1009819,124,205,16,345
"9820",1009820,30,223,8,261
"9821",1009821,142,123,24,289
"9822",1009822,14,153,2,169
"9823",1009823,4,0,0,4
"9824",1009824,18,258,1,277
"9825",1009825,171,60,8,239
"9826",1009826,122,70,15,207
"9827",1009827,86,138,26,250
"9828",1009828,216,75,18,309
"9829",1009829,52,110,0,162
"9830",1009830,182,84,8,274
"9831",1009831,175,17,7,199
"9832",1009832,174,4,3,181
"9833",1009833,175,45,3,223
"9834",1009834,69,161,14,244
"9835",1009835,41,64,7,112
"9836",1009836,89,42,13,144
"9837",1009837,95,145,5,245
"9838",1009838,177,51,11,239
"9839",1009839,105,111,3,219
"9840",1009840,59,20,9,88
"9841",1009841,100,72,3,175
"9842",1009842,41,164,6,211
"9843",1009843,91,173,4,268
"9844",1009844,40,154,3,197
"9845",1009845,20,37,1,58
"9846",1009846,73,195,3,271
"9847",1009847,91,197,22,310
"9848",1009848,127,146,6,279
"9849",1009849,157,53,6,216
"9850",1009850,37,37,3,77
"9851",1009851,191,104,24,319
"9852",1009852,150,37,13,200
"9853",1009853,124,154,7,285
"9854",1009854,226,26,3,255
"9855",1009855,95,78,4,177
"9856",1009856,87,37,4,128
"9857",1009857,156,81,7,244
"9858",1009858,66,186,12,264
"9859",1009859,49,239,3,291
"9860",1009860,109,124,11,244
"9861",1009861,104,178,6,288
"9862",1009862,165,169,12,346
"9863",1009863,109,45,9,163
"9864",1009864,76,33,6,115
"9865",1009865,68,184,7,259
"9866",1009866,95,51,5,151
"9867",1009867,139,22,8,169
"9868",1009868,29,182,5,216
"9869",1009869,52,165,2,219
"9870",1009870,158,104,18,280
"9871",1009871,120,84,14,218
"9872",1009872,89,82,3,174
"9873",1009873,179,103,16,298
"9874",1009874,174,41,6,221
"9875",1009875,45,158,6,209
"9876",1009876,239,41,10,290
"9877",1009877,70,31,4,105
"9878",1009878,88,202,10,300
"9879",1009879,116,153,26,295
"9880",1009880,8,5,0,13
"9881",1009881,124,48,2,174
"9882",1009882,70,171,3,244
"9883",1009883,48,108,2,158
"9884",1009884,112,22,7,141
"9885",1009885,196,76,20,292
"9886",1009886,139,80,12,231
"9887",1009887,175,50,12,237
"9888",1009888,56,51,3,110
"9889",1009889,128,104,3,235
"9890",1009890,78,30,3,111
"9891",1009891,90,47,9,146
"9892",1009892,79,80,4,163
"9893",1009893,130,151,20,301
"9894",1009894,136,116,14,266
"9895",1009895,150,62,8,220
"9896",1009896,73,79,7,159
"9897",1009897,89,126,6,221
"9898",1009898,146,165,14,325
"9899",1009899,113,39,5,157
"9900",1009900,174,2,4,180
"9901",1009901,131,84,8,223
"9902",1009902,15,6,0,21
"9903",1009903,116,172,11,299
"9904",1009904,4,27,0,31
"9905",1009905,90,187,5,282
"9906",1009906,85,160,9,254
"9907",1009907,5,17,0,22
"9908",1009908,85,107,5,197
"9909",1009909,82,34,9,125
"9910",1009910,125,118,23,266
"9911",1009911,66,66,3,135
"9912",1009912,258,78,7,343
"9913",1009913,74,150,11,235
"9914",1009914,74,92,14,180
"9915",1009915,51,167,7,225
"9916",1009916,16,4,1,21
"9917",1009917,0,6,0,6
"9918",1009918,110,78,5,193
"9919",1009919,169,22,3,194
"9920",1009920,44,79,2,125
"9921",1009921,191,11,0,202
"9922",1009922,113,31,3,147
"9923",1009923,100,157,14,271
"9924",1009924,84,256,1,341
"9925",1009925,74,152,3,229
"9926",1009926,68,181,15,264
"9927",1009927,138,91,11,240
"9928",1009928,75,117,6,198
"9929",1009929,90,153,8,251
"9930",1009930,195,54,7,256
"9931",1009931,22,5,2,29
"9932",1009932,103,47,3,153
"9933",1009933,29,108,6,143
"9934",1009934,12,5,0,17
"9935",1009935,98,151,8,257
"9936",1009936,183,87,6,276
"9937",1009937,68,201,2,271
"9938",1009938,189,67,19,275
"9939",1009939,9,46,2,57
"9940",1009940,23,172,1,196
"9941",1009941,171,137,16,324
"9942",1009942,137,95,20,252
"9943",1009943,95,142,7,244
"9944",1009944,128,120,11,259
"9945",1009945,86,122,5,213
"9946",1009946,104,28,0,132
"9947",1009947,38,185,10,233
"9948",1009948,64,205,8,277
"9949",1009949,44,36,2,82
"9950",1009950,212,60,9,281
"9951",1009951,254,51,10,315
"9952",1009952,157,7,7,171
"9953",1009953,129,72,6,207
"9954",1009954,207,55,8,270
"9955",1009955,124,78,5,207
"9956",1009956,61,200,3,264
"9957",1009957,161,101,4,266
"9958",1009958,118,172,7,297
"9959",1009959,9,230,1,240
"9960",1009960,95,68,4,167
"9961",1009961,41,228,6,275
"9962",1009962,188,98,22,308
"9963",1009963,193,43,8,244
"9964",1009964,45,196,17,258
"9965",1009965,37,270,2,309
"9966",1009966,121,45,12,178
"9967",1009967,72,164,21,257
"9968",1009968,102,177,5,284
"9969",1009969,82,197,9,288
"9970",1009970,136,19,3,158
"9971",1009971,167,115,6,288
"9972",1009972,48,196,6,250
"9973",1009973,205,22,7,234
"9974",1009974,254,73,13,340
"9975",1009975,144,56,3,203
"9976",1009976,177,71,4,252
"9977",1009977,18,2,3,23
"9978",1009978,85,173,8,266
"9979",1009979,25,121,8,154
"9980",1009980,154,115,6,275
"9981",1009981,119,168,15,302
"9982",1009982,200,30,7,237
"9983",1009983,138,93,4,235
"9984",1009984,158,79,15,252
"9985",1009985,158,22,2,182
"9986",1009986,115,150,19,284
"9987",1009987,188,81,15,284
"9988",1009988,171,90,8,269
"9989",1009989,50,169,1,220
"9990",1009990,34,301,2,337
"9991",1009991,150,58,10,218
"9992",1009992,22,6,2,30
"9993",1009993,106,193,9,308
"9994",1009994,22,99,4,125
"9995",1009995,172,8,0,180
"9996",1009996,127,174,8,309
"9997",1009997,6,4,1,11
"9998",1009998,94,58,8,160
"9999",1009999,164,40,2,206
"10000",1010000,73,160,6,239
"10001",1010001,140,156,27,323
"10002",1010002,204,75,13,292
"10003",1010003,80,95,9,184
"10004",1010004,110,172,10,292
"10005",1010005,30,32,2,64
"10006",1010006,250,8,5,263
"10007",1010007,22,67,6,95
"10008",1010008,156,70,11,237
"10009",1010009,203,49,10,262
"10010",1010010,56,118,5,179
"10011",1010011,4,125,0,129
"10012",1010012,87,189,17,293
"10013",1010013,127,117,13,257
"10014",1010014,188,18,12,218
"10015",1010015,156,15,1,172
"10016",1010016,101,144,5,250
"10017",1010017,80,84,1,165
"10018",1010018,143,76,18,237
"10019",1010019,57,160,7,224
"10020",1010020,149,30,9,188
"10021",1010021,16,15,3,34
"10022",1010022,43,245,7,295
"10023",1010023,191,46,4,241
"10024",1010024,23,250,1,274
"10025",1010025,22,174,3,199
"10026",1010026,175,64,18,257
"10027",1010027,103,167,10,280
"10028",1010028,61,54,7,122
"10029",1010029,24,158,2,184
"10030",1010030,105,107,3,215
"10031",1010031,206,33,12,251
"10032",1010032,35,157,6,198
"10033",1010033,101,182,4,287
"10034",1010034,115,72,8,195
"10035",1010035,70,152,11,233
"10036",1010036,87,122,3,212
"10037",1010037,80,73,4,157
"10038",1010038,60,58,7,125
"10039",1010039,21,24,3,48
"10040",1010040,136,73,9,218
"10041",1010041,169,108,5,282
"10042",1010042,135,24,7,166
"10043",1010043,62,151,6,219
"10044",1010044,172,32,4,208
"10045",1010045,53,13,1,67
"10046",1010046,148,82,12,242
"10047",1010047,112,75,4,191
"10048",1010048,196,86,11,293
"10049",1010049,147,30,6,183
"10050",1010050,40,281,9,330
"10051",1010051,150,122,3,275
"10052",1010052,159,72,14,245
"10053",1010053,17,83,4,104
"10054",1010054,85,110,12,207
"10055",1010055,143,52,0,195
"10056",1010056,160,106,4,270
"10057",1010057,223,82,12,317
"10058",1010058,188,34,2,224
"10059",1010059,128,189,8,325
"10060",1010060,155,112,14,281
"10061",1010061,49,192,2,243
"10062",1010062,157,41,7,205
"10063",1010063,175,85,11,271
"10064",1010064,164,72,11,247
"10065",1010065,171,47,3,221
"10066",1010066,77,181,6,264
"10067",1010067,184,15,5,204
"10068",1010068,205,33,5,243
"10069",1010069,4,212,2,218
"10070",1010070,134,71,9,214
"10071",1010071,54,207,19,280
"10072",1010072,1,58,3,62
"10073",1010073,41,158,6,205
"10074",1010074,81,119,8,208
"10075",1010075,222,20,8,250
"10076",1010076,106,75,0,181
"10077",1010077,143,131,17,291
"10078",1010078,63,61,1,125
"10079",1010079,108,104,4,216
"10080",1010080,45,206,1,252
"10081",1010081,55,176,5,236
"10082",1010082,50,221,11,282
"10083",1010083,27,40,1,68
"10084",1010084,99,174,10,283
"10085",1010085,119,121,7,247
"10086",1010086,13,4,1,18
"10087",1010087,52,218,9,279
"10088",1010088,123,101,10,234
"10089",1010089,8,36,1,45
"10090",1010090,54,221,6,281
"10091",1010091,125,27,3,155
"10092",1010092,162,56,11,229
"10093",1010093,116,64,14,194
"10094",1010094,171,53,11,235
"10095",1010095,265,42,15,322
"10096",1010096,115,130,13,258
"10097",1010097,154,92,7,253
"10098",1010098,38,143,9,190
"10099",1010099,37,130,12,179
"10100",1010100,150,83,7,240
"10101",1010101,184,27,11,222
"10102",1010102,125,139,18,282
"10103",1010103,181,45,8,234
"10104",1010104,72,116,11,199
"10105",1010105,44,90,7,141
"10106",1010106,91,62,6,159
"10107",1010107,145,16,3,164
"10108",1010108,97,134,6,237
"10109",1010109,87,206,9,302
"10110",1010110,50,209,9,268
"10111",1010111,95,84,9,188
"10112",1010112,18,122,3,143
"10113",1010113,32,122,5,159
"10114",1010114,97,51,1,149
"10115",1010115,77,65,4,146
"10116",1010116,175,126,11,312
"10117",1010117,23,221,8,252
"10118",1010118,62,140,6,208
"10119",1010119,195,106,17,318
"10120",1010120,59,185,5,249
"10121",1010121,27,9,3,39
"10122",1010122,97,95,10,202
"10123",1010123,129,57,11,197
"10124",1010124,28,248,6,282
"10125",1010125,82,110,2,194
"10126",1010126,33,289,2,324
"10127",1010127,47,190,13,250
"10128",1010128,86,197,1,284
"10129",1010129,68,207,5,280
"10130",1010130,99,167,1,267
"10131",1010131,171,47,8,226
"10132",1010132,107,143,4,254
"10133",1010133,204,67,13,284
"10134",1010134,89,179,9,277
"10135",1010135,204,12,7,223
"10136",1010136,107,141,5,253
"10137",1010137,107,124,6,237
"10138",1010138,56,140,9,205
"10139",1010139,109,174,5,288
"10140",1010140,225,84,9,318
"10141",1010141,29,17,0,46
"10142",1010142,50,173,6,229
"10143",1010143,15,44,3,62
"10144",1010144,96,73,11,180
"10145",1010145,77,21,2,100
"10146",1010146,57,85,2,144
"10147",1010147,160,10,7,177
"10148",1010148,65,161,9,235
"10149",1010149,113,95,8,216
"10150",1010150,15,8,0,23
"10151",1010151,108,113,7,228
"10152",1010152,168,38,7,213
"10153",1010153,4,46,3,53
"10154",1010154,139,54,4,197
"10155",1010155,71,175,3,249
"10156",1010156,135,112,4,251
"10157",1010157,10,2,1,13
"10158",1010158,113,13,3,129
"10159",1010159,180,21,4,205
"10160",1010160,218,17,10,245
"10161",1010161,153,155,11,319
"10162",1010162,109,166,3,278
"10163",1010163,159,140,7,306
"10164",1010164,174,99,8,281
"10165",1010165,51,264,10,325
"10166",1010166,184,67,17,268
"10167",1010167,119,144,3,266
"10168",1010168,138,44,6,188
"10169",1010169,156,97,9,262
"10170",1010170,168,56,10,234
"10171",1010171,180,97,8,285
"10172",1010172,127,79,6,212
"10173",1010173,88,162,3,253
"10174",1010174,102,166,9,277
"10175",1010175,71,187,11,269
"10176",1010176,78,166,5,249
"10177",1010177,193,58,6,257
"10178",1010178,77,177,13,267
"10179",1010179,100,48,5,153
"10180",1010180,254,22,7,283
"10181",1010181,100,44,14,158
"10182",1010182,120,125,12,257
"10183",1010183,168,68,8,244
"10184",1010184,61,188,11,260
"10185",1010185,57,237,1,295
"10186",1010186,128,35,7,170
"10187",1010187,125,18,10,153
"10188",1010188,64,77,4,145
"10189",1010189,11,258,3,272
"10190",1010190,26,235,6,267
"10191",1010191,303,9,8,320
"10192",1010192,77,4,1,82
"10193",1010193,116,2,0,118
"10194",1010194,38,204,9,251
"10195",1010195,67,234,14,315
"10196",1010196,46,213,15,274
"10197",1010197,42,173,10,225
"10198",1010198,104,196,9,309
"10199",1010199,89,117,7,213
"10200",1010200,144,48,9,201
"10201",1010201,130,67,13,210
"10202",1010202,118,90,9,217
"10203",1010203,85,84,5,174
"10204",1010204,109,86,7,202
"10205",1010205,241,17,12,270
"10206",1010206,171,44,11,226
"10207",1010207,94,88,9,191
"10208",1010208,221,146,17,384
"10209",1010209,192,118,13,323
"10210",1010210,63,28,4,95
"10211",1010211,89,105,3,197
"10212",1010212,163,35,8,206
"10213",1010213,137,63,6,206
"10214",1010214,59,67,5,131
"10215",1010215,103,83,9,195
"10216",1010216,53,215,8,276
"10217",1010217,164,98,8,270
"10218",1010218,107,78,10,195
"10219",1010219,68,186,10,264
"10220",1010220,143,46,8,197
"10221",1010221,50,235,2,287
"10222",1010222,213,86,6,305
"10223",1010223,163,44,4,211
"10224",1010224,80,175,14,269
"10225",1010225,95,31,8,134
"10226",1010226,79,79,11,169
"10227",1010227,35,15,2,52
"10228",1010228,128,20,6,154
"10229",1010229,171,99,5,275
"10230",1010230,135,32,12,179
"10231",1010231,95,157,12,264
"10232",1010232,32,226,4,262
"10233",1010233,21,218,3,242
"10234",1010234,176,51,6,233
"10235",1010235,133,103,12,248
"10236",1010236,308,0,3,311
"10237",1010237,79,124,5,208
"10238",1010238,186,39,15,240
"10239",1010239,194,19,7,220
"10240",1010240,174,0,0,174
"10241",1010241,157,12,4,173
"10242",1010242,140,21,8,169
"10243",1010243,64,254,22,340
"10244",1010244,89,82,9,180
"10245",1010245,64,127,10,201
"10246",1010246,177,62,4,243
"10247",1010247,117,136,16,269
"10248",1010248,144,81,7,232
"10249",1010249,217,9,2,228
"10250",1010250,127,47,7,181
"10251",1010251,43,23,1,67
"10252",1010252,138,49,4,191
"10253",1010253,135,49,15,199
"10254",1010254,97,189,10,296
"10255",1010255,31,66,2,99
"10256",1010256,41,7,2,50
"10257",1010257,141,67,2,210
"10258",1010258,152,6,8,166
"10259",1010259,54,226,4,284
"10260",1010260,6,29,4,39
"10261",1010261,13,18,0,31
"10262",1010262,117,98,13,228
"10263",1010263,5,4,0,9
"10264",1010264,46,149,9,204
"10265",1010265,194,49,7,250
"10266",1010266,261,9,3,273
"10267",1010267,50,111,3,164
"10268",1010268,66,95,7,168
"10269",1010269,49,61,7,117
"10270",1010270,105,238,7,350
"10271",1010271,217,26,3,246
"10272",1010272,81,111,2,194
"10273",1010273,122,115,10,247
"10274",1010274,100,41,5,146
"10275",1010275,97,95,10,202
"10276",1010276,270,25,7,302
"10277",1010277,113,134,13,260
"10278",1010278,185,57,38,280
"10279",1010279,148,60,7,215
"10280",1010280,177,52,11,240
"10281",1010281,175,59,13,247
"10282",1010282,39,220,5,264
"10283",1010283,53,35,4,92
"10284",1010284,86,82,7,175
"10285",1010285,143,126,12,281
"10286",1010286,80,96,11,187
"10287",1010287,93,146,15,254
"10288",1010288,184,75,6,265
"10289",1010289,13,2,0,15
"10290",1010290,176,93,7,276
"10291",1010291,137,125,12,274
"10292",1010292,78,147,11,236
"10293",1010293,130,141,11,282
"10294",1010294,109,88,5,202
"10295",1010295,60,48,1,109
"10296",1010296,61,169,3,233
"10297",1010297,92,19,0,111
"10298",1010298,70,152,1,223
"10299",1010299,58,74,4,136
"10300",1010300,147,133,18,298
"10301",1010301,127,54,10,191
"10302",1010302,143,112,1,256
"10303",1010303,84,143,18,245
"10304",1010304,200,18,5,223
"10305",1010305,48,195,6,249
"10306",1010306,119,116,8,243
"10307",1010307,154,20,3,177
"10308",1010308,137,126,10,273
"10309",1010309,18,153,6,177
"10310",1010310,66,207,11,284
"10311",1010311,175,70,14,259
"10312",1010312,131,132,8,271
"10313",1010313,101,154,11,266
"10314",1010314,153,102,6,261
"10315",1010315,121,193,12,326
"10316",1010316,228,3,10,241
"10317",1010317,211,78,13,302
"10318",1010318,148,160,15,323
"10319",1010319,99,39,3,141
"10320",1010320,93,127,7,227
"10321",1010321,105,126,9,240
"10322",1010322,128,48,11,187
"10323",1010323,201,44,4,249
"10324",1010324,25,55,1,81
"10325",1010325,127,40,10,177
"10326",1010326,237,19,16,272
"10327",1010327,242,76,20,338
"10328",1010328,127,58,7,192
"10329",1010329,101,35,1,137
"10330",1010330,44,230,3,277
"10331",1010331,75,181,29,285
"10332",1010332,70,18,19,107
"10333",1010333,200,51,13,264
"10334",1010334,158,18,10,186
"10335",1010335,226,41,17,284
"10336",1010336,101,192,14,307
"10337",1010337,197,81,3,281
"10338",1010338,23,64,1,88
"10339",1010339,112,151,10,273
"10340",1010340,98,89,4,191
"10341",1010341,52,191,4,247
"10342",1010342,80,131,0,211
"10343",1010343,32,170,3,205
"10344",1010344,105,131,8,244
"10345",1010345,24,185,9,218
"10346",1010346,62,181,4,247
"10347",1010347,183,48,11,242
"10348",1010348,88,66,6,160
"10349",1010349,107,66,5,178
"10350",1010350,31,224,3,258
"10351",1010351,179,69,6,254
"10352",1010352,77,110,7,194
"10353",1010353,99,11,3,113
"10354",1010354,160,44,8,212
"10355",1010355,186,46,7,239
"10356",1010356,221,45,8,274
"10357",1010357,107,149,8,264
"10358",1010358,104,49,4,157
"10359",1010359,68,80,3,151
"10360",1010360,82,156,7,245
"10361",1010361,61,63,6,130
"10362",1010362,69,213,15,297
"10363",1010363,120,189,9,318
"10364",1010364,41,15,7,63
"10365",1010365,15,35,0,50
"10366",1010366,63,166,4,233
"10367",1010367,139,62,4,205
"10368",1010368,137,48,9,194
"10369",1010369,146,16,3,165
"10370",1010370,149,37,18,204
"10371",1010371,76,156,5,237
"10372",1010372,120,69,2,191
"10373",1010373,171,23,5,199
"10374",1010374,1,12,0,13
"10375",1010375,62,153,9,224
"10376",1010376,110,21,2,133
"10377",1010377,183,14,6,203
"10378",1010378,100,71,13,184
"10379",1010379,34,103,3,140
"10380",1010380,260,5,0,265
"10381",1010381,87,131,3,221
"10382",1010382,62,200,16,278
"10383",1010383,40,211,3,254
"10384",1010384,39,135,6,180
"10385",1010385,10,142,3,155
"10386",1010386,141,56,7,204
"10387",1010387,91,94,3,188
"10388",1010388,184,11,1,196
"10389",1010389,15,7,2,24
"10390",1010390,68,6,1,75
"10391",1010391,166,40,10,216
"10392",1010392,179,84,11,274
"10393",1010393,130,69,9,208
"10394",1010394,179,8,7,194
"10395",1010395,84,143,8,235
"10396",1010396,159,79,2,240
"10397",1010397,56,251,4,311
"10398",1010398,78,154,15,247
"10399",1010399,204,57,17,278
"10400",1010400,167,64,5,236
"10401",1010401,13,282,2,297
"10402",1010402,67,15,4,86
"10403",1010403,281,18,5,304
"10404",1010404,71,184,19,274
"10405",1010405,143,127,7,277
"10406",1010406,95,149,15,259
"10407",1010407,162,6,5,173
"10408",1010408,80,175,8,263
"10409",1010409,164,33,9,206
"10410",1010410,59,240,4,303
"10411",1010411,43,118,3,164
"10412",1010412,191,78,0,269
"10413",1010413,95,153,7,255
"10414",1010414,59,44,10,113
"10415",1010415,41,186,6,233
"10416",1010416,162,59,3,224
"10417",1010417,15,87,1,103
"10418",1010418,98,160,14,272
"10419",1010419,23,215,7,245
"10420",1010420,72,61,7,140
"10421",1010421,136,160,14,310
"10422",1010422,85,114,8,207
"10423",1010423,85,84,4,173
"10424",1010424,109,86,4,199
"10425",1010425,136,97,6,239
"10426",1010426,172,76,6,254
"10427",1010427,137,50,12,199
"10428",1010428,219,0,0,219
"10429",1010429,221,44,7,272
"10430",1010430,152,143,15,310
"10431",1010431,130,120,6,256
"10432",1010432,1,1,0,2
"10433",1010433,13,42,2,57
"10434",1010434,24,223,4,251
"10435",1010435,113,107,8,228
"10436",1010436,159,27,12,198
"10437",1010437,40,17,0,57
"10438",1010438,68,200,2,270
"10439",1010439,185,85,16,286
"10440",1010440,114,186,7,307
"10441",1010441,117,43,6,166
"10442",1010442,13,130,2,145
"10443",1010443,210,74,4,288
"10444",1010444,162,75,10,247
"10445",1010445,130,44,14,188
"10446",1010446,115,29,6,150
"10447",1010447,24,11,0,35
"10448",1010448,45,178,8,231
"10449",1010449,51,146,9,206
"10450",1010450,66,103,6,175
"10451",1010451,12,12,1,25
"10452",1010452,151,114,9,274
"10453",1010453,37,156,1,194
"10454",1010454,27,13,3,43
"10455",1010455,65,139,11,215
"10456",1010456,56,215,8,279
"10457",1010457,101,302,10,413
"10458",1010458,143,6,3,152
"10459",1010459,128,160,11,299
"10460",1010460,188,40,9,237
"10461",1010461,78,216,10,304
"10462",1010462,187,55,15,257
"10463",1010463,142,94,5,241
"10464",1010464,140,78,13,231
"10465",1010465,80,268,12,360
"10466",1010466,199,10,10,219
"10467",1010467,143,55,5,203
"10468",1010468,51,49,0,100
"10469",1010469,156,98,19,273
"10470",1010470,198,71,9,278
"10471",1010471,105,117,4,226
"10472",1010472,107,89,5,201
"10473",1010473,212,47,5,264
"10474",1010474,92,36,18,146
"10475",1010475,236,67,3,306
"10476",1010476,116,92,16,224
"10477",1010477,58,56,4,118
"10478",1010478,230,38,16,284
"10479",1010479,217,34,20,271
"10480",1010480,198,50,17,265
"10481",1010481,105,20,4,129
"10482",1010482,56,78,12,146
"10483",1010483,105,113,4,222
"10484",1010484,205,56,8,269
"10485",1010485,51,154,6,211
"10486",1010486,108,93,6,207
"10487",1010487,167,68,17,252
"10488",1010488,108,161,10,279
"10489",1010489,105,27,5,137
"10490",1010490,130,103,1,234
"10491",1010491,32,109,9,150
"10492",1010492,31,234,13,278
"10493",1010493,110,166,14,290
"10494",1010494,165,49,7,221
"10495",1010495,56,240,5,301
"10496",1010496,135,6,8,149
"10497",1010497,44,260,6,310
"10498",1010498,173,96,14,283
"10499",1010499,88,159,11,258
"10500",1010500,178,99,11,288
"10501",1010501,193,49,9,251
"10502",1010502,67,184,7,258
"10503",1010503,29,218,3,250
"10504",1010504,207,33,8,248
"10505",1010505,243,30,5,278
"10506",1010506,190,71,2,263
"10507",1010507,86,175,9,270
"10508",1010508,52,292,8,352
"10509",1010509,247,31,11,289
"10510",1010510,145,166,8,319
"10511",1010511,27,63,1,91
"10512",1010512,159,33,10,202
"10513",1010513,179,57,7,243
"10514",1010514,56,133,3,192
"10515",1010515,57,1,0,58
"10516",1010516,29,139,9,177
"10517",1010517,90,42,7,139
"10518",1010518,221,39,8,268
"10519",1010519,93,124,3,220
"10520",1010520,76,143,8,227
"10521",1010521,193,83,13,289
"10522",1010522,63,129,8,200
"10523",1010523,35,209,1,245
"10524",1010524,136,27,4,167
"10525",1010525,117,45,2,164
"10526",1010526,56,27,8,91
"10527",1010527,43,252,2,297
"10528",1010528,28,227,4,259
"10529",1010529,157,37,5,199
"10530",1010530,116,126,5,247
"10531",1010531,28,230,10,268
"10532",1010532,34,198,7,239
"10533",1010533,123,38,5,166
"10534",1010534,100,167,10,277
"10535",1010535,83,180,4,267
"10536",1010536,53,38,11,102
"10537",1010537,177,80,7,264
"10538",1010538,66,118,12,196
"10539",1010539,70,248,2,320
"10540",1010540,140,79,7,226
"10541",1010541,100,8,2,110
"10542",1010542,73,254,16,343
"10543",1010543,116,118,1,235
"10544",1010544,76,222,7,305
"10545",1010545,169,24,3,196
"10546",1010546,168,87,3,258
"10547",1010547,145,58,4,207
"10548",1010548,156,52,13,221
"10549",1010549,92,195,4,291
"10550",1010550,65,166,22,253
"10551",1010551,20,89,2,111
"10552",1010552,23,237,2,262
"10553",1010553,37,75,9,121
"10554",1010554,146,10,3,159
"10555",1010555,30,100,4,134
"10556",1010556,143,86,3,232
"10557",1010557,115,111,5,231
"10558",1010558,25,136,13,174
"10559",1010559,134,133,13,280
"10560",1010560,37,203,1,241
"10561",1010561,72,175,11,258
"10562",1010562,119,71,3,193
"10563",1010563,108,214,5,327
"10564",1010564,118,49,4,171
"10565",1010565,125,29,2,156
"10566",1010566,54,61,3,118
"10567",1010567,194,46,9,249
"10568",1010568,132,43,4,179
"10569",1010569,33,271,7,311
"10570",1010570,189,17,4,210
"10571",1010571,31,110,1,142
"10572",1010572,101,144,3,248
"10573",1010573,31,260,10,301
"10574",1010574,109,105,6,220
"10575",1010575,142,112,13,267
"10576",1010576,99,116,2,217
"10577",1010577,158,81,10,249
"10578",1010578,81,156,24,261
"10579",1010579,32,42,2,76
"10580",1010580,145,164,22,331
"10581",1010581,62,171,8,241
"10582",1010582,148,16,10,174
"10583",1010583,31,156,4,191
"10584",1010584,41,37,0,78
"10585",1010585,132,85,9,226
"10586",1010586,128,43,7,178
"10587",1010587,46,242,3,291
"10588",1010588,158,114,10,282
"10589",1010589,90,66,16,172
"10590",1010590,125,75,21,221
"10591",1010591,193,98,14,305
"10592",1010592,200,37,9,246
"10593",1010593,125,160,9,294
"10594",1010594,1,67,0,68
"10595",1010595,47,284,6,337
"10596",1010596,140,112,12,264
"10597",1010597,108,126,2,236
"10598",1010598,65,182,12,259
"10599",1010599,119,39,8,166
"10600",1010600,20,177,7,204
"10601",1010601,35,269,9,313
"10602",1010602,56,121,16,193
"10603",1010603,60,204,5,269
"10604",1010604,138,55,7,200
"10605",1010605,83,202,13,298
"10606",1010606,103,10,2,115
"10607",1010607,162,55,4,221
"10608",1010608,104,175,10,289
"10609",1010609,108,34,8,150
"10610",1010610,193,67,8,268
"10611",1010611,160,94,7,261
"10612",1010612,53,200,10,263
"10613",1010613,133,58,6,197
"10614",1010614,64,14,4,82
"10615",1010615,41,231,3,275
"10616",1010616,5,17,1,23
"10617",1010617,122,61,11,194
"10618",1010618,86,22,4,112
"10619",1010619,149,33,2,184
"10620",1010620,94,130,8,232
"10621",1010621,88,125,9,222
"10622",1010622,105,146,1,252
"10623",1010623,82,122,9,213
"10624",1010624,111,55,15,181
"10625",1010625,123,164,8,295
"10626",1010626,91,87,19,197
"10627",1010627,161,96,8,265
"10628",1010628,142,78,7,227
"10629",1010629,94,78,8,180
"10630",1010630,126,99,4,229
"10631",1010631,39,245,16,300
"10632",1010632,93,181,27,301
"10633",1010633,127,114,3,244
"10634",1010634,74,48,6,128
"10635",1010635,87,246,7,340
"10636",1010636,60,54,3,117
"10637",1010637,186,41,5,232
"10638",1010638,52,302,10,364
"10639",1010639,199,39,5,243
"10640",1010640,154,44,6,204
"10641",1010641,165,11,5,181
"10642",1010642,213,23,9,245
"10643",1010643,32,57,5,94
"10644",1010644,34,97,6,137
"10645",1010645,210,48,8,266
"10646",1010646,0,4,0,4
"10647",1010647,140,99,13,252
"10648",1010648,105,99,21,225
"10649",1010649,72,70,12,154
"10650",1010650,132,116,4,252
"10651",1010651,172,103,4,279
"10652",1010652,143,82,5,230
"10653",1010653,94,188,6,288
"10654",1010654,98,135,11,244
"10655",1010655,188,48,8,244
"10656",1010656,110,103,5,218
"10657",1010657,47,177,2,226
"10658",1010658,54,117,15,186
"10659",1010659,149,106,6,261
"10660",1010660,153,104,8,265
"10661",1010661,191,17,2,210
"10662",1010662,205,9,7,221
"10663",1010663,123,68,6,197
"10664",1010664,146,99,12,257
"10665",1010665,157,5,1,163
"10666",1010666,143,113,3,259
"10667",1010667,43,184,6,233
"10668",1010668,78,172,12,262
"10669",1010669,113,57,3,173
"10670",1010670,164,91,3,258
"10671",1010671,59,148,3,210
"10672",1010672,146,100,15,261
"10673",1010673,82,20,2,104
"10674",1010674,239,67,6,312
"10675",1010675,68,193,9,270
"10676",1010676,40,142,6,188
"10677",1010677,78,29,1,108
"10678",1010678,90,134,8,232
"10679",1010679,177,34,8,219
"10680",1010680,158,95,13,266
"10681",1010681,147,60,7,214
"10682",1010682,148,52,9,209
"10683",1010683,97,175,9,281
"10684",1010684,199,52,3,254
"10685",1010685,135,55,16,206
"10686",1010686,125,61,8,194
"10687",1010687,177,65,12,254
"10688",1010688,50,301,3,354
"10689",1010689,105,65,7,177
"10690",1010690,116,133,13,262
"10691",1010691,106,35,12,153
"10692",1010692,211,64,8,283
"10693",1010693,179,88,6,273
"10694",1010694,167,59,2,228
"10695",1010695,66,211,13,290
"10696",1010696,51,129,6,186
"10697",1010697,137,154,19,310
"10698",1010698,73,207,8,288
"10699",1010699,148,61,6,215
"10700",1010700,93,190,13,296
"10701",1010701,119,81,5,205
"10702",1010702,83,177,4,264
"10703",1010703,94,141,8,243
"10704",1010704,93,174,13,280
"10705",1010705,71,168,16,255
"10706",1010706,28,48,6,82
"10707",1010707,143,23,2,168
"10708",1010708,33,185,11,229
"10709",1010709,143,108,4,255
"10710",1010710,165,142,5,312
"10711",1010711,46,231,3,280
"10712",1010712,80,160,7,247
"10713",1010713,188,70,13,271
"10714",1010714,37,219,7,263
"10715",1010715,76,217,7,300
"10716",1010716,122,56,14,192
"10717",1010717,124,49,4,177
"10718",1010718,155,49,9,213
"10719",1010719,246,19,5,270
"10720",1010720,89,67,10,166
"10721",1010721,49,198,7,254
"10722",1010722,51,162,14,227
"10723",1010723,195,37,7,239
"10724",1010724,108,65,5,178
"10725",1010725,95,188,9,292
"10726",1010726,39,32,4,75
"10727",1010727,43,2,2,47
"10728",1010728,100,156,21,277
"10729",1010729,104,48,15,167
"10730",1010730,192,112,15,319
"10731",1010731,117,152,3,272
"10732",1010732,93,168,9,270
"10733",1010733,131,23,4,158
"10734",1010734,82,193,5,280
"10735",1010735,170,8,1,179
"10736",1010736,160,83,10,253
"10737",1010737,78,116,11,205
"10738",1010738,52,156,2,210
"10739",1010739,91,71,13,175
"10740",1010740,101,160,6,267
"10741",1010741,82,138,9,229
"10742",1010742,103,113,3,219
"10743",1010743,259,51,8,318
"10744",1010744,136,93,3,232
"10745",1010745,135,9,0,144
"10746",1010746,47,31,1,79
"10747",1010747,43,19,2,64
"10748",1010748,115,45,4,164
"10749",1010749,152,73,9,234
"10750",1010750,217,24,11,252
"10751",1010751,35,262,11,308
"10752",1010752,187,76,9,272
"10753",1010753,60,165,14,239
"10754",1010754,10,14,3,27
"10755",1010755,111,135,13,259
"10756",1010756,183,88,2,273
"10757",1010757,36,11,2,49
"10758",1010758,97,122,18,237
"10759",1010759,30,78,1,109
"10760",1010760,116,60,6,182
"10761",1010761,131,113,8,252
"10762",1010762,85,136,13,234
"10763",1010763,3,4,0,7
"10764",1010764,204,31,4,239
"10765",1010765,178,63,1,242
"10766",1010766,88,230,8,326
"10767",1010767,129,96,5,230
"10768",1010768,53,181,9,243
"10769",1010769,13,114,3,130
"10770",1010770,21,218,4,243
"10771",1010771,2,1,0,3
"10772",1010772,114,112,9,235
"10773",1010773,183,49,14,246
"10774",1010774,13,105,2,120
"10775",1010775,121,219,13,353
"10776",1010776,175,82,24,281
"10777",1010777,104,118,12,234
"10778",1010778,193,60,6,259
"10779",1010779,157,153,13,323
"10780",1010780,91,111,5,207
"10781",1010781,143,65,10,218
"10782",1010782,40,168,5,213
"10783",1010783,10,3,0,13
"10784",1010784,132,99,7,238
"10785",1010785,30,93,15,138
"10786",1010786,239,11,8,258
"10787",1010787,61,155,8,224
"10788",1010788,104,113,19,236
"10789",1010789,45,243,4,292
"10790",1010790,172,88,15,275
"10791",1010791,230,38,14,282
"10792",1010792,180,67,5,252
"10793",1010793,108,0,6,114
"10794",1010794,169,63,9,241
"10795",1010795,156,60,24,240
"10796",1010796,91,145,5,241
"10797",1010797,14,111,1,126
"10798",1010798,25,180,5,210
"10799",1010799,154,55,8,217
"10800",1010800,119,128,3,250
"10801",1010801,15,13,1,29
"10802",1010802,185,55,5,245
"10803",1010803,63,50,1,114
"10804",1010804,123,24,6,153
"10805",1010805,120,149,9,278
"10806",1010806,88,166,1,255
"10807",1010807,176,95,14,285
"10808",1010808,28,5,1,34
"10809",1010809,195,22,3,220
"10810",1010810,85,140,4,229
"10811",1010811,179,51,4,234
"10812",1010812,161,47,7,215
"10813",1010813,57,44,0,101
"10814",1010814,153,67,18,238
"10815",1010815,36,2,1,39
"10816",1010816,87,196,4,287
"10817",1010817,33,22,2,57
"10818",1010818,146,48,7,201
"10819",1010819,115,1,0,116
"10820",1010820,148,43,1,192
"10821",1010821,150,29,3,182
"10822",1010822,138,103,3,244
"10823",1010823,203,60,16,279
"10824",1010824,130,128,6,264
"10825",1010825,88,115,6,209
"10826",1010826,31,55,1,87
"10827",1010827,48,131,6,185
"10828",1010828,194,108,16,318
"10829",1010829,91,112,2,205
"10830",1010830,123,102,5,230
"10831",1010831,91,37,10,138
"10832",1010832,230,50,13,293
"10833",1010833,24,20,1,45
"10834",1010834,135,161,5,301
"10835",1010835,228,19,5,252
"10836",1010836,72,218,3,293
"10837",1010837,26,235,1,262
"10838",1010838,91,39,3,133
"10839",1010839,133,69,8,210
"10840",1010840,61,33,6,100
"10841",1010841,146,29,5,180
"10842",1010842,94,81,6,181
"10843",1010843,187,49,12,248
"10844",1010844,83,203,13,299
"10845",1010845,100,209,4,313
"10846",1010846,116,118,8,242
"10847",1010847,51,250,3,304
"10848",1010848,230,76,16,322
"10849",1010849,16,202,4,222
"10850",1010850,53,164,9,226
"10851",1010851,140,74,14,228
"10852",1010852,126,110,27,263
"10853",1010853,112,51,3,166
"10854",1010854,156,110,8,274
"10855",1010855,115,160,20,295
"10856",1010856,108,77,8,193
"10857",1010857,80,232,9,321
"10858",1010858,180,161,7,348
"10859",1010859,43,96,5,144
"10860",1010860,158,52,5,215
"10861",1010861,183,29,18,230
"10862",1010862,126,76,5,207
"10863",1010863,54,140,4,198
"10864",1010864,5,78,0,83
"10865",1010865,189,31,10,230
"10866",1010866,29,113,8,150
"10867",1010867,89,162,4,255
"10868",1010868,3,67,0,70
"10869",1010869,120,127,4,251
"10870",1010870,120,81,11,212
"10871",1010871,103,84,5,192
"10872",1010872,25,63,2,90
"10873",1010873,96,110,11,217
"10874",1010874,121,136,10,267
"10875",1010875,88,156,3,247
"10876",1010876,91,59,9,159
"10877",1010877,192,132,22,346
"10878",1010878,173,70,9,252
"10879",1010879,130,142,11,283
"10880",1010880,26,150,4,180
"10881",1010881,125,149,13,287
"10882",1010882,125,48,9,182
"10883",1010883,27,94,3,124
"10884",1010884,39,77,8,124
"10885",1010885,116,118,6,240
"10886",1010886,134,18,2,154
"10887",1010887,85,206,16,307
"10888",1010888,190,80,13,283
"10889",1010889,189,75,16,280
"10890",1010890,199,83,10,292
"10891",1010891,150,22,8,180
"10892",1010892,106,112,6,224
"10893",1010893,136,181,5,322
"10894",1010894,139,123,18,280
"10895",1010895,35,15,2,52
"10896",1010896,120,86,6,212
"10897",1010897,203,35,15,253
"10898",1010898,77,190,7,274
"10899",1010899,55,169,11,235
"10900",1010900,256,61,17,334
"10901",1010901,180,66,3,249
"10902",1010902,75,28,3,106
"10903",1010903,76,91,4,171
"10904",1010904,113,68,10,191
"10905",1010905,45,47,6,98
"10906",1010906,188,26,20,234
"10907",1010907,53,148,5,206
"10908",1010908,5,6,0,11
"10909",1010909,49,78,10,137
"10910",1010910,154,30,3,187
"10911",1010911,68,33,5,106
"10912",1010912,169,17,6,192
"10913",1010913,215,50,7,272
"10914",1010914,216,30,12,258
"10915",1010915,20,187,11,218
"10916",1010916,8,139,4,151
"10917",1010917,53,182,9,244
"10918",1010918,89,118,5,212
"10919",1010919,130,52,7,189
"10920",1010920,49,40,7,96
"10921",1010921,108,158,9,275
"10922",1010922,164,80,28,272
"10923",1010923,179,103,11,293
"10924",1010924,260,60,12,332
"10925",1010925,0,7,0,7
"10926",1010926,206,52,6,264
"10927",1010927,120,50,10,180
"10928",1010928,257,43,9,309
"10929",1010929,188,46,7,241
"10930",1010930,62,254,9,325
"10931",1010931,113,139,6,258
"10932",1010932,145,79,6,230
"10933",1010933,123,135,14,272
"10934",1010934,43,25,1,69
"10935",1010935,121,55,2,178
"10936",1010936,4,4,1,9
"10937",1010937,139,44,2,185
"10938",1010938,188,49,4,241
"10939",1010939,11,32,0,43
"10940",1010940,33,75,6,114
"10941",1010941,149,60,9,218
"10942",1010942,108,33,5,146
"10943",1010943,161,71,12,244
"10944",1010944,217,46,6,269
"10945",1010945,3,3,0,6
"10946",1010946,126,22,4,152
"10947",1010947,44,209,7,260
"10948",1010948,19,16,3,38
"10949",1010949,139,105,8,252
"10950",1010950,274,12,9,295
"10951",1010951,253,35,15,303
"10952",1010952,220,106,25,351
"10953",1010953,176,63,5,244
"10954",1010954,16,102,3,121
"10955",1010955,89,85,6,180
"10956",1010956,13,168,3,184
"10957",1010957,121,63,3,187
"10958",1010958,45,39,5,89
"10959",1010959,180,129,5,314
"10960",1010960,66,61,6,133
"10961",1010961,86,96,4,186
"10962",1010962,49,244,13,306
"10963",1010963,23,25,4,52
"10964",1010964,80,134,8,222
"10965",1010965,148,161,19,328
"10966",1010966,64,161,4,229
"10967",1010967,5,2,2,9
"10968",1010968,182,45,6,233
"10969",1010969,59,12,5,76
"10970",1010970,126,95,3,224
"10971",1010971,91,136,21,248
"10972",1010972,68,99,9,176
"10973",1010973,124,22,7,153
"10974",1010974,131,32,7,170
"10975",1010975,53,172,4,229
"10976",1010976,56,102,5,163
"10977",1010977,164,32,8,204
"10978",1010978,147,108,8,263
"10979",1010979,248,33,7,288
"10980",1010980,124,62,8,194
"10981",1010981,93,176,8,277
"10982",1010982,170,25,20,215
"10983",1010983,244,2,0,246
"10984",1010984,39,164,12,215
"10985",1010985,102,117,8,227
"10986",1010986,67,135,2,204
"10987",1010987,47,206,10,263
"10988",1010988,119,44,12,175
"10989",1010989,34,26,3,63
"10990",1010990,196,85,10,291
"10991",1010991,78,187,3,268
"10992",1010992,43,251,2,296
"10993",1010993,235,44,27,306
"10994",1010994,153,149,20,322
"10995",1010995,151,60,14,225
"10996",1010996,100,84,16,200
"10997",1010997,35,232,6,273
"10998",1010998,131,15,2,148
"10999",1010999,4,26,2,32
"11000",1011000,201,126,15,342
"11001",1011001,124,11,3,138
"11002",1011002,229,60,7,296
"11003",1011003,83,213,13,309
"11004",1011004,15,16,4,35
"11005",1011005,67,219,8,294
"11006",1011006,97,106,8,211
"11007",1011007,117,59,13,189
"11008",1011008,149,18,5,172
"11009",1011009,47,43,3,93
"11010",1011010,52,242,0,294
"11011",1011011,161,118,1,280
"11012",1011012,202,89,8,299
"11013",1011013,116,23,6,145
"11014",1011014,86,183,7,276
"11015",1011015,81,101,3,185
"11016",1011016,153,102,8,263
"11017",1011017,129,95,18,242
"11018",1011018,190,73,13,276
"11019",1011019,161,69,13,243
"11020",1011020,171,107,17,295
"11021",1011021,68,193,22,283
"11022",1011022,125,59,4,188
"11023",1011023,89,30,4,123
"11024",1011024,133,154,15,302
"11025",1011025,105,31,2,138
"11026",1011026,125,119,8,252
"11027",1011027,102,6,2,110
"11028",1011028,62,37,6,105
"11029",1011029,58,239,4,301
"11030",1011030,193,35,12,240
"11031",1011031,129,13,1,143
"11032",1011032,62,205,11,278
"11033",1011033,134,61,4,199
"11034",1011034,35,76,4,115
"11035",1011035,136,31,4,171
"11036",1011036,183,100,20,303
"11037",1011037,61,253,3,317
"11038",1011038,7,25,5,37
"11039",1011039,185,6,0,191
"11040",1011040,105,45,10,160
"11041",1011041,106,52,1,159
"11042",1011042,157,84,1,242
"11043",1011043,55,200,13,268
"11044",1011044,200,51,5,256
"11045",1011045,95,30,3,128
"11046",1011046,100,98,7,205
"11047",1011047,64,195,11,270
"11048",1011048,40,159,6,205
"11049",1011049,21,186,12,219
"11050",1011050,107,53,13,173
"11051",1011051,119,161,20,300
"11052",1011052,78,12,2,92
"11053",1011053,171,58,11,240
"11054",1011054,50,45,6,101
"11055",1011055,16,182,5,203
"11056",1011056,84,73,15,172
"11057",1011057,59,139,3,201
"11058",1011058,146,89,12,247
"11059",1011059,142,78,18,238
"11060",1011060,76,120,7,203
"11061",1011061,97,185,12,294
"11062",1011062,67,1,0,68
"11063",1011063,110,182,6,298
"11064",1011064,109,80,6,195
"11065",1011065,187,36,5,228
"11066",1011066,10,3,0,13
"11067",1011067,140,37,8,185
"11068",1011068,154,127,27,308
"11069",1011069,6,5,0,11
"11070",1011070,163,32,6,201
"11071",1011071,15,299,4,318
"11072",1011072,133,185,12,330
"11073",1011073,159,79,11,249
"11074",1011074,140,153,8,301
"11075",1011075,214,21,7,242
"11076",1011076,171,62,5,238
"11077",1011077,37,241,11,289
"11078",1011078,89,256,11,356
"11079",1011079,184,74,5,263
"11080",1011080,57,54,9,120
"11081",1011081,175,71,9,255
"11082",1011082,283,37,6,326
"11083",1011083,204,42,9,255
"11084",1011084,86,56,7,149
"11085",1011085,148,57,4,209
"11086",1011086,46,206,4,256
"11087",1011087,185,37,7,229
"11088",1011088,146,72,16,234
"11089",1011089,159,41,5,205
"11090",1011090,65,161,10,236
"11091",1011091,210,41,6,257
"11092",1011092,98,20,6,124
"11093",1011093,66,204,15,285
"11094",1011094,57,116,4,177
"11095",1011095,35,150,3,188
"11096",1011096,207,12,9,228
"11097",1011097,177,80,2,259
"11098",1011098,85,92,3,180
"11099",1011099,73,11,2,86
"11100",1011100,161,36,5,202
"11101",1011101,115,21,10,146
"11102",1011102,61,142,4,207
"11103",1011103,144,17,4,165
"11104",1011104,122,108,8,238
"11105",1011105,206,95,25,326
"11106",1011106,46,233,4,283
"11107",1011107,124,87,14,225
"11108",1011108,84,153,7,244
"11109",1011109,56,209,9,274
"11110",1011110,159,93,6,258
"11111",1011111,273,19,6,298
"11112",1011112,260,67,18,345
"11113",1011113,50,207,5,262
"11114",1011114,62,156,20,238
"11115",1011115,51,170,16,237
"11116",1011116,128,172,7,307
"11117",1011117,173,81,16,270
"11118",1011118,9,10,2,21
"11119",1011119,171,25,8,204
"11120",1011120,85,48,4,137
"11121",1011121,197,37,3,237
"11122",1011122,146,110,5,261
"11123",1011123,188,47,8,243
"11124",1011124,82,78,6,166
"11125",1011125,109,209,19,337
"11126",1011126,50,60,5,115
"11127",1011127,111,108,7,226
"11128",1011128,64,224,23,311
"11129",1011129,217,41,11,269
"11130",1011130,100,88,4,192
"11131",1011131,57,176,11,244
"11132",1011132,46,112,5,163
"11133",1011133,140,67,15,222
"11134",1011134,200,48,13,261
"11135",1011135,184,17,2,203
"11136",1011136,102,117,16,235
"11137",1011137,61,89,5,155
"11138",1011138,110,171,4,285
"11139",1011139,82,171,9,262
"11140",1011140,198,95,10,303
"11141",1011141,74,165,4,243
"11142",1011142,125,72,13,210
"11143",1011143,42,60,5,107
"11144",1011144,52,213,6,271
"11145",1011145,93,144,5,242
"11146",1011146,68,43,7,118
"11147",1011147,22,273,2,297
"11148",1011148,53,122,4,179
"11149",1011149,39,14,0,53
"11150",1011150,160,76,10,246
"11151",1011151,13,104,2,119
"11152",1011152,101,163,6,270
"11153",1011153,185,1,1,187
"11154",1011154,116,27,7,150
"11155",1011155,100,91,11,202
"11156",1011156,128,106,14,248
"11157",1011157,128,38,12,178
"11158",1011158,220,7,0,227
"11159",1011159,181,91,16,288
"11160",1011160,97,83,8,188
"11161",1011161,152,77,6,235
"11162",1011162,71,78,9,158
"11163",1011163,58,167,7,232
"11164",1011164,25,60,0,85
"11165",1011165,88,79,9,176
"11166",1011166,109,96,12,217
"11167",1011167,64,70,8,142
"11168",1011168,80,108,8,196
"11169",1011169,106,183,21,310
"11170",1011170,78,201,7,286
"11171",1011171,49,91,5,145
"11172",1011172,76,61,12,149
"11173",1011173,106,116,8,230
"11174",1011174,189,115,17,321
"11175",1011175,8,9,0,17
"11176",1011176,65,158,12,235
"11177",1011177,56,254,8,318
"11178",1011178,63,216,9,288
"11179",1011179,63,20,1,84
"11180",1011180,162,137,9,308
"11181",1011181,144,62,14,220
"11182",1011182,148,85,6,239
"11183",1011183,114,172,7,293
"11184",1011184,102,100,16,218
"11185",1011185,15,196,6,217
"11186",1011186,128,125,13,266
"11187",1011187,31,4,3,38
"11188",1011188,16,112,9,137
"11189",1011189,95,88,5,188
"11190",1011190,186,66,6,258
"11191",1011191,186,44,13,243
"11192",1011192,52,213,13,278
"11193",1011193,145,97,9,251
"11194",1011194,139,84,5,228
"11195",1011195,61,89,5,155
"11196",1011196,195,78,5,278
"11197",1011197,157,47,8,212
"11198",1011198,66,19,2,87
"11199",1011199,144,67,4,215
"11200",1011200,66,122,9,197
"11201",1011201,112,197,7,316
"11202",1011202,19,330,5,354
"11203",1011203,62,172,18,252
"11204",1011204,91,43,10,144
"11205",1011205,50,70,2,122
"11206",1011206,152,110,11,273
"11207",1011207,92,361,10,463
"11208",1011208,155,53,6,214
"11209",1011209,71,232,8,311
"11210",1011210,200,64,10,274
"11211",1011211,89,153,5,247
"11212",1011212,89,176,21,286
"11213",1011213,125,26,2,153
"11214",1011214,153,34,15,202
"11215",1011215,11,6,1,18
"11216",1011216,108,85,9,202
"11217",1011217,71,171,7,249
"11218",1011218,162,99,2,263
"11219",1011219,31,182,2,215
"11220",1011220,99,46,20,165
"11221",1011221,174,31,7,212
"11222",1011222,92,97,9,198
"11223",1011223,105,55,15,175
"11224",1011224,72,137,9,218
"11225",1011225,201,77,10,288
"11226",1011226,146,138,13,297
"11227",1011227,102,136,1,239
"11228",1011228,160,97,11,268
"11229",1011229,57,180,6,243
"11230",1011230,27,114,11,152
"11231",1011231,160,18,8,186
"11232",1011232,66,231,3,300
"11233",1011233,69,187,12,268
"11234",1011234,156,99,3,258
"11235",1011235,90,111,5,206
"11236",1011236,142,118,28,288
"11237",1011237,155,124,8,287
"11238",1011238,177,36,7,220
"11239",1011239,54,228,9,291
"11240",1011240,128,26,6,160
"11241",1011241,89,171,3,263
"11242",1011242,0,265,3,268
"11243",1011243,46,159,11,216
"11244",1011244,98,39,8,145
"11245",1011245,93,12,8,113
"11246",1011246,6,19,1,26
"11247",1011247,191,60,7,258
"11248",1011248,77,162,9,248
"11249",1011249,32,97,3,132
"11250",1011250,118,103,6,227
"11251",1011251,75,152,7,234
"11252",1011252,187,66,11,264
"11253",1011253,80,213,18,311
"11254",1011254,59,234,4,297
"11255",1011255,166,80,16,262
"11256",1011256,111,82,10,203
"11257",1011257,150,58,4,212
"11258",1011258,194,39,9,242
"11259",1011259,96,186,5,287
"11260",1011260,134,44,5,183
"11261",1011261,191,81,14,286
"11262",1011262,98,101,7,206
"11263",1011263,268,26,9,303
"11264",1011264,63,212,2,277
"11265",1011265,84,242,6,332
"11266",1011266,99,2,3,104
"11267",1011267,200,90,16,306
"11268",1011268,149,49,6,204
"11269",1011269,91,190,5,286
"11270",1011270,80,110,8,198
"11271",1011271,133,77,3,213
"11272",1011272,200,79,12,291
"11273",1011273,17,172,5,194
"11274",1011274,47,264,7,318
"11275",1011275,137,72,9,218
"11276",1011276,9,173,1,183
"11277",1011277,48,136,3,187
"11278",1011278,166,104,6,276
"11279",1011279,107,106,6,219
"11280",1011280,68,62,9,139
"11281",1011281,13,83,3,99
"11282",1011282,96,178,19,293
"11283",1011283,161,66,14,241
"11284",1011284,187,24,5,216
"11285",1011285,122,47,5,174
"11286",1011286,84,159,18,261
"11287",1011287,125,130,18,273
"11288",1011288,57,58,2,117
"11289",1011289,39,137,20,196
"11290",1011290,119,65,6,190
"11291",1011291,46,161,1,208
"11292",1011292,161,57,5,223
"11293",1011293,57,197,11,265
"11294",1011294,219,9,10,238
"11295",1011295,78,208,10,296
"11296",1011296,39,6,1,46
"11297",1011297,153,26,11,190
"11298",1011298,108,29,6,143
"11299",1011299,135,45,3,183
"11300",1011300,132,102,12,246
"11301",1011301,156,64,6,226
"11302",1011302,47,127,2,176
"11303",1011303,209,67,16,292
"11304",1011304,69,89,7,165
"11305",1011305,44,231,12,287
"11306",1011306,57,209,5,271
"11307",1011307,145,124,2,271
"11308",1011308,139,102,14,255
"11309",1011309,98,43,4,145
"11310",1011310,88,176,12,276
"11311",1011311,77,20,6,103
"11312",1011312,124,67,5,196
"11313",1011313,116,13,9,138
"11314",1011314,31,23,3,57
"11315",1011315,96,423,14,533
"11316",1011316,174,163,7,344
"11317",1011317,107,143,10,260
"11318",1011318,123,163,11,297
"11319",1011319,131,42,11,184
"11320",1011320,28,0,0,28
"11321",1011321,224,48,10,282
"11322",1011322,42,123,4,169
"11323",1011323,126,143,8,277
"11324",1011324,115,107,12,234
"11325",1011325,75,126,9,210
"11326",1011326,40,32,3,75
"11327",1011327,132,17,5,154
"11328",1011328,118,155,13,286
"11329",1011329,267,31,10,308
"11330",1011330,51,222,9,282
"11331",1011331,164,80,12,256
"11332",1011332,115,82,11,208
"11333",1011333,102,64,0,166
"11334",1011334,73,146,5,224
"11335",1011335,125,61,6,192
"11336",1011336,151,73,3,227
"11337",1011337,147,23,5,175
"11338",1011338,169,52,2,223
"11339",1011339,80,141,5,226
"11340",1011340,133,154,6,293
"11341",1011341,167,95,15,277
"11342",1011342,117,109,4,230
"11343",1011343,178,98,11,287
"11344",1011344,111,138,8,257
"11345",1011345,162,92,8,262
"11346",1011346,93,124,9,226
"11347",1011347,95,102,3,200
"11348",1011348,96,114,2,212
"11349",1011349,40,59,2,101
"11350",1011350,92,43,4,139
"11351",1011351,69,55,3,127
"11352",1011352,217,51,14,282
"11353",1011353,225,59,13,297
"11354",1011354,134,18,1,153
"11355",1011355,137,175,18,330
"11356",1011356,10,87,4,101
"11357",1011357,122,102,15,239
"11358",1011358,58,101,4,163
"11359",1011359,10,82,0,92
"11360",1011360,51,110,3,164
"11361",1011361,98,27,3,128
"11362",1011362,18,4,1,23
"11363",1011363,117,48,9,174
"11364",1011364,123,80,11,214
"11365",1011365,60,192,13,265
"11366",1011366,39,203,9,251
"11367",1011367,76,101,7,184
"11368",1011368,171,34,4,209
"11369",1011369,151,49,15,215
"11370",1011370,28,254,11,293
"11371",1011371,175,26,6,207
"11372",1011372,73,135,7,215
"11373",1011373,257,111,13,381
"11374",1011374,121,75,11,207
"11375",1011375,93,180,4,277
"11376",1011376,83,190,4,277
"11377",1011377,182,121,14,317
"11378",1011378,31,243,2,276
"11379",1011379,287,46,12,345
"11380",1011380,100,190,11,301
"11381",1011381,70,48,3,121
"11382",1011382,45,152,3,200
"11383",1011383,36,242,8,286
"11384",1011384,75,117,8,200
"11385",1011385,161,73,2,236
"11386",1011386,49,168,5,222
"11387",1011387,61,222,2,285
"11388",1011388,161,113,13,287
"11389",1011389,149,17,2,168
"11390",1011390,182,81,9,272
"11391",1011391,68,115,8,191
"11392",1011392,101,130,0,231
"11393",1011393,34,214,3,251
"11394",1011394,10,236,4,250
"11395",1011395,185,69,7,261
"11396",1011396,28,216,8,252
"11397",1011397,152,34,7,193
"11398",1011398,102,19,4,125
"11399",1011399,144,83,4,231
"11400",1011400,162,38,6,206
"11401",1011401,108,119,13,240
"11402",1011402,9,13,2,24
"11403",1011403,118,128,3,249
"11404",1011404,53,177,2,232
"11405",1011405,41,163,13,217
"11406",1011406,90,52,7,149
"11407",1011407,104,44,2,150
"11408",1011408,169,37,8,214
"11409",1011409,108,30,2,140
"11410",1011410,111,52,1,164
"11411",1011411,94,82,5,181
"11412",1011412,24,42,5,71
"11413",1011413,127,86,4,217
"11414",1011414,0,76,1,77
"11415",1011415,146,75,4,225
"11416",1011416,164,71,6,241
"11417",1011417,85,66,13,164
"11418",1011418,119,61,8,188
"11419",1011419,41,180,2,223
"11420",1011420,34,248,11,293
"11421",1011421,127,142,9,278
"11422",1011422,160,30,4,194
"11423",1011423,239,44,2,285
"11424",1011424,168,72,10,250
"11425",1011425,86,142,5,233
"11426",1011426,203,78,14,295
"11427",1011427,86,159,12,257
"11428",1011428,36,66,4,106
"11429",1011429,71,163,9,243
"11430",1011430,223,47,19,289
"11431",1011431,88,162,11,261
"11432",1011432,129,125,12,266
"11433",1011433,59,160,1,220
"11434",1011434,179,46,4,229
"11435",1011435,62,190,3,255
"11436",1011436,192,23,9,224
"11437",1011437,96,165,5,266
"11438",1011438,168,68,13,249
"11439",1011439,107,143,11,261
"11440",1011440,177,38,6,221
"11441",1011441,170,80,13,263
"11442",1011442,45,84,7,136
"11443",1011443,122,88,11,221
"11444",1011444,32,204,9,245
"11445",1011445,41,175,5,221
"11446",1011446,64,229,5,298
"11447",1011447,86,124,12,222
"11448",1011448,172,45,4,221
"11449",1011449,111,46,9,166
"11450",1011450,73,44,8,125
"11451",1011451,89,173,9,271
"11452",1011452,84,178,5,267
"11453",1011453,59,37,1,97
"11454",1011454,137,23,9,169
"11455",1011455,80,172,20,272
"11456",1011456,173,64,9,246
"11457",1011457,150,48,4,202
"11458",1011458,114,7,4,125
"11459",1011459,38,17,1,56
"11460",1011460,39,153,1,193
"11461",1011461,119,120,7,246
"11462",1011462,57,165,6,228
"11463",1011463,84,148,23,255
"11464",1011464,156,56,13,225
"11465",1011465,67,208,20,295
"11466",1011466,203,41,8,252
"11467",1011467,13,193,2,208
"11468",1011468,49,34,4,87
"11469",1011469,197,32,4,233
"11470",1011470,70,213,15,298
"11471",1011471,275,25,4,304
"11472",1011472,67,155,24,246
"11473",1011473,114,14,2,130
"11474",1011474,238,17,11,266
"11475",1011475,156,25,4,185
"11476",1011476,59,168,1,228
"11477",1011477,140,77,4,221
"11478",1011478,72,60,3,135
"11479",1011479,178,39,8,225
"11480",1011480,36,244,13,293
"11481",1011481,29,15,2,46
"11482",1011482,93,136,4,233
"11483",1011483,83,109,12,204
"11484",1011484,177,84,11,272
"11485",1011485,62,162,4,228
"11486",1011486,80,148,11,239
"11487",1011487,57,137,6,200
"11488",1011488,84,44,7,135
"11489",1011489,21,107,1,129
"11490",1011490,94,105,11,210
"11491",1011491,114,125,8,247
"11492",1011492,95,112,7,214
"11493",1011493,70,22,5,97
"11494",1011494,104,151,2,257
"11495",1011495,95,117,19,231
"11496",1011496,49,262,9,320
"11497",1011497,55,236,4,295
"11498",1011498,117,74,3,194
"11499",1011499,76,53,0,129
"11500",1011500,58,3,2,63
"11501",1011501,13,3,0,16
"11502",1011502,166,23,6,195
"11503",1011503,94,190,13,297
"11504",1011504,123,40,11,174
"11505",1011505,77,236,11,324
"11506",1011506,180,86,17,283
"11507",1011507,98,27,2,127
"11508",1011508,116,35,4,155
"11509",1011509,8,173,3,184
"11510",1011510,72,108,3,183
"11511",1011511,70,164,1,235
"11512",1011512,33,242,3,278
"11513",1011513,61,184,11,256
"11514",1011514,145,123,12,280
"11515",1011515,100,43,7,150
"11516",1011516,31,234,0,265
"11517",1011517,156,103,11,270
"11518",1011518,128,78,8,214
"11519",1011519,136,50,15,201
"11520",1011520,150,88,8,246
"11521",1011521,248,16,7,271
"11522",1011522,125,135,5,265
"11523",1011523,185,58,13,256
"11524",1011524,88,38,14,140
"11525",1011525,72,160,10,242
"11526",1011526,93,32,8,133
"11527",1011527,99,177,16,292
"11528",1011528,46,102,7,155
"11529",1011529,104,170,5,279
"11530",1011530,90,83,16,189
"11531",1011531,136,74,7,217
"11532",1011532,154,106,6,266
"11533",1011533,143,110,1,254
"11534",1011534,98,127,3,228
"11535",1011535,182,0,0,182
"11536",1011536,162,51,13,226
"11537",1011537,23,109,3,135
"11538",1011538,153,108,17,278
"11539",1011539,173,29,11,213
"11540",1011540,38,29,4,71
"11541",1011541,180,54,2,236
"11542",1011542,95,125,10,230
"11543",1011543,74,154,13,241
"11544",1011544,46,48,4,98
"11545",1011545,58,195,3,256
"11546",1011546,164,58,4,226
"11547",1011547,120,87,11,218
"11548",1011548,134,44,3,181
"11549",1011549,27,203,3,233
"11550",1011550,143,149,10,302
"11551",1011551,52,122,7,181
"11552",1011552,176,31,4,211
"11553",1011553,131,34,2,167
"11554",1011554,148,44,3,195
"11555",1011555,40,207,5,252
"11556",1011556,106,84,9,199
"11557",1011557,191,75,5,271
"11558",1011558,29,163,9,201
"11559",1011559,44,134,1,179
"11560",1011560,219,37,38,294
"11561",1011561,109,58,8,175
"11562",1011562,196,47,13,256
"11563",1011563,220,14,3,237
"11564",1011564,12,58,2,72
"11565",1011565,60,184,2,246
"11566",1011566,91,137,7,235
"11567",1011567,145,161,19,325
"11568",1011568,184,66,12,262
"11569",1011569,124,158,26,308
"11570",1011570,94,163,11,268
"11571",1011571,92,14,4,110
"11572",1011572,112,26,4,142
"11573",1011573,46,185,5,236
"11574",1011574,35,23,2,60
"11575",1011575,26,89,3,118
"11576",1011576,36,209,6,251
"11577",1011577,94,177,13,284
"11578",1011578,79,194,15,288
"11579",1011579,195,23,8,226
"11580",1011580,100,60,9,169
"11581",1011581,179,32,3,214
"11582",1011582,185,1,1,187
"11583",1011583,27,328,10,365
"11584",1011584,88,218,8,314
"11585",1011585,89,161,9,259
"11586",1011586,62,205,16,283
"11587",1011587,179,39,10,228
"11588",1011588,36,43,4,83
"11589",1011589,200,13,11,224
"11590",1011590,116,52,6,174
"11591",1011591,178,70,4,252
"11592",1011592,137,41,5,183
"11593",1011593,39,100,8,147
"11594",1011594,119,89,10,218
"11595",1011595,28,11,1,40
"11596",1011596,115,184,12,311
"11597",1011597,214,31,9,254
"11598",1011598,158,105,4,267
"11599",1011599,176,79,11,266
"11600",1011600,182,84,10,276
"11601",1011601,115,178,13,306
"11602",1011602,195,83,12,290
"11603",1011603,109,150,7,266
"11604",1011604,96,55,3,154
"11605",1011605,111,136,9,256
"11606",1011606,79,247,9,335
"11607",1011607,146,123,8,277
"11608",1011608,24,225,3,252
"11609",1011609,181,65,11,257
"11610",1011610,50,202,18,270
"11611",1011611,167,50,6,223
"11612",1011612,163,30,10,203
"11613",1011613,78,80,7,165
"11614",1011614,68,144,5,217
"11615",1011615,25,110,2,137
"11616",1011616,163,82,21,266
"11617",1011617,80,90,13,183
"11618",1011618,52,229,11,292
"11619",1011619,191,44,9,244
"11620",1011620,68,114,8,190
"11621",1011621,187,59,9,255
"11622",1011622,38,236,4,278
"11623",1011623,215,37,8,260
"11624",1011624,25,146,10,181
"11625",1011625,138,10,5,153
"11626",1011626,45,66,0,111
"11627",1011627,50,7,3,60
"11628",1011628,24,97,2,123
"11629",1011629,9,11,0,20
"11630",1011630,10,40,0,50
"11631",1011631,120,165,4,289
"11632",1011632,104,127,9,240
"11633",1011633,241,7,4,252
"11634",1011634,119,72,12,203
"11635",1011635,242,52,5,299
"11636",1011636,62,188,0,250
"11637",1011637,152,61,13,226
"11638",1011638,77,134,5,216
"11639",1011639,40,139,3,182
"11640",1011640,201,95,10,306
"11641",1011641,98,97,7,202
"11642",1011642,68,158,4,230
"11643",1011643,204,28,4,236
"11644",1011644,76,113,6,195
"11645",1011645,115,169,19,303
"11646",1011646,253,51,12,316
"11647",1011647,41,192,4,237
"11648",1011648,112,119,12,243
"11649",1011649,49,71,2,122
"11650",1011650,143,84,9,236
"11651",1011651,85,171,14,270
"11652",1011652,39,248,15,302
"11653",1011653,54,178,12,244
"11654",1011654,21,150,1,172
"11655",1011655,173,53,3,229
"11656",1011656,232,12,4,248
"11657",1011657,44,219,5,268
"11658",1011658,34,228,5,267
"11659",1011659,221,22,6,249
"11660",1011660,39,195,4,238
"11661",1011661,97,95,14,206
"11662",1011662,57,188,8,253
"11663",1011663,66,113,2,181
"11664",1011664,171,84,8,263
"11665",1011665,21,221,4,246
"11666",1011666,44,233,15,292
"11667",1011667,29,103,4,136
"11668",1011668,191,35,3,229
"11669",1011669,134,87,11,232
"11670",1011670,128,150,10,288
"11671",1011671,69,119,7,195
"11672",1011672,184,33,7,224
"11673",1011673,88,179,11,278
"11674",1011674,128,131,7,266
"11675",1011675,86,193,8,287
"11676",1011676,103,160,18,281
"11677",1011677,162,58,19,239
"11678",1011678,119,130,12,261
"11679",1011679,208,34,9,251
"11680",1011680,118,94,9,221
"11681",1011681,68,62,3,133
"11682",1011682,137,126,4,267
"11683",1011683,189,31,15,235
"11684",1011684,87,140,12,239
"11685",1011685,113,162,12,287
"11686",1011686,88,157,3,248
"11687",1011687,107,144,8,259
"11688",1011688,92,52,12,156
"11689",1011689,43,165,10,218
"11690",1011690,29,33,3,65
"11691",1011691,95,31,2,128
"11692",1011692,11,22,0,33
"11693",1011693,36,275,0,311
"11694",1011694,137,88,13,238
"11695",1011695,184,87,4,275
"11696",1011696,107,154,15,276
"11697",1011697,190,61,6,257
"11698",1011698,150,36,14,200
"11699",1011699,224,94,9,327
"11700",1011700,101,130,10,241
"11701",1011701,85,119,9,213
"11702",1011702,181,82,19,282
"11703",1011703,64,153,6,223
"11704",1011704,19,141,2,162
"11705",1011705,99,158,11,268
"11706",1011706,131,90,7,228
"11707",1011707,143,86,13,242
"11708",1011708,71,207,8,286
"11709",1011709,178,45,2,225
"11710",1011710,61,124,2,187
"11711",1011711,166,82,7,255
"11712",1011712,67,87,20,174
"11713",1011713,110,60,6,176
"11714",1011714,180,29,12,221
"11715",1011715,164,31,8,203
"11716",1011716,214,23,10,247
"11717",1011717,171,81,5,257
"11718",1011718,112,90,19,221
"11719",1011719,116,160,6,282
"11720",1011720,169,111,8,288
"11721",1011721,163,100,17,280
"11722",1011722,99,134,6,239
"11723",1011723,297,0,0,297
"11724",1011724,56,26,4,86
"11725",1011725,165,108,13,286
"11726",1011726,159,63,11,233
"11727",1011727,176,60,11,247
"11728",1011728,138,132,5,275
"11729",1011729,164,88,25,277
"11730",1011730,112,47,6,165
"11731",1011731,128,34,14,176
"11732",1011732,171,39,7,217
"11733",1011733,25,75,7,107
"11734",1011734,77,210,9,296
"11735",1011735,55,95,1,151
"11736",1011736,67,198,4,269
"11737",1011737,84,77,2,163
"11738",1011738,158,86,10,254
"11739",1011739,94,147,11,252
"11740",1011740,223,22,4,249
"11741",1011741,1,18,0,19
"11742",1011742,174,113,12,299
"11743",1011743,130,6,4,140
"11744",1011744,27,162,0,189
"11745",1011745,114,0,0,114
"11746",1011746,192,38,6,236
"11747",1011747,237,0,0,237
"11748",1011748,51,194,13,258
"11749",1011749,155,46,9,210
"11750",1011750,276,14,4,294
"11751",1011751,149,99,8,256
"11752",1011752,105,117,3,225
"11753",1011753,305,31,5,341
"11754",1011754,91,140,5,236
"11755",1011755,122,62,11,195
"11756",1011756,122,57,9,188
"11757",1011757,72,62,3,137
"11758",1011758,114,20,1,135
"11759",1011759,64,87,8,159
"11760",1011760,159,107,4,270
"11761",1011761,35,266,5,306
"11762",1011762,16,42,0,58
"11763",1011763,101,143,5,249
"11764",1011764,87,62,9,158
"11765",1011765,238,54,10,302
"11766",1011766,115,80,4,199
"11767",1011767,76,178,23,277
"11768",1011768,267,16,2,285
"11769",1011769,60,276,5,341
"11770",1011770,17,27,3,47
"11771",1011771,88,126,7,221
"11772",1011772,170,76,10,256
"11773",1011773,166,70,5,241
"11774",1011774,86,203,10,299
"11775",1011775,61,155,13,229
"11776",1011776,138,158,12,308
"11777",1011777,85,187,9,281
"11778",1011778,35,2,1,38
"11779",1011779,178,79,14,271
"11780",1011780,129,111,14,254
"11781",1011781,159,83,7,249
"11782",1011782,47,179,9,235
"11783",1011783,29,152,8,189
"11784",1011784,212,52,8,272
"11785",1011785,134,154,8,296
"11786",1011786,54,68,10,132
"11787",1011787,36,259,5,300
"11788",1011788,110,168,13,291
"11789",1011789,90,145,8,243
"11790",1011790,143,82,9,234
"11791",1011791,173,30,3,206
"11792",1011792,167,102,15,284
"11793",1011793,88,188,3,279
"11794",1011794,158,90,13,261
"11795",1011795,85,169,9,263
"11796",1011796,150,13,7,170
"11797",1011797,38,237,8,283
"11798",1011798,102,214,11,327
"11799",1011799,76,147,10,233
"11800",1011800,120,46,4,170
"11801",1011801,72,39,3,114
"11802",1011802,39,145,1,185
"11803",1011803,173,63,14,250
"11804",1011804,247,27,13,287
"11805",1011805,127,8,1,136
"11806",1011806,210,109,16,335
"11807",1011807,149,120,6,275
"11808",1011808,38,235,13,286
"11809",1011809,93,149,12,254
"11810",1011810,23,128,1,152
"11811",1011811,97,172,14,283
"11812",1011812,21,242,5,268
"11813",1011813,203,23,8,234
"11814",1011814,141,94,1,236
"11815",1011815,36,115,9,160
"11816",1011816,192,86,4,282
"11817",1011817,76,60,3,139
"11818",1011818,35,12,1,48
"11819",1011819,77,172,15,264
"11820",1011820,141,82,5,228
"11821",1011821,171,83,14,268
"11822",1011822,54,123,7,184
"11823",1011823,64,121,21,206
"11824",1011824,115,48,4,167
"11825",1011825,93,142,5,240
"11826",1011826,75,174,4,253
"11827",1011827,57,139,8,204
"11828",1011828,83,66,6,155
"11829",1011829,172,33,3,208
"11830",1011830,77,175,7,259
"11831",1011831,154,45,2,201
"11832",1011832,190,101,9,300
"11833",1011833,186,42,11,239
"11834",1011834,13,12,0,25
"11835",1011835,90,34,1,125
"11836",1011836,38,33,0,71
"11837",1011837,76,108,5,189
"11838",1011838,1,17,0,18
"11839",1011839,208,15,1,224
"11840",1011840,60,74,5,139
"11841",1011841,209,37,6,252
"11842",1011842,234,67,13,314
"11843",1011843,114,91,12,217
"11844",1011844,130,49,3,182
"11845",1011845,191,121,14,326
"11846",1011846,65,108,2,175
"11847",1011847,122,148,6,276
"11848",1011848,47,168,4,219
"11849",1011849,186,58,3,247
"11850",1011850,54,163,13,230
"11851",1011851,154,73,15,242
"11852",1011852,39,103,10,152
"11853",1011853,117,92,14,223
"11854",1011854,59,34,3,96
"11855",1011855,43,281,4,328
"11856",1011856,52,208,18,278
"11857",1011857,23,206,1,230
"11858",1011858,56,5,0,61
"11859",1011859,81,158,7,246
"11860",1011860,295,6,7,308
"11861",1011861,47,165,5,217
"11862",1011862,182,19,3,204
"11863",1011863,100,14,4,118
"11864",1011864,173,55,15,243
"11865",1011865,15,75,0,90
"11866",1011866,182,77,12,271
"11867",1011867,177,42,5,224
"11868",1011868,119,190,13,322
"11869",1011869,145,118,9,272
"11870",1011870,19,12,0,31
"11871",1011871,85,174,16,275
"11872",1011872,246,40,9,295
"11873",1011873,146,115,10,271
"11874",1011874,37,128,5,170
"11875",1011875,97,112,8,217
"11876",1011876,74,49,7,130
"11877",1011877,85,220,9,314
"11878",1011878,21,153,2,176
"11879",1011879,66,245,7,318
"11880",1011880,49,54,1,104
"11881",1011881,126,122,10,258
"11882",1011882,102,135,2,239
"11883",1011883,131,51,12,194
"11884",1011884,69,153,8,230
"11885",1011885,0,0,0,0
"11886",1011886,78,87,7,172
"11887",1011887,33,195,0,228
"11888",1011888,52,247,12,311
"11889",1011889,144,39,7,190
"11890",1011890,173,122,7,302
"11891",1011891,53,237,7,297
"11892",1011892,130,24,3,157
"11893",1011893,141,96,9,246
"11894",1011894,92,154,8,254
"11895",1011895,108,188,2,298
"11896",1011896,182,102,5,289
"11897",1011897,117,207,10,334
"11898",1011898,80,15,2,97
"11899",1011899,140,63,19,222
"11900",1011900,162,89,13,264
"11901",1011901,105,153,6,264
"11902",1011902,12,23,0,35
"11903",1011903,80,227,3,310
"11904",1011904,119,140,16,275
"11905",1011905,230,23,6,259
"11906",1011906,36,66,9,111
"11907",1011907,184,95,13,292
"11908",1011908,120,143,7,270
"11909",1011909,64,150,4,218
"11910",1011910,175,123,14,312
"11911",1011911,178,35,1,214
"11912",1011912,138,158,18,314
"11913",1011913,89,109,10,208
"11914",1011914,101,8,2,111
"11915",1011915,148,57,16,221
"11916",1011916,162,65,18,245
"11917",1011917,39,200,4,243
"11918",1011918,62,186,16,264
"11919",1011919,93,201,8,302
"11920",1011920,106,96,3,205
"11921",1011921,205,53,10,268
"11922",1011922,82,51,12,145
"11923",1011923,214,29,4,247
"11924",1011924,150,78,21,249
"11925",1011925,0,0,0,0
"11926",1011926,71,83,2,156
"11927",1011927,211,78,4,293
"11928",1011928,131,58,6,195
"11929",1011929,119,110,5,234
"11930",1011930,118,98,14,230
"11931",1011931,11,3,0,14
"11932",1011932,67,178,4,249
"11933",1011933,46,134,3,183
"11934",1011934,155,113,11,279
"11935",1011935,192,92,7,291
"11936",1011936,138,149,6,293
"11937",1011937,85,44,7,136
"11938",1011938,147,76,10,233
"11939",1011939,145,64,8,217
"11940",1011940,117,182,9,308
"11941",1011941,114,57,12,183
"11942",1011942,105,81,16,202
"11943",1011943,149,66,19,234
"11944",1011944,156,48,8,212
"11945",1011945,53,165,5,223
"11946",1011946,184,84,13,281
"11947",1011947,58,36,6,100
"11948",1011948,122,130,34,286
"11949",1011949,169,66,12,247
"11950",1011950,31,155,2,188
"11951",1011951,39,136,3,178
"11952",1011952,29,224,3,256
"11953",1011953,110,131,9,250
"11954",1011954,128,96,5,229
"11955",1011955,115,189,9,313
"11956",1011956,196,38,5,239
"11957",1011957,136,94,8,238
"11958",1011958,96,78,2,176
"11959",1011959,8,20,1,29
"11960",1011960,53,150,6,209
"11961",1011961,16,25,2,43
"11962",1011962,85,216,24,325
"11963",1011963,119,95,12,226
"11964",1011964,164,26,3,193
"11965",1011965,116,50,0,166
"11966",1011966,61,184,17,262
"11967",1011967,52,227,7,286
"11968",1011968,71,186,9,266
"11969",1011969,205,29,6,240
"11970",1011970,113,180,4,297
"11971",1011971,30,242,5,277
"11972",1011972,146,52,1,199
"11973",1011973,59,21,4,84
"11974",1011974,119,146,14,279
"11975",1011975,85,250,5,340
"11976",1011976,66,101,2,169
"11977",1011977,78,3,3,84
"11978",1011978,57,196,10,263
"11979",1011979,36,205,2,243
"11980",1011980,99,114,1,214
"11981",1011981,102,86,12,200
"11982",1011982,62,27,6,95
"11983",1011983,118,49,2,169
"11984",1011984,94,143,5,242
"11985",1011985,68,18,3,89
"11986",1011986,7,137,1,145
"11987",1011987,26,215,6,247
"11988",1011988,148,32,3,183
"11989",1011989,6,17,4,27
"11990",1011990,99,52,3,154
"11991",1011991,80,186,8,274
"11992",1011992,80,63,7,150
"11993",1011993,151,34,9,194
"11994",1011994,101,180,7,288
"11995",1011995,231,114,11,356
"11996",1011996,234,19,10,263
"11997",1011997,71,30,7,108
"11998",1011998,175,19,4,198
"11999",1011999,78,185,4,267
"12000",1012000,71,198,24,293
"12001",1012001,77,42,4,123
"12002",1012002,133,39,3,175
"12003",1012003,21,36,3,60
"12004",1012004,181,65,26,272
"12005",1012005,42,169,5,216
"12006",1012006,67,177,14,258
"12007",1012007,36,167,10,213
"12008",1012008,84,159,2,245
"12009",1012009,126,19,4,149
"12010",1012010,146,1,0,147
"12011",1012011,104,114,20,238
"12012",1012012,112,172,15,299
"12013",1012013,152,65,15,232
"12014",1012014,198,16,6,220
"12015",1012015,204,48,13,265
"12016",1012016,25,125,1,151
"12017",1012017,5,7,0,12
"12018",1012018,154,36,4,194
"12019",1012019,69,172,6,247
"12020",1012020,185,119,10,314
"12021",1012021,105,183,4,292
"12022",1012022,33,165,12,210
"12023",1012023,203,76,16,295
"12024",1012024,172,84,20,276
"12025",1012025,171,35,2,208
"12026",1012026,107,117,15,239
"12027",1012027,106,193,14,313
"12028",1012028,127,60,5,192
"12029",1012029,108,163,4,275
"12030",1012030,112,121,12,245
"12031",1012031,163,51,4,218
"12032",1012032,172,97,18,287
"12033",1012033,191,25,5,221
"12034",1012034,104,157,9,270
"12035",1012035,153,84,11,248
"12036",1012036,136,98,6,240
"12037",1012037,134,129,12,275
"12038",1012038,148,17,4,169
"12039",1012039,26,142,5,173
"12040",1012040,115,165,9,289
"12041",1012041,154,84,4,242
"12042",1012042,160,102,13,275
"12043",1012043,103,170,1,274
"12044",1012044,146,20,2,168
"12045",1012045,108,33,4,145
"12046",1012046,178,87,6,271
"12047",1012047,151,70,2,223
"12048",1012048,168,107,17,292
"12049",1012049,202,93,5,300
"12050",1012050,139,101,18,258
"12051",1012051,58,212,13,283
"12052",1012052,149,69,10,228
"12053",1012053,172,33,9,214
"12054",1012054,71,20,2,93
"12055",1012055,160,29,5,194
"12056",1012056,234,30,6,270
"12057",1012057,145,71,1,217
"12058",1012058,42,16,5,63
"12059",1012059,100,70,1,171
"12060",1012060,184,29,9,222
"12061",1012061,151,127,6,284
"12062",1012062,140,34,3,177
"12063",1012063,40,43,1,84
"12064",1012064,41,122,7,170
"12065",1012065,129,40,9,178
"12066",1012066,83,172,16,271
"12067",1012067,166,85,7,258
"12068",1012068,145,131,13,289
"12069",1012069,63,65,1,129
"12070",1012070,22,66,2,90
"12071",1012071,61,278,9,348
"12072",1012072,9,6,0,15
"12073",1012073,118,79,10,207
"12074",1012074,178,69,17,264
"12075",1012075,149,29,3,181
"12076",1012076,10,7,0,17
"12077",1012077,67,10,2,79
"12078",1012078,88,52,10,150
"12079",1012079,157,53,6,216
"12080",1012080,228,37,11,276
"12081",1012081,182,93,6,281
"12082",1012082,180,46,6,232
"12083",1012083,100,87,12,199
"12084",1012084,30,300,4,334
"12085",1012085,199,47,8,254
"12086",1012086,138,43,10,191
"12087",1012087,46,5,4,55
"12088",1012088,94,95,3,192
"12089",1012089,75,97,4,176
"12090",1012090,91,125,7,223
"12091",1012091,205,89,5,299
"12092",1012092,41,120,4,165
"12093",1012093,112,104,3,219
"12094",1012094,100,144,11,255
"12095",1012095,5,10,1,16
"12096",1012096,72,136,3,211
"12097",1012097,26,219,11,256
"12098",1012098,73,35,1,109
"12099",1012099,184,30,5,219
"12100",1012100,152,124,9,285
"12101",1012101,170,62,2,234
"12102",1012102,43,218,7,268
"12103",1012103,81,272,5,358
"12104",1012104,99,72,2,173
"12105",1012105,165,111,4,280
"12106",1012106,76,163,12,251
"12107",1012107,122,78,12,212
"12108",1012108,111,88,6,205
"12109",1012109,54,153,7,214
"12110",1012110,40,5,2,47
"12111",1012111,96,54,6,156
"12112",1012112,93,164,11,268
"12113",1012113,85,83,5,173
"12114",1012114,85,171,5,261
"12115",1012115,182,106,12,300
"12116",1012116,48,162,8,218
"12117",1012117,66,104,8,178
"12118",1012118,163,22,3,188
"12119",1012119,90,100,17,207
"12120",1012120,91,203,8,302
"12121",1012121,70,121,18,209
"12122",1012122,106,119,10,235
"12123",1012123,10,215,5,230
"12124",1012124,65,207,3,275
"12125",1012125,123,162,3,288
"12126",1012126,145,139,1,285
"12127",1012127,42,147,6,195
"12128",1012128,83,146,8,237
"12129",1012129,97,146,7,250
"12130",1012130,111,174,6,291
"12131",1012131,92,202,11,305
"12132",1012132,204,58,9,271
"12133",1012133,100,68,6,174
"12134",1012134,201,43,13,257
"12135",1012135,40,143,2,185
"12136",1012136,245,40,9,294
"12137",1012137,61,197,3,261
"12138",1012138,61,46,6,113
"12139",1012139,26,234,8,268
"12140",1012140,143,111,16,270
"12141",1012141,160,137,5,302
"12142",1012142,76,195,17,288
"12143",1012143,71,154,11,236
"12144",1012144,79,57,5,141
"12145",1012145,145,54,14,213
"12146",1012146,138,53,4,195
"12147",1012147,239,57,7,303
"12148",1012148,201,49,12,262
"12149",1012149,41,318,4,363
"12150",1012150,75,63,7,145
"12151",1012151,52,254,8,314
"12152",1012152,150,98,12,260
"12153",1012153,28,192,5,225
"12154",1012154,109,105,16,230
"12155",1012155,52,162,2,216
"12156",1012156,150,89,8,247
"12157",1012157,148,89,8,245
"12158",1012158,67,206,5,278
"12159",1012159,144,147,1,292
"12160",1012160,122,87,13,222
"12161",1012161,81,166,26,273
"12162",1012162,125,174,12,311
"12163",1012163,171,9,3,183
"12164",1012164,154,3,1,158
"12165",1012165,41,177,9,227
"12166",1012166,205,43,6,254
"12167",1012167,218,40,9,267
"12168",1012168,134,19,2,155
"12169",1012169,93,146,12,251
"12170",1012170,119,90,3,212
"12171",1012171,129,27,5,161
"12172",1012172,118,155,4,277
"12173",1012173,24,64,1,89
"12174",1012174,35,143,4,182
"12175",1012175,73,127,11,211
"12176",1012176,111,23,5,139
"12177",1012177,181,126,13,320
"12178",1012178,118,214,10,342
"12179",1012179,113,99,18,230
"12180",1012180,19,174,6,199
"12181",1012181,7,193,0,200
"12182",1012182,21,201,5,227
"12183",1012183,215,10,6,231
"12184",1012184,85,31,3,119
"12185",1012185,184,40,11,235
"12186",1012186,149,60,2,211
"12187",1012187,64,165,8,237
"12188",1012188,107,151,6,264
"12189",1012189,75,188,16,279
"12190",1012190,168,24,2,194
"12191",1012191,113,37,3,153
"12192",1012192,210,31,0,241
"12193",1012193,76,107,13,196
"12194",1012194,164,15,1,180
"12195",1012195,12,38,4,54
"12196",1012196,61,55,5,121
"12197",1012197,136,87,11,234
"12198",1012198,113,17,5,135
"12199",1012199,172,52,1,225
"12200",1012200,140,89,9,238
"12201",1012201,152,122,9,283
"12202",1012202,33,60,4,97
"12203",1012203,47,228,11,286
"12204",1012204,15,17,4,36
"12205",1012205,187,21,8,216
"12206",1012206,78,110,15,203
"12207",1012207,213,68,9,290
"12208",1012208,107,38,3,148
"12209",1012209,16,106,1,123
"12210",1012210,66,184,13,263
"12211",1012211,173,102,15,290
"12212",1012212,47,227,19,293
"12213",1012213,74,113,4,191
"12214",1012214,206,34,5,245
"12215",1012215,99,60,5,164
"12216",1012216,91,45,3,139
"12217",1012217,136,83,6,225
"12218",1012218,111,103,11,225
"12219",1012219,143,113,5,261
"12220",1012220,23,52,3,78
"12221",1012221,178,109,11,298
"12222",1012222,148,101,8,257
"12223",1012223,48,25,1,74
"12224",1012224,59,200,9,268
"12225",1012225,112,176,3,291
"12226",1012226,154,82,6,242
"12227",1012227,101,164,6,271
"12228",1012228,3,25,1,29
"12229",1012229,27,143,1,171
"12230",1012230,222,29,9,260
"12231",1012231,77,72,21,170
"12232",1012232,61,94,11,166
"12233",1012233,79,119,7,205
"12234",1012234,320,9,5,334
"12235",1012235,122,52,10,184
"12236",1012236,72,187,11,270
"12237",1012237,74,102,9,185
"12238",1012238,31,151,4,186
"12239",1012239,39,235,4,278
"12240",1012240,190,45,4,239
"12241",1012241,143,67,4,214
"12242",1012242,41,257,10,308
"12243",1012243,103,184,14,301
"12244",1012244,31,204,1,236
"12245",1012245,51,171,10,232
"12246",1012246,140,32,10,182
"12247",1012247,142,78,12,232
"12248",1012248,104,24,1,129
"12249",1012249,48,172,20,240
"12250",1012250,60,150,9,219
"12251",1012251,87,134,16,237
"12252",1012252,88,196,9,293
"12253",1012253,83,120,10,213
"12254",1012254,191,3,0,194
"12255",1012255,10,147,9,166
"12256",1012256,96,36,5,137
"12257",1012257,87,42,10,139
"12258",1012258,217,43,10,270
"12259",1012259,126,108,11,245
"12260",1012260,105,125,7,237
"12261",1012261,86,6,5,97
"12262",1012262,129,86,8,223
"12263",1012263,148,91,5,244
"12264",1012264,111,41,9,161
"12265",1012265,90,108,14,212
"12266",1012266,158,44,2,204
"12267",1012267,95,200,10,305
"12268",1012268,70,47,11,128
"12269",1012269,111,84,8,203
"12270",1012270,46,197,4,247
"12271",1012271,82,91,6,179
"12272",1012272,156,83,5,244
"12273",1012273,140,53,5,198
"12274",1012274,286,101,8,395
"12275",1012275,60,211,14,285
"12276",1012276,157,50,10,217
"12277",1012277,29,154,6,189
"12278",1012278,120,118,17,255
"12279",1012279,30,135,6,171
"12280",1012280,186,44,26,256
"12281",1012281,99,118,8,225
"12282",1012282,102,135,13,250
"12283",1012283,83,69,11,163
"12284",1012284,237,17,6,260
"12285",1012285,70,183,7,260
"12286",1012286,59,210,4,273
"12287",1012287,159,63,8,230
"12288",1012288,222,52,8,282
"12289",1012289,232,37,9,278
"12290",1012290,90,70,2,162
"12291",1012291,77,49,6,132
"12292",1012292,83,195,7,285
"12293",1012293,176,48,6,230
"12294",1012294,10,1,1,12
"12295",1012295,110,137,9,256
"12296",1012296,45,21,3,69
"12297",1012297,58,13,3,74
"12298",1012298,52,229,6,287
"12299",1012299,179,42,15,236
"12300",1012300,67,172,11,250
"12301",1012301,49,142,7,198
"12302",1012302,120,85,5,210
"12303",1012303,93,157,21,271
"12304",1012304,175,67,14,256
"12305",1012305,5,25,1,31
"12306",1012306,4,17,1,22
"12307",1012307,122,190,5,317
"12308",1012308,119,39,8,166
"12309",1012309,150,29,3,182
"12310",1012310,15,126,3,144
"12311",1012311,50,240,4,294
"12312",1012312,161,62,6,229
"12313",1012313,96,206,24,326
"12314",1012314,81,240,7,328
"12315",1012315,124,173,4,301
"12316",1012316,174,87,2,263
"12317",1012317,163,67,5,235
"12318",1012318,43,127,6,176
"12319",1012319,122,55,2,179
"12320",1012320,13,0,0,13
"12321",1012321,123,115,10,248
"12322",1012322,95,148,4,247
"12323",1012323,105,165,2,272
"12324",1012324,141,104,9,254
"12325",1012325,20,177,3,200
"12326",1012326,42,13,1,56
"12327",1012327,95,96,10,201
"12328",1012328,100,132,8,240
"12329",1012329,74,127,8,209
"12330",1012330,95,104,8,207
"12331",1012331,216,36,5,257
"12332",1012332,97,103,4,204
"12333",1012333,47,159,7,213
"12334",1012334,49,145,4,198
"12335",1012335,180,84,12,276
"12336",1012336,51,263,10,324
"12337",1012337,83,197,11,291
"12338",1012338,45,227,2,274
"12339",1012339,183,63,12,258
"12340",1012340,37,254,3,294
"12341",1012341,49,210,5,264
"12342",1012342,66,214,12,292
"12343",1012343,90,139,6,235
"12344",1012344,160,11,4,175
"12345",1012345,155,59,5,219
"12346",1012346,188,35,7,230
"12347",1012347,118,46,6,170
"12348",1012348,58,112,11,181
"12349",1012349,46,234,2,282
"12350",1012350,89,131,6,226
"12351",1012351,44,163,2,209
"12352",1012352,124,123,4,251
"12353",1012353,81,144,15,240
"12354",1012354,34,90,2,126
"12355",1012355,90,186,5,281
"12356",1012356,176,88,10,274
"12357",1012357,111,110,6,227
"12358",1012358,81,29,0,110
"12359",1012359,122,21,5,148
"12360",1012360,61,157,12,230
"12361",1012361,152,21,9,182
"12362",1012362,83,178,0,261
"12363",1012363,111,96,2,209
"12364",1012364,18,197,4,219
"12365",1012365,70,245,6,321
"12366",1012366,96,203,16,315
"12367",1012367,141,128,15,284
"12368",1012368,148,30,9,187
"12369",1012369,141,160,15,316
"12370",1012370,133,23,7,163
"12371",1012371,10,44,0,54
"12372",1012372,172,95,15,282
"12373",1012373,168,76,20,264
"12374",1012374,18,164,8,190
"12375",1012375,111,46,5,162
"12376",1012376,186,74,8,268
"12377",1012377,70,67,2,139
"12378",1012378,81,217,7,305
"12379",1012379,63,86,6,155
"12380",1012380,131,157,20,308
"12381",1012381,92,133,11,236
"12382",1012382,138,134,9,281
"12383",1012383,123,120,9,252
"12384",1012384,188,59,18,265
"12385",1012385,60,188,13,261
"12386",1012386,163,33,4,200
"12387",1012387,125,68,12,205
"12388",1012388,85,35,9,129
"12389",1012389,95,167,12,274
"12390",1012390,72,106,6,184
"12391",1012391,77,147,8,232
"12392",1012392,148,122,19,289
"12393",1012393,94,77,7,178
"12394",1012394,52,187,6,245
"12395",1012395,69,179,5,253
"12396",1012396,153,6,1,160
"12397",1012397,109,90,15,214
"12398",1012398,101,152,7,260
"12399",1012399,130,114,10,254
"12400",1012400,136,63,12,211
"12401",1012401,36,171,2,209
"12402",1012402,66,34,6,106
"12403",1012403,157,106,5,268
"12404",1012404,90,168,13,271
"12405",1012405,3,13,1,17
"12406",1012406,118,51,4,173
"12407",1012407,134,16,6,156
"12408",1012408,62,182,13,257
"12409",1012409,284,30,11,325
"12410",1012410,106,86,4,196
"12411",1012411,30,12,0,42
"12412",1012412,105,173,13,291
"12413",1012413,204,29,8,241
"12414",1012414,75,90,5,170
"12415",1012415,244,46,10,300
"12416",1012416,115,46,5,166
"12417",1012417,147,105,4,256
"12418",1012418,170,19,8,197
"12419",1012419,172,49,8,229
"12420",1012420,213,53,7,273
"12421",1012421,171,44,4,219
"12422",1012422,209,20,6,235
"12423",1012423,104,100,7,211
"12424",1012424,26,65,6,97
"12425",1012425,52,253,6,311
"12426",1012426,172,64,7,243
"12427",1012427,59,186,19,264
"12428",1012428,38,149,2,189
"12429",1012429,43,44,4,91
"12430",1012430,76,131,12,219
"12431",1012431,124,77,10,211
"12432",1012432,84,115,4,203
"12433",1012433,147,26,7,180
"12434",1012434,15,44,0,59
"12435",1012435,139,49,5,193
"12436",1012436,7,5,1,13
"12437",1012437,258,22,6,286
"12438",1012438,183,9,5,197
"12439",1012439,34,52,2,88
"12440",1012440,64,194,9,267
"12441",1012441,170,124,9,303
"12442",1012442,137,120,15,272
"12443",1012443,127,147,15,289
"12444",1012444,125,119,8,252
"12445",1012445,154,24,6,184
"12446",1012446,77,66,4,147
"12447",1012447,167,62,6,235
"12448",1012448,114,112,12,238
"12449",1012449,96,158,24,278
"12450",1012450,102,181,8,291
"12451",1012451,31,12,3,46
"12452",1012452,140,64,6,210
"12453",1012453,187,82,6,275
"12454",1012454,167,21,4,192
"12455",1012455,36,139,5,180
"12456",1012456,185,53,9,247
"12457",1012457,102,156,7,265
"12458",1012458,59,30,1,90
"12459",1012459,186,23,17,226
"12460",1012460,139,140,11,290
"12461",1012461,92,110,11,213
"12462",1012462,6,3,0,9
"12463",1012463,13,64,4,81
"12464",1012464,174,81,16,271
"12465",1012465,142,61,1,204
"12466",1012466,120,21,10,151
"12467",1012467,112,96,3,211
"12468",1012468,147,93,12,252
"12469",1012469,102,16,2,120
"12470",1012470,125,139,11,275
"12471",1012471,31,154,3,188
"12472",1012472,21,19,3,43
"12473",1012473,147,124,6,277
"12474",1012474,226,35,10,271
"12475",1012475,115,19,5,139
"12476",1012476,45,14,6,65
"12477",1012477,177,49,4,230
"12478",1012478,59,65,6,130
"12479",1012479,281,25,1,307
"12480",1012480,111,38,3,152
"12481",1012481,106,98,9,213
"12482",1012482,66,95,6,167
"12483",1012483,43,221,12,276
"12484",1012484,86,70,12,168
"12485",1012485,113,308,14,435
"12486",1012486,83,172,12,267
"12487",1012487,125,188,7,320
"12488",1012488,126,121,10,257
"12489",1012489,124,109,10,243
"12490",1012490,47,208,11,266
"12491",1012491,138,20,1,159
"12492",1012492,16,18,1,35
"12493",1012493,158,88,11,257
"12494",1012494,106,128,9,243
"12495",1012495,90,172,18,280
"12496",1012496,160,172,12,344
"12497",1012497,52,127,8,187
"12498",1012498,208,71,29,308
"12499",1012499,239,7,3,249
"12500",1012500,10,205,2,217
"12501",1012501,90,60,5,155
"12502",1012502,63,186,10,259
"12503",1012503,152,61,8,221
"12504",1012504,50,193,3,246
"12505",1012505,105,209,17,331
"12506",1012506,3,5,2,10
"12507",1012507,164,69,17,250
"12508",1012508,34,150,6,190
"12509",1012509,131,107,22,260
"12510",1012510,278,68,17,363
"12511",1012511,84,192,12,288
"12512",1012512,28,292,4,324
"12513",1012513,229,10,3,242
"12514",1012514,176,173,15,364
"12515",1012515,226,27,6,259
"12516",1012516,90,125,2,217
"12517",1012517,132,66,8,206
"12518",1012518,232,63,20,315
"12519",1012519,112,88,7,207
"12520",1012520,114,58,6,178
"12521",1012521,111,106,24,241
"12522",1012522,213,25,5,243
"12523",1012523,56,137,8,201
"12524",1012524,117,43,5,165
"12525",1012525,245,40,5,290
"12526",1012526,45,169,2,216
"12527",1012527,155,15,6,176
"12528",1012528,81,123,4,208
"12529",1012529,193,23,10,226
"12530",1012530,164,73,14,251
"12531",1012531,127,28,8,163
"12532",1012532,113,158,14,285
"12533",1012533,68,185,6,259
"12534",1012534,66,188,2,256
"12535",1012535,226,22,3,251
"12536",1012536,23,301,5,329
"12537",1012537,49,141,8,198
"12538",1012538,108,105,9,222
"12539",1012539,49,10,6,65
"12540",1012540,190,11,8,209
"12541",1012541,138,81,4,223
"12542",1012542,23,173,3,199
"12543",1012543,179,73,9,261
"12544",1012544,227,9,5,241
"12545",1012545,32,48,5,85
"12546",1012546,194,33,10,237
"12547",1012547,63,145,12,220
"12548",1012548,62,226,2,290
"12549",1012549,90,154,9,253
"12550",1012550,47,66,4,117
"12551",1012551,111,143,11,265
"12552",1012552,84,232,6,322
"12553",1012553,57,187,7,251
"12554",1012554,41,150,19,210
"12555",1012555,115,116,22,253
"12556",1012556,83,5,5,93
"12557",1012557,108,77,7,192
"12558",1012558,101,81,12,194
"12559",1012559,33,58,21,112
"12560",1012560,166,135,10,311
"12561",1012561,187,46,10,243
"12562",1012562,140,70,5,215
"12563",1012563,7,63,1,71
"12564",1012564,107,105,4,216
"12565",1012565,115,50,2,167
"12566",1012566,230,20,7,257
"12567",1012567,177,24,7,208
"12568",1012568,183,3,2,188
"12569",1012569,163,86,4,253
"12570",1012570,220,33,6,259
"12571",1012571,101,183,8,292
"12572",1012572,110,54,2,166
"12573",1012573,56,235,11,302
"12574",1012574,45,119,4,168
"12575",1012575,65,196,15,276
"12576",1012576,21,14,0,35
"12577",1012577,75,170,11,256
"12578",1012578,84,180,11,275
"12579",1012579,179,103,10,292
"12580",1012580,105,61,5,171
"12581",1012581,124,111,2,237
"12582",1012582,67,138,5,210
"12583",1012583,87,167,9,263
"12584",1012584,186,31,6,223
"12585",1012585,97,159,9,265
"12586",1012586,166,14,3,183
"12587",1012587,99,62,6,167
"12588",1012588,128,145,4,277
"12589",1012589,98,75,3,176
"12590",1012590,127,183,4,314
"12591",1012591,30,182,4,216
"12592",1012592,220,114,20,354
"12593",1012593,131,95,6,232
"12594",1012594,230,7,2,239
"12595",1012595,106,143,2,251
"12596",1012596,12,73,4,89
"12597",1012597,102,65,7,174
"12598",1012598,155,53,4,212
"12599",1012599,53,197,12,262
"12600",1012600,136,39,7,182
"12601",1012601,112,76,9,197
"12602",1012602,21,234,3,258
"12603",1012603,133,53,13,199
"12604",1012604,67,177,9,253
"12605",1012605,232,33,5,270
"12606",1012606,213,70,28,311
"12607",1012607,114,135,13,262
"12608",1012608,49,196,7,252
"12609",1012609,196,65,7,268
"12610",1012610,173,130,12,315
"12611",1012611,68,144,23,235
"12612",1012612,101,53,6,160
"12613",1012613,139,125,9,273
"12614",1012614,49,70,2,121
"12615",1012615,64,157,4,225
"12616",1012616,187,21,12,220
"12617",1012617,68,155,3,226
"12618",1012618,59,58,5,122
"12619",1012619,243,23,8,274
"12620",1012620,87,231,16,334
"12621",1012621,65,139,32,236
"12622",1012622,98,199,3,300
"12623",1012623,126,137,18,281
"12624",1012624,152,148,12,312
"12625",1012625,179,96,2,277
"12626",1012626,29,228,2,259
"12627",1012627,98,165,20,283
"12628",1012628,21,11,0,32
"12629",1012629,58,169,9,236
"12630",1012630,23,172,7,202
"12631",1012631,189,51,7,247
"12632",1012632,72,74,8,154
"12633",1012633,136,134,12,282
"12634",1012634,34,259,4,297
"12635",1012635,73,151,5,229
"12636",1012636,83,161,16,260
"12637",1012637,96,195,9,300
"12638",1012638,20,287,13,320
"12639",1012639,155,32,6,193
"12640",1012640,78,99,5,182
"12641",1012641,210,22,2,234
"12642",1012642,128,64,6,198
"12643",1012643,95,113,14,222
"12644",1012644,79,59,7,145
"12645",1012645,71,150,9,230
"12646",1012646,35,229,12,276
"12647",1012647,70,221,14,305
"12648",1012648,203,25,0,228
"12649",1012649,45,229,1,275
"12650",1012650,28,117,1,146
"12651",1012651,156,43,5,204
"12652",1012652,21,23,3,47
"12653",1012653,81,101,15,197
"12654",1012654,66,277,9,352
"12655",1012655,158,62,11,231
"12656",1012656,181,41,3,225
"12657",1012657,75,204,11,290
"12658",1012658,198,79,2,279
"12659",1012659,39,65,1,105
"12660",1012660,127,8,0,135
"12661",1012661,62,238,18,318
"12662",1012662,118,95,11,224
"12663",1012663,153,28,5,186
"12664",1012664,35,248,22,305
"12665",1012665,56,230,6,292
"12666",1012666,58,118,8,184
"12667",1012667,146,141,11,298
"12668",1012668,173,31,4,208
"12669",1012669,65,168,4,237
"12670",1012670,228,21,8,257
"12671",1012671,72,169,5,246
"12672",1012672,53,220,4,277
"12673",1012673,216,32,14,262
"12674",1012674,3,110,2,115
"12675",1012675,79,181,7,267
"12676",1012676,154,109,8,271
"12677",1012677,37,161,3,201
"12678",1012678,55,12,2,69
"12679",1012679,45,47,7,99
"12680",1012680,36,232,10,278
"12681",1012681,189,49,14,252
"12682",1012682,91,145,3,239
"12683",1012683,60,160,7,227
"12684",1012684,212,14,0,226
"12685",1012685,144,121,10,275
"12686",1012686,116,100,9,225
"12687",1012687,237,22,12,271
"12688",1012688,208,73,6,287
"12689",1012689,72,139,7,218
"12690",1012690,37,27,0,64
"12691",1012691,129,140,3,272
"12692",1012692,27,16,5,48
"12693",1012693,115,139,13,267
"12694",1012694,108,137,23,268
"12695",1012695,55,189,4,248
"12696",1012696,42,36,5,83
"12697",1012697,208,62,7,277
"12698",1012698,93,9,3,105
"12699",1012699,171,35,7,213
"12700",1012700,152,60,3,215
"12701",1012701,85,2,2,89
"12702",1012702,111,33,5,149
"12703",1012703,102,91,5,198
"12704",1012704,8,27,0,35
"12705",1012705,149,45,10,204
"12706",1012706,45,204,10,259
"12707",1012707,244,29,7,280
"12708",1012708,100,142,15,257
"12709",1012709,136,63,3,202
"12710",1012710,171,50,5,226
"12711",1012711,157,9,3,169
"12712",1012712,74,51,11,136
"12713",1012713,185,15,4,204
"12714",1012714,136,108,23,267
"12715",1012715,194,88,18,300
"12716",1012716,89,73,2,164
"12717",1012717,118,74,13,205
"12718",1012718,270,2,2,274
"12719",1012719,44,69,7,120
"12720",1012720,187,33,9,229
"12721",1012721,38,143,6,187
"12722",1012722,14,288,0,302
"12723",1012723,39,51,2,92
"12724",1012724,109,134,6,249
"12725",1012725,3,1,0,4
"12726",1012726,25,171,0,196
"12727",1012727,64,109,12,185
"12728",1012728,136,93,6,235
"12729",1012729,134,65,3,202
"12730",1012730,238,98,15,351
"12731",1012731,106,139,9,254
"12732",1012732,142,13,10,165
"12733",1012733,3,25,2,30
"12734",1012734,35,148,4,187
"12735",1012735,32,186,4,222
"12736",1012736,69,153,5,227
"12737",1012737,209,35,9,253
"12738",1012738,14,61,0,75
"12739",1012739,167,51,6,224
"12740",1012740,11,293,3,307
"12741",1012741,36,161,4,201
"12742",1012742,256,10,2,268
"12743",1012743,167,0,0,167
"12744",1012744,100,181,11,292
"12745",1012745,186,28,3,217
"12746",1012746,81,16,0,97
"12747",1012747,26,47,1,74
"12748",1012748,98,141,16,255
"12749",1012749,3,29,0,32
"12750",1012750,107,81,12,200
"12751",1012751,52,139,8,199
"12752",1012752,0,0,0,0
"12753",1012753,205,101,9,315
"12754",1012754,7,22,2,31
"12755",1012755,47,126,17,190
"12756",1012756,93,72,28,193
"12757",1012757,142,25,11,178
"12758",1012758,131,116,7,254
"12759",1012759,139,116,10,265
"12760",1012760,38,191,3,232
"12761",1012761,123,184,7,314
"12762",1012762,148,96,10,254
"12763",1012763,40,241,2,283
"12764",1012764,28,123,2,153
"12765",1012765,154,66,6,226
"12766",1012766,38,79,3,120
"12767",1012767,53,22,2,77
"12768",1012768,123,123,4,250
"12769",1012769,222,80,11,313
"12770",1012770,64,125,12,201
"12771",1012771,85,61,3,149
"12772",1012772,53,185,13,251
"12773",1012773,50,146,3,199
"12774",1012774,140,65,14,219
"12775",1012775,162,71,10,243
"12776",1012776,238,59,4,301
"12777",1012777,146,22,8,176
"12778",1012778,107,169,18,294
"12779",1012779,119,28,12,159
"12780",1012780,186,49,7,242
"12781",1012781,73,90,3,166
"12782",1012782,167,67,6,240
"12783",1012783,101,92,3,196
"12784",1012784,139,43,7,189
"12785",1012785,123,92,11,226
"12786",1012786,110,207,5,322
"12787",1012787,47,153,6,206
"12788",1012788,35,277,7,319
"12789",1012789,165,76,8,249
"12790",1012790,82,257,5,344
"12791",1012791,132,20,4,156
"12792",1012792,97,20,0,117
"12793",1012793,72,173,5,250
"12794",1012794,151,124,2,277
"12795",1012795,110,94,5,209
"12796",1012796,151,139,19,309
"12797",1012797,85,163,6,254
"12798",1012798,144,54,5,203
"12799",1012799,178,66,9,253
"12800",1012800,172,97,5,274
"12801",1012801,91,170,7,268
"12802",1012802,200,114,15,329
"12803",1012803,91,173,10,274
"12804",1012804,73,182,9,264
"12805",1012805,69,137,5,211
"12806",1012806,27,203,2,232
"12807",1012807,175,140,18,333
"12808",1012808,21,15,5,41
"12809",1012809,80,187,6,273
"12810",1012810,176,18,4,198
"12811",1012811,99,35,7,141
"12812",1012812,23,187,6,216
"12813",1012813,181,25,4,210
"12814",1012814,99,101,15,215
"12815",1012815,27,259,13,299
"12816",1012816,40,10,5,55
"12817",1012817,201,79,26,306
"12818",1012818,152,153,7,312
"12819",1012819,121,73,6,200
"12820",1012820,76,227,19,322
"12821",1012821,98,98,12,208
"12822",1012822,44,152,1,197
"12823",1012823,149,38,5,192
"12824",1012824,135,115,9,259
"12825",1012825,114,22,3,139
"12826",1012826,15,79,4,98
"12827",1012827,89,9,2,100
"12828",1012828,31,252,14,297
"12829",1012829,28,5,0,33
"12830",1012830,154,38,9,201
"12831",1012831,225,71,11,307
"12832",1012832,129,82,4,215
"12833",1012833,130,62,13,205
"12834",1012834,178,108,12,298
"12835",1012835,56,128,6,190
"12836",1012836,58,141,2,201
"12837",1012837,84,124,12,220
"12838",1012838,12,24,1,37
"12839",1012839,248,43,10,301
"12840",1012840,135,86,22,243
"12841",1012841,211,48,7,266
"12842",1012842,111,47,9,167
"12843",1012843,11,11,1,23
"12844",1012844,175,70,10,255
"12845",1012845,80,184,11,275
"12846",1012846,141,128,9,278
"12847",1012847,78,191,6,275
"12848",1012848,155,56,9,220
"12849",1012849,211,128,13,352
"12850",1012850,64,12,2,78
"12851",1012851,82,133,11,226
"12852",1012852,133,83,9,225
"12853",1012853,31,149,4,184
"12854",1012854,94,187,14,295
"12855",1012855,127,77,11,215
"12856",1012856,171,87,21,279
"12857",1012857,256,35,11,302
"12858",1012858,180,77,18,275
"12859",1012859,195,31,4,230
"12860",1012860,82,61,0,143
"12861",1012861,1,6,1,8
"12862",1012862,184,42,2,228
"12863",1012863,112,30,8,150
"12864",1012864,70,121,9,200
"12865",1012865,92,188,25,305
"12866",1012866,197,76,20,293
"12867",1012867,84,143,6,233
"12868",1012868,76,166,13,255
"12869",1012869,45,261,4,310
"12870",1012870,253,44,14,311
"12871",1012871,100,155,12,267
"12872",1012872,95,156,14,265
"12873",1012873,245,24,24,293
"12874",1012874,141,164,8,313
"12875",1012875,49,70,4,123
"12876",1012876,112,74,6,192
"12877",1012877,164,109,7,280
"12878",1012878,43,47,4,94
"12879",1012879,129,96,10,235
"12880",1012880,71,220,10,301
"12881",1012881,60,122,4,186
"12882",1012882,153,152,21,326
"12883",1012883,251,14,5,270
"12884",1012884,192,11,7,210
"12885",1012885,95,149,11,255
"12886",1012886,14,35,1,50
"12887",1012887,135,30,7,172
"12888",1012888,40,272,8,320
"12889",1012889,190,89,15,294
"12890",1012890,46,14,3,63
"12891",1012891,134,129,9,272
"12892",1012892,185,105,8,298
"12893",1012893,39,151,3,193
"12894",1012894,62,143,17,222
"12895",1012895,44,135,10,189
"12896",1012896,205,97,8,310
"12897",1012897,129,38,5,172
"12898",1012898,34,9,2,45
"12899",1012899,59,39,3,101
"12900",1012900,16,10,2,28
"12901",1012901,69,133,6,208
"12902",1012902,188,61,11,260
"12903",1012903,225,37,7,269
"12904",1012904,29,278,5,312
"12905",1012905,121,191,14,326
"12906",1012906,195,85,24,304
"12907",1012907,96,90,2,188
"12908",1012908,48,143,3,194
"12909",1012909,192,35,7,234
"12910",1012910,73,82,9,164
"12911",1012911,25,231,13,269
"12912",1012912,70,195,4,269
"12913",1012913,46,127,4,177
"12914",1012914,138,189,18,345
"12915",1012915,56,185,9,250
"12916",1012916,77,128,13,218
"12917",1012917,112,13,2,127
"12918",1012918,46,225,5,276
"12919",1012919,113,185,13,311
"12920",1012920,41,177,8,226
"12921",1012921,91,67,15,173
"12922",1012922,188,30,5,223
"12923",1012923,182,20,1,203
"12924",1012924,184,51,12,247
"12925",1012925,94,39,4,137
"12926",1012926,23,11,0,34
"12927",1012927,137,128,7,272
"12928",1012928,142,134,11,287
"12929",1012929,177,95,3,275
"12930",1012930,188,23,11,222
"12931",1012931,97,104,4,205
"12932",1012932,31,44,5,80
"12933",1012933,89,75,2,166
"12934",1012934,57,87,13,157
"12935",1012935,142,44,5,191
"12936",1012936,154,141,15,310
"12937",1012937,163,66,11,240
"12938",1012938,123,186,6,315
"12939",1012939,220,45,9,274
"12940",1012940,72,172,12,256
"12941",1012941,82,97,11,190
"12942",1012942,173,11,7,191
"12943",1012943,139,95,11,245
"12944",1012944,30,197,5,232
"12945",1012945,118,202,21,341
"12946",1012946,140,42,6,188
"12947",1012947,154,137,3,294
"12948",1012948,81,208,5,294
"12949",1012949,133,131,17,281
"12950",1012950,110,67,12,189
"12951",1012951,71,53,3,127
"12952",1012952,75,279,8,362
"12953",1012953,44,2,2,48
"12954",1012954,113,28,6,147
"12955",1012955,125,59,3,187
"12956",1012956,54,139,0,193
"12957",1012957,49,140,6,195
"12958",1012958,69,82,8,159
"12959",1012959,80,160,16,256
"12960",1012960,88,127,5,220
"12961",1012961,70,199,6,275
"12962",1012962,110,407,15,532
"12963",1012963,53,207,3,263
"12964",1012964,91,75,14,180
"12965",1012965,62,229,5,296
"12966",1012966,195,41,6,242
"12967",1012967,96,78,5,179
"12968",1012968,140,118,8,266
"12969",1012969,114,172,13,299
"12970",1012970,272,13,6,291
"12971",1012971,159,121,2,282
"12972",1012972,113,75,5,193
"12973",1012973,100,136,10,246
"12974",1012974,67,73,9,149
"12975",1012975,51,217,1,269
"12976",1012976,27,156,8,191
"12977",1012977,11,17,3,31
"12978",1012978,26,59,5,90
"12979",1012979,178,85,8,271
"12980",1012980,127,65,4,196
"12981",1012981,181,133,23,337
"12982",1012982,123,87,5,215
"12983",1012983,180,100,11,291
"12984",1012984,222,70,19,311
"12985",1012985,55,207,2,264
"12986",1012986,168,50,3,221
"12987",1012987,87,168,15,270
"12988",1012988,184,110,7,301
"12989",1012989,185,25,4,214
"12990",1012990,83,98,18,199
"12991",1012991,74,134,3,211
"12992",1012992,161,116,8,285
"12993",1012993,66,112,6,184
"12994",1012994,99,226,6,331
"12995",1012995,75,13,2,90
"12996",1012996,130,155,9,294
"12997",1012997,13,156,1,170
"12998",1012998,174,76,10,260
"12999",1012999,152,144,20,316
"13000",1013000,65,61,11,137
"13001",1013001,177,7,5,189
"13002",1013002,84,223,6,313
"13003",1013003,64,164,11,239
"13004",1013004,77,193,12,282
"13005",1013005,61,203,5,269
"13006",1013006,137,64,5,206
"13007",1013007,142,68,2,212
"13008",1013008,210,30,7,247
"13009",1013009,98,184,11,293
"13010",1013010,38,169,11,218
"13011",1013011,38,180,11,229
"13012",1013012,151,166,9,326
"13013",1013013,90,78,6,174
"13014",1013014,193,50,8,251
"13015",1013015,63,216,14,293
"13016",1013016,152,68,13,233
"13017",1013017,146,7,10,163
"13018",1013018,142,69,14,225
"13019",1013019,118,39,10,167
"13020",1013020,107,43,5,155
"13021",1013021,232,38,12,282
"13022",1013022,80,126,15,221
"13023",1013023,66,119,16,201
"13024",1013024,43,269,6,318
"13025",1013025,168,76,9,253
"13026",1013026,3,67,0,70
"13027",1013027,79,74,13,166
"13028",1013028,18,104,4,126
"13029",1013029,88,199,11,298
"13030",1013030,85,240,2,327
"13031",1013031,173,20,12,205
"13032",1013032,117,116,4,237
"13033",1013033,35,238,8,281
"13034",1013034,170,127,13,310
"13035",1013035,53,184,5,242
"13036",1013036,250,66,12,328
"13037",1013037,163,125,21,309
"13038",1013038,61,77,5,143
"13039",1013039,78,176,7,261
"13040",1013040,52,61,10,123
"13041",1013041,104,131,12,247
"13042",1013042,26,199,1,226
"13043",1013043,99,12,5,116
"13044",1013044,120,79,19,218
"13045",1013045,68,127,7,202
"13046",1013046,68,131,5,204
"13047",1013047,42,69,7,118
"13048",1013048,39,124,3,166
"13049",1013049,11,111,1,123
"13050",1013050,104,206,9,319
"13051",1013051,83,208,9,300
"13052",1013052,51,208,4,263
"13053",1013053,89,201,16,306
"13054",1013054,177,73,4,254
"13055",1013055,224,43,3,270
"13056",1013056,7,1,0,8
"13057",1013057,80,18,4,102
"13058",1013058,178,56,10,244
"13059",1013059,115,176,7,298
"13060",1013060,101,41,4,146
"13061",1013061,40,4,1,45
"13062",1013062,102,176,6,284
"13063",1013063,21,3,1,25
"13064",1013064,206,57,4,267
"13065",1013065,133,44,5,182
"13066",1013066,38,200,6,244
"13067",1013067,34,18,3,55
"13068",1013068,149,107,14,270
"13069",1013069,190,43,13,246
"13070",1013070,115,102,8,225
"13071",1013071,125,94,11,230
"13072",1013072,39,33,6,78
"13073",1013073,149,140,13,302
"13074",1013074,36,54,2,92
"13075",1013075,98,59,3,160
"13076",1013076,291,8,6,305
"13077",1013077,191,75,6,272
"13078",1013078,45,266,5,316
"13079",1013079,244,50,8,302
"13080",1013080,80,31,4,115
"13081",1013081,64,232,1,297
"13082",1013082,13,5,0,18
"13083",1013083,115,80,22,217
"13084",1013084,129,212,4,345
"13085",1013085,179,59,8,246
"13086",1013086,269,48,16,333
"13087",1013087,167,57,6,230
"13088",1013088,12,1,0,13
"13089",1013089,44,142,7,193
"13090",1013090,36,24,0,60
"13091",1013091,149,22,9,180
"13092",1013092,233,42,7,282
"13093",1013093,105,95,1,201
"13094",1013094,113,74,10,197
"13095",1013095,65,220,11,296
"13096",1013096,77,249,11,337
"13097",1013097,64,124,12,200
"13098",1013098,136,36,7,179
"13099",1013099,162,124,17,303
"13100",1013100,53,78,9,140
"13101",1013101,14,44,0,58
"13102",1013102,82,182,14,278
"13103",1013103,157,78,8,243
"13104",1013104,61,82,8,151
"13105",1013105,26,120,6,152
"13106",1013106,121,97,11,229
"13107",1013107,138,77,5,220
"13108",1013108,82,12,2,96
"13109",1013109,83,109,10,202
"13110",1013110,107,132,8,247
"13111",1013111,144,86,12,242
"13112",1013112,31,226,9,266
"13113",1013113,72,186,9,267
"13114",1013114,128,57,4,189
"13115",1013115,49,293,10,352
"13116",1013116,111,126,11,248
"13117",1013117,227,36,1,264
"13118",1013118,171,58,6,235
"13119",1013119,58,219,3,280
"13120",1013120,54,2,0,56
"13121",1013121,100,165,16,281
"13122",1013122,42,171,2,215
"13123",1013123,204,35,6,245
"13124",1013124,74,20,2,96
"13125",1013125,165,47,10,222
"13126",1013126,65,112,8,185
"13127",1013127,72,225,7,304
"13128",1013128,174,71,2,247
"13129",1013129,226,79,7,312
"13130",1013130,74,7,8,89
"13131",1013131,210,86,18,314
"13132",1013132,80,7,5,92
"13133",1013133,111,42,6,159
"13134",1013134,131,85,12,228
"13135",1013135,69,156,5,230
"13136",1013136,67,132,16,215
"13137",1013137,43,221,0,264
"13138",1013138,97,143,9,249
"13139",1013139,127,106,5,238
"13140",1013140,77,240,10,327
"13141",1013141,184,89,13,286
"13142",1013142,193,26,10,229
"13143",1013143,122,132,8,262
"13144",1013144,74,71,9,154
"13145",1013145,133,17,6,156
"13146",1013146,81,180,1,262
"13147",1013147,121,89,7,217
"13148",1013148,105,91,11,207
"13149",1013149,181,42,12,235
"13150",1013150,169,142,8,319
"13151",1013151,83,168,13,264
"13152",1013152,64,95,9,168
"13153",1013153,52,181,4,237
"13154",1013154,178,38,3,219
"13155",1013155,58,123,10,191
"13156",1013156,109,27,1,137
"13157",1013157,99,133,7,239
"13158",1013158,188,47,15,250
"13159",1013159,92,114,9,215
"13160",1013160,97,64,8,169
"13161",1013161,54,51,7,112
"13162",1013162,48,86,6,140
"13163",1013163,133,96,8,237
"13164",1013164,193,138,5,336
"13165",1013165,82,151,4,237
"13166",1013166,155,102,20,277
"13167",1013167,88,230,11,329
"13168",1013168,113,66,4,183
"13169",1013169,3,32,0,35
"13170",1013170,221,15,6,242
"13171",1013171,115,22,5,142
"13172",1013172,72,126,8,206
"13173",1013173,124,165,10,299
"13174",1013174,33,55,1,89
"13175",1013175,96,56,11,163
"13176",1013176,94,97,5,196
"13177",1013177,263,10,1,274
"13178",1013178,14,197,1,212
"13179",1013179,70,55,7,132
"13180",1013180,114,97,7,218
"13181",1013181,43,206,5,254
"13182",1013182,37,158,20,215
"13183",1013183,59,211,9,279
"13184",1013184,104,206,17,327
"13185",1013185,69,83,11,163
"13186",1013186,108,366,14,488
"13187",1013187,86,213,11,310
"13188",1013188,99,157,16,272
"13189",1013189,107,104,11,222
"13190",1013190,83,247,9,339
"13191",1013191,92,183,15,290
"13192",1013192,24,273,9,306
"13193",1013193,132,88,5,225
"13194",1013194,56,172,11,239
"13195",1013195,235,58,11,304
"13196",1013196,14,61,1,76
"13197",1013197,80,112,4,196
"13198",1013198,115,22,3,140
"13199",1013199,109,80,11,200
"13200",1013200,160,36,8,204
"13201",1013201,41,167,9,217
"13202",1013202,63,196,11,270
"13203",1013203,146,39,1,186
"13204",1013204,57,146,3,206
"13205",1013205,127,164,8,299
"13206",1013206,124,88,6,218
"13207",1013207,113,94,12,219
"13208",1013208,143,72,6,221
"13209",1013209,149,129,13,291
"13210",1013210,121,20,9,150
"13211",1013211,134,53,0,187
"13212",1013212,245,50,11,306
"13213",1013213,82,189,8,279
"13214",1013214,91,102,10,203
"13215",1013215,38,87,5,130
"13216",1013216,35,215,5,255
"13217",1013217,123,53,16,192
"13218",1013218,90,183,13,286
"13219",1013219,26,191,14,231
"13220",1013220,141,122,14,277
"13221",1013221,59,183,20,262
"13222",1013222,106,97,2,205
"13223",1013223,102,77,9,188
"13224",1013224,11,331,1,343
"13225",1013225,7,91,0,98
"13226",1013226,90,153,4,247
"13227",1013227,72,160,4,236
"13228",1013228,54,92,6,152
"13229",1013229,43,153,6,202
"13230",1013230,109,189,9,307
"13231",1013231,92,152,1,245
"13232",1013232,115,157,17,289
"13233",1013233,189,26,8,223
"13234",1013234,69,214,13,296
"13235",1013235,132,85,8,225
"13236",1013236,120,91,7,218
"13237",1013237,38,73,1,112
"13238",1013238,194,63,5,262
"13239",1013239,108,49,5,162
"13240",1013240,147,50,3,200
"13241",1013241,86,68,2,156
"13242",1013242,66,224,7,297
"13243",1013243,147,50,8,205
"13244",1013244,122,46,9,177
"13245",1013245,221,43,9,273
"13246",1013246,45,205,3,253
"13247",1013247,37,264,10,311
"13248",1013248,126,110,14,250
"13249",1013249,26,190,5,221
"13250",1013250,212,16,3,231
"13251",1013251,84,188,6,278
"13252",1013252,110,144,11,265
"13253",1013253,6,3,0,9
"13254",1013254,3,4,1,8
"13255",1013255,127,101,9,237
"13256",1013256,98,145,3,246
"13257",1013257,114,141,14,269
"13258",1013258,84,194,16,294
"13259",1013259,109,75,2,186
"13260",1013260,168,123,29,320
"13261",1013261,186,92,11,289
"13262",1013262,12,21,1,34
"13263",1013263,196,61,8,265
"13264",1013264,105,133,8,246
"13265",1013265,132,46,12,190
"13266",1013266,82,108,6,196
"13267",1013267,12,301,6,319
"13268",1013268,93,126,2,221
"13269",1013269,137,0,0,137
"13270",1013270,146,26,7,179
"13271",1013271,252,109,10,371
"13272",1013272,53,251,8,312
"13273",1013273,154,106,15,275
"13274",1013274,86,143,3,232
"13275",1013275,152,123,11,286
"13276",1013276,140,44,6,190
"13277",1013277,124,100,12,236
"13278",1013278,61,196,7,264
"13279",1013279,151,96,15,262
"13280",1013280,180,63,5,248
"13281",1013281,160,143,19,322
"13282",1013282,105,161,13,279
"13283",1013283,155,117,15,287
"13284",1013284,163,101,8,272
"13285",1013285,245,32,5,282
"13286",1013286,149,86,12,247
"13287",1013287,83,154,9,246
"13288",1013288,260,69,9,338
"13289",1013289,85,158,6,249
"13290",1013290,3,23,1,27
"13291",1013291,82,173,10,265
"13292",1013292,81,179,9,269
"13293",1013293,93,101,15,209
"13294",1013294,156,42,9,207
"13295",1013295,141,92,19,252
"13296",1013296,266,38,11,315
"13297",1013297,98,162,6,266
"13298",1013298,195,28,14,237
"13299",1013299,158,159,22,339
"13300",1013300,28,145,2,175
"13301",1013301,163,67,7,237
"13302",1013302,158,81,9,248
"13303",1013303,116,103,5,224
"13304",1013304,105,107,12,224
"13305",1013305,65,116,3,184
"13306",1013306,108,176,10,294
"13307",1013307,96,177,6,279
"13308",1013308,69,188,8,265
"13309",1013309,210,82,10,302
"13310",1013310,112,123,15,250
"13311",1013311,103,130,3,236
"13312",1013312,82,161,2,245
"13313",1013313,67,202,6,275
"13314",1013314,60,186,2,248
"13315",1013315,80,3,1,84
"13316",1013316,169,54,10,233
"13317",1013317,187,58,11,256
"13318",1013318,118,103,14,235
"13319",1013319,177,8,5,190
"13320",1013320,53,187,5,245
"13321",1013321,24,50,0,74
"13322",1013322,121,48,6,175
"13323",1013323,92,98,8,198
"13324",1013324,18,172,0,190
"13325",1013325,45,247,6,298
"13326",1013326,161,54,5,220
"13327",1013327,19,29,0,48
"13328",1013328,96,151,16,263
"13329",1013329,128,75,7,210
"13330",1013330,101,142,6,249
"13331",1013331,48,266,10,324
"13332",1013332,93,136,7,236
"13333",1013333,41,237,1,279
"13334",1013334,128,75,8,211
"13335",1013335,133,109,7,249
"13336",1013336,81,194,5,280
"13337",1013337,212,46,12,270
"13338",1013338,10,90,2,102
"13339",1013339,62,126,15,203
"13340",1013340,139,61,11,211
"13341",1013341,101,111,3,215
"13342",1013342,45,225,8,278
"13343",1013343,140,46,10,196
"13344",1013344,102,174,22,298
"13345",1013345,112,104,13,229
"13346",1013346,133,68,7,208
"13347",1013347,36,224,10,270
"13348",1013348,118,125,3,246
"13349",1013349,139,18,3,160
"13350",1013350,172,93,23,288
"13351",1013351,66,2,5,73
"13352",1013352,206,108,22,336
"13353",1013353,73,203,23,299
"13354",1013354,143,150,20,313
"13355",1013355,291,3,15,309
"13356",1013356,116,85,5,206
"13357",1013357,132,63,5,200
"13358",1013358,61,171,21,253
"13359",1013359,103,44,9,156
"13360",1013360,204,86,14,304
"13361",1013361,110,30,9,149
"13362",1013362,68,230,12,310
"13363",1013363,84,120,4,208
"13364",1013364,98,207,8,313
"13365",1013365,82,97,4,183
"13366",1013366,76,39,3,118
"13367",1013367,150,15,6,171
"13368",1013368,62,13,2,77
"13369",1013369,141,70,13,224
"13370",1013370,101,47,7,155
"13371",1013371,67,247,1,315
"13372",1013372,22,2,1,25
"13373",1013373,84,228,16,328
"13374",1013374,174,20,4,198
"13375",1013375,246,50,5,301
"13376",1013376,93,170,9,272
"13377",1013377,103,93,10,206
"13378",1013378,29,9,0,38
"13379",1013379,197,48,11,256
"13380",1013380,114,61,4,179
"13381",1013381,8,29,0,37
"13382",1013382,194,77,6,277
"13383",1013383,64,102,10,176
"13384",1013384,190,74,9,273
"13385",1013385,114,190,13,317
"13386",1013386,37,77,7,121
"13387",1013387,99,81,8,188
"13388",1013388,26,252,8,286
"13389",1013389,235,1,1,237
"13390",1013390,144,80,7,231
"13391",1013391,105,97,12,214
"13392",1013392,74,245,20,339
"13393",1013393,53,206,5,264
"13394",1013394,76,219,6,301
"13395",1013395,1,8,0,9
"13396",1013396,80,36,6,122
"13397",1013397,60,105,7,172
"13398",1013398,171,100,7,278
"13399",1013399,179,99,6,284
"13400",1013400,145,47,14,206
"13401",1013401,41,61,1,103
"13402",1013402,114,79,22,215
"13403",1013403,156,84,9,249
"13404",1013404,201,109,11,321
"13405",1013405,149,54,13,216
"13406",1013406,113,74,4,191
"13407",1013407,44,222,14,280
"13408",1013408,7,87,1,95
"13409",1013409,42,120,9,171
"13410",1013410,154,135,19,308
"13411",1013411,84,80,7,171
"13412",1013412,43,107,7,157
"13413",1013413,135,35,5,175
"13414",1013414,176,46,7,229
"13415",1013415,20,191,4,215
"13416",1013416,70,75,2,147
"13417",1013417,128,117,16,261
"13418",1013418,135,71,13,219
"13419",1013419,75,180,16,271
"13420",1013420,160,76,9,245
"13421",1013421,183,74,14,271
"13422",1013422,135,98,4,237
"13423",1013423,75,179,10,264
"13424",1013424,17,4,1,22
"13425",1013425,185,99,11,295
"13426",1013426,89,137,3,229
"13427",1013427,91,253,26,370
"13428",1013428,191,54,8,253
"13429",1013429,122,38,5,165
"13430",1013430,141,38,11,190
"13431",1013431,93,195,12,300
"13432",1013432,9,262,7,278
"13433",1013433,80,89,3,172
"13434",1013434,96,77,12,185
"13435",1013435,29,144,3,176
"13436",1013436,93,168,11,272
"13437",1013437,111,129,10,250
"13438",1013438,36,6,1,43
"13439",1013439,202,101,15,318
"13440",1013440,70,186,6,262
"13441",1013441,26,97,5,128
"13442",1013442,133,72,1,206
"13443",1013443,48,83,11,142
"13444",1013444,90,210,6,306
"13445",1013445,45,16,3,64
"13446",1013446,131,98,15,244
"13447",1013447,166,127,16,309
"13448",1013448,108,77,12,197
"13449",1013449,220,28,4,252
"13450",1013450,127,43,8,178
"13451",1013451,110,144,14,268
"13452",1013452,118,81,2,201
"13453",1013453,94,45,12,151
"13454",1013454,191,27,8,226
"13455",1013455,203,18,3,224
"13456",1013456,113,176,12,301
"13457",1013457,228,35,1,264
"13458",1013458,68,163,12,243
"13459",1013459,112,88,20,220
"13460",1013460,42,155,3,200
"13461",1013461,85,91,5,181
"13462",1013462,111,42,11,164
"13463",1013463,96,189,6,291
"13464",1013464,167,36,8,211
"13465",1013465,96,137,13,246
"13466",1013466,158,50,4,212
"13467",1013467,216,54,9,279
"13468",1013468,34,90,6,130
"13469",1013469,60,154,5,219
"13470",1013470,120,84,1,205
"13471",1013471,112,148,13,273
"13472",1013472,80,109,19,208
"13473",1013473,34,189,3,226
"13474",1013474,164,36,11,211
"13475",1013475,84,152,8,244
"13476",1013476,27,136,3,166
"13477",1013477,167,21,3,191
"13478",1013478,117,74,2,193
"13479",1013479,157,62,12,231
"13480",1013480,217,36,10,263
"13481",1013481,59,225,12,296
"13482",1013482,86,138,1,225
"13483",1013483,36,128,5,169
"13484",1013484,79,170,17,266
"13485",1013485,153,50,3,206
"13486",1013486,151,127,10,288
"13487",1013487,117,92,13,222
"13488",1013488,111,34,3,148
"13489",1013489,22,1,2,25
"13490",1013490,126,25,6,157
"13491",1013491,137,60,4,201
"13492",1013492,48,80,1,129
"13493",1013493,249,14,4,267
"13494",1013494,85,101,3,189
"13495",1013495,79,121,7,207
"13496",1013496,176,98,18,292
"13497",1013497,77,206,4,287
"13498",1013498,109,188,12,309
"13499",1013499,107,57,13,177
"13500",1013500,99,198,19,316
"13501",1013501,201,18,5,224
"13502",1013502,233,74,8,315
"13503",1013503,32,166,8,206
"13504",1013504,198,57,14,269
"13505",1013505,21,12,2,35
"13506",1013506,41,226,6,273
"13507",1013507,176,27,9,212
"13508",1013508,62,139,8,209
"13509",1013509,133,132,11,276
"13510",1013510,124,136,5,265
"13511",1013511,179,29,13,221
"13512",1013512,201,126,12,339
"13513",1013513,88,146,24,258
"13514",1013514,47,126,6,179
"13515",1013515,60,202,21,283
"13516",1013516,109,154,7,270
"13517",1013517,86,49,4,139
"13518",1013518,22,168,2,192
"13519",1013519,150,87,9,246
"13520",1013520,26,145,8,179
"13521",1013521,29,217,5,251
"13522",1013522,232,67,6,305
"13523",1013523,122,34,12,168
"13524",1013524,115,85,9,209
"13525",1013525,32,89,9,130
"13526",1013526,48,130,3,181
"13527",1013527,243,16,9,268
"13528",1013528,133,34,4,171
"13529",1013529,31,8,0,39
"13530",1013530,134,135,11,280
"13531",1013531,50,240,3,293
"13532",1013532,55,150,10,215
"13533",1013533,198,63,9,270
"13534",1013534,76,86,6,168
"13535",1013535,211,42,7,260
"13536",1013536,91,136,5,232
"13537",1013537,149,125,15,289
"13538",1013538,188,18,6,212
"13539",1013539,63,30,4,97
"13540",1013540,38,147,3,188
"13541",1013541,163,47,4,214
"13542",1013542,92,53,5,150
"13543",1013543,49,190,17,256
"13544",1013544,51,143,2,196
"13545",1013545,34,222,2,258
"13546",1013546,32,183,8,223
"13547",1013547,86,195,6,287
"13548",1013548,71,136,5,212
"13549",1013549,134,64,5,203
"13550",1013550,101,38,7,146
"13551",1013551,13,84,1,98
"13552",1013552,133,132,9,274
"13553",1013553,133,123,6,262
"13554",1013554,147,120,4,271
"13555",1013555,171,17,6,194
"13556",1013556,60,177,4,241
"13557",1013557,189,32,7,228
"13558",1013558,167,87,7,261
"13559",1013559,196,59,5,260
"13560",1013560,129,141,7,277
"13561",1013561,159,22,12,193
"13562",1013562,32,93,3,128
"13563",1013563,86,178,7,271
"13564",1013564,38,59,1,98
"13565",1013565,65,150,13,228
"13566",1013566,84,68,6,158
"13567",1013567,166,109,8,283
"13568",1013568,42,215,8,265
"13569",1013569,144,120,13,277
"13570",1013570,81,139,8,228
"13571",1013571,100,85,7,192
"13572",1013572,25,20,3,48
"13573",1013573,171,65,8,244
"13574",1013574,178,60,12,250
"13575",1013575,36,160,8,204
"13576",1013576,226,3,7,236
"13577",1013577,117,71,8,196
"13578",1013578,16,218,1,235
"13579",1013579,115,94,4,213
"13580",1013580,173,130,5,308
"13581",1013581,92,135,4,231
"13582",1013582,249,160,13,422
"13583",1013583,71,172,9,252
"13584",1013584,107,129,19,255
"13585",1013585,40,67,4,111
"13586",1013586,37,155,1,193
"13587",1013587,167,13,10,190
"13588",1013588,257,31,14,302
"13589",1013589,187,71,8,266
"13590",1013590,36,138,3,177
"13591",1013591,164,15,3,182
"13592",1013592,186,27,10,223
"13593",1013593,111,165,11,287
"13594",1013594,101,155,23,279
"13595",1013595,73,46,4,123
"13596",1013596,202,51,10,263
"13597",1013597,209,46,15,270
"13598",1013598,195,30,6,231
"13599",1013599,147,92,7,246
"13600",1013600,7,7,1,15
"13601",1013601,40,212,5,257
"13602",1013602,66,136,7,209
"13603",1013603,87,150,8,245
"13604",1013604,66,146,8,220
"13605",1013605,41,285,10,336
"13606",1013606,92,137,9,238
"13607",1013607,115,133,13,261
"13608",1013608,114,87,1,202
"13609",1013609,62,89,6,157
"13610",1013610,105,201,7,313
"13611",1013611,161,87,18,266
"13612",1013612,129,148,5,282
"13613",1013613,15,3,0,18
"13614",1013614,202,56,6,264
"13615",1013615,183,54,12,249
"13616",1013616,98,60,10,168
"13617",1013617,37,32,4,73
"13618",1013618,118,173,22,313
"13619",1013619,22,8,3,33
"13620",1013620,78,173,7,258
"13621",1013621,83,168,8,259
"13622",1013622,26,15,2,43
"13623",1013623,51,252,2,305
"13624",1013624,103,160,4,267
"13625",1013625,8,55,1,64
"13626",1013626,90,178,7,275
"13627",1013627,75,250,6,331
"13628",1013628,207,20,6,233
"13629",1013629,13,347,2,362
"13630",1013630,178,114,8,300
"13631",1013631,82,48,2,132
"13632",1013632,131,39,3,173
"13633",1013633,56,195,10,261
"13634",1013634,120,48,7,175
"13635",1013635,43,12,2,57
"13636",1013636,69,13,2,84
"13637",1013637,74,169,6,249
"13638",1013638,83,209,4,296
"13639",1013639,98,92,17,207
"13640",1013640,29,295,8,332
"13641",1013641,172,108,5,285
"13642",1013642,77,251,17,345
"13643",1013643,161,11,2,174
"13644",1013644,55,176,15,246
"13645",1013645,135,157,24,316
"13646",1013646,21,64,1,86
"13647",1013647,60,195,3,258
"13648",1013648,77,165,11,253
"13649",1013649,29,165,6,200
"13650",1013650,56,257,12,325
"13651",1013651,25,180,6,211
"13652",1013652,174,65,0,239
"13653",1013653,23,35,7,65
"13654",1013654,9,1,0,10
"13655",1013655,127,130,18,275
"13656",1013656,47,174,4,225
"13657",1013657,82,1,1,84
"13658",1013658,164,111,12,287
"13659",1013659,117,160,13,290
"13660",1013660,11,4,1,16
"13661",1013661,21,232,5,258
"13662",1013662,120,9,4,133
"13663",1013663,131,103,13,247
"13664",1013664,130,50,5,185
"13665",1013665,82,5,1,88
"13666",1013666,68,151,3,222
"13667",1013667,93,48,9,150
"13668",1013668,100,190,6,296
"13669",1013669,161,74,21,256
"13670",1013670,92,1,0,93
"13671",1013671,22,214,5,241
"13672",1013672,214,52,8,274
"13673",1013673,109,108,14,231
"13674",1013674,114,137,19,270
"13675",1013675,105,87,8,200
"13676",1013676,93,245,9,347
"13677",1013677,169,30,3,202
"13678",1013678,125,119,12,256
"13679",1013679,55,243,3,301
"13680",1013680,11,16,3,30
"13681",1013681,117,67,16,200
"13682",1013682,98,105,6,209
"13683",1013683,91,213,10,314
"13684",1013684,41,264,1,306
"13685",1013685,198,33,13,244
"13686",1013686,57,115,4,176
"13687",1013687,125,4,0,129
"13688",1013688,161,53,10,224
"13689",1013689,216,80,10,306
"13690",1013690,79,84,10,173
"13691",1013691,98,194,2,294
"13692",1013692,157,88,6,251
"13693",1013693,99,7,5,111
"13694",1013694,99,88,0,187
"13695",1013695,77,32,4,113
"13696",1013696,158,107,7,272
"13697",1013697,284,216,39,539
"13698",1013698,143,33,4,180
"13699",1013699,40,221,4,265
"13700",1013700,142,19,7,168
"13701",1013701,94,80,4,178
"13702",1013702,163,41,4,208
"13703",1013703,169,115,6,290
"13704",1013704,167,41,8,216
"13705",1013705,180,25,3,208
"13706",1013706,136,80,10,226
"13707",1013707,133,47,10,190
"13708",1013708,224,30,7,261
"13709",1013709,73,254,10,337
"13710",1013710,164,53,6,223
"13711",1013711,66,179,2,247
"13712",1013712,193,77,19,289
"13713",1013713,40,167,4,211
"13714",1013714,145,74,8,227
"13715",1013715,46,192,13,251
"13716",1013716,65,133,5,203
"13717",1013717,160,27,4,191
"13718",1013718,198,106,12,316
"13719",1013719,28,122,8,158
"13720",1013720,45,68,4,117
"13721",1013721,142,58,2,202
"13722",1013722,90,65,3,158
"13723",1013723,80,133,10,223
"13724",1013724,82,116,11,209
"13725",1013725,125,72,6,203
"13726",1013726,6,10,1,17
"13727",1013727,176,47,6,229
"13728",1013728,304,97,16,417
"13729",1013729,83,151,20,254
"13730",1013730,20,28,2,50
"13731",1013731,129,84,5,218
"13732",1013732,65,160,1,226
"13733",1013733,127,70,7,204
"13734",1013734,253,151,4,408
"13735",1013735,123,171,5,299
"13736",1013736,87,163,8,258
"13737",1013737,61,98,2,161
"13738",1013738,28,94,2,124
"13739",1013739,13,57,0,70
"13740",1013740,43,213,20,276
"13741",1013741,26,21,2,49
"13742",1013742,111,122,8,241
"13743",1013743,34,16,0,50
"13744",1013744,172,34,6,212
"13745",1013745,127,46,4,177
"13746",1013746,141,25,4,170
"13747",1013747,184,82,7,273
"13748",1013748,195,16,12,223
"13749",1013749,66,129,7,202
"13750",1013750,200,33,10,243
"13751",1013751,131,56,9,196
"13752",1013752,85,175,8,268
"13753",1013753,90,174,13,277
"13754",1013754,73,175,18,266
"13755",1013755,0,0,0,0
"13756",1013756,207,45,14,266
"13757",1013757,142,82,11,235
"13758",1013758,53,12,4,69
"13759",1013759,159,103,13,275
"13760",1013760,154,114,9,277
"13761",1013761,87,172,7,266
"13762",1013762,155,75,9,239
"13763",1013763,44,191,3,238
"13764",1013764,40,182,3,225
"13765",1013765,73,71,9,153
"13766",1013766,212,49,9,270
"13767",1013767,123,100,6,229
"13768",1013768,64,128,6,198
"13769",1013769,135,143,8,286
"13770",1013770,155,103,15,273
"13771",1013771,32,249,1,282
"13772",1013772,142,86,6,234
"13773",1013773,130,103,10,243
"13774",1013774,82,225,7,314
"13775",1013775,24,131,8,163
"13776",1013776,173,135,6,314
"13777",1013777,64,250,14,328
"13778",1013778,43,143,3,189
"13779",1013779,148,95,15,258
"13780",1013780,18,57,2,77
"13781",1013781,88,7,2,97
"13782",1013782,254,26,2,282
"13783",1013783,113,97,12,222
"13784",1013784,153,93,17,263
"13785",1013785,218,18,6,242
"13786",1013786,98,176,13,287
"13787",1013787,1,1,0,2
"13788",1013788,147,62,1,210
"13789",1013789,132,82,7,221
"13790",1013790,76,170,10,256
"13791",1013791,120,141,12,273
"13792",1013792,93,149,3,245
"13793",1013793,153,95,9,257
"13794",1013794,79,77,12,168
"13795",1013795,240,25,12,277
"13796",1013796,92,150,19,261
"13797",1013797,70,45,2,117
"13798",1013798,82,208,24,314
"13799",1013799,105,83,6,194
"13800",1013800,160,37,8,205
"13801",1013801,126,101,10,237
"13802",1013802,162,87,21,270
"13803",1013803,81,91,2,174
"13804",1013804,68,218,4,290
"13805",1013805,248,38,6,292
"13806",1013806,174,43,9,226
"13807",1013807,131,109,8,248
"13808",1013808,51,248,4,303
"13809",1013809,42,103,3,148
"13810",1013810,74,188,5,267
"13811",1013811,161,72,11,244
"13812",1013812,192,26,5,223
"13813",1013813,88,153,2,243
"13814",1013814,168,43,3,214
"13815",1013815,177,32,5,214
"13816",1013816,140,62,3,205
"13817",1013817,63,202,2,267
"13818",1013818,74,180,16,270
"13819",1013819,21,186,4,211
"13820",1013820,51,14,2,67
"13821",1013821,169,93,7,269
"13822",1013822,69,33,1,103
"13823",1013823,33,54,9,96
"13824",1013824,103,136,9,248
"13825",1013825,150,126,6,282
"13826",1013826,49,211,6,266
"13827",1013827,55,170,9,234
"13828",1013828,60,70,4,134
"13829",1013829,33,12,1,46
"13830",1013830,121,12,0,133
"13831",1013831,52,184,12,248
"13832",1013832,24,12,2,38
"13833",1013833,162,135,18,315
"13834",1013834,129,15,8,152
"13835",1013835,62,19,8,89
"13836",1013836,245,20,6,271
"13837",1013837,102,143,9,254
"13838",1013838,97,160,7,264
"13839",1013839,137,52,10,199
"13840",1013840,124,154,12,290
"13841",1013841,139,85,12,236
"13842",1013842,225,63,7,295
"13843",1013843,92,78,3,173
"13844",1013844,28,40,2,70
"13845",1013845,187,1,0,188
"13846",1013846,195,95,2,292
"13847",1013847,65,21,2,88
"13848",1013848,170,47,11,228
"13849",1013849,53,192,4,249
"13850",1013850,123,122,32,277
"13851",1013851,177,117,21,315
"13852",1013852,226,45,10,281
"13853",1013853,153,114,11,278
"13854",1013854,103,96,4,203
"13855",1013855,43,237,3,283
"13856",1013856,173,32,4,209
"13857",1013857,127,185,10,322
"13858",1013858,107,170,12,289
"13859",1013859,185,72,9,266
"13860",1013860,14,41,2,57
"13861",1013861,157,41,8,206
"13862",1013862,137,134,8,279
"13863",1013863,88,213,13,314
"13864",1013864,135,152,14,301
"13865",1013865,74,157,2,233
"13866",1013866,127,123,14,264
"13867",1013867,189,73,12,274
"13868",1013868,66,237,2,305
"13869",1013869,177,115,9,301
"13870",1013870,181,112,11,304
"13871",1013871,45,235,6,286
"13872",1013872,27,217,3,247
"13873",1013873,129,78,9,216
"13874",1013874,35,192,14,241
"13875",1013875,107,173,9,289
"13876",1013876,157,68,9,234
"13877",1013877,78,126,4,208
"13878",1013878,124,15,4,143
"13879",1013879,75,205,5,285
"13880",1013880,84,167,11,262
"13881",1013881,163,80,19,262
"13882",1013882,142,45,5,192
"13883",1013883,51,70,3,124
"13884",1013884,141,48,8,197
"13885",1013885,40,96,12,148
"13886",1013886,11,3,0,14
"13887",1013887,164,115,1,280
"13888",1013888,185,22,4,211
"13889",1013889,61,172,14,247
"13890",1013890,37,279,7,323
"13891",1013891,222,10,6,238
"13892",1013892,130,26,5,161
"13893",1013893,63,98,4,165
"13894",1013894,13,305,2,320
"13895",1013895,62,30,2,94
"13896",1013896,35,205,17,257
"13897",1013897,68,182,5,255
"13898",1013898,34,228,6,268
"13899",1013899,147,9,6,162
"13900",1013900,38,177,4,219
"13901",1013901,201,81,19,301
"13902",1013902,158,247,35,440
"13903",1013903,128,72,8,208
"13904",1013904,37,141,16,194
"13905",1013905,96,93,7,196
"13906",1013906,45,163,14,222
"13907",1013907,84,123,8,215
"13908",1013908,36,261,5,302
"13909",1013909,163,93,4,260
"13910",1013910,170,73,3,246
"13911",1013911,27,220,0,247
"13912",1013912,30,214,2,246
"13913",1013913,145,96,9,250
"13914",1013914,90,173,14,277
"13915",1013915,46,139,5,190
"13916",1013916,168,82,14,264
"13917",1013917,81,180,19,280
"13918",1013918,81,43,5,129
"13919",1013919,57,235,0,292
"13920",1013920,91,159,11,261
"13921",1013921,184,47,7,238
"13922",1013922,147,69,8,224
"13923",1013923,186,45,6,237
"13924",1013924,199,68,1,268
"13925",1013925,154,93,3,250
"13926",1013926,126,134,21,281
"13927",1013927,124,168,6,298
"13928",1013928,28,145,5,178
"13929",1013929,138,29,8,175
"13930",1013930,33,250,6,289
"13931",1013931,62,103,6,171
"13932",1013932,201,10,3,214
"13933",1013933,84,142,11,237
"13934",1013934,32,187,2,221
"13935",1013935,192,19,9,220
"13936",1013936,86,91,21,198
"13937",1013937,63,80,13,156
"13938",1013938,71,117,9,197
"13939",1013939,95,140,13,248
"13940",1013940,142,127,7,276
"13941",1013941,126,56,6,188
"13942",1013942,100,145,13,258
"13943",1013943,70,154,4,228
"13944",1013944,210,77,8,295
"13945",1013945,93,127,2,222
"13946",1013946,70,135,3,208
"13947",1013947,137,55,4,196
"13948",1013948,145,109,10,264
"13949",1013949,72,234,4,310
"13950",1013950,107,177,10,294
"13951",1013951,206,28,1,235
"13952",1013952,141,99,3,243
"13953",1013953,60,109,0,169
"13954",1013954,131,29,4,164
"13955",1013955,28,72,1,101
"13956",1013956,83,177,14,274
"13957",1013957,56,157,7,220
"13958",1013958,40,203,6,249
"13959",1013959,149,42,6,197
"13960",1013960,87,148,6,241
"13961",1013961,151,116,16,283
"13962",1013962,130,70,10,210
"13963",1013963,182,35,14,231
"13964",1013964,88,203,15,306
"13965",1013965,207,35,7,249
"13966",1013966,200,90,6,296
"13967",1013967,101,128,4,233
"13968",1013968,222,12,1,235
"13969",1013969,93,119,5,217
"13970",1013970,55,177,5,237
"13971",1013971,93,66,7,166
"13972",1013972,141,125,19,285
"13973",1013973,84,236,2,322
"13974",1013974,141,125,29,295
"13975",1013975,78,183,11,272
"13976",1013976,66,175,6,247
"13977",1013977,143,73,18,234
"13978",1013978,144,25,9,178
"13979",1013979,96,129,9,234
"13980",1013980,79,42,3,124
"13981",1013981,71,8,2,81
"13982",1013982,59,141,3,203
"13983",1013983,5,0,0,5
"13984",1013984,228,155,9,392
"13985",1013985,125,163,15,303
"13986",1013986,99,172,7,278
"13987",1013987,198,88,10,296
"13988",1013988,133,95,0,228
"13989",1013989,43,234,6,283
"13990",1013990,96,135,5,236
"13991",1013991,82,143,11,236
"13992",1013992,61,295,7,363
"13993",1013993,151,68,4,223
"13994",1013994,48,144,9,201
"13995",1013995,59,98,7,164
"13996",1013996,205,72,10,287
"13997",1013997,132,159,5,296
"13998",1013998,37,43,3,83
"13999",1013999,77,132,6,215
"14000",1014000,27,214,4,245
"14001",1014001,79,81,8,168
"14002",1014002,43,203,5,251
"14003",1014003,137,3,1,141
"14004",1014004,143,31,6,180
"14005",1014005,18,44,0,62
"14006",1014006,62,267,12,341
"14007",1014007,176,113,3,292
"14008",1014008,171,31,5,207
"14009",1014009,154,49,5,208
"14010",1014010,187,47,4,238
"14011",1014011,153,155,11,319
"14012",1014012,85,197,16,298
"14013",1014013,58,221,5,284
"14014",1014014,219,62,19,300
"14015",1014015,151,44,9,204
"14016",1014016,78,13,3,94
"14017",1014017,96,52,3,151
"14018",1014018,115,78,7,200
"14019",1014019,80,214,13,307
"14020",1014020,141,87,6,234
"14021",1014021,164,29,4,197
"14022",1014022,251,16,14,281
"14023",1014023,33,1,1,35
"14024",1014024,157,45,8,210
"14025",1014025,34,203,10,247
"14026",1014026,141,103,14,258
"14027",1014027,204,51,22,277
"14028",1014028,131,110,10,251
"14029",1014029,83,53,2,138
"14030",1014030,134,65,10,209
"14031",1014031,46,242,4,292
"14032",1014032,115,27,4,146
"14033",1014033,267,40,7,314
"14034",1014034,48,228,4,280
"14035",1014035,142,46,5,193
"14036",1014036,111,26,0,137
"14037",1014037,144,137,6,287
"14038",1014038,40,79,7,126
"14039",1014039,69,165,4,238
"14040",1014040,40,240,9,289
"14041",1014041,130,144,15,289
"14042",1014042,195,56,7,258
"14043",1014043,96,15,3,114
"14044",1014044,122,85,6,213
"14045",1014045,187,84,1,272
"14046",1014046,100,110,6,216
"14047",1014047,62,144,10,216
"14048",1014048,52,195,10,257
"14049",1014049,248,29,7,284
"14050",1014050,28,22,1,51
"14051",1014051,176,60,10,246
"14052",1014052,38,136,3,177
"14053",1014053,195,37,7,239
"14054",1014054,39,159,9,207
"14055",1014055,54,191,16,261
"14056",1014056,105,160,7,272
"14057",1014057,140,58,26,224
"14058",1014058,42,191,5,238
"14059",1014059,12,156,1,169
"14060",1014060,109,42,4,155
"14061",1014061,73,198,19,290
"14062",1014062,137,81,8,226
"14063",1014063,243,39,5,287
"14064",1014064,167,64,2,233
"14065",1014065,104,123,24,251
"14066",1014066,107,163,11,281
"14067",1014067,76,178,22,276
"14068",1014068,119,113,12,244
"14069",1014069,187,57,9,253
"14070",1014070,75,194,13,282
"14071",1014071,177,54,9,240
"14072",1014072,196,48,13,257
"14073",1014073,165,65,11,241
"14074",1014074,82,227,10,319
"14075",1014075,150,146,30,326
"14076",1014076,103,8,2,113
"14077",1014077,157,107,14,278
"14078",1014078,112,103,14,229
"14079",1014079,65,202,18,285
"14080",1014080,71,222,13,306
"14081",1014081,111,29,6,146
"14082",1014082,38,56,3,97
"14083",1014083,134,149,11,294
"14084",1014084,170,42,3,215
"14085",1014085,100,158,19,277
"14086",1014086,125,48,14,187
"14087",1014087,54,26,3,83
"14088",1014088,16,233,3,252
"14089",1014089,126,172,20,318
"14090",1014090,61,158,15,234
"14091",1014091,221,77,9,307
"14092",1014092,201,47,5,253
"14093",1014093,119,165,8,292
"14094",1014094,113,184,15,312
"14095",1014095,98,142,4,244
"14096",1014096,257,23,6,286
"14097",1014097,58,276,8,342
"14098",1014098,79,213,4,296
"14099",1014099,6,14,2,22
"14100",1014100,188,11,4,203
"14101",1014101,72,258,5,335
"14102",1014102,183,59,5,247
"14103",1014103,38,297,4,339
"14104",1014104,193,65,9,267
"14105",1014105,76,33,7,116
"14106",1014106,97,87,16,200
"14107",1014107,3,3,0,6
"14108",1014108,181,97,9,287
"14109",1014109,150,95,4,249
"14110",1014110,169,87,14,270
"14111",1014111,24,61,0,85
"14112",1014112,72,125,1,198
"14113",1014113,174,48,9,231
"14114",1014114,91,98,7,196
"14115",1014115,129,177,7,313
"14116",1014116,22,51,4,77
"14117",1014117,82,26,2,110
"14118",1014118,89,98,5,192
"14119",1014119,293,18,8,319
"14120",1014120,53,207,8,268
"14121",1014121,236,100,10,346
"14122",1014122,106,130,18,254
"14123",1014123,192,61,12,265
"14124",1014124,26,435,3,464
"14125",1014125,120,148,7,275
"14126",1014126,117,128,5,250
"14127",1014127,109,130,4,243
"14128",1014128,16,18,0,34
"14129",1014129,183,93,6,282
"14130",1014130,51,13,2,66
"14131",1014131,145,65,12,222
"14132",1014132,140,60,14,214
"14133",1014133,156,78,9,243
"14134",1014134,231,58,26,315
"14135",1014135,150,74,12,236
"14136",1014136,96,206,12,314
"14137",1014137,24,238,3,265
"14138",1014138,165,77,10,252
"14139",1014139,73,79,7,159
"14140",1014140,9,7,2,18
"14141",1014141,65,215,1,281
"14142",1014142,77,193,8,278
"14143",1014143,10,10,2,22
"14144",1014144,103,64,12,179
"14145",1014145,76,143,2,221
"14146",1014146,170,48,11,229
"14147",1014147,35,134,11,180
"14148",1014148,65,228,16,309
"14149",1014149,86,163,13,262
"14150",1014150,141,92,3,236
"14151",1014151,84,85,7,176
"14152",1014152,90,157,14,261
"14153",1014153,69,64,10,143
"14154",1014154,79,170,11,260
"14155",1014155,158,47,15,220
"14156",1014156,25,211,2,238
"14157",1014157,96,6,1,103
"14158",1014158,60,128,7,195
"14159",1014159,127,177,15,319
"14160",1014160,87,88,14,189
"14161",1014161,178,47,14,239
"14162",1014162,128,10,1,139
"14163",1014163,157,33,4,194
"14164",1014164,299,72,13,384
"14165",1014165,42,165,7,214
"14166",1014166,139,98,2,239
"14167",1014167,91,27,6,124
"14168",1014168,95,184,8,287
"14169",1014169,121,101,18,240
"14170",1014170,83,84,6,173
"14171",1014171,168,120,3,291
"14172",1014172,63,219,6,288
"14173",1014173,193,31,7,231
"14174",1014174,130,99,11,240
"14175",1014175,10,227,0,237
"14176",1014176,60,38,6,104
"14177",1014177,44,223,5,272
"14178",1014178,48,226,9,283
"14179",1014179,50,3,0,53
"14180",1014180,93,72,6,171
"14181",1014181,5,50,2,57
"14182",1014182,106,102,11,219
"14183",1014183,74,159,12,245
"14184",1014184,57,223,16,296
"14185",1014185,158,32,15,205
"14186",1014186,139,157,9,305
"14187",1014187,111,179,12,302
"14188",1014188,103,78,7,188
"14189",1014189,44,8,4,56
"14190",1014190,186,111,6,303
"14191",1014191,24,125,3,152
"14192",1014192,37,190,3,230
"14193",1014193,61,225,4,290
"14194",1014194,207,11,6,224
"14195",1014195,3,2,0,5
"14196",1014196,65,115,8,188
"14197",1014197,168,106,11,285
"14198",1014198,226,48,11,285
"14199",1014199,159,37,9,205
"14200",1014200,31,215,6,252
"14201",1014201,36,24,2,62
"14202",1014202,85,68,3,156
"14203",1014203,158,39,4,201
"14204",1014204,61,225,7,293
"14205",1014205,117,77,6,200
"14206",1014206,169,18,11,198
"14207",1014207,16,6,1,23
"14208",1014208,173,43,9,225
"14209",1014209,42,199,8,249
"14210",1014210,95,70,11,176
"14211",1014211,178,89,15,282
"14212",1014212,56,214,3,273
"14213",1014213,146,72,9,227
"14214",1014214,33,137,6,176
"14215",1014215,139,86,4,229
"14216",1014216,110,191,18,319
"14217",1014217,156,62,1,219
"14218",1014218,184,70,10,264
"14219",1014219,57,176,4,237
"14220",1014220,69,14,2,85
"14221",1014221,34,220,4,258
"14222",1014222,76,95,4,175
"14223",1014223,134,74,17,225
"14224",1014224,70,167,2,239
"14225",1014225,76,158,7,241
"14226",1014226,104,79,9,192
"14227",1014227,157,90,12,259
"14228",1014228,133,109,4,246
"14229",1014229,249,14,9,272
"14230",1014230,103,67,6,176
"14231",1014231,84,132,4,220
"14232",1014232,183,36,8,227
"14233",1014233,41,0,0,41
"14234",1014234,179,9,3,191
"14235",1014235,167,17,4,188
"14236",1014236,99,106,5,210
"14237",1014237,70,131,2,203
"14238",1014238,115,106,5,226
"14239",1014239,3,207,1,211
"14240",1014240,203,59,14,276
"14241",1014241,108,124,11,243
"14242",1014242,44,162,5,211
"14243",1014243,111,81,6,198
"14244",1014244,120,86,17,223
"14245",1014245,72,159,11,242
"14246",1014246,156,62,8,226
"14247",1014247,295,3,3,301
"14248",1014248,61,165,12,238
"14249",1014249,127,96,12,235
"14250",1014250,190,33,3,226
"14251",1014251,43,209,7,259
"14252",1014252,72,253,6,331
"14253",1014253,76,160,10,246
"14254",1014254,64,178,5,247
"14255",1014255,94,225,19,338
"14256",1014256,37,119,13,169
"14257",1014257,189,13,8,210
"14258",1014258,111,201,19,331
"14259",1014259,117,145,13,275
"14260",1014260,162,124,18,304
"14261",1014261,109,135,11,255
"14262",1014262,45,239,5,289
"14263",1014263,30,143,6,179
"14264",1014264,125,65,7,197
"14265",1014265,65,239,9,313
"14266",1014266,120,98,4,222
"14267",1014267,137,68,2,207
"14268",1014268,190,20,7,217
"14269",1014269,131,146,12,289
"14270",1014270,184,51,8,243
"14271",1014271,113,132,9,254
"14272",1014272,137,42,6,185
"14273",1014273,81,95,8,184
"14274",1014274,100,121,9,230
"14275",1014275,55,197,4,256
"14276",1014276,237,69,14,320
"14277",1014277,96,130,10,236
"14278",1014278,70,177,9,256
"14279",1014279,154,48,5,207
"14280",1014280,121,36,4,161
"14281",1014281,89,119,5,213
"14282",1014282,132,67,14,213
"14283",1014283,52,123,3,178
"14284",1014284,225,38,10,273
"14285",1014285,22,98,7,127
"14286",1014286,137,61,8,206
"14287",1014287,85,246,13,344
"14288",1014288,162,57,12,231
"14289",1014289,239,29,6,274
"14290",1014290,95,156,2,253
"14291",1014291,195,68,5,268
"14292",1014292,83,186,16,285
"14293",1014293,80,73,0,153
"14294",1014294,46,254,0,300
"14295",1014295,12,18,1,31
"14296",1014296,168,50,8,226
"14297",1014297,179,86,7,272
"14298",1014298,176,133,15,324
"14299",1014299,84,52,5,141
"14300",1014300,171,28,13,212
"14301",1014301,221,40,15,276
"14302",1014302,100,98,6,204
"14303",1014303,37,246,5,288
"14304",1014304,198,30,6,234
"14305",1014305,29,87,1,117
"14306",1014306,34,258,7,299
"14307",1014307,49,258,7,314
"14308",1014308,104,144,8,256
"14309",1014309,39,21,0,60
"14310",1014310,70,44,3,117
"14311",1014311,169,90,12,271
"14312",1014312,205,47,5,257
"14313",1014313,86,160,17,263
"14314",1014314,61,131,1,193
"14315",1014315,39,219,10,268
"14316",1014316,98,130,5,233
"14317",1014317,149,31,8,188
"14318",1014318,139,87,10,236
"14319",1014319,28,209,6,243
"14320",1014320,137,89,9,235
"14321",1014321,240,60,14,314
"14322",1014322,98,125,6,229
"14323",1014323,155,85,8,248
"14324",1014324,59,255,5,319
"14325",1014325,96,40,4,140
"14326",1014326,200,56,6,262
"14327",1014327,39,215,22,276
"14328",1014328,251,29,16,296
"14329",1014329,29,58,1,88
"14330",1014330,84,102,16,202
"14331",1014331,59,196,13,268
"14332",1014332,26,172,20,218
"14333",1014333,114,29,3,146
"14334",1014334,84,186,10,280
"14335",1014335,65,130,7,202
"14336",1014336,29,28,1,58
"14337",1014337,20,81,0,101
"14338",1014338,88,131,7,226
"14339",1014339,162,95,3,260
"14340",1014340,49,244,4,297
"14341",1014341,130,170,11,311
"14342",1014342,148,148,11,307
"14343",1014343,250,28,8,286
"14344",1014344,131,92,9,232
"14345",1014345,75,33,2,110
"14346",1014346,33,112,0,145
"14347",1014347,73,29,7,109
"14348",1014348,177,61,4,242
"14349",1014349,145,148,7,300
"14350",1014350,89,74,1,164
"14351",1014351,159,104,9,272
"14352",1014352,47,199,4,250
"14353",1014353,35,161,2,198
"14354",1014354,101,24,8,133
"14355",1014355,155,173,10,338
"14356",1014356,26,218,6,250
"14357",1014357,40,175,7,222
"14358",1014358,53,111,2,166
"14359",1014359,98,146,4,248
"14360",1014360,101,121,6,228
"14361",1014361,145,195,10,350
"14362",1014362,92,148,23,263
"14363",1014363,38,104,10,152
"14364",1014364,96,136,7,239
"14365",1014365,101,141,1,243
"14366",1014366,125,129,6,260
"14367",1014367,74,238,9,321
"14368",1014368,198,50,11,259
"14369",1014369,74,52,8,134
"14370",1014370,95,93,7,195
"14371",1014371,160,41,10,211
"14372",1014372,94,132,7,233
"14373",1014373,19,296,1,316
"14374",1014374,39,162,8,209
"14375",1014375,206,74,6,286
"14376",1014376,97,159,4,260
"14377",1014377,60,17,2,79
"14378",1014378,186,29,6,221
"14379",1014379,218,51,19,288
"14380",1014380,162,49,3,214
"14381",1014381,137,186,11,334
"14382",1014382,125,158,9,292
"14383",1014383,177,70,9,256
"14384",1014384,45,174,11,230
"14385",1014385,196,136,9,341
"14386",1014386,158,56,6,220
"14387",1014387,40,210,4,254
"14388",1014388,126,65,7,198
"14389",1014389,112,225,18,355
"14390",1014390,114,139,10,263
"14391",1014391,16,221,1,238
"14392",1014392,182,30,11,223
"14393",1014393,229,8,4,241
"14394",1014394,140,48,8,196
"14395",1014395,143,133,5,281
"14396",1014396,159,33,10,202
"14397",1014397,60,232,2,294
"14398",1014398,92,26,1,119
"14399",1014399,136,100,7,243
"14400",1014400,146,47,8,201
"14401",1014401,23,195,17,235
"14402",1014402,61,13,2,76
"14403",1014403,161,62,8,231
"14404",1014404,191,42,5,238
"14405",1014405,110,53,12,175
"14406",1014406,123,52,1,176
"14407",1014407,143,126,14,283
"14408",1014408,96,16,3,115
"14409",1014409,141,81,9,231
"14410",1014410,152,65,12,229
"14411",1014411,89,60,13,162
"14412",1014412,120,131,7,258
"14413",1014413,107,74,11,192
"14414",1014414,133,115,11,259
"14415",1014415,114,120,19,253
"14416",1014416,200,67,6,273
"14417",1014417,142,59,17,218
"14418",1014418,237,63,13,313
"14419",1014419,71,226,7,304
"14420",1014420,122,68,4,194
"14421",1014421,133,77,14,224
"14422",1014422,36,191,7,234
"14423",1014423,123,183,7,313
"14424",1014424,87,185,10,282
"14425",1014425,249,55,13,317
"14426",1014426,151,54,6,211
"14427",1014427,124,31,7,162
"14428",1014428,265,43,12,320
"14429",1014429,4,7,1,12
"14430",1014430,64,162,0,226
"14431",1014431,247,23,9,279
"14432",1014432,41,183,8,232
"14433",1014433,112,141,4,257
"14434",1014434,184,86,12,282
"14435",1014435,16,25,0,41
"14436",1014436,188,43,21,252
"14437",1014437,57,188,13,258
"14438",1014438,304,13,4,321
"14439",1014439,40,86,4,130
"14440",1014440,151,161,19,331
"14441",1014441,228,47,6,281
"14442",1014442,38,229,2,269
"14443",1014443,139,38,7,184
"14444",1014444,155,141,12,308
"14445",1014445,44,178,6,228
"14446",1014446,148,42,3,193
"14447",1014447,149,123,6,278
"14448",1014448,122,121,16,259
"14449",1014449,103,91,17,211
"14450",1014450,120,22,0,142
"14451",1014451,314,208,14,536
"14452",1014452,110,107,9,226
"14453",1014453,160,48,5,213
"14454",1014454,173,84,10,267
"14455",1014455,70,185,8,263
"14456",1014456,20,52,9,81
"14457",1014457,131,188,9,328
"14458",1014458,171,42,6,219
"14459",1014459,98,176,20,294
"14460",1014460,149,45,3,197
"14461",1014461,100,167,9,276
"14462",1014462,47,268,5,320
"14463",1014463,76,156,16,248
"14464",1014464,35,128,1,164
"14465",1014465,28,134,1,163
"14466",1014466,168,87,9,264
"14467",1014467,171,31,4,206
"14468",1014468,76,188,14,278
"14469",1014469,77,233,8,318
"14470",1014470,173,31,4,208
"14471",1014471,78,47,4,129
"14472",1014472,74,140,5,219
"14473",1014473,58,169,19,246
"14474",1014474,179,73,5,257
"14475",1014475,171,101,9,281
"14476",1014476,30,213,5,248
"14477",1014477,92,145,9,246
"14478",1014478,154,24,3,181
"14479",1014479,79,98,3,180
"14480",1014480,135,162,6,303
"14481",1014481,9,0,0,9
"14482",1014482,144,111,10,265
"14483",1014483,175,79,6,260
"14484",1014484,165,48,3,216
"14485",1014485,158,159,18,335
"14486",1014486,79,224,10,313
"14487",1014487,192,67,11,270
"14488",1014488,227,21,7,255
"14489",1014489,138,55,5,198
"14490",1014490,173,105,9,287
"14491",1014491,204,71,6,281
"14492",1014492,141,51,11,203
"14493",1014493,192,30,4,226
"14494",1014494,157,59,4,220
"14495",1014495,130,253,21,404
"14496",1014496,5,5,0,10
"14497",1014497,165,47,6,218
"14498",1014498,178,51,4,233
"14499",1014499,100,125,3,228
"14500",1014500,103,159,8,270
"14501",1014501,148,123,2,273
"14502",1014502,218,23,2,243
"14503",1014503,105,159,16,280
"14504",1014504,120,55,6,181
"14505",1014505,51,9,2,62
"14506",1014506,69,172,15,256
"14507",1014507,84,31,9,124
"14508",1014508,185,38,3,226
"14509",1014509,160,121,11,292
"14510",1014510,34,242,7,283
"14511",1014511,81,63,7,151
"14512",1014512,45,256,17,318
"14513",1014513,76,224,4,304
"14514",1014514,108,130,16,254
"14515",1014515,207,46,6,259
"14516",1014516,99,35,5,139
"14517",1014517,132,91,19,242
"14518",1014518,219,77,18,314
"14519",1014519,117,113,3,233
"14520",1014520,202,104,3,309
"14521",1014521,57,138,5,200
"14522",1014522,49,181,12,242
"14523",1014523,71,158,7,236
"14524",1014524,119,45,9,173
"14525",1014525,71,107,2,180
"14526",1014526,236,17,5,258
"14527",1014527,64,92,4,160
"14528",1014528,47,188,1,236
"14529",1014529,153,49,9,211
"14530",1014530,135,134,21,290
"14531",1014531,138,39,3,180
"14532",1014532,94,64,4,162
"14533",1014533,98,58,11,167
"14534",1014534,49,20,2,71
"14535",1014535,66,149,2,217
"14536",1014536,110,179,4,293
"14537",1014537,25,233,1,259
"14538",1014538,121,17,6,144
"14539",1014539,44,244,2,290
"14540",1014540,8,3,1,12
"14541",1014541,30,8,0,38
"14542",1014542,153,75,9,237
"14543",1014543,143,72,4,219
"14544",1014544,144,40,3,187
"14545",1014545,195,56,14,265
"14546",1014546,59,216,2,277
"14547",1014547,94,150,7,251
"14548",1014548,151,48,4,203
"14549",1014549,11,21,2,34
"14550",1014550,193,94,12,299
"14551",1014551,72,152,0,224
"14552",1014552,53,154,6,213
"14553",1014553,162,18,5,185
"14554",1014554,41,11,4,56
"14555",1014555,57,86,5,148
"14556",1014556,45,216,13,274
"14557",1014557,54,110,9,173
"14558",1014558,105,114,6,225
"14559",1014559,150,68,6,224
"14560",1014560,97,132,6,235
"14561",1014561,45,234,9,288
"14562",1014562,74,265,8,347
"14563",1014563,168,71,9,248
"14564",1014564,59,76,2,137
"14565",1014565,48,159,5,212
"14566",1014566,93,104,13,210
"14567",1014567,62,22,1,85
"14568",1014568,145,25,3,173
"14569",1014569,63,219,7,289
"14570",1014570,53,91,0,144
"14571",1014571,148,40,2,190
"14572",1014572,103,45,8,156
"14573",1014573,122,2,1,125
"14574",1014574,162,91,12,265
"14575",1014575,110,70,8,188
"14576",1014576,184,72,17,273
"14577",1014577,258,52,8,318
"14578",1014578,122,143,4,269
"14579",1014579,31,216,4,251
"14580",1014580,183,56,9,248
"14581",1014581,103,169,9,281
"14582",1014582,48,184,8,240
"14583",1014583,92,112,1,205
"14584",1014584,132,74,18,224
"14585",1014585,106,121,6,233
"14586",1014586,136,64,9,209
"14587",1014587,171,22,17,210
"14588",1014588,49,35,3,87
"14589",1014589,133,81,7,221
"14590",1014590,37,228,5,270
"14591",1014591,73,135,8,216
"14592",1014592,68,46,1,115
"14593",1014593,174,54,8,236
"14594",1014594,138,95,7,240
"14595",1014595,193,14,6,213
"14596",1014596,119,23,8,150
"14597",1014597,123,78,4,205
"14598",1014598,134,128,25,287
"14599",1014599,148,62,9,219
"14600",1014600,104,14,6,124
"14601",1014601,55,141,1,197
"14602",1014602,38,200,3,241
"14603",1014603,127,77,15,219
"14604",1014604,31,32,1,64
"14605",1014605,162,71,5,238
"14606",1014606,39,174,20,233
"14607",1014607,195,72,8,275
"14608",1014608,87,192,5,284
"14609",1014609,125,181,16,322
"14610",1014610,50,232,1,283
"14611",1014611,61,137,17,215
"14612",1014612,70,182,15,267
"14613",1014613,188,12,1,201
"14614",1014614,132,58,19,209
"14615",1014615,55,146,2,203
"14616",1014616,171,63,7,241
"14617",1014617,123,129,12,264
"14618",1014618,129,170,10,309
"14619",1014619,96,7,0,103
"14620",1014620,51,259,9,319
"14621",1014621,84,230,1,315
"14622",1014622,32,158,4,194
"14623",1014623,29,177,18,224
"14624",1014624,100,192,3,295
"14625",1014625,84,24,3,111
"14626",1014626,119,115,8,242
"14627",1014627,238,40,10,288
"14628",1014628,63,83,2,148
"14629",1014629,31,264,8,303
"14630",1014630,62,27,4,93
"14631",1014631,66,164,13,243
"14632",1014632,171,63,20,254
"14633",1014633,58,90,5,153
"14634",1014634,172,42,6,220
"14635",1014635,104,128,4,236
"14636",1014636,79,127,9,215
"14637",1014637,198,91,0,289
"14638",1014638,48,205,4,257
"14639",1014639,136,51,4,191
"14640",1014640,67,150,10,227
"14641",1014641,92,178,2,272
"14642",1014642,156,15,1,172
"14643",1014643,185,38,9,232
"14644",1014644,110,154,17,281
"14645",1014645,133,91,15,239
"14646",1014646,228,4,14,246
"14647",1014647,152,80,5,237
"14648",1014648,45,118,4,167
"14649",1014649,140,70,5,215
"14650",1014650,160,111,18,289
"14651",1014651,146,108,10,264
"14652",1014652,238,47,7,292
"14653",1014653,3,17,1,21
"14654",1014654,97,5,2,104
"14655",1014655,60,82,2,144
"14656",1014656,64,70,17,151
"14657",1014657,102,69,2,173
"14658",1014658,165,77,13,255
"14659",1014659,91,229,11,331
"14660",1014660,35,40,3,78
"14661",1014661,66,73,8,147
"14662",1014662,129,10,5,144
"14663",1014663,129,126,4,259
"14664",1014664,34,22,3,59
"14665",1014665,189,49,4,242
"14666",1014666,57,53,3,113
"14667",1014667,128,47,2,177
"14668",1014668,169,108,25,302
"14669",1014669,242,18,5,265
"14670",1014670,88,217,12,317
"14671",1014671,156,61,5,222
"14672",1014672,107,185,15,307
"14673",1014673,128,106,8,242
"14674",1014674,108,211,22,341
"14675",1014675,53,269,3,325
"14676",1014676,48,218,14,280
"14677",1014677,142,191,10,343
"14678",1014678,151,35,6,192
"14679",1014679,170,129,14,313
"14680",1014680,137,75,8,220
"14681",1014681,31,28,4,63
"14682",1014682,42,207,4,253
"14683",1014683,179,68,17,264
"14684",1014684,199,67,15,281
"14685",1014685,132,44,3,179
"14686",1014686,84,68,18,170
"14687",1014687,117,112,7,236
"14688",1014688,158,123,15,296
"14689",1014689,67,230,5,302
"14690",1014690,169,81,9,259
"14691",1014691,229,69,13,311
"14692",1014692,58,212,7,277
"14693",1014693,250,12,5,267
"14694",1014694,119,203,9,331
"14695",1014695,163,109,2,274
"14696",1014696,118,104,12,234
"14697",1014697,59,78,15,152
"14698",1014698,54,144,3,201
"14699",1014699,26,97,5,128
"14700",1014700,176,55,4,235
"14701",1014701,33,64,1,98
"14702",1014702,102,29,6,137
"14703",1014703,150,35,5,190
"14704",1014704,85,242,3,330
"14705",1014705,65,76,3,144
"14706",1014706,98,104,8,210
"14707",1014707,117,88,9,214
"14708",1014708,193,79,5,277
"14709",1014709,44,71,2,117
"14710",1014710,37,164,10,211
"14711",1014711,25,159,3,187
"14712",1014712,158,13,4,175
"14713",1014713,117,106,8,231
"14714",1014714,88,188,3,279
"14715",1014715,60,6,0,66
"14716",1014716,206,132,14,352
"14717",1014717,135,83,16,234
"14718",1014718,51,87,5,143
"14719",1014719,54,30,3,87
"14720",1014720,103,46,4,153
"14721",1014721,114,65,10,189
"14722",1014722,97,85,6,188
"14723",1014723,10,271,2,283
"14724",1014724,106,68,3,177
"14725",1014725,98,75,8,181
"14726",1014726,140,109,4,253
"14727",1014727,196,96,16,308
"14728",1014728,128,102,10,240
"14729",1014729,95,14,1,110
"14730",1014730,122,76,6,204
"14731",1014731,92,107,3,202
"14732",1014732,11,166,1,178
"14733",1014733,85,170,8,263
"14734",1014734,146,140,10,296
"14735",1014735,103,139,8,250
"14736",1014736,63,21,8,92
"14737",1014737,103,102,7,212
"14738",1014738,122,134,8,264
"14739",1014739,197,71,18,286
"14740",1014740,104,99,14,217
"14741",1014741,117,53,3,173
"14742",1014742,52,160,5,217
"14743",1014743,120,41,5,166
"14744",1014744,177,65,11,253
"14745",1014745,73,97,16,186
"14746",1014746,150,104,3,257
"14747",1014747,224,79,2,305
"14748",1014748,68,109,14,191
"14749",1014749,58,207,2,267
"14750",1014750,173,14,5,192
"14751",1014751,22,273,6,301
"14752",1014752,231,29,8,268
"14753",1014753,14,141,0,155
"14754",1014754,162,126,14,302
"14755",1014755,178,28,2,208
"14756",1014756,164,86,11,261
"14757",1014757,74,180,8,262
"14758",1014758,6,15,0,21
"14759",1014759,115,93,6,214
"14760",1014760,6,16,2,24
"14761",1014761,167,14,5,186
"14762",1014762,238,36,6,280
"14763",1014763,125,30,4,159
"14764",1014764,71,155,9,235
"14765",1014765,229,36,6,271
"14766",1014766,62,181,14,257
"14767",1014767,64,133,31,228
"14768",1014768,33,0,0,33
"14769",1014769,203,71,5,279
"14770",1014770,94,173,24,291
"14771",1014771,97,50,6,153
"14772",1014772,134,43,7,184
"14773",1014773,136,77,10,223
"14774",1014774,20,177,6,203
"14775",1014775,38,231,3,272
"14776",1014776,147,119,7,273
"14777",1014777,155,84,22,261
"14778",1014778,133,112,18,263
"14779",1014779,290,45,10,345
"14780",1014780,179,43,4,226
"14781",1014781,24,84,0,108
"14782",1014782,80,181,13,274
"14783",1014783,139,104,4,247
"14784",1014784,101,115,13,229
"14785",1014785,166,116,7,289
"14786",1014786,186,48,8,242
"14787",1014787,159,66,12,237
"14788",1014788,219,97,15,331
"14789",1014789,83,133,5,221
"14790",1014790,169,86,20,275
"14791",1014791,231,27,10,268
"14792",1014792,136,71,4,211
"14793",1014793,231,15,3,249
"14794",1014794,55,91,7,153
"14795",1014795,18,196,5,219
"14796",1014796,34,282,3,319
"14797",1014797,159,43,4,206
"14798",1014798,39,291,7,337
"14799",1014799,134,92,13,239
"14800",1014800,229,76,6,311
"14801",1014801,77,13,4,94
"14802",1014802,138,94,22,254
"14803",1014803,169,28,6,203
"14804",1014804,191,109,18,318
"14805",1014805,153,115,3,271
"14806",1014806,31,168,9,208
"14807",1014807,54,296,4,354
"14808",1014808,41,242,13,296
"14809",1014809,13,194,5,212
"14810",1014810,142,26,6,174
"14811",1014811,117,55,5,177
"14812",1014812,132,60,5,197
"14813",1014813,37,180,4,221
"14814",1014814,4,12,1,17
"14815",1014815,43,138,4,185
"14816",1014816,66,156,6,228
"14817",1014817,62,103,1,166
"14818",1014818,212,63,10,285
"14819",1014819,56,272,16,344
"14820",1014820,193,48,8,249
"14821",1014821,36,138,0,174
"14822",1014822,63,158,13,234
"14823",1014823,102,168,7,277
"14824",1014824,25,253,6,284
"14825",1014825,0,2,0,2
"14826",1014826,134,152,7,293
"14827",1014827,103,153,9,265
"14828",1014828,34,212,6,252
"14829",1014829,158,141,6,305
"14830",1014830,69,176,9,254
"14831",1014831,8,90,1,99
"14832",1014832,188,40,12,240
"14833",1014833,170,1,0,171
"14834",1014834,89,105,4,198
"14835",1014835,12,219,6,237
"14836",1014836,50,211,13,274
"14837",1014837,5,190,3,198
"14838",1014838,133,28,6,167
"14839",1014839,20,4,0,24
"14840",1014840,214,61,19,294
"14841",1014841,191,69,18,278
"14842",1014842,117,144,9,270
"14843",1014843,117,184,11,312
"14844",1014844,152,78,7,237
"14845",1014845,226,28,7,261
"14846",1014846,94,134,3,231
"14847",1014847,5,1,0,6
"14848",1014848,82,68,9,159
"14849",1014849,148,96,9,253
"14850",1014850,74,90,2,166
"14851",1014851,40,107,4,151
"14852",1014852,52,210,7,269
"14853",1014853,111,55,11,177
"14854",1014854,262,57,18,337
"14855",1014855,186,113,13,312
"14856",1014856,115,42,7,164
"14857",1014857,46,60,3,109
"14858",1014858,142,78,6,226
"14859",1014859,159,25,5,189
"14860",1014860,274,9,3,286
"14861",1014861,88,139,6,233
"14862",1014862,131,112,7,250
"14863",1014863,10,184,11,205
"14864",1014864,117,86,14,217
"14865",1014865,111,69,3,183
"14866",1014866,91,118,8,217
"14867",1014867,72,84,9,165
"14868",1014868,79,131,7,217
"14869",1014869,18,173,4,195
"14870",1014870,73,213,4,290
"14871",1014871,78,192,19,289
"14872",1014872,124,85,9,218
"14873",1014873,111,80,1,192
"14874",1014874,246,40,9,295
"14875",1014875,92,171,3,266
"14876",1014876,84,139,8,231
"14877",1014877,155,73,4,232
"14878",1014878,34,118,0,152
"14879",1014879,106,233,4,343
"14880",1014880,215,26,8,249
"14881",1014881,104,111,10,225
"14882",1014882,101,194,11,306
"14883",1014883,167,16,6,189
"14884",1014884,152,72,8,232
"14885",1014885,27,4,1,32
"14886",1014886,49,112,4,165
"14887",1014887,141,148,12,301
"14888",1014888,134,60,6,200
"14889",1014889,180,36,12,228
"14890",1014890,148,30,4,182
"14891",1014891,196,79,10,285
"14892",1014892,153,90,13,256
"14893",1014893,86,125,33,244
"14894",1014894,148,52,7,207
"14895",1014895,48,85,5,138
"14896",1014896,70,232,11,313
"14897",1014897,173,66,1,240
"14898",1014898,74,207,16,297
"14899",1014899,43,39,2,84
"14900",1014900,145,99,9,253
"14901",1014901,17,278,5,300
"14902",1014902,46,213,5,264
"14903",1014903,76,191,15,282
"14904",1014904,81,247,7,335
"14905",1014905,12,38,4,54
"14906",1014906,162,33,10,205
"14907",1014907,50,160,3,213
"14908",1014908,123,155,12,290
"14909",1014909,14,26,1,41
"14910",1014910,50,29,1,80
"14911",1014911,63,108,3,174
"14912",1014912,177,106,10,293
"14913",1014913,80,236,3,319
"14914",1014914,59,213,2,274
"14915",1014915,83,16,1,100
"14916",1014916,106,116,3,225
"14917",1014917,81,80,15,176
"14918",1014918,67,196,17,280
"14919",1014919,214,74,21,309
"14920",1014920,73,167,10,250
"14921",1014921,86,97,17,200
"14922",1014922,152,69,15,236
"14923",1014923,184,106,12,302
"14924",1014924,51,156,18,225
"14925",1014925,52,212,0,264
"14926",1014926,45,152,10,207
"14927",1014927,64,90,7,161
"14928",1014928,160,60,15,235
"14929",1014929,78,24,0,102
"14930",1014930,110,169,14,293
"14931",1014931,78,144,6,228
"14932",1014932,141,81,16,238
"14933",1014933,114,82,7,203
"14934",1014934,73,130,2,205
"14935",1014935,24,49,2,75
"14936",1014936,124,27,7,158
"14937",1014937,112,23,20,155
"14938",1014938,125,34,6,165
"14939",1014939,119,145,11,275
"14940",1014940,238,24,5,267
"14941",1014941,88,100,8,196
"14942",1014942,23,150,4,177
"14943",1014943,53,160,3,216
"14944",1014944,37,2,0,39
"14945",1014945,109,114,8,231
"14946",1014946,51,241,0,292
"14947",1014947,80,133,5,218
"14948",1014948,134,145,10,289
"14949",1014949,36,29,4,69
"14950",1014950,65,217,10,292
"14951",1014951,142,37,5,184
"14952",1014952,40,247,2,289
"14953",1014953,71,239,7,317
"14954",1014954,42,53,2,97
"14955",1014955,45,84,3,132
"14956",1014956,38,189,10,237
"14957",1014957,47,22,4,73
"14958",1014958,94,173,11,278
"14959",1014959,174,74,16,264
"14960",1014960,17,18,1,36
"14961",1014961,75,73,7,155
"14962",1014962,22,7,0,29
"14963",1014963,28,309,3,340
"14964",1014964,6,40,0,46
"14965",1014965,38,106,4,148
"14966",1014966,172,21,2,195
"14967",1014967,121,169,7,297
"14968",1014968,9,12,0,21
"14969",1014969,62,135,7,204
"14970",1014970,40,146,11,197
"14971",1014971,130,50,7,187
"14972",1014972,68,98,14,180
"14973",1014973,119,72,5,196
"14974",1014974,175,18,7,200
"14975",1014975,89,50,7,146
"14976",1014976,221,44,14,279
"14977",1014977,144,47,4,195
"14978",1014978,122,93,11,226
"14979",1014979,46,20,5,71
"14980",1014980,53,242,5,300
"14981",1014981,102,74,8,184
"14982",1014982,39,196,4,239
"14983",1014983,3,2,2,7
"14984",1014984,108,12,1,121
"14985",1014985,187,13,4,204
"14986",1014986,187,68,8,263
"14987",1014987,93,130,8,231
"14988",1014988,157,37,10,204
"14989",1014989,191,57,6,254
"14990",1014990,13,240,8,261
"14991",1014991,110,92,6,208
"14992",1014992,33,217,7,257
"14993",1014993,176,82,15,273
"14994",1014994,52,98,1,151
"14995",1014995,136,72,18,226
"14996",1014996,143,127,12,282
"14997",1014997,66,36,2,104
"14998",1014998,105,156,16,277
"14999",1014999,29,127,7,163
"15000",1015000,115,70,9,194
"15001",1015001,107,181,27,315
"15002",1015002,30,13,1,44
"15003",1015003,100,109,14,223
"15004",1015004,214,45,14,273
"15005",1015005,190,78,5,273
"15006",1015006,57,126,5,188
"15007",1015007,79,172,7,258
"15008",1015008,199,47,6,252
"15009",1015009,187,45,12,244
"15010",1015010,105,83,17,205
"15011",1015011,143,111,9,263
"15012",1015012,113,148,7,268
"15013",1015013,104,64,9,177
"15014",1015014,215,18,10,243
"15015",1015015,191,57,13,261
"15016",1015016,185,36,9,230
"15017",1015017,181,103,13,297
"15018",1015018,66,186,20,272
"15019",1015019,52,147,1,200
"15020",1015020,80,252,9,341
"15021",1015021,94,139,10,243
"15022",1015022,199,26,9,234
"15023",1015023,167,30,3,200
"15024",1015024,50,35,4,89
"15025",1015025,255,46,9,310
"15026",1015026,122,11,0,133
"15027",1015027,20,104,5,129
"15028",1015028,193,96,12,301
"15029",1015029,47,213,3,263
"15030",1015030,117,176,21,314
"15031",1015031,96,79,19,194
"15032",1015032,248,19,4,271
"15033",1015033,90,105,1,196
"15034",1015034,92,181,11,284
"15035",1015035,20,16,3,39
"15036",1015036,201,47,16,264
"15037",1015037,55,207,6,268
"15038",1015038,179,85,26,290
"15039",1015039,98,142,14,254
"15040",1015040,53,232,8,293
"15041",1015041,40,144,7,191
"15042",1015042,57,206,8,271
"15043",1015043,117,152,9,278
"15044",1015044,119,83,9,211
"15045",1015045,2,5,0,7
"15046",1015046,86,187,18,291
"15047",1015047,182,61,6,249
"15048",1015048,110,202,4,316
"15049",1015049,90,77,4,171
"15050",1015050,157,59,10,226
"15051",1015051,28,243,3,274
"15052",1015052,76,237,5,318
"15053",1015053,174,93,9,276
"15054",1015054,91,29,7,127
"15055",1015055,143,137,10,290
"15056",1015056,142,76,7,225
"15057",1015057,34,101,1,136
"15058",1015058,23,63,1,87
"15059",1015059,24,182,7,213
"15060",1015060,270,24,7,301
"15061",1015061,78,145,12,235
"15062",1015062,160,118,4,282
"15063",1015063,216,44,11,271
"15064",1015064,80,178,14,272
"15065",1015065,41,280,16,337
"15066",1015066,68,13,3,84
"15067",1015067,53,54,5,112
"15068",1015068,27,134,5,166
"15069",1015069,64,32,1,97
"15070",1015070,67,142,15,224
"15071",1015071,152,35,2,189
"15072",1015072,94,183,5,282
"15073",1015073,34,12,3,49
"15074",1015074,118,84,1,203
"15075",1015075,148,61,9,218
"15076",1015076,225,51,22,298
"15077",1015077,56,208,3,267
"15078",1015078,184,36,4,224
"15079",1015079,35,8,3,46
"15080",1015080,58,159,2,219
"15081",1015081,92,180,24,296
"15082",1015082,144,146,9,299
"15083",1015083,189,36,9,234
"15084",1015084,131,15,2,148
"15085",1015085,262,46,21,329
"15086",1015086,175,48,6,229
"15087",1015087,22,158,2,182
"15088",1015088,274,3,2,279
"15089",1015089,41,17,3,61
"15090",1015090,3,14,0,17
"15091",1015091,140,175,9,324
"15092",1015092,95,185,8,288
"15093",1015093,26,230,2,258
"15094",1015094,36,125,1,162
"15095",1015095,81,189,14,284
"15096",1015096,133,38,4,175
"15097",1015097,81,187,7,275
"15098",1015098,204,85,15,304
"15099",1015099,130,24,3,157
"15100",1015100,99,202,12,313
"15101",1015101,136,139,19,294
"15102",1015102,198,44,11,253
"15103",1015103,185,23,4,212
"15104",1015104,210,14,6,230
"15105",1015105,48,254,9,311
"15106",1015106,83,86,11,180
"15107",1015107,213,76,3,292
"15108",1015108,199,48,18,265
"15109",1015109,34,178,5,217
"15110",1015110,90,127,17,234
"15111",1015111,66,237,6,309
"15112",1015112,92,211,5,308
"15113",1015113,234,17,4,255
"15114",1015114,41,160,5,206
"15115",1015115,161,78,7,246
"15116",1015116,134,54,10,198
"15117",1015117,90,112,9,211
"15118",1015118,170,131,12,313
"15119",1015119,71,75,3,149
"15120",1015120,82,91,3,176
"15121",1015121,84,24,6,114
"15122",1015122,67,157,4,228
"15123",1015123,105,142,9,256
"15124",1015124,19,244,0,263
"15125",1015125,55,77,10,142
"15126",1015126,101,112,5,218
"15127",1015127,161,122,18,301
"15128",1015128,181,20,6,207
"15129",1015129,31,151,2,184
"15130",1015130,23,210,4,237
"15131",1015131,86,124,10,220
"15132",1015132,70,141,7,218
"15133",1015133,102,43,4,149
"15134",1015134,117,135,11,263
"15135",1015135,51,154,6,211
"15136",1015136,56,6,2,64
"15137",1015137,169,10,8,187
"15138",1015138,117,207,6,330
"15139",1015139,198,42,4,244
"15140",1015140,112,127,3,242
"15141",1015141,192,29,7,228
"15142",1015142,115,26,8,149
"15143",1015143,61,203,7,271
"15144",1015144,206,26,5,237
"15145",1015145,118,71,5,194
"15146",1015146,96,100,3,199
"15147",1015147,170,23,4,197
"15148",1015148,37,29,2,68
"15149",1015149,86,45,2,133
"15150",1015150,5,6,0,11
"15151",1015151,228,10,2,240
"15152",1015152,86,207,12,305
"15153",1015153,83,95,8,186
"15154",1015154,62,205,3,270
"15155",1015155,197,58,19,274
"15156",1015156,89,113,16,218
"15157",1015157,206,12,7,225
"15158",1015158,104,58,7,169
"15159",1015159,97,44,6,147
"15160",1015160,45,186,13,244
"15161",1015161,8,188,2,198
"15162",1015162,208,85,4,297
"15163",1015163,132,53,2,187
"15164",1015164,95,116,8,219
"15165",1015165,194,49,6,249
"15166",1015166,27,196,3,226
"15167",1015167,132,167,10,309
"15168",1015168,112,167,3,282
"15169",1015169,188,67,6,261
"15170",1015170,53,213,6,272
"15171",1015171,49,195,5,249
"15172",1015172,20,183,8,211
"15173",1015173,46,157,6,209
"15174",1015174,55,180,14,249
"15175",1015175,107,31,5,143
"15176",1015176,81,175,5,261
"15177",1015177,124,156,15,295
"15178",1015178,199,65,7,271
"15179",1015179,51,121,1,173
"15180",1015180,117,81,10,208
"15181",1015181,51,152,4,207
"15182",1015182,81,192,11,284
"15183",1015183,48,242,5,295
"15184",1015184,207,136,15,358
"15185",1015185,124,68,9,201
"15186",1015186,4,23,1,28
"15187",1015187,198,17,4,219
"15188",1015188,191,25,9,225
"15189",1015189,202,46,4,252
"15190",1015190,206,27,3,236
"15191",1015191,79,125,7,211
"15192",1015192,138,66,7,211
"15193",1015193,136,40,3,179
"15194",1015194,151,68,8,227
"15195",1015195,51,158,8,217
"15196",1015196,140,104,1,245
"15197",1015197,200,33,10,243
"15198",1015198,140,22,6,168
"15199",1015199,121,10,6,137
"15200",1015200,111,206,5,322
"15201",1015201,54,104,5,163
"15202",1015202,160,93,14,267
"15203",1015203,134,63,13,210
"15204",1015204,158,75,14,247
"15205",1015205,79,36,3,118
"15206",1015206,155,113,9,277
"15207",1015207,30,252,7,289
"15208",1015208,89,161,33,283
"15209",1015209,179,33,9,221
"15210",1015210,9,122,1,132
"15211",1015211,236,40,27,303
"15212",1015212,82,171,7,260
"15213",1015213,86,118,4,208
"15214",1015214,64,45,5,114
"15215",1015215,129,37,4,170
"15216",1015216,138,78,4,220
"15217",1015217,103,132,3,238
"15218",1015218,63,53,3,119
"15219",1015219,102,88,5,195
"15220",1015220,102,160,10,272
"15221",1015221,23,8,1,32
"15222",1015222,100,92,4,196
"15223",1015223,196,31,4,231
"15224",1015224,153,68,4,225
"15225",1015225,115,9,2,126
"15226",1015226,142,92,0,234
"15227",1015227,179,31,4,214
"15228",1015228,133,96,1,230
"15229",1015229,93,68,5,166
"15230",1015230,54,127,5,186
"15231",1015231,178,20,8,206
"15232",1015232,34,158,4,196
"15233",1015233,19,11,0,30
"15234",1015234,42,44,3,89
"15235",1015235,108,100,8,216
"15236",1015236,101,76,6,183
"15237",1015237,90,211,21,322
"15238",1015238,184,18,14,216
"15239",1015239,123,71,4,198
"15240",1015240,71,78,5,154
"15241",1015241,139,123,8,270
"15242",1015242,167,49,6,222
"15243",1015243,34,124,4,162
"15244",1015244,85,49,14,148
"15245",1015245,98,175,7,280
"15246",1015246,79,200,9,288
"15247",1015247,201,19,10,230
"15248",1015248,65,218,10,293
"15249",1015249,189,34,5,228
"15250",1015250,41,247,3,291
"15251",1015251,30,216,3,249
"15252",1015252,216,48,8,272
"15253",1015253,20,175,1,196
"15254",1015254,238,30,11,279
"15255",1015255,198,74,21,293
"15256",1015256,163,88,11,262
"15257",1015257,89,197,6,292
"15258",1015258,191,46,20,257
"15259",1015259,174,56,7,237
"15260",1015260,169,92,14,275
"15261",1015261,140,45,9,194
"15262",1015262,84,135,10,229
"15263",1015263,55,190,9,254
"15264",1015264,129,87,15,231
"15265",1015265,145,65,5,215
"15266",1015266,71,93,6,170
"15267",1015267,147,44,16,207
"15268",1015268,133,70,9,212
"15269",1015269,94,150,14,258
"15270",1015270,134,7,3,144
"15271",1015271,83,176,12,271
"15272",1015272,15,19,0,34
"15273",1015273,120,41,8,169
"15274",1015274,105,80,1,186
"15275",1015275,65,236,10,311
"15276",1015276,51,43,2,96
"15277",1015277,107,116,5,228
"15278",1015278,79,5,2,86
"15279",1015279,70,162,12,244
"15280",1015280,14,39,1,54
"15281",1015281,99,46,9,154
"15282",1015282,55,206,14,275
"15283",1015283,191,97,23,311
"15284",1015284,201,13,8,222
"15285",1015285,127,148,11,286
"15286",1015286,64,263,11,338
"15287",1015287,0,5,0,5
"15288",1015288,199,115,12,326
"15289",1015289,130,114,2,246
"15290",1015290,56,142,4,202
"15291",1015291,83,80,13,176
"15292",1015292,163,119,24,306
"15293",1015293,148,109,4,261
"15294",1015294,45,193,6,244
"15295",1015295,181,104,6,291
"15296",1015296,138,97,11,246
"15297",1015297,9,11,2,22
"15298",1015298,48,192,1,241
"15299",1015299,73,185,12,270
"15300",1015300,65,54,1,120
"15301",1015301,51,76,9,136
"15302",1015302,71,8,5,84
"15303",1015303,39,140,8,187
"15304",1015304,12,192,0,204
"15305",1015305,179,50,14,243
"15306",1015306,254,33,5,292
"15307",1015307,121,40,8,169
"15308",1015308,24,1,2,27
"15309",1015309,134,17,2,153
"15310",1015310,103,101,10,214
"15311",1015311,75,107,3,185
"15312",1015312,75,160,7,242
"15313",1015313,204,54,12,270
"15314",1015314,84,206,11,301
"15315",1015315,126,54,6,186
"15316",1015316,76,190,5,271
"15317",1015317,201,72,8,281
"15318",1015318,112,73,7,192
"15319",1015319,81,127,3,211
"15320",1015320,22,37,4,63
"15321",1015321,35,202,7,244
"15322",1015322,70,233,15,318
"15323",1015323,160,80,11,251
"15324",1015324,84,205,13,302
"15325",1015325,143,82,3,228
"15326",1015326,133,55,7,195
"15327",1015327,117,162,5,284
"15328",1015328,156,25,3,184
"15329",1015329,182,65,10,257
"15330",1015330,94,162,10,266
"15331",1015331,4,0,0,4
"15332",1015332,198,47,30,275
"15333",1015333,11,4,1,16
"15334",1015334,47,248,4,299
"15335",1015335,36,180,16,232
"15336",1015336,95,84,4,183
"15337",1015337,36,126,14,176
"15338",1015338,202,11,9,222
"15339",1015339,214,45,10,269
"15340",1015340,31,169,8,208
"15341",1015341,109,26,4,139
"15342",1015342,39,14,1,54
"15343",1015343,48,233,4,285
"15344",1015344,3,8,0,11
"15345",1015345,119,134,6,259
"15346",1015346,60,26,2,88
"15347",1015347,202,51,9,262
"15348",1015348,129,94,4,227
"15349",1015349,108,197,6,311
"15350",1015350,204,22,6,232
"15351",1015351,75,77,6,158
"15352",1015352,178,98,17,293
"15353",1015353,98,51,7,156
"15354",1015354,192,40,10,242
"15355",1015355,39,235,3,277
"15356",1015356,166,100,26,292
"15357",1015357,79,49,5,133
"15358",1015358,98,55,8,161
"15359",1015359,200,75,7,282
"15360",1015360,229,11,5,245
"15361",1015361,58,166,10,234
"15362",1015362,155,84,7,246
"15363",1015363,62,31,9,102
"15364",1015364,186,50,13,249
"15365",1015365,130,98,15,243
"15366",1015366,52,22,11,85
"15367",1015367,167,101,14,282
"15368",1015368,35,102,2,139
"15369",1015369,192,19,5,216
"15370",1015370,112,115,12,239
"15371",1015371,27,145,3,175
"15372",1015372,45,175,7,227
"15373",1015373,66,18,12,96
"15374",1015374,213,92,4,309
"15375",1015375,191,7,2,200
"15376",1015376,123,62,6,191
"15377",1015377,86,147,7,240
"15378",1015378,19,213,17,249
"15379",1015379,127,103,7,237
"15380",1015380,130,64,7,201
"15381",1015381,196,36,9,241
"15382",1015382,106,179,8,293
"15383",1015383,39,219,10,268
"15384",1015384,57,120,13,190
"15385",1015385,146,74,5,225
"15386",1015386,55,186,4,245
"15387",1015387,98,8,1,107
"15388",1015388,239,33,1,273
"15389",1015389,29,186,2,217
"15390",1015390,244,43,9,296
"15391",1015391,152,179,12,343
"15392",1015392,81,39,6,126
"15393",1015393,97,83,8,188
"15394",1015394,255,15,7,277
"15395",1015395,178,68,12,258
"15396",1015396,117,191,7,315
"15397",1015397,171,18,6,195
"15398",1015398,122,48,2,172
"15399",1015399,30,221,15,266
"15400",1015400,89,172,7,268
"15401",1015401,71,246,10,327
"15402",1015402,177,18,2,197
"15403",1015403,59,250,7,316
"15404",1015404,79,13,1,93
"15405",1015405,81,118,17,216
"15406",1015406,105,177,14,296
"15407",1015407,201,37,10,248
"15408",1015408,41,266,5,312
"15409",1015409,50,160,11,221
"15410",1015410,166,1,3,170
"15411",1015411,144,54,4,202
"15412",1015412,129,59,12,200
"15413",1015413,82,168,25,275
"15414",1015414,161,131,15,307
"15415",1015415,269,40,7,316
"15416",1015416,134,106,12,252
"15417",1015417,146,103,2,251
"15418",1015418,139,67,2,208
"15419",1015419,58,114,4,176
"15420",1015420,54,151,6,211
"15421",1015421,44,7,6,57
"15422",1015422,173,58,2,233
"15423",1015423,135,46,5,186
"15424",1015424,151,83,24,258
"15425",1015425,43,159,10,212
"15426",1015426,80,129,5,214
"15427",1015427,191,52,8,251
"15428",1015428,56,184,15,255
"15429",1015429,10,62,1,73
"15430",1015430,82,233,10,325
"15431",1015431,255,56,13,324
"15432",1015432,80,196,13,289
"15433",1015433,208,118,20,346
"15434",1015434,203,48,10,261
"15435",1015435,170,46,10,226
"15436",1015436,186,41,7,234
"15437",1015437,14,4,1,19
"15438",1015438,129,135,11,275
"15439",1015439,143,43,7,193
"15440",1015440,193,67,9,269
"15441",1015441,64,260,9,333
"15442",1015442,202,86,2,290
"15443",1015443,26,130,9,165
"15444",1015444,257,33,11,301
"15445",1015445,42,20,3,65
"15446",1015446,182,41,6,229
"15447",1015447,159,48,2,209
"15448",1015448,141,67,4,212
"15449",1015449,113,80,4,197
"15450",1015450,28,117,5,150
"15451",1015451,59,145,5,209
"15452",1015452,196,28,9,233
"15453",1015453,109,190,6,305
"15454",1015454,91,112,7,210
"15455",1015455,67,188,4,259
"15456",1015456,44,196,5,245
"15457",1015457,239,23,8,270
"15458",1015458,73,147,8,228
"15459",1015459,227,43,10,280
"15460",1015460,121,105,3,229
"15461",1015461,96,169,9,274
"15462",1015462,86,162,8,256
"15463",1015463,182,49,2,233
"15464",1015464,54,96,8,158
"15465",1015465,184,45,4,233
"15466",1015466,98,188,16,302
"15467",1015467,140,41,7,188
"15468",1015468,83,78,8,169
"15469",1015469,154,85,5,244
"15470",1015470,117,163,14,294
"15471",1015471,119,103,8,230
"15472",1015472,164,38,4,206
"15473",1015473,132,116,6,254
"15474",1015474,166,87,9,262
"15475",1015475,56,152,12,220
"15476",1015476,60,195,9,264
"15477",1015477,163,115,8,286
"15478",1015478,108,2,0,110
"15479",1015479,115,105,11,231
"15480",1015480,23,227,3,253
"15481",1015481,123,111,20,254
"15482",1015482,192,58,11,261
"15483",1015483,187,68,10,265
"15484",1015484,45,175,9,229
"15485",1015485,97,59,8,164
"15486",1015486,50,208,5,263
"15487",1015487,175,129,17,321
"15488",1015488,244,25,5,274
"15489",1015489,91,92,8,191
"15490",1015490,120,66,7,193
"15491",1015491,85,228,15,328
"15492",1015492,14,13,2,29
"15493",1015493,141,146,18,305
"15494",1015494,157,53,19,229
"15495",1015495,89,168,20,277
"15496",1015496,42,2,3,47
"15497",1015497,219,75,18,312
"15498",1015498,45,132,5,182
"15499",1015499,111,118,14,243
"15500",1015500,41,90,4,135
"15501",1015501,9,4,0,13
"15502",1015502,138,35,8,181
"15503",1015503,129,63,11,203
"15504",1015504,87,67,2,156
"15505",1015505,8,3,0,11
"15506",1015506,40,189,3,232
"15507",1015507,69,234,15,318
"15508",1015508,150,20,12,182
"15509",1015509,186,77,12,275
"15510",1015510,196,48,7,251
"15511",1015511,95,110,3,208
"15512",1015512,124,109,8,241
"15513",1015513,152,130,5,287
"15514",1015514,139,25,5,169
"15515",1015515,233,43,7,283
"15516",1015516,142,28,7,177
"15517",1015517,160,45,11,216
"15518",1015518,172,64,7,243
"15519",1015519,231,36,11,278
"15520",1015520,101,184,10,295
"15521",1015521,56,185,6,247
"15522",1015522,93,141,7,241
"15523",1015523,137,13,2,152
"15524",1015524,46,213,7,266
"15525",1015525,128,94,11,233
"15526",1015526,161,62,14,237
"15527",1015527,50,193,11,254
"15528",1015528,105,225,8,338
"15529",1015529,48,273,10,331
"15530",1015530,134,4,2,140
"15531",1015531,112,128,6,246
"15532",1015532,53,83,2,138
"15533",1015533,104,29,6,139
"15534",1015534,192,63,19,274
"15535",1015535,29,218,11,258
"15536",1015536,111,108,6,225
"15537",1015537,77,48,5,130
"15538",1015538,93,242,20,355
"15539",1015539,53,207,10,270
"15540",1015540,66,7,2,75
"15541",1015541,53,54,4,111
"15542",1015542,131,56,16,203
"15543",1015543,157,18,6,181
"15544",1015544,141,108,11,260
"15545",1015545,69,156,8,233
"15546",1015546,207,73,15,295
"15547",1015547,240,33,6,279
"15548",1015548,24,2,1,27
"15549",1015549,96,88,7,191
"15550",1015550,178,63,7,248
"15551",1015551,148,95,9,252
"15552",1015552,118,104,6,228
"15553",1015553,120,79,9,208
"15554",1015554,115,167,13,295
"15555",1015555,136,132,14,282
"15556",1015556,177,48,4,229
"15557",1015557,66,197,6,269
"15558",1015558,32,315,1,348
"15559",1015559,130,135,7,272
"15560",1015560,160,21,4,185
"15561",1015561,95,131,9,235
"15562",1015562,67,0,0,67
"15563",1015563,126,138,2,266
"15564",1015564,140,68,7,215
"15565",1015565,112,103,12,227
"15566",1015566,105,120,10,235
"15567",1015567,73,42,0,115
"15568",1015568,71,91,11,173
"15569",1015569,48,203,9,260
"15570",1015570,29,303,4,336
"15571",1015571,71,68,6,145
"15572",1015572,201,79,9,289
"15573",1015573,12,344,7,363
"15574",1015574,7,39,0,46
"15575",1015575,144,77,7,228
"15576",1015576,175,89,23,287
"15577",1015577,152,61,10,223
"15578",1015578,107,116,9,232
"15579",1015579,23,141,3,167
"15580",1015580,49,115,3,167
"15581",1015581,164,145,7,316
"15582",1015582,114,81,14,209
"15583",1015583,104,24,4,132
"15584",1015584,53,55,1,109
"15585",1015585,110,31,14,155
"15586",1015586,119,35,5,159
"15587",1015587,160,36,4,200
"15588",1015588,111,144,3,258
"15589",1015589,46,204,8,258
"15590",1015590,173,43,8,224
"15591",1015591,219,19,6,244
"15592",1015592,132,179,14,325
"15593",1015593,177,67,5,249
"15594",1015594,86,85,14,185
"15595",1015595,47,261,5,313
"15596",1015596,52,131,3,186
"15597",1015597,104,117,7,228
"15598",1015598,121,69,7,197
"15599",1015599,81,191,17,289
"15600",1015600,134,66,7,207
"15601",1015601,131,117,4,252
"15602",1015602,153,47,2,202
"15603",1015603,31,184,9,224
"15604",1015604,86,134,6,226
"15605",1015605,20,31,0,51
"15606",1015606,162,47,7,216
"15607",1015607,38,8,7,53
"15608",1015608,176,10,1,187
"15609",1015609,107,132,9,248
"15610",1015610,80,163,8,251
"15611",1015611,191,89,14,294
"15612",1015612,109,27,6,142
"15613",1015613,121,26,3,150
"15614",1015614,26,175,2,203
"15615",1015615,250,9,4,263
"15616",1015616,118,83,2,203
"15617",1015617,92,111,7,210
"15618",1015618,170,42,14,226
"15619",1015619,62,215,5,282
"15620",1015620,95,135,10,240
"15621",1015621,81,196,5,282
"15622",1015622,62,227,14,303
"15623",1015623,144,95,3,242
"15624",1015624,35,86,0,121
"15625",1015625,126,158,7,291
"15626",1015626,141,144,5,290
"15627",1015627,113,87,9,209
"15628",1015628,132,179,5,316
"15629",1015629,190,31,6,227
"15630",1015630,84,174,13,271
"15631",1015631,165,91,10,266
"15632",1015632,64,175,27,266
"15633",1015633,43,61,1,105
"15634",1015634,132,15,3,150
"15635",1015635,36,86,5,127
"15636",1015636,163,131,13,307
"15637",1015637,212,29,12,253
"15638",1015638,53,138,4,195
"15639",1015639,37,149,7,193
"15640",1015640,91,173,2,266
"15641",1015641,25,252,7,284
"15642",1015642,39,50,4,93
"15643",1015643,106,122,5,233
"15644",1015644,86,162,3,251
"15645",1015645,196,70,6,272
"15646",1015646,201,42,6,249
"15647",1015647,88,29,6,123
"15648",1015648,130,95,8,233
"15649",1015649,176,144,10,330
"15650",1015650,133,143,21,297
"15651",1015651,156,44,11,211
"15652",1015652,273,41,10,324
"15653",1015653,61,164,6,231
"15654",1015654,182,48,8,238
"15655",1015655,114,11,4,129
"15656",1015656,150,75,10,235
"15657",1015657,142,82,14,238
"15658",1015658,105,108,7,220
"15659",1015659,73,194,10,277
"15660",1015660,195,85,15,295
"15661",1015661,98,104,7,209
"15662",1015662,208,66,9,283
"15663",1015663,15,240,8,263
"15664",1015664,69,24,3,96
"15665",1015665,101,189,11,301
"15666",1015666,59,149,2,210
"15667",1015667,121,50,6,177
"15668",1015668,30,213,8,251
"15669",1015669,48,197,12,257
"15670",1015670,32,130,1,163
"15671",1015671,27,33,1,61
"15672",1015672,70,105,5,180
"15673",1015673,76,48,3,127
"15674",1015674,214,44,6,264
"15675",1015675,118,115,10,243
"15676",1015676,124,100,1,225
"15677",1015677,39,64,5,108
"15678",1015678,118,58,8,184
"15679",1015679,110,151,18,279
"15680",1015680,125,90,11,226
"15681",1015681,84,114,5,203
"15682",1015682,5,72,1,78
"15683",1015683,200,39,9,248
"15684",1015684,75,204,15,294
"15685",1015685,25,6,0,31
"15686",1015686,134,26,7,167
"15687",1015687,62,50,2,114
"15688",1015688,193,29,4,226
"15689",1015689,41,183,3,227
"15690",1015690,82,75,11,168
"15691",1015691,170,62,10,242
"15692",1015692,113,129,16,258
"15693",1015693,166,30,10,206
"15694",1015694,118,65,7,190
"15695",1015695,30,36,3,69
"15696",1015696,98,34,2,134
"15697",1015697,125,131,7,263
"15698",1015698,189,48,9,246
"15699",1015699,96,132,2,230
"15700",1015700,89,128,5,222
"15701",1015701,175,88,4,267
"15702",1015702,38,284,9,331
"15703",1015703,156,76,4,236
"15704",1015704,59,159,8,226
"15705",1015705,27,8,0,35
"15706",1015706,101,122,3,226
"15707",1015707,123,159,7,289
"15708",1015708,89,74,3,166
"15709",1015709,141,54,4,199
"15710",1015710,180,22,4,206
"15711",1015711,34,84,6,124
"15712",1015712,197,77,6,280
"15713",1015713,111,358,12,481
"15714",1015714,99,54,3,156
"15715",1015715,139,43,2,184
"15716",1015716,61,199,7,267
"15717",1015717,87,109,5,201
"15718",1015718,161,106,9,276
"15719",1015719,70,171,6,247
"15720",1015720,84,91,12,187
"15721",1015721,133,42,2,177
"15722",1015722,73,118,5,196
"15723",1015723,157,51,3,211
"15724",1015724,118,116,18,252
"15725",1015725,87,176,14,277
"15726",1015726,195,55,12,262
"15727",1015727,146,77,13,236
"15728",1015728,201,49,11,261
"15729",1015729,105,111,9,225
"15730",1015730,178,74,1,253
"15731",1015731,148,14,5,167
"15732",1015732,90,1,3,94
"15733",1015733,156,53,8,217
"15734",1015734,108,150,11,269
"15735",1015735,93,128,15,236
"15736",1015736,202,23,3,228
"15737",1015737,50,197,8,255
"15738",1015738,126,76,14,216
"15739",1015739,100,156,3,259
"15740",1015740,116,182,6,304
"15741",1015741,169,65,17,251
"15742",1015742,110,76,5,191
"15743",1015743,62,185,19,266
"15744",1015744,98,165,7,270
"15745",1015745,17,144,2,163
"15746",1015746,91,126,14,231
"15747",1015747,152,43,6,201
"15748",1015748,114,150,9,273
"15749",1015749,161,62,8,231
"15750",1015750,57,45,10,112
"15751",1015751,165,37,7,209
"15752",1015752,78,231,4,313
"15753",1015753,135,68,5,208
"15754",1015754,51,194,6,251
"15755",1015755,207,93,10,310
"15756",1015756,198,78,6,282
"15757",1015757,154,70,7,231
"15758",1015758,14,34,7,55
"15759",1015759,210,37,3,250
"15760",1015760,96,105,2,203
"15761",1015761,65,257,4,326
"15762",1015762,64,173,7,244
"15763",1015763,152,128,12,292
"15764",1015764,147,77,10,234
"15765",1015765,34,176,5,215
"15766",1015766,153,66,8,227
"15767",1015767,156,42,6,204
"15768",1015768,8,45,0,53
"15769",1015769,45,192,9,246
"15770",1015770,141,36,9,186
"15771",1015771,328,6,1,335
"15772",1015772,167,117,20,304
"15773",1015773,65,214,4,283
"15774",1015774,76,93,5,174
"15775",1015775,179,33,11,223
"15776",1015776,197,66,11,274
"15777",1015777,93,89,9,191
"15778",1015778,55,180,4,239
"15779",1015779,68,124,14,206
"15780",1015780,64,225,5,294
"15781",1015781,107,168,13,288
"15782",1015782,119,54,17,190
"15783",1015783,36,7,1,44
"15784",1015784,25,13,2,40
"15785",1015785,125,73,1,199
"15786",1015786,44,311,6,361
"15787",1015787,195,30,6,231
"15788",1015788,69,198,11,278
"15789",1015789,102,209,10,321
"15790",1015790,59,96,5,160
"15791",1015791,92,51,16,159
"15792",1015792,82,111,11,204
"15793",1015793,109,59,9,177
"15794",1015794,88,57,6,151
"15795",1015795,42,141,1,184
"15796",1015796,83,106,21,210
"15797",1015797,165,19,5,189
"15798",1015798,92,47,6,145
"15799",1015799,191,67,10,268
"15800",1015800,126,91,12,229
"15801",1015801,110,12,1,123
"15802",1015802,89,118,3,210
"15803",1015803,114,142,9,265
"15804",1015804,67,214,10,291
"15805",1015805,73,160,3,236
"15806",1015806,120,46,9,175
"15807",1015807,104,61,3,168
"15808",1015808,82,20,2,104
"15809",1015809,32,191,8,231
"15810",1015810,72,190,3,265
"15811",1015811,149,26,4,179
"15812",1015812,142,51,1,194
"15813",1015813,24,44,3,71
"15814",1015814,223,26,11,260
"15815",1015815,178,43,7,228
"15816",1015816,155,24,9,188
"15817",1015817,195,50,9,254
"15818",1015818,71,29,4,104
"15819",1015819,219,35,8,262
"15820",1015820,56,49,0,105
"15821",1015821,49,148,11,208
"15822",1015822,150,69,5,224
"15823",1015823,113,135,12,260
"15824",1015824,104,31,4,139
"15825",1015825,44,46,2,92
"15826",1015826,106,51,10,167
"15827",1015827,150,72,11,233
"15828",1015828,140,45,5,190
"15829",1015829,65,20,4,89
"15830",1015830,78,66,2,146
"15831",1015831,90,98,10,198
"15832",1015832,2,14,1,17
"15833",1015833,80,194,10,284
"15834",1015834,169,87,3,259
"15835",1015835,114,135,10,259
"15836",1015836,187,32,9,228
"15837",1015837,69,33,1,103
"15838",1015838,97,197,7,301
"15839",1015839,165,84,6,255
"15840",1015840,195,17,2,214
"15841",1015841,152,71,12,235
"15842",1015842,150,78,7,235
"15843",1015843,27,51,7,85
"15844",1015844,106,40,4,150
"15845",1015845,257,66,13,336
"15846",1015846,62,170,12,244
"15847",1015847,177,98,19,294
"15848",1015848,31,113,4,148
"15849",1015849,177,16,5,198
"15850",1015850,130,151,13,294
"15851",1015851,75,217,13,305
"15852",1015852,24,153,3,180
"15853",1015853,83,197,3,283
"15854",1015854,54,145,2,201
"15855",1015855,187,8,8,203
"15856",1015856,55,140,3,198
"15857",1015857,84,154,9,247
"15858",1015858,135,65,10,210
"15859",1015859,38,5,2,45
"15860",1015860,206,37,4,247
"15861",1015861,49,112,1,162
"15862",1015862,83,171,4,258
"15863",1015863,69,203,12,284
"15864",1015864,47,59,4,110
"15865",1015865,25,6,2,33
"15866",1015866,50,206,2,258
"15867",1015867,158,98,4,260
"15868",1015868,142,55,9,206
"15869",1015869,75,181,12,268
"15870",1015870,43,246,2,291
"15871",1015871,79,96,2,177
"15872",1015872,55,269,4,328
"15873",1015873,32,174,4,210
"15874",1015874,8,14,0,22
"15875",1015875,29,148,1,178
"15876",1015876,118,155,11,284
"15877",1015877,92,82,1,175
"15878",1015878,60,118,5,183
"15879",1015879,114,117,2,233
"15880",1015880,167,22,6,195
"15881",1015881,103,19,5,127
"15882",1015882,100,131,10,241
"15883",1015883,163,108,12,283
"15884",1015884,204,62,9,275
"15885",1015885,214,22,9,245
"15886",1015886,193,15,6,214
"15887",1015887,187,23,5,215
"15888",1015888,5,25,0,30
"15889",1015889,179,127,12,318
"15890",1015890,118,59,3,180
"15891",1015891,154,115,25,294
"15892",1015892,127,72,9,208
"15893",1015893,97,155,4,256
"15894",1015894,76,81,3,160
"15895",1015895,90,176,10,276
"15896",1015896,28,30,1,59
"15897",1015897,240,54,18,312
"15898",1015898,208,51,6,265
"15899",1015899,66,117,13,196
"15900",1015900,91,143,10,244
"15901",1015901,86,46,7,139
"15902",1015902,171,59,2,232
"15903",1015903,140,42,3,185
"15904",1015904,70,150,8,228
"15905",1015905,52,247,4,303
"15906",1015906,114,137,14,265
"15907",1015907,39,52,4,95
"15908",1015908,86,121,2,209
"15909",1015909,103,67,4,174
"15910",1015910,77,100,4,181
"15911",1015911,207,85,5,297
"15912",1015912,152,75,8,235
"15913",1015913,63,259,4,326
"15914",1015914,68,53,4,125
"15915",1015915,157,111,13,281
"15916",1015916,204,67,15,286
"15917",1015917,145,51,4,200
"15918",1015918,34,126,7,167
"15919",1015919,126,180,15,321
"15920",1015920,155,80,5,240
"15921",1015921,102,61,3,166
"15922",1015922,10,26,2,38
"15923",1015923,60,83,7,150
"15924",1015924,154,126,12,292
"15925",1015925,249,51,12,312
"15926",1015926,151,105,4,260
"15927",1015927,163,79,3,245
"15928",1015928,188,89,14,291
"15929",1015929,41,101,2,144
"15930",1015930,108,126,10,244
"15931",1015931,95,117,12,224
"15932",1015932,160,54,4,218
"15933",1015933,216,10,4,230
"15934",1015934,65,164,26,255
"15935",1015935,244,57,14,315
"15936",1015936,59,173,8,240
"15937",1015937,173,109,12,294
"15938",1015938,169,58,5,232
"15939",1015939,66,319,14,399
"15940",1015940,100,218,8,326
"15941",1015941,174,48,13,235
"15942",1015942,93,230,17,340
"15943",1015943,139,89,4,232
"15944",1015944,147,29,3,179
"15945",1015945,76,111,9,196
"15946",1015946,179,58,9,246
"15947",1015947,45,12,0,57
"15948",1015948,124,63,3,190
"15949",1015949,181,88,17,286
"15950",1015950,176,109,12,297
"15951",1015951,97,159,15,271
"15952",1015952,168,41,14,223
"15953",1015953,38,56,13,107
"15954",1015954,54,283,5,342
"15955",1015955,65,20,5,90
"15956",1015956,99,33,7,139
"15957",1015957,93,128,10,231
"15958",1015958,153,98,7,258
"15959",1015959,79,43,0,122
"15960",1015960,154,26,8,188
"15961",1015961,77,225,20,322
"15962",1015962,34,138,5,177
"15963",1015963,48,133,7,188
"15964",1015964,42,245,4,291
"15965",1015965,176,44,8,228
"15966",1015966,146,48,7,201
"15967",1015967,191,93,15,299
"15968",1015968,194,56,9,259
"15969",1015969,73,131,6,210
"15970",1015970,65,90,2,157
"15971",1015971,100,55,4,159
"15972",1015972,82,51,6,139
"15973",1015973,114,114,6,234
"15974",1015974,36,23,3,62
"15975",1015975,93,93,6,192
"15976",1015976,112,19,4,135
"15977",1015977,156,51,7,214
"15978",1015978,38,308,1,347
"15979",1015979,6,91,1,98
"15980",1015980,46,302,6,354
"15981",1015981,15,153,4,172
"15982",1015982,136,85,7,228
"15983",1015983,147,87,7,241
"15984",1015984,183,53,25,261
"15985",1015985,89,120,1,210
"15986",1015986,202,24,7,233
"15987",1015987,117,100,11,228
"15988",1015988,26,190,3,219
"15989",1015989,181,68,2,251
"15990",1015990,111,151,21,283
"15991",1015991,185,53,10,248
"15992",1015992,144,168,11,323
"15993",1015993,35,263,7,305
"15994",1015994,11,178,0,189
"15995",1015995,155,102,10,267
"15996",1015996,48,216,8,272
"15997",1015997,181,46,6,233
"15998",1015998,130,134,16,280
"15999",1015999,148,54,6,208
"16000",1016000,34,250,11,295
"16001",1016001,176,35,4,215
"16002",1016002,150,73,5,228
"16003",1016003,40,8,5,53
"16004",1016004,133,36,3,172
"16005",1016005,78,81,2,161
"16006",1016006,228,23,7,258
"16007",1016007,9,89,2,100
"16008",1016008,125,67,7,199
"16009",1016009,146,37,5,188
"16010",1016010,152,95,8,255
"16011",1016011,186,76,5,267
"16012",1016012,195,98,16,309
"16013",1016013,172,40,7,219
"16014",1016014,188,23,15,226
"16015",1016015,90,155,11,256
"16016",1016016,163,154,30,347
"16017",1016017,59,194,9,262
"16018",1016018,20,22,4,46
"16019",1016019,168,90,12,270
"16020",1016020,59,38,2,99
"16021",1016021,209,25,5,239
"16022",1016022,10,321,6,337
"16023",1016023,81,167,4,252
"16024",1016024,64,207,4,275
"16025",1016025,128,13,3,144
"16026",1016026,14,36,1,51
"16027",1016027,10,18,1,29
"16028",1016028,11,42,4,57
"16029",1016029,68,116,12,196
"16030",1016030,63,156,10,229
"16031",1016031,192,91,11,294
"16032",1016032,198,46,6,250
"16033",1016033,74,205,10,289
"16034",1016034,234,45,12,291
"16035",1016035,27,153,3,183
"16036",1016036,94,80,8,182
"16037",1016037,147,111,5,263
"16038",1016038,75,188,20,283
"16039",1016039,159,92,8,259
"16040",1016040,131,151,25,307
"16041",1016041,79,86,9,174
"16042",1016042,46,233,4,283
"16043",1016043,214,55,8,277
"16044",1016044,13,132,4,149
"16045",1016045,257,35,17,309
"16046",1016046,147,57,5,209
"16047",1016047,48,261,3,312
"16048",1016048,182,18,8,208
"16049",1016049,66,103,7,176
"16050",1016050,115,93,25,233
"16051",1016051,152,33,4,189
"16052",1016052,80,16,6,102
"16053",1016053,80,256,9,345
"16054",1016054,207,30,7,244
"16055",1016055,11,2,0,13
"16056",1016056,33,125,2,160
"16057",1016057,15,259,1,275
"16058",1016058,43,233,19,295
"16059",1016059,2,9,1,12
"16060",1016060,43,33,10,86
"16061",1016061,119,134,21,274
"16062",1016062,201,44,14,259
"16063",1016063,55,138,7,200
"16064",1016064,147,121,12,280
"16065",1016065,68,253,2,323
"16066",1016066,127,138,25,290
"16067",1016067,73,199,13,285
"16068",1016068,38,183,13,234
"16069",1016069,48,229,11,288
"16070",1016070,41,250,5,296
"16071",1016071,70,64,2,136
"16072",1016072,173,43,4,220
"16073",1016073,112,45,12,169
"16074",1016074,122,34,5,161
"16075",1016075,126,132,12,270
"16076",1016076,100,167,10,277
"16077",1016077,183,96,11,290
"16078",1016078,64,195,27,286
"16079",1016079,76,34,5,115
"16080",1016080,206,31,11,248
"16081",1016081,40,197,11,248
"16082",1016082,95,105,12,212
"16083",1016083,123,22,5,150
"16084",1016084,91,138,8,237
"16085",1016085,127,81,18,226
"16086",1016086,195,17,3,215
"16087",1016087,175,41,4,220
"16088",1016088,173,50,1,224
"16089",1016089,137,165,11,313
"16090",1016090,128,98,12,238
"16091",1016091,123,108,7,238
"16092",1016092,62,182,17,261
"16093",1016093,61,89,3,153
"16094",1016094,99,85,13,197
"16095",1016095,161,44,19,224
"16096",1016096,150,37,8,195
"16097",1016097,108,59,3,170
"16098",1016098,42,184,6,232
"16099",1016099,152,71,6,229
"16100",1016100,54,97,0,151
"16101",1016101,5,95,1,101
"16102",1016102,155,102,16,273
"16103",1016103,190,77,8,275
"16104",1016104,36,36,2,74
"16105",1016105,36,93,3,132
"16106",1016106,72,143,11,226
"16107",1016107,11,2,1,14
"16108",1016108,146,91,13,250
"16109",1016109,87,151,7,245
"16110",1016110,46,218,13,277
"16111",1016111,110,40,14,164
"16112",1016112,43,178,7,228
"16113",1016113,203,104,9,316
"16114",1016114,56,163,13,232
"16115",1016115,145,156,11,312
"16116",1016116,133,72,4,209
"16117",1016117,12,7,4,23
"16118",1016118,163,63,8,234
"16119",1016119,87,134,8,229
"16120",1016120,87,141,3,231
"16121",1016121,34,251,7,292
"16122",1016122,203,23,15,241
"16123",1016123,106,97,6,209
"16124",1016124,136,162,23,321
"16125",1016125,52,178,9,239
"16126",1016126,116,79,17,212
"16127",1016127,48,215,24,287
"16128",1016128,43,204,4,251
"16129",1016129,164,83,17,264
"16130",1016130,26,338,4,368
"16131",1016131,160,54,12,226
"16132",1016132,147,94,10,251
"16133",1016133,135,114,9,258
"16134",1016134,149,50,3,202
"16135",1016135,62,80,9,151
"16136",1016136,40,191,7,238
"16137",1016137,25,266,6,297
"16138",1016138,112,100,7,219
"16139",1016139,184,135,8,327
"16140",1016140,125,125,6,256
"16141",1016141,59,124,8,191
"16142",1016142,193,14,7,214
"16143",1016143,140,163,7,310
"16144",1016144,106,74,14,194
"16145",1016145,169,26,8,203
"16146",1016146,83,171,6,260
"16147",1016147,67,56,3,126
"16148",1016148,119,108,3,230
"16149",1016149,211,41,8,260
"16150",1016150,28,157,6,191
"16151",1016151,176,95,1,272
"16152",1016152,175,118,8,301
"16153",1016153,187,166,11,364
"16154",1016154,115,109,13,237
"16155",1016155,164,145,15,324
"16156",1016156,68,164,24,256
"16157",1016157,167,66,18,251
"16158",1016158,152,121,8,281
"16159",1016159,123,92,12,227
"16160",1016160,98,186,6,290
"16161",1016161,103,187,7,297
"16162",1016162,123,127,7,257
"16163",1016163,87,140,4,231
"16164",1016164,54,123,6,183
"16165",1016165,14,10,0,24
"16166",1016166,102,111,13,226
"16167",1016167,77,77,2,156
"16168",1016168,41,18,1,60
"16169",1016169,190,48,2,240
"16170",1016170,92,197,11,300
"16171",1016171,21,173,2,196
"16172",1016172,20,225,0,245
"16173",1016173,229,44,10,283
"16174",1016174,53,6,4,63
"16175",1016175,16,178,3,197
"16176",1016176,67,5,3,75
"16177",1016177,235,24,7,266
"16178",1016178,117,162,22,301
"16179",1016179,184,81,13,278
"16180",1016180,34,20,4,58
"16181",1016181,169,79,3,251
"16182",1016182,92,122,21,235
"16183",1016183,72,184,17,273
"16184",1016184,104,18,3,125
"16185",1016185,130,64,4,198
"16186",1016186,128,10,23,161
"16187",1016187,62,131,5,198
"16188",1016188,72,191,12,275
"16189",1016189,143,36,7,186
"16190",1016190,126,87,15,228
"16191",1016191,130,70,0,200
"16192",1016192,77,174,9,260
"16193",1016193,129,103,6,238
"16194",1016194,245,67,12,324
"16195",1016195,133,153,7,293
"16196",1016196,98,186,22,306
"16197",1016197,0,0,0,0
"16198",1016198,168,103,7,278
"16199",1016199,103,264,5,372
"16200",1016200,92,170,6,268
"16201",1016201,193,31,7,231
"16202",1016202,36,238,7,281
"16203",1016203,128,15,7,150
"16204",1016204,56,66,13,135
"16205",1016205,58,257,5,320
"16206",1016206,191,31,5,227
"16207",1016207,238,27,2,267
"16208",1016208,153,105,5,263
"16209",1016209,170,49,7,226
"16210",1016210,70,171,2,243
"16211",1016211,134,118,12,264
"16212",1016212,111,172,12,295
"16213",1016213,103,163,10,276
"16214",1016214,64,155,10,229
"16215",1016215,155,102,9,266
"16216",1016216,163,47,3,213
"16217",1016217,99,119,4,222
"16218",1016218,124,101,16,241
"16219",1016219,51,71,5,127
"16220",1016220,235,3,7,245
"16221",1016221,14,345,8,367
"16222",1016222,108,130,8,246
"16223",1016223,94,143,6,243
"16224",1016224,96,96,4,196
"16225",1016225,31,171,1,203
"16226",1016226,143,29,3,175
"16227",1016227,103,116,7,226
"16228",1016228,112,169,10,291
"16229",1016229,187,32,13,232
"16230",1016230,9,121,3,133
"16231",1016231,110,153,15,278
"16232",1016232,16,197,1,214
"16233",1016233,224,50,8,282
"16234",1016234,32,220,7,259
"16235",1016235,17,235,5,257
"16236",1016236,70,201,9,280
"16237",1016237,176,68,5,249
"16238",1016238,33,17,0,50
"16239",1016239,95,157,11,263
"16240",1016240,107,21,2,130
"16241",1016241,65,60,3,128
"16242",1016242,89,161,2,252
"16243",1016243,131,78,16,225
"16244",1016244,49,130,9,188
"16245",1016245,151,42,3,196
"16246",1016246,81,141,3,225
"16247",1016247,69,185,13,267
"16248",1016248,6,89,2,97
"16249",1016249,69,20,0,89
"16250",1016250,121,34,12,167
"16251",1016251,169,36,7,212
"16252",1016252,120,66,2,188
"16253",1016253,159,87,8,254
"16254",1016254,210,60,6,276
"16255",1016255,227,73,3,303
"16256",1016256,188,26,16,230
"16257",1016257,25,204,2,231
"16258",1016258,68,27,8,103
"16259",1016259,49,173,8,230
"16260",1016260,15,4,0,19
"16261",1016261,151,51,4,206
"16262",1016262,195,171,4,370
"16263",1016263,120,37,4,161
"16264",1016264,116,70,13,199
"16265",1016265,162,89,13,264
"16266",1016266,107,139,9,255
"16267",1016267,151,70,13,234
"16268",1016268,33,259,8,300
"16269",1016269,136,93,6,235
"16270",1016270,90,148,6,244
"16271",1016271,170,29,8,207
"16272",1016272,95,190,3,288
"16273",1016273,145,133,4,282
"16274",1016274,151,101,2,254
"16275",1016275,126,264,19,409
"16276",1016276,99,79,2,180
"16277",1016277,187,75,8,270
"16278",1016278,199,68,12,279
"16279",1016279,105,118,6,229
"16280",1016280,185,26,8,219
"16281",1016281,151,62,2,215
"16282",1016282,216,79,7,302
"16283",1016283,71,200,5,276
"16284",1016284,132,92,8,232
"16285",1016285,85,48,1,134
"16286",1016286,163,1,4,168
"16287",1016287,25,185,5,215
"16288",1016288,227,39,11,277
"16289",1016289,214,56,5,275
"16290",1016290,185,62,19,266
"16291",1016291,174,51,7,232
"16292",1016292,96,53,5,154
"16293",1016293,20,8,0,28
"16294",1016294,71,68,8,147
"16295",1016295,164,71,11,246
"16296",1016296,14,7,2,23
"16297",1016297,158,69,1,228
"16298",1016298,225,26,0,251
"16299",1016299,19,50,1,70
"16300",1016300,158,135,4,297
"16301",1016301,2,1,0,3
"16302",1016302,176,57,9,242
"16303",1016303,55,112,13,180
"16304",1016304,141,11,3,155
"16305",1016305,84,73,4,161
"16306",1016306,65,115,8,188
"16307",1016307,118,91,2,211
"16308",1016308,116,4,3,123
"16309",1016309,119,44,11,174
"16310",1016310,86,69,5,160
"16311",1016311,62,155,10,227
"16312",1016312,84,53,5,142
"16313",1016313,34,160,5,199
"16314",1016314,183,39,10,232
"16315",1016315,66,53,5,124
"16316",1016316,36,104,1,141
"16317",1016317,194,109,19,322
"16318",1016318,120,81,14,215
"16319",1016319,67,83,6,156
"16320",1016320,53,205,10,268
"16321",1016321,225,27,11,263
"16322",1016322,201,48,15,264
"16323",1016323,116,111,4,231
"16324",1016324,123,113,6,242
"16325",1016325,153,108,9,270
"16326",1016326,86,117,1,204
"16327",1016327,134,108,7,249
"16328",1016328,181,52,10,243
"16329",1016329,235,17,8,260
"16330",1016330,51,216,3,270
"16331",1016331,148,61,12,221
"16332",1016332,101,95,15,211
"16333",1016333,58,214,5,277
"16334",1016334,114,190,1,305
"16335",1016335,49,190,13,252
"16336",1016336,118,74,4,196
"16337",1016337,47,72,3,122
"16338",1016338,99,145,4,248
"16339",1016339,67,170,18,255
"16340",1016340,138,30,6,174
"16341",1016341,38,304,13,355
"16342",1016342,138,73,17,228
"16343",1016343,166,110,8,284
"16344",1016344,8,3,1,12
"16345",1016345,67,280,7,354
"16346",1016346,74,211,8,293
"16347",1016347,102,173,16,291
"16348",1016348,202,4,5,211
"16349",1016349,243,30,8,281
"16350",1016350,135,31,6,172
"16351",1016351,55,234,1,290
"16352",1016352,138,36,3,177
"16353",1016353,42,237,7,286
"16354",1016354,46,37,3,86
"16355",1016355,117,94,18,229
"16356",1016356,147,19,7,173
"16357",1016357,225,71,5,301
"16358",1016358,140,61,6,207
"16359",1016359,267,54,9,330
"16360",1016360,192,86,8,286
"16361",1016361,31,242,2,275
"16362",1016362,10,10,0,20
"16363",1016363,45,171,2,218
"16364",1016364,123,83,11,217
"16365",1016365,150,141,16,307
"16366",1016366,75,178,19,272
"16367",1016367,165,25,4,194
"16368",1016368,57,109,5,171
"16369",1016369,88,172,9,269
"16370",1016370,119,40,6,165
"16371",1016371,164,80,14,258
"16372",1016372,159,145,15,319
"16373",1016373,97,17,2,116
"16374",1016374,142,100,1,243
"16375",1016375,145,98,9,252
"16376",1016376,166,89,7,262
"16377",1016377,59,137,11,207
"16378",1016378,166,47,12,225
"16379",1016379,212,74,13,299
"16380",1016380,55,206,10,271
"16381",1016381,153,55,9,217
"16382",1016382,88,124,21,233
"16383",1016383,165,61,6,232
"16384",1016384,20,194,4,218
"16385",1016385,43,210,4,257
"16386",1016386,33,248,6,287
"16387",1016387,42,103,5,150
"16388",1016388,18,8,2,28
"16389",1016389,17,83,0,100
"16390",1016390,39,242,5,286
"16391",1016391,83,193,5,281
"16392",1016392,123,59,3,185
"16393",1016393,46,253,5,304
"16394",1016394,208,90,11,309
"16395",1016395,127,42,0,169
"16396",1016396,55,218,7,280
"16397",1016397,196,15,4,215
"16398",1016398,119,102,15,236
"16399",1016399,51,190,2,243
"16400",1016400,179,112,10,301
"16401",1016401,99,104,11,214
"16402",1016402,90,104,6,200
"16403",1016403,131,180,15,326
"16404",1016404,162,60,8,230
"16405",1016405,151,112,12,275
"16406",1016406,110,184,7,301
"16407",1016407,63,181,13,257
"16408",1016408,111,144,5,260
"16409",1016409,50,20,1,71
"16410",1016410,63,179,6,248
"16411",1016411,174,3,9,186
"16412",1016412,154,98,8,260
"16413",1016413,60,41,3,104
"16414",1016414,41,82,1,124
"16415",1016415,82,153,10,245
"16416",1016416,35,0,0,35
"16417",1016417,36,198,9,243
"16418",1016418,124,10,7,141
"16419",1016419,155,78,21,254
"16420",1016420,39,216,5,260
"16421",1016421,60,195,12,267
"16422",1016422,62,84,7,153
"16423",1016423,207,72,1,280
"16424",1016424,202,40,10,252
"16425",1016425,57,226,9,292
"16426",1016426,124,105,8,237
"16427",1016427,141,23,2,166
"16428",1016428,161,22,5,188
"16429",1016429,111,135,12,258
"16430",1016430,50,159,13,222
"16431",1016431,140,104,21,265
"16432",1016432,4,40,3,47
"16433",1016433,22,129,3,154
"16434",1016434,95,45,4,144
"16435",1016435,45,217,16,278
"16436",1016436,50,246,8,304
"16437",1016437,125,91,9,225
"16438",1016438,113,182,13,308
"16439",1016439,22,73,4,99
"16440",1016440,51,185,5,241
"16441",1016441,50,162,7,219
"16442",1016442,67,13,2,82
"16443",1016443,149,158,12,319
"16444",1016444,81,100,3,184
"16445",1016445,60,119,7,186
"16446",1016446,129,72,2,203
"16447",1016447,110,133,10,253
"16448",1016448,154,141,13,308
"16449",1016449,36,146,5,187
"16450",1016450,180,37,7,224
"16451",1016451,165,124,5,294
"16452",1016452,105,164,5,274
"16453",1016453,38,148,1,187
"16454",1016454,127,124,16,267
"16455",1016455,85,247,8,340
"16456",1016456,96,155,7,258
"16457",1016457,49,219,10,278
"16458",1016458,10,36,0,46
"16459",1016459,77,135,9,221
"16460",1016460,143,102,13,258
"16461",1016461,73,18,5,96
"16462",1016462,145,41,9,195
"16463",1016463,140,42,3,185
"16464",1016464,10,42,2,54
"16465",1016465,120,67,7,194
"16466",1016466,135,381,20,536
"16467",1016467,184,43,8,235
"16468",1016468,67,72,9,148
"16469",1016469,144,78,11,233
"16470",1016470,81,3,3,87
"16471",1016471,73,17,1,91
"16472",1016472,186,99,7,292
"16473",1016473,183,78,22,283
"16474",1016474,79,57,8,144
"16475",1016475,82,177,2,261
"16476",1016476,135,132,6,273
"16477",1016477,57,171,16,244
"16478",1016478,73,177,6,256
"16479",1016479,165,119,9,293
"16480",1016480,141,124,8,273
"16481",1016481,118,174,11,303
"16482",1016482,69,111,10,190
"16483",1016483,90,205,11,306
"16484",1016484,144,30,3,177
"16485",1016485,71,257,14,342
"16486",1016486,132,165,15,312
"16487",1016487,81,142,29,252
"16488",1016488,168,73,9,250
"16489",1016489,141,97,15,253
"16490",1016490,18,40,4,62
"16491",1016491,144,24,10,178
"16492",1016492,127,23,10,160
"16493",1016493,76,191,9,276
"16494",1016494,243,24,6,273
"16495",1016495,190,54,6,250
"16496",1016496,85,161,9,255
"16497",1016497,44,243,5,292
"16498",1016498,133,44,4,181
"16499",1016499,35,157,11,203
"16500",1016500,141,89,10,240
"16501",1016501,80,78,4,162
"16502",1016502,284,214,37,535
"16503",1016503,215,10,4,229
"16504",1016504,184,56,8,248
"16505",1016505,171,70,11,252
"16506",1016506,85,46,2,133
"16507",1016507,32,187,14,233
"16508",1016508,11,4,0,15
"16509",1016509,7,4,1,12
"16510",1016510,211,14,8,233
"16511",1016511,21,183,4,208
"16512",1016512,42,20,3,65
"16513",1016513,58,173,6,237
"16514",1016514,104,74,13,191
"16515",1016515,116,12,1,129
"16516",1016516,79,93,7,179
"16517",1016517,73,174,7,254
"16518",1016518,106,140,5,251
"16519",1016519,66,181,8,255
"16520",1016520,101,152,8,261
"16521",1016521,174,11,7,192
"16522",1016522,118,124,4,246
"16523",1016523,87,58,5,150
"16524",1016524,151,45,8,204
"16525",1016525,108,47,12,167
"16526",1016526,131,55,4,190
"16527",1016527,147,30,5,182
"16528",1016528,167,52,16,235
"16529",1016529,282,30,3,315
"16530",1016530,122,46,4,172
"16531",1016531,21,154,4,179
"16532",1016532,102,22,4,128
"16533",1016533,96,83,1,180
"16534",1016534,79,166,9,254
"16535",1016535,151,18,7,176
"16536",1016536,22,6,0,28
"16537",1016537,154,50,12,216
"16538",1016538,106,149,11,266
"16539",1016539,52,136,5,193
"16540",1016540,176,61,18,255
"16541",1016541,130,52,10,192
"16542",1016542,76,143,10,229
"16543",1016543,93,23,4,120
"16544",1016544,190,63,15,268
"16545",1016545,114,130,9,253
"16546",1016546,184,75,10,269
"16547",1016547,44,143,2,189
"16548",1016548,62,144,6,212
"16549",1016549,16,0,1,17
"16550",1016550,24,129,4,157
"16551",1016551,138,50,9,197
"16552",1016552,148,121,9,278
"16553",1016553,56,25,15,96
"16554",1016554,171,77,1,249
"16555",1016555,46,56,5,107
"16556",1016556,61,146,21,228
"16557",1016557,111,119,2,232
"16558",1016558,34,107,3,144
"16559",1016559,53,225,1,279
"16560",1016560,50,152,7,209
"16561",1016561,93,25,4,122
"16562",1016562,54,191,5,250
"16563",1016563,121,213,9,343
"16564",1016564,5,25,1,31
"16565",1016565,55,78,0,133
"16566",1016566,122,157,12,291
"16567",1016567,135,55,19,209
"16568",1016568,113,95,13,221
"16569",1016569,153,91,4,248
"16570",1016570,35,165,10,210
"16571",1016571,65,224,8,297
"16572",1016572,114,81,13,208
"16573",1016573,109,31,4,144
"16574",1016574,148,37,5,190
"16575",1016575,103,19,3,125
"16576",1016576,260,39,17,316
"16577",1016577,199,35,7,241
"16578",1016578,107,177,4,288
"16579",1016579,107,165,9,281
"16580",1016580,206,109,12,327
"16581",1016581,239,35,21,295
"16582",1016582,37,214,6,257
"16583",1016583,66,24,0,90
"16584",1016584,48,134,9,191
"16585",1016585,96,134,38,268
"16586",1016586,218,31,9,258
"16587",1016587,73,209,5,287
"16588",1016588,55,207,2,264
"16589",1016589,118,36,2,156
"16590",1016590,259,23,7,289
"16591",1016591,51,186,6,243
"16592",1016592,228,94,16,338
"16593",1016593,29,247,3,279
"16594",1016594,106,18,2,126
"16595",1016595,19,109,2,130
"16596",1016596,108,82,7,197
"16597",1016597,46,8,2,56
"16598",1016598,84,9,10,103
"16599",1016599,21,292,5,318
"16600",1016600,102,50,8,160
"16601",1016601,104,180,13,297
"16602",1016602,78,135,4,217
"16603",1016603,47,133,4,184
"16604",1016604,181,119,10,310
"16605",1016605,136,84,6,226
"16606",1016606,92,101,5,198
"16607",1016607,63,240,18,321
"16608",1016608,205,63,10,278
"16609",1016609,216,49,12,277
"16610",1016610,84,241,11,336
"16611",1016611,238,46,13,297
"16612",1016612,192,54,9,255
"16613",1016613,51,187,5,243
"16614",1016614,187,76,8,271
"16615",1016615,119,56,7,182
"16616",1016616,13,3,2,18
"16617",1016617,195,37,13,245
"16618",1016618,27,99,7,133
"16619",1016619,44,130,7,181
"16620",1016620,68,192,11,271
"16621",1016621,76,17,8,101
"16622",1016622,96,48,4,148
"16623",1016623,211,229,46,486
"16624",1016624,190,186,10,386
"16625",1016625,81,176,1,258
"16626",1016626,4,29,1,34
"16627",1016627,188,83,17,288
"16628",1016628,121,107,43,271
"16629",1016629,120,401,6,527
"16630",1016630,52,274,9,335
"16631",1016631,168,84,6,258
"16632",1016632,158,103,11,272
"16633",1016633,107,163,5,275
"16634",1016634,72,27,2,101
"16635",1016635,186,152,19,357
"16636",1016636,119,12,5,136
"16637",1016637,50,74,7,131
"16638",1016638,60,145,5,210
"16639",1016639,38,21,3,62
"16640",1016640,190,68,10,268
"16641",1016641,39,250,5,294
"16642",1016642,104,67,7,178
"16643",1016643,81,150,16,247
"16644",1016644,154,134,10,298
"16645",1016645,23,151,7,181
"16646",1016646,5,40,3,48
"16647",1016647,179,28,7,214
"16648",1016648,88,63,9,160
"16649",1016649,58,72,5,135
"16650",1016650,194,39,14,247
"16651",1016651,26,229,0,255
"16652",1016652,48,4,4,56
"16653",1016653,129,25,3,157
"16654",1016654,118,159,7,284
"16655",1016655,24,68,1,93
"16656",1016656,208,14,6,228
"16657",1016657,128,90,15,233
"16658",1016658,236,76,11,323
"16659",1016659,73,76,3,152
"16660",1016660,17,33,1,51
"16661",1016661,67,164,3,234
"16662",1016662,167,48,4,219
"16663",1016663,79,121,5,205
"16664",1016664,157,123,15,295
"16665",1016665,83,69,2,154
"16666",1016666,107,1,3,111
"16667",1016667,99,144,13,256
"16668",1016668,72,231,7,310
"16669",1016669,63,113,11,187
"16670",1016670,99,181,9,289
"16671",1016671,130,30,1,161
"16672",1016672,110,79,1,190
"16673",1016673,157,37,6,200
"16674",1016674,192,101,17,310
"16675",1016675,151,56,7,214
"16676",1016676,103,53,2,158
"16677",1016677,160,77,10,247
"16678",1016678,123,91,5,219
"16679",1016679,26,149,10,185
"16680",1016680,161,75,2,238
"16681",1016681,210,60,4,274
"16682",1016682,65,199,5,269
"16683",1016683,142,87,11,240
"16684",1016684,68,29,8,105
"16685",1016685,154,22,5,181
"16686",1016686,33,191,6,230
"16687",1016687,85,223,19,327
"16688",1016688,25,127,2,154
"16689",1016689,157,44,7,208
"16690",1016690,92,210,6,308
"16691",1016691,142,191,12,345
"16692",1016692,5,6,0,11
"16693",1016693,209,88,21,318
"16694",1016694,96,216,14,326
"16695",1016695,24,31,6,61
"16696",1016696,22,45,2,69
"16697",1016697,176,93,12,281
"16698",1016698,75,122,3,200
"16699",1016699,142,73,7,222
"16700",1016700,23,6,3,32
"16701",1016701,122,65,9,196
"16702",1016702,87,182,9,278
"16703",1016703,129,85,15,229
"16704",1016704,124,146,16,286
"16705",1016705,136,42,2,180
"16706",1016706,77,120,3,200
"16707",1016707,84,156,9,249
"16708",1016708,70,46,3,119
"16709",1016709,156,32,7,195
"16710",1016710,120,19,6,145
"16711",1016711,48,180,1,229
"16712",1016712,98,165,7,270
"16713",1016713,109,129,6,244
"16714",1016714,90,72,19,181
"16715",1016715,81,75,8,164
"16716",1016716,114,54,11,179
"16717",1016717,207,71,9,287
"16718",1016718,137,125,5,267
"16719",1016719,86,2,2,90
"16720",1016720,134,82,10,226
"16721",1016721,185,85,9,279
"16722",1016722,201,34,4,239
"16723",1016723,98,146,10,254
"16724",1016724,133,92,5,230
"16725",1016725,84,201,10,295
"16726",1016726,152,86,10,248
"16727",1016727,120,65,15,200
"16728",1016728,10,50,0,60
"16729",1016729,98,87,6,191
"16730",1016730,201,65,9,275
"16731",1016731,153,96,5,254
"16732",1016732,152,118,16,286
"16733",1016733,124,74,3,201
"16734",1016734,88,9,1,98
"16735",1016735,106,141,9,256
"16736",1016736,163,35,6,204
"16737",1016737,74,81,5,160
"16738",1016738,172,62,13,247
"16739",1016739,158,103,16,277
"16740",1016740,20,60,2,82
"16741",1016741,102,8,0,110
"16742",1016742,264,31,11,306
"16743",1016743,53,217,1,271
"16744",1016744,146,100,6,252
"16745",1016745,145,32,7,184
"16746",1016746,68,73,6,147
"16747",1016747,201,55,1,257
"16748",1016748,26,238,4,268
"16749",1016749,63,39,15,117
"16750",1016750,158,90,15,263
"16751",1016751,116,60,9,185
"16752",1016752,130,134,13,277
"16753",1016753,192,62,11,265
"16754",1016754,34,119,4,157
"16755",1016755,48,144,14,206
"16756",1016756,247,19,7,273
"16757",1016757,45,38,7,90
"16758",1016758,230,84,15,329
"16759",1016759,125,52,11,188
"16760",1016760,170,115,7,292
"16761",1016761,38,58,4,100
"16762",1016762,155,66,9,230
"16763",1016763,110,135,8,253
"16764",1016764,166,48,7,221
"16765",1016765,169,37,13,219
"16766",1016766,66,232,21,319
"16767",1016767,39,163,3,205
"16768",1016768,118,52,0,170
"16769",1016769,75,250,2,327
"16770",1016770,38,175,9,222
"16771",1016771,65,25,1,91
"16772",1016772,210,106,15,331
"16773",1016773,32,109,9,150
"16774",1016774,136,131,11,278
"16775",1016775,67,208,8,283
"16776",1016776,149,16,2,167
"16777",1016777,22,263,3,288
"16778",1016778,56,173,2,231
"16779",1016779,107,128,6,241
"16780",1016780,30,229,0,259
"16781",1016781,114,43,7,164
"16782",1016782,72,138,7,217
"16783",1016783,140,81,10,231
"16784",1016784,71,182,13,266
"16785",1016785,116,78,5,199
"16786",1016786,295,19,17,331
"16787",1016787,116,180,4,300
"16788",1016788,107,155,10,272
"16789",1016789,101,54,4,159
"16790",1016790,61,135,5,201
"16791",1016791,92,66,3,161
"16792",1016792,60,217,14,291
"16793",1016793,118,82,15,215
"16794",1016794,46,5,1,52
"16795",1016795,131,56,4,191
"16796",1016796,209,115,11,335
"16797",1016797,49,106,3,158
"16798",1016798,205,82,17,304
"16799",1016799,197,107,16,320
"16800",1016800,52,260,11,323
"16801",1016801,134,66,19,219
"16802",1016802,109,127,6,242
"16803",1016803,102,116,15,233
"16804",1016804,211,47,7,265
"16805",1016805,149,54,9,212
"16806",1016806,142,61,4,207
"16807",1016807,154,62,12,228
"16808",1016808,129,55,2,186
"16809",1016809,133,75,9,217
"16810",1016810,73,200,8,281
"16811",1016811,59,144,4,207
"16812",1016812,162,66,4,232
"16813",1016813,186,73,11,270
"16814",1016814,201,62,3,266
"16815",1016815,57,257,3,317
"16816",1016816,66,81,7,154
"16817",1016817,76,111,8,195
"16818",1016818,171,114,27,312
"16819",1016819,163,26,6,195
"16820",1016820,97,180,13,290
"16821",1016821,213,17,1,231
"16822",1016822,143,55,7,205
"16823",1016823,72,40,12,124
"16824",1016824,23,148,4,175
"16825",1016825,122,70,13,205
"16826",1016826,207,38,10,255
"16827",1016827,172,27,8,207
"16828",1016828,43,143,8,194
"16829",1016829,61,120,3,184
"16830",1016830,129,146,12,287
"16831",1016831,126,65,8,199
"16832",1016832,42,65,3,110
"16833",1016833,116,81,9,206
"16834",1016834,97,169,5,271
"16835",1016835,92,260,8,360
"16836",1016836,132,24,4,160
"16837",1016837,75,191,15,281
"16838",1016838,124,155,6,285
"16839",1016839,58,193,10,261
"16840",1016840,42,221,1,264
"16841",1016841,77,98,7,182
"16842",1016842,68,201,4,273
"16843",1016843,226,93,22,341
"16844",1016844,123,113,5,241
"16845",1016845,112,157,13,282
"16846",1016846,55,162,10,227
"16847",1016847,103,34,7,144
"16848",1016848,84,111,7,202
"16849",1016849,190,34,12,236
"16850",1016850,164,59,15,238
"16851",1016851,205,15,6,226
"16852",1016852,220,42,19,281
"16853",1016853,114,45,1,160
"16854",1016854,102,14,2,118
"16855",1016855,147,20,10,177
"16856",1016856,25,78,4,107
"16857",1016857,57,24,3,84
"16858",1016858,59,152,13,224
"16859",1016859,92,88,8,188
"16860",1016860,101,145,9,255
"16861",1016861,79,226,4,309
"16862",1016862,205,63,21,289
"16863",1016863,103,151,7,261
"16864",1016864,99,71,10,180
"16865",1016865,84,14,4,102
"16866",1016866,202,65,2,269
"16867",1016867,136,143,8,287
"16868",1016868,136,86,5,227
"16869",1016869,232,22,7,261
"16870",1016870,17,221,2,240
"16871",1016871,228,16,2,246
"16872",1016872,164,88,17,269
"16873",1016873,155,73,7,235
"16874",1016874,66,232,5,303
"16875",1016875,43,103,17,163
"16876",1016876,95,137,13,245
"16877",1016877,22,5,0,27
"16878",1016878,99,114,12,225
"16879",1016879,61,171,18,250
"16880",1016880,141,196,15,352
"16881",1016881,12,11,1,24
"16882",1016882,37,220,6,263
"16883",1016883,44,85,6,135
"16884",1016884,147,22,10,179
"16885",1016885,111,154,14,279
"16886",1016886,117,120,17,254
"16887",1016887,120,14,7,141
"16888",1016888,100,149,7,256
"16889",1016889,136,120,18,274
"16890",1016890,75,41,7,123
"16891",1016891,104,211,17,332
"16892",1016892,65,237,2,304
"16893",1016893,96,183,11,290
"16894",1016894,63,227,9,299
"16895",1016895,152,85,11,248
"16896",1016896,48,135,11,194
"16897",1016897,91,172,3,266
"16898",1016898,270,27,4,301
"16899",1016899,216,42,9,267
"16900",1016900,62,182,4,248
"16901",1016901,129,74,6,209
"16902",1016902,46,246,13,305
"16903",1016903,89,97,3,189
"16904",1016904,65,161,7,233
"16905",1016905,79,171,15,265
"16906",1016906,159,131,4,294
"16907",1016907,225,49,13,287
"16908",1016908,177,132,15,324
"16909",1016909,42,291,3,336
"16910",1016910,120,164,2,286
"16911",1016911,248,80,34,362
"16912",1016912,74,169,12,255
"16913",1016913,81,208,8,297
"16914",1016914,181,48,8,237
"16915",1016915,140,84,17,241
"16916",1016916,190,88,6,284
"16917",1016917,98,146,10,254
"16918",1016918,88,173,13,274
"16919",1016919,107,3,6,116
"16920",1016920,65,169,11,245
"16921",1016921,49,241,5,295
"16922",1016922,178,101,8,287
"16923",1016923,231,50,5,286
"16924",1016924,75,150,18,243
"16925",1016925,137,23,2,162
"16926",1016926,101,98,9,208
"16927",1016927,100,206,13,319
"16928",1016928,132,116,8,256
"16929",1016929,144,21,13,178
"16930",1016930,111,62,6,179
"16931",1016931,101,102,9,212
"16932",1016932,75,163,3,241
"16933",1016933,205,27,10,242
"16934",1016934,78,86,4,168
"16935",1016935,137,56,12,205
"16936",1016936,101,107,6,214
"16937",1016937,154,78,12,244
"16938",1016938,142,25,7,174
"16939",1016939,88,159,2,249
"16940",1016940,297,4,9,310
"16941",1016941,162,79,7,248
"16942",1016942,68,85,13,166
"16943",1016943,109,140,7,256
"16944",1016944,99,44,11,154
"16945",1016945,73,274,8,355
"16946",1016946,251,31,15,297
"16947",1016947,54,118,16,188
"16948",1016948,93,162,1,256
"16949",1016949,95,59,11,165
"16950",1016950,89,36,2,127
"16951",1016951,169,54,8,231
"16952",1016952,88,102,5,195
"16953",1016953,233,49,13,295
"16954",1016954,114,46,9,169
"16955",1016955,168,42,10,220
"16956",1016956,175,39,5,219
"16957",1016957,170,50,3,223
"16958",1016958,176,59,5,240
"16959",1016959,72,165,20,257
"16960",1016960,24,160,1,185
"16961",1016961,74,198,10,282
"16962",1016962,182,101,3,286
"16963",1016963,89,174,7,270
"16964",1016964,72,162,18,252
"16965",1016965,12,68,0,80
"16966",1016966,97,106,5,208
"16967",1016967,66,154,2,222
"16968",1016968,200,46,5,251
"16969",1016969,125,58,6,189
"16970",1016970,80,197,10,287
"16971",1016971,19,226,2,247
"16972",1016972,165,38,6,209
"16973",1016973,214,44,6,264
"16974",1016974,133,65,9,207
"16975",1016975,55,183,4,242
"16976",1016976,142,95,11,248
"16977",1016977,201,41,11,253
"16978",1016978,53,245,9,307
"16979",1016979,146,72,8,226
"16980",1016980,23,208,5,236
"16981",1016981,48,133,14,195
"16982",1016982,87,101,1,189
"16983",1016983,96,222,7,325
"16984",1016984,200,34,6,240
"16985",1016985,43,95,2,140
"16986",1016986,84,23,5,112
"16987",1016987,133,94,14,241
"16988",1016988,128,108,17,253
"16989",1016989,135,205,7,347
"16990",1016990,126,58,6,190
"16991",1016991,78,179,18,275
"16992",1016992,129,173,21,323
"16993",1016993,157,72,4,233
"16994",1016994,124,37,3,164
"16995",1016995,144,75,6,225
"16996",1016996,78,73,4,155
"16997",1016997,104,138,8,250
"16998",1016998,201,87,20,308
"16999",1016999,83,224,5,312
"17000",1017000,41,6,1,48
"17001",1017001,59,2,1,62
"17002",1017002,32,174,8,214
"17003",1017003,84,150,5,239
"17004",1017004,53,2,0,55
"17005",1017005,79,47,5,131
"17006",1017006,56,124,6,186
"17007",1017007,111,164,8,283
"17008",1017008,173,81,8,262
"17009",1017009,110,191,5,306
"17010",1017010,125,57,9,191
"17011",1017011,163,57,4,224
"17012",1017012,162,164,20,346
"17013",1017013,230,65,15,310
"17014",1017014,190,59,11,260
"17015",1017015,6,20,0,26
"17016",1017016,37,33,3,73
"17017",1017017,189,50,11,250
"17018",1017018,170,55,14,239
"17019",1017019,59,210,17,286
"17020",1017020,146,26,2,174
"17021",1017021,136,144,8,288
"17022",1017022,99,85,3,187
"17023",1017023,194,0,0,194
"17024",1017024,202,62,10,274
"17025",1017025,97,208,8,313
"17026",1017026,171,103,6,280
"17027",1017027,134,103,10,247
"17028",1017028,146,82,3,231
"17029",1017029,126,154,15,295
"17030",1017030,40,260,5,305
"17031",1017031,26,13,3,42
"17032",1017032,121,176,4,301
"17033",1017033,182,80,15,277
"17034",1017034,65,158,4,227
"17035",1017035,63,134,9,206
"17036",1017036,153,69,7,229
"17037",1017037,166,18,4,188
"17038",1017038,79,108,0,187
"17039",1017039,137,127,9,273
"17040",1017040,69,189,15,273
"17041",1017041,135,3,3,141
"17042",1017042,45,250,4,299
"17043",1017043,34,239,3,276
"17044",1017044,79,25,0,104
"17045",1017045,173,63,7,243
"17046",1017046,11,23,0,34
"17047",1017047,175,72,8,255
"17048",1017048,395,63,9,467
"17049",1017049,101,127,6,234
"17050",1017050,75,169,3,247
"17051",1017051,140,83,11,234
"17052",1017052,45,13,2,60
"17053",1017053,84,137,6,227
"17054",1017054,196,44,5,245
"17055",1017055,110,185,5,300
"17056",1017056,26,259,3,288
"17057",1017057,102,103,14,219
"17058",1017058,71,249,8,328
"17059",1017059,4,3,0,7
"17060",1017060,56,242,5,303
"17061",1017061,126,24,3,153
"17062",1017062,142,102,8,252
"17063",1017063,20,267,5,292
"17064",1017064,163,98,7,268
"17065",1017065,77,37,2,116
"17066",1017066,103,152,6,261
"17067",1017067,16,51,3,70
"17068",1017068,104,83,12,199
"17069",1017069,129,56,2,187
"17070",1017070,83,71,3,157
"17071",1017071,158,84,10,252
"17072",1017072,122,189,10,321
"17073",1017073,156,88,4,248
"17074",1017074,76,59,1,136
"17075",1017075,12,120,1,133
"17076",1017076,143,103,23,269
"17077",1017077,122,70,9,201
"17078",1017078,75,187,9,271
"17079",1017079,71,143,7,221
"17080",1017080,100,48,13,161
"17081",1017081,44,137,4,185
"17082",1017082,22,244,10,276
"17083",1017083,38,253,3,294
"17084",1017084,120,41,0,161
"17085",1017085,75,66,6,147
"17086",1017086,196,18,3,217
"17087",1017087,56,203,13,272
"17088",1017088,186,35,5,226
"17089",1017089,80,155,13,248
"17090",1017090,59,204,9,272
"17091",1017091,116,11,9,136
"17092",1017092,168,35,3,206
"17093",1017093,42,159,4,205
"17094",1017094,131,121,15,267
"17095",1017095,126,166,12,304
"17096",1017096,124,109,5,238
"17097",1017097,176,6,0,182
"17098",1017098,99,155,14,268
"17099",1017099,55,173,16,244
"17100",1017100,56,221,2,279
"17101",1017101,38,212,3,253
"17102",1017102,81,177,17,275
"17103",1017103,68,113,7,188
"17104",1017104,29,145,8,182
"17105",1017105,174,117,12,303
"17106",1017106,99,115,7,221
"17107",1017107,85,196,2,283
"17108",1017108,198,163,2,363
"17109",1017109,163,58,8,229
"17110",1017110,211,73,10,294
"17111",1017111,178,20,1,199
"17112",1017112,103,102,5,210
"17113",1017113,92,81,12,185
"17114",1017114,57,223,6,286
"17115",1017115,89,217,5,311
"17116",1017116,118,104,14,236
"17117",1017117,78,192,8,278
"17118",1017118,96,212,8,316
"17119",1017119,77,85,8,170
"17120",1017120,70,190,7,267
"17121",1017121,196,44,7,247
"17122",1017122,58,261,10,329
"17123",1017123,179,47,9,235
"17124",1017124,18,7,1,26
"17125",1017125,31,233,5,269
"17126",1017126,93,34,4,131
"17127",1017127,101,50,4,155
"17128",1017128,149,27,2,178
"17129",1017129,40,78,4,122
"17130",1017130,66,208,15,289
"17131",1017131,48,9,2,59
"17132",1017132,190,66,6,262
"17133",1017133,145,49,22,216
"17134",1017134,31,128,3,162
"17135",1017135,43,192,7,242
"17136",1017136,97,188,2,287
"17137",1017137,114,147,0,261
"17138",1017138,31,254,3,288
"17139",1017139,149,134,14,297
"17140",1017140,163,46,11,220
"17141",1017141,184,85,5,274
"17142",1017142,168,21,4,193
"17143",1017143,66,222,11,299
"17144",1017144,53,86,12,151
"17145",1017145,65,38,1,104
"17146",1017146,149,72,7,228
"17147",1017147,6,4,0,10
"17148",1017148,64,239,11,314
"17149",1017149,90,166,8,264
"17150",1017150,118,179,22,319
"17151",1017151,144,110,1,255
"17152",1017152,118,66,4,188
"17153",1017153,172,6,12,190
"17154",1017154,102,26,7,135
"17155",1017155,164,18,3,185
"17156",1017156,108,183,20,311
"17157",1017157,49,215,11,275
"17158",1017158,41,169,8,218
"17159",1017159,125,88,16,229
"17160",1017160,272,20,2,294
"17161",1017161,79,102,10,191
"17162",1017162,268,26,3,297
"17163",1017163,121,111,20,252
"17164",1017164,118,117,24,259
"17165",1017165,18,247,3,268
"17166",1017166,70,259,19,348
"17167",1017167,206,61,12,279
"17168",1017168,146,52,18,216
"17169",1017169,146,93,19,258
"17170",1017170,172,28,10,210
"17171",1017171,158,62,0,220
"17172",1017172,39,167,10,216
"17173",1017173,68,126,8,202
"17174",1017174,64,67,1,132
"17175",1017175,121,212,18,351
"17176",1017176,144,39,19,202
"17177",1017177,3,1,2,6
"17178",1017178,201,120,11,332
"17179",1017179,97,43,4,144
"17180",1017180,81,179,11,271
"17181",1017181,177,39,6,222
"17182",1017182,111,133,8,252
"17183",1017183,16,223,2,241
"17184",1017184,140,55,6,201
"17185",1017185,61,195,12,268
"17186",1017186,91,168,4,263
"17187",1017187,149,143,8,300
"17188",1017188,97,187,9,293
"17189",1017189,89,82,12,183
"17190",1017190,21,81,1,103
"17191",1017191,97,102,9,208
"17192",1017192,4,3,0,7
"17193",1017193,31,257,6,294
"17194",1017194,180,32,5,217
"17195",1017195,67,196,4,267
"17196",1017196,51,252,8,311
"17197",1017197,11,3,2,16
"17198",1017198,141,117,10,268
"17199",1017199,175,3,0,178
"17200",1017200,162,48,5,215
"17201",1017201,152,75,7,234
"17202",1017202,83,195,8,286
"17203",1017203,111,165,21,297
"17204",1017204,47,246,0,293
"17205",1017205,81,154,7,242
"17206",1017206,111,75,5,191
"17207",1017207,202,68,11,281
"17208",1017208,103,78,12,193
"17209",1017209,191,87,15,293
"17210",1017210,77,132,0,209
"17211",1017211,61,127,13,201
"17212",1017212,73,202,5,280
"17213",1017213,188,24,6,218
"17214",1017214,48,17,0,65
"17215",1017215,156,8,11,175
"17216",1017216,148,6,3,157
"17217",1017217,37,163,9,209
"17218",1017218,75,130,6,211
"17219",1017219,189,97,8,294
"17220",1017220,51,170,8,229
"17221",1017221,97,71,3,171
"17222",1017222,53,191,6,250
"17223",1017223,238,53,7,298
"17224",1017224,77,140,6,223
"17225",1017225,93,158,10,261
"17226",1017226,77,71,7,155
"17227",1017227,99,93,4,196
"17228",1017228,165,92,3,260
"17229",1017229,140,104,9,253
"17230",1017230,190,92,15,297
"17231",1017231,179,20,6,205
"17232",1017232,79,181,12,272
"17233",1017233,37,35,1,73
"17234",1017234,145,59,6,210
"17235",1017235,24,0,0,24
"17236",1017236,180,107,11,298
"17237",1017237,150,22,10,182
"17238",1017238,49,232,3,284
"17239",1017239,56,124,7,187
"17240",1017240,64,168,6,238
"17241",1017241,112,60,8,180
"17242",1017242,18,11,2,31
"17243",1017243,237,115,7,359
"17244",1017244,0,0,0,0
"17245",1017245,41,241,1,283
"17246",1017246,60,138,18,216
"17247",1017247,67,129,10,206
"17248",1017248,128,76,7,211
"17249",1017249,206,52,14,272
"17250",1017250,138,101,4,243
"17251",1017251,6,15,1,22
"17252",1017252,32,41,3,76
"17253",1017253,55,54,2,111
"17254",1017254,159,119,13,291
"17255",1017255,110,70,2,182
"17256",1017256,41,193,16,250
"17257",1017257,178,73,9,260
"17258",1017258,194,33,7,234
"17259",1017259,129,95,12,236
"17260",1017260,190,82,8,280
"17261",1017261,148,167,19,334
"17262",1017262,49,253,5,307
"17263",1017263,111,154,7,272
"17264",1017264,46,259,12,317
"17265",1017265,192,22,6,220
"17266",1017266,206,36,4,246
"17267",1017267,151,66,10,227
"17268",1017268,117,191,21,329
"17269",1017269,105,167,20,292
"17270",1017270,152,115,0,267
"17271",1017271,16,12,1,29
"17272",1017272,61,235,5,301
"17273",1017273,188,43,5,236
"17274",1017274,107,176,18,301
"17275",1017275,151,38,10,199
"17276",1017276,84,55,3,142
"17277",1017277,113,168,13,294
"17278",1017278,192,79,11,282
"17279",1017279,141,75,8,224
"17280",1017280,154,70,19,243
"17281",1017281,56,254,4,314
"17282",1017282,58,82,3,143
"17283",1017283,85,173,17,275
"17284",1017284,241,67,9,317
"17285",1017285,233,20,2,255
"17286",1017286,94,115,5,214
"17287",1017287,69,205,6,280
"17288",1017288,11,38,0,49
"17289",1017289,40,246,6,292
"17290",1017290,154,118,6,278
"17291",1017291,45,293,10,348
"17292",1017292,76,105,12,193
"17293",1017293,166,44,11,221
"17294",1017294,147,2,0,149
"17295",1017295,140,1,1,142
"17296",1017296,134,24,4,162
"17297",1017297,204,34,8,246
"17298",1017298,161,56,6,223
"17299",1017299,147,127,14,288
"17300",1017300,50,214,12,276
"17301",1017301,180,36,8,224
"17302",1017302,12,220,5,237
"17303",1017303,142,44,5,191
"17304",1017304,121,119,7,247
"17305",1017305,89,182,4,275
"17306",1017306,126,98,6,230
"17307",1017307,65,12,2,79
"17308",1017308,7,6,0,13
"17309",1017309,128,36,5,169
"17310",1017310,95,29,5,129
"17311",1017311,83,165,4,252
"17312",1017312,84,57,5,146
"17313",1017313,20,222,4,246
"17314",1017314,146,89,9,244
"17315",1017315,166,53,12,231
"17316",1017316,159,42,5,206
"17317",1017317,14,94,3,111
"17318",1017318,122,94,3,219
"17319",1017319,185,51,14,250
"17320",1017320,143,63,7,213
"17321",1017321,92,12,1,105
"17322",1017322,168,54,6,228
"17323",1017323,113,64,9,186
"17324",1017324,94,154,4,252
"17325",1017325,3,7,0,10
"17326",1017326,48,5,2,55
"17327",1017327,16,108,4,128
"17328",1017328,144,65,7,216
"17329",1017329,228,30,17,275
"17330",1017330,132,77,4,213
"17331",1017331,25,100,2,127
"17332",1017332,142,51,10,203
"17333",1017333,82,156,17,255
"17334",1017334,145,27,17,189
"17335",1017335,1,0,0,1
"17336",1017336,142,146,13,301
"17337",1017337,53,174,2,229
"17338",1017338,126,95,3,224
"17339",1017339,164,59,7,230
"17340",1017340,190,24,5,219
"17341",1017341,21,182,17,220
"17342",1017342,93,13,2,108
"17343",1017343,84,34,2,120
"17344",1017344,172,51,8,231
"17345",1017345,127,117,4,248
"17346",1017346,155,53,8,216
"17347",1017347,51,10,4,65
"17348",1017348,209,16,8,233
"17349",1017349,82,154,21,257
"17350",1017350,153,108,15,276
"17351",1017351,174,51,8,233
"17352",1017352,65,180,8,253
"17353",1017353,170,30,8,208
"17354",1017354,119,140,15,274
"17355",1017355,30,3,0,33
"17356",1017356,19,16,0,35
"17357",1017357,106,7,5,118
"17358",1017358,211,64,4,279
"17359",1017359,181,55,21,257
"17360",1017360,15,105,1,121
"17361",1017361,91,1,1,93
"17362",1017362,130,106,6,242
"17363",1017363,156,45,7,208
"17364",1017364,59,175,10,244
"17365",1017365,178,66,11,255
"17366",1017366,51,130,4,185
"17367",1017367,94,173,14,281
"17368",1017368,119,73,2,194
"17369",1017369,60,112,7,179
"17370",1017370,83,190,8,281
"17371",1017371,171,59,6,236
"17372",1017372,133,72,10,215
"17373",1017373,238,54,19,311
"17374",1017374,141,32,4,177
"17375",1017375,92,165,6,263
"17376",1017376,25,125,0,150
"17377",1017377,16,228,7,251
"17378",1017378,89,133,9,231
"17379",1017379,137,106,4,247
"17380",1017380,72,119,9,200
"17381",1017381,204,79,19,302
"17382",1017382,157,55,13,225
"17383",1017383,141,9,7,157
"17384",1017384,150,46,13,209
"17385",1017385,70,103,5,178
"17386",1017386,32,266,4,302
"17387",1017387,65,43,5,113
"17388",1017388,143,163,8,314
"17389",1017389,34,252,5,291
"17390",1017390,218,47,10,275
"17391",1017391,107,190,5,302
"17392",1017392,50,206,3,259
"17393",1017393,152,34,10,196
"17394",1017394,169,59,10,238
"17395",1017395,160,93,20,273
"17396",1017396,155,80,14,249
"17397",1017397,191,76,15,282
"17398",1017398,107,117,23,247
"17399",1017399,63,173,4,240
"17400",1017400,102,96,10,208
"17401",1017401,131,42,13,186
"17402",1017402,71,34,0,105
"17403",1017403,218,57,21,296
"17404",1017404,36,166,11,213
"17405",1017405,105,72,3,180
"17406",1017406,53,133,17,203
"17407",1017407,54,3,0,57
"17408",1017408,64,159,12,235
"17409",1017409,84,160,3,247
"17410",1017410,201,61,22,284
"17411",1017411,181,44,3,228
"17412",1017412,77,178,11,266
"17413",1017413,221,18,2,241
"17414",1017414,72,185,15,272
"17415",1017415,76,61,4,141
"17416",1017416,150,114,9,273
"17417",1017417,96,185,15,296
"17418",1017418,257,28,2,287
"17419",1017419,33,43,4,80
"17420",1017420,160,122,6,288
"17421",1017421,130,98,10,238
"17422",1017422,202,68,15,285
"17423",1017423,60,12,2,74
"17424",1017424,73,147,12,232
"17425",1017425,201,17,5,223
"17426",1017426,41,113,13,167
"17427",1017427,81,137,15,233
"17428",1017428,146,118,8,272
"17429",1017429,99,70,18,187
"17430",1017430,84,98,9,191
"17431",1017431,100,38,7,145
"17432",1017432,48,3,0,51
"17433",1017433,134,42,2,178
"17434",1017434,167,96,8,271
"17435",1017435,259,10,2,271
"17436",1017436,92,92,8,192
"17437",1017437,171,25,10,206
"17438",1017438,29,371,2,402
"17439",1017439,153,17,9,179
"17440",1017440,88,238,5,331
"17441",1017441,141,26,8,175
"17442",1017442,126,30,9,165
"17443",1017443,19,150,1,170
"17444",1017444,179,4,6,189
"17445",1017445,173,46,11,230
"17446",1017446,123,59,4,186
"17447",1017447,76,132,1,209
"17448",1017448,70,57,8,135
"17449",1017449,169,98,6,273
"17450",1017450,116,83,5,204
"17451",1017451,132,0,0,132
"17452",1017452,200,69,3,272
"17453",1017453,59,206,23,288
"17454",1017454,138,40,4,182
"17455",1017455,56,51,7,114
"17456",1017456,227,95,14,336
"17457",1017457,78,156,14,248
"17458",1017458,69,109,8,186
"17459",1017459,62,141,2,205
"17460",1017460,54,144,19,217
"17461",1017461,77,28,3,108
"17462",1017462,196,38,13,247
"17463",1017463,58,203,6,267
"17464",1017464,4,7,1,12
"17465",1017465,29,140,4,173
"17466",1017466,60,113,7,180
"17467",1017467,80,145,5,230
"17468",1017468,216,37,16,269
"17469",1017469,69,146,10,225
"17470",1017470,42,42,3,87
"17471",1017471,248,37,9,294
"17472",1017472,140,134,4,278
"17473",1017473,39,233,3,275
"17474",1017474,227,16,10,253
"17475",1017475,162,167,12,341
"17476",1017476,129,117,9,255
"17477",1017477,162,9,2,173
"17478",1017478,115,115,6,236
"17479",1017479,62,201,13,276
"17480",1017480,51,15,0,66
"17481",1017481,70,56,8,134
"17482",1017482,121,124,8,253
"17483",1017483,45,92,10,147
"17484",1017484,85,94,6,185
"17485",1017485,82,161,13,256
"17486",1017486,22,63,5,90
"17487",1017487,119,53,5,177
"17488",1017488,43,169,6,218
"17489",1017489,51,164,1,216
"17490",1017490,174,98,9,281
"17491",1017491,122,183,4,309
"17492",1017492,132,139,9,280
"17493",1017493,18,1,0,19
"17494",1017494,74,29,3,106
"17495",1017495,17,50,1,68
"17496",1017496,100,204,17,321
"17497",1017497,94,104,11,209
"17498",1017498,78,167,5,250
"17499",1017499,143,47,2,192
"17500",1017500,111,125,6,242
"17501",1017501,16,180,1,197
"17502",1017502,146,77,2,225
"17503",1017503,27,43,9,79
"17504",1017504,133,137,23,293
"17505",1017505,131,167,6,304
"17506",1017506,87,167,10,264
"17507",1017507,86,114,11,211
"17508",1017508,193,42,3,238
"17509",1017509,65,190,7,262
"17510",1017510,144,112,3,259
"17511",1017511,63,34,5,102
"17512",1017512,20,272,0,292
"17513",1017513,285,0,0,285
"17514",1017514,105,68,16,189
"17515",1017515,119,187,18,324
"17516",1017516,123,25,7,155
"17517",1017517,142,87,5,234
"17518",1017518,180,52,19,251
"17519",1017519,196,77,19,292
"17520",1017520,23,87,3,113
"17521",1017521,203,92,16,311
"17522",1017522,8,59,0,67
"17523",1017523,13,2,1,16
"17524",1017524,109,67,20,196
"17525",1017525,117,212,9,338
"17526",1017526,82,121,4,207
"17527",1017527,102,103,6,211
"17528",1017528,13,128,5,146
"17529",1017529,105,78,12,195
"17530",1017530,137,124,8,269
"17531",1017531,89,191,3,283
"17532",1017532,173,48,12,233
"17533",1017533,56,44,1,101
"17534",1017534,158,70,14,242
"17535",1017535,94,166,8,268
"17536",1017536,58,81,5,144
"17537",1017537,45,44,5,94
"17538",1017538,194,27,9,230
"17539",1017539,43,188,1,232
"17540",1017540,74,125,23,222
"17541",1017541,153,65,9,227
"17542",1017542,209,18,8,235
"17543",1017543,117,106,7,230
"17544",1017544,83,6,0,89
"17545",1017545,68,199,6,273
"17546",1017546,188,64,9,261
"17547",1017547,143,63,3,209
"17548",1017548,149,106,13,268
"17549",1017549,113,133,10,256
"17550",1017550,146,75,10,231
"17551",1017551,80,133,7,220
"17552",1017552,98,154,1,253
"17553",1017553,77,46,5,128
"17554",1017554,279,8,0,287
"17555",1017555,17,33,2,52
"17556",1017556,68,224,13,305
"17557",1017557,22,284,6,312
"17558",1017558,232,21,6,259
"17559",1017559,127,57,5,189
"17560",1017560,58,163,2,223
"17561",1017561,195,70,7,272
"17562",1017562,230,15,5,250
"17563",1017563,67,251,13,331
"17564",1017564,120,148,4,272
"17565",1017565,77,127,4,208
"17566",1017566,186,55,20,261
"17567",1017567,39,29,1,69
"17568",1017568,36,287,7,330
"17569",1017569,74,140,12,226
"17570",1017570,73,90,1,164
"17571",1017571,110,124,0,234
"17572",1017572,123,138,8,269
"17573",1017573,50,0,0,50
"17574",1017574,48,77,7,132
"17575",1017575,45,233,7,285
"17576",1017576,233,22,9,264
"17577",1017577,18,11,0,29
"17578",1017578,112,63,2,177
"17579",1017579,112,146,12,270
"17580",1017580,40,170,3,213
"17581",1017581,168,42,6,216
"17582",1017582,204,49,5,258
"17583",1017583,25,213,9,247
"17584",1017584,57,224,5,286
"17585",1017585,138,10,6,154
"17586",1017586,60,225,14,299
"17587",1017587,46,249,5,300
"17588",1017588,163,20,2,185
"17589",1017589,46,221,9,276
"17590",1017590,78,8,3,89
"17591",1017591,91,153,10,254
"17592",1017592,37,1,0,38
"17593",1017593,219,20,4,243
"17594",1017594,101,208,13,322
"17595",1017595,162,36,8,206
"17596",1017596,101,25,7,133
"17597",1017597,131,73,11,215
"17598",1017598,59,184,12,255
"17599",1017599,87,65,15,167
"17600",1017600,1,22,0,23
"17601",1017601,30,176,11,217
"17602",1017602,95,78,8,181
"17603",1017603,95,39,9,143
"17604",1017604,43,121,4,168
"17605",1017605,210,17,14,241
"17606",1017606,47,166,1,214
"17607",1017607,80,218,4,302
"17608",1017608,206,40,12,258
"17609",1017609,122,54,6,182
"17610",1017610,49,118,2,169
"17611",1017611,16,126,2,144
"17612",1017612,84,152,14,250
"17613",1017613,185,58,5,248
"17614",1017614,129,118,6,253
"17615",1017615,19,1,1,21
"17616",1017616,218,30,11,259
"17617",1017617,21,192,4,217
"17618",1017618,27,150,6,183
"17619",1017619,149,47,6,202
"17620",1017620,122,112,2,236
"17621",1017621,42,199,8,249
"17622",1017622,180,62,7,249
"17623",1017623,188,76,12,276
"17624",1017624,197,42,5,244
"17625",1017625,101,115,12,228
"17626",1017626,112,185,14,311
"17627",1017627,80,25,1,106
"17628",1017628,183,76,13,272
"17629",1017629,106,73,3,182
"17630",1017630,119,30,3,152
"17631",1017631,148,151,13,312
"17632",1017632,47,176,4,227
"17633",1017633,186,116,13,315
"17634",1017634,224,26,5,255
"17635",1017635,48,94,2,144
"17636",1017636,25,18,1,44
"17637",1017637,14,72,3,89
"17638",1017638,91,24,8,123
"17639",1017639,85,182,9,276
"17640",1017640,23,159,3,185
"17641",1017641,164,131,16,311
"17642",1017642,71,68,12,151
"17643",1017643,98,143,3,244
"17644",1017644,149,107,1,257
"17645",1017645,208,96,11,315
"17646",1017646,37,262,3,302
"17647",1017647,70,247,9,326
"17648",1017648,129,92,2,223
"17649",1017649,32,151,3,186
"17650",1017650,94,92,11,197
"17651",1017651,73,211,5,289
"17652",1017652,201,58,14,273
"17653",1017653,143,135,23,301
"17654",1017654,53,154,6,213
"17655",1017655,116,47,9,172
"17656",1017656,25,237,1,263
"17657",1017657,122,48,7,177
"17658",1017658,21,30,2,53
"17659",1017659,137,137,0,274
"17660",1017660,47,42,2,91
"17661",1017661,63,83,4,150
"17662",1017662,25,162,4,191
"17663",1017663,149,62,7,218
"17664",1017664,76,155,4,235
"17665",1017665,168,13,6,187
"17666",1017666,247,18,7,272
"17667",1017667,5,3,0,8
"17668",1017668,209,12,6,227
"17669",1017669,73,175,6,254
"17670",1017670,137,143,12,292
"17671",1017671,101,182,4,287
"17672",1017672,87,118,4,209
"17673",1017673,123,89,6,218
"17674",1017674,101,222,5,328
"17675",1017675,207,88,11,306
"17676",1017676,153,94,5,252
"17677",1017677,37,195,18,250
"17678",1017678,110,96,9,215
"17679",1017679,106,190,6,302
"17680",1017680,57,182,15,254
"17681",1017681,4,17,0,21
"17682",1017682,126,50,5,181
"17683",1017683,129,84,5,218
"17684",1017684,46,100,12,158
"17685",1017685,114,42,5,161
"17686",1017686,110,31,3,144
"17687",1017687,144,1,1,146
"17688",1017688,110,147,26,283
"17689",1017689,231,19,7,257
"17690",1017690,19,119,3,141
"17691",1017691,40,235,8,283
"17692",1017692,43,204,7,254
"17693",1017693,126,67,16,209
"17694",1017694,227,15,10,252
"17695",1017695,120,63,5,188
"17696",1017696,62,151,19,232
"17697",1017697,318,15,0,333
"17698",1017698,178,26,13,217
"17699",1017699,43,259,1,303
"17700",1017700,213,70,17,300
"17701",1017701,42,132,12,186
"17702",1017702,154,124,7,285
"17703",1017703,3,25,1,29
"17704",1017704,61,199,9,269
"17705",1017705,205,59,8,272
"17706",1017706,25,272,1,298
"17707",1017707,176,80,10,266
"17708",1017708,39,160,4,203
"17709",1017709,143,133,16,292
"17710",1017710,144,120,9,273
"17711",1017711,94,181,6,281
"17712",1017712,201,95,3,299
"17713",1017713,89,104,11,204
"17714",1017714,103,82,3,188
"17715",1017715,223,12,2,237
"17716",1017716,112,56,4,172
"17717",1017717,174,24,6,204
"17718",1017718,145,70,7,222
"17719",1017719,146,97,12,255
"17720",1017720,173,21,8,202
"17721",1017721,147,54,6,207
"17722",1017722,58,91,9,158
"17723",1017723,194,68,8,270
"17724",1017724,127,137,22,286
"17725",1017725,213,29,7,249
"17726",1017726,39,210,12,261
"17727",1017727,19,177,5,201
"17728",1017728,235,20,5,260
"17729",1017729,14,30,3,47
"17730",1017730,22,242,5,269
"17731",1017731,40,64,1,105
"17732",1017732,41,161,7,209
"17733",1017733,66,113,14,193
"17734",1017734,24,193,6,223
"17735",1017735,122,172,3,297
"17736",1017736,107,128,5,240
"17737",1017737,237,49,5,291
"17738",1017738,221,24,8,253
"17739",1017739,83,160,12,255
"17740",1017740,89,55,6,150
"17741",1017741,25,111,0,136
"17742",1017742,228,32,14,274
"17743",1017743,192,75,7,274
"17744",1017744,13,325,2,340
"17745",1017745,34,36,5,75
"17746",1017746,55,168,16,239
"17747",1017747,136,104,6,246
"17748",1017748,61,16,3,80
"17749",1017749,60,15,2,77
"17750",1017750,7,121,0,128
"17751",1017751,95,91,6,192
"17752",1017752,72,95,2,169
"17753",1017753,98,67,4,169
"17754",1017754,94,401,13,508
"17755",1017755,135,91,15,241
"17756",1017756,185,29,8,222
"17757",1017757,153,61,3,217
"17758",1017758,92,30,11,133
"17759",1017759,144,65,9,218
"17760",1017760,2,13,0,15
"17761",1017761,113,125,18,256
"17762",1017762,31,143,3,177
"17763",1017763,96,172,9,277
"17764",1017764,26,140,8,174
"17765",1017765,130,136,12,278
"17766",1017766,48,29,0,77
"17767",1017767,62,95,8,165
"17768",1017768,136,50,7,193
"17769",1017769,47,177,6,230
"17770",1017770,119,93,2,214
"17771",1017771,60,248,22,330
"17772",1017772,73,210,5,288
"17773",1017773,141,140,14,295
"17774",1017774,61,191,14,266
"17775",1017775,37,9,2,48
"17776",1017776,47,68,5,120
"17777",1017777,62,84,16,162
"17778",1017778,199,25,8,232
"17779",1017779,38,240,13,291
"17780",1017780,46,52,4,102
"17781",1017781,183,101,17,301
"17782",1017782,154,68,5,227
"17783",1017783,30,258,5,293
"17784",1017784,227,216,14,457
"17785",1017785,72,154,3,229
"17786",1017786,51,166,9,226
"17787",1017787,124,224,2,350
"17788",1017788,16,193,1,210
"17789",1017789,144,56,11,211
"17790",1017790,137,128,5,270
"17791",1017791,124,38,4,166
"17792",1017792,146,143,21,310
"17793",1017793,67,29,7,103
"17794",1017794,135,70,11,216
"17795",1017795,22,230,4,256
"17796",1017796,156,111,3,270
"17797",1017797,87,166,0,253
"17798",1017798,128,108,12,248
"17799",1017799,73,113,4,190
"17800",1017800,13,215,7,235
"17801",1017801,45,323,4,372
"17802",1017802,120,59,3,182
"17803",1017803,90,112,10,212
"17804",1017804,192,26,5,223
"17805",1017805,110,119,12,241
"17806",1017806,138,43,9,190
"17807",1017807,43,22,2,67
"17808",1017808,128,16,1,145
"17809",1017809,108,119,11,238
"17810",1017810,152,31,3,186
"17811",1017811,31,245,3,279
"17812",1017812,105,75,10,190
"17813",1017813,131,138,21,290
"17814",1017814,66,208,11,285
"17815",1017815,152,46,11,209
"17816",1017816,106,194,18,318
"17817",1017817,34,214,6,254
"17818",1017818,168,12,7,187
"17819",1017819,42,266,9,317
"17820",1017820,106,76,5,187
"17821",1017821,76,85,23,184
"17822",1017822,61,89,4,154
"17823",1017823,93,158,10,261
"17824",1017824,108,30,10,148
"17825",1017825,105,199,19,323
"17826",1017826,8,99,0,107
"17827",1017827,200,48,13,261
"17828",1017828,128,43,10,181
"17829",1017829,120,163,17,300
"17830",1017830,92,131,12,235
"17831",1017831,123,51,4,178
"17832",1017832,103,107,22,232
"17833",1017833,62,259,13,334
"17834",1017834,231,84,16,331
"17835",1017835,28,108,9,145
"17836",1017836,90,120,9,219
"17837",1017837,35,162,11,208
"17838",1017838,219,39,11,269
"17839",1017839,134,68,5,207
"17840",1017840,189,63,5,257
"17841",1017841,78,200,8,286
"17842",1017842,9,28,0,37
"17843",1017843,52,230,2,284
"17844",1017844,135,155,13,303
"17845",1017845,158,78,9,245
"17846",1017846,117,124,3,244
"17847",1017847,191,86,19,296
"17848",1017848,113,65,7,185
"17849",1017849,213,12,1,226
"17850",1017850,121,130,15,266
"17851",1017851,36,78,4,118
"17852",1017852,168,138,9,315
"17853",1017853,291,41,3,335
"17854",1017854,157,96,11,264
"17855",1017855,73,238,8,319
"17856",1017856,182,56,11,249
"17857",1017857,20,47,0,67
"17858",1017858,73,244,3,320
"17859",1017859,59,66,0,125
"17860",1017860,18,7,3,28
"17861",1017861,167,52,1,220
"17862",1017862,142,103,16,261
"17863",1017863,183,80,11,274
"17864",1017864,132,90,9,231
"17865",1017865,199,26,7,232
"17866",1017866,18,38,1,57
"17867",1017867,128,196,13,337
"17868",1017868,97,24,8,129
"17869",1017869,35,221,4,260
"17870",1017870,215,96,15,326
"17871",1017871,82,184,10,276
"17872",1017872,73,90,12,175
"17873",1017873,14,246,2,262
"17874",1017874,38,290,7,335
"17875",1017875,34,149,8,191
"17876",1017876,84,126,13,223
"17877",1017877,133,112,5,250
"17878",1017878,129,123,7,259
"17879",1017879,54,37,5,96
"17880",1017880,10,109,2,121
"17881",1017881,8,269,0,277
"17882",1017882,199,95,15,309
"17883",1017883,149,64,7,220
"17884",1017884,124,140,14,278
"17885",1017885,78,206,19,303
"17886",1017886,99,87,3,189
"17887",1017887,67,11,3,81
"17888",1017888,65,158,14,237
"17889",1017889,140,38,12,190
"17890",1017890,179,26,8,213
"17891",1017891,26,189,8,223
"17892",1017892,84,179,13,276
"17893",1017893,83,71,5,159
"17894",1017894,29,86,6,121
"17895",1017895,155,60,9,224
"17896",1017896,71,281,1,353
"17897",1017897,113,124,8,245
"17898",1017898,184,110,12,306
"17899",1017899,161,24,2,187
"17900",1017900,40,218,11,269
"17901",1017901,116,201,12,329
"17902",1017902,54,101,10,165
"17903",1017903,28,26,1,55
"17904",1017904,152,91,6,249
"17905",1017905,109,144,22,275
"17906",1017906,90,127,8,225
"17907",1017907,62,140,5,207
"17908",1017908,169,77,15,261
"17909",1017909,15,113,2,130
"17910",1017910,149,131,17,297
"17911",1017911,134,3,2,139
"17912",1017912,123,99,6,228
"17913",1017913,45,272,5,322
"17914",1017914,173,89,17,279
"17915",1017915,82,145,9,236
"17916",1017916,108,190,5,303
"17917",1017917,2,38,0,40
"17918",1017918,226,93,0,319
"17919",1017919,107,62,5,174
"17920",1017920,148,67,8,223
"17921",1017921,136,83,11,230
"17922",1017922,13,117,1,131
"17923",1017923,201,101,10,312
"17924",1017924,93,187,7,287
"17925",1017925,71,175,4,250
"17926",1017926,74,73,4,151
"17927",1017927,142,99,13,254
"17928",1017928,97,18,10,125
"17929",1017929,49,213,14,276
"17930",1017930,121,60,3,184
"17931",1017931,185,95,9,289
"17932",1017932,96,105,5,206
"17933",1017933,11,186,1,198
"17934",1017934,120,58,6,184
"17935",1017935,54,31,2,87
"17936",1017936,76,273,17,366
"17937",1017937,150,40,12,202
"17938",1017938,104,79,3,186
"17939",1017939,41,118,16,175
"17940",1017940,142,38,8,188
"17941",1017941,122,133,5,260
"17942",1017942,9,218,6,233
"17943",1017943,252,6,3,261
"17944",1017944,44,234,4,282
"17945",1017945,96,172,6,274
"17946",1017946,174,26,9,209
"17947",1017947,192,63,17,272
"17948",1017948,282,30,6,318
"17949",1017949,148,96,13,257
"17950",1017950,132,45,8,185
"17951",1017951,164,23,6,193
"17952",1017952,185,23,3,211
"17953",1017953,56,245,7,308
"17954",1017954,46,120,3,169
"17955",1017955,112,185,9,306
"17956",1017956,116,69,4,189
"17957",1017957,192,29,9,230
"17958",1017958,240,11,6,257
"17959",1017959,119,27,4,150
"17960",1017960,42,150,5,197
"17961",1017961,187,63,18,268
"17962",1017962,148,93,21,262
"17963",1017963,85,15,4,104
"17964",1017964,200,44,11,255
"17965",1017965,148,137,9,294
"17966",1017966,146,77,8,231
"17967",1017967,34,250,4,288
"17968",1017968,60,31,5,96
"17969",1017969,13,160,25,198
"17970",1017970,123,103,4,230
"17971",1017971,106,147,14,267
"17972",1017972,9,0,0,9
"17973",1017973,167,51,2,220
"17974",1017974,10,54,3,67
"17975",1017975,96,18,5,119
"17976",1017976,120,97,6,223
"17977",1017977,103,178,1,282
"17978",1017978,138,25,2,165
"17979",1017979,202,46,13,261
"17980",1017980,37,2,0,39
"17981",1017981,220,51,10,281
"17982",1017982,107,125,10,242
"17983",1017983,129,41,8,178
"17984",1017984,58,205,8,271
"17985",1017985,132,70,9,211
"17986",1017986,133,100,13,246
"17987",1017987,194,80,7,281
"17988",1017988,66,127,4,197
"17989",1017989,160,124,24,308
"17990",1017990,33,92,5,130
"17991",1017991,107,37,3,147
"17992",1017992,92,34,2,128
"17993",1017993,83,180,9,272
"17994",1017994,53,261,8,322
"17995",1017995,153,49,9,211
"17996",1017996,21,12,2,35
"17997",1017997,3,231,0,234
"17998",1017998,223,40,7,270
"17999",1017999,166,33,4,203
"18000",1018000,81,100,11,192
"18001",1018001,135,25,9,169
"18002",1018002,173,87,12,272
"18003",1018003,60,255,5,320
"18004",1018004,164,89,7,260
"18005",1018005,59,233,3,295
"18006",1018006,123,121,4,248
"18007",1018007,57,174,16,247
"18008",1018008,175,98,7,280
"18009",1018009,70,37,5,112
"18010",1018010,91,81,13,185
"18011",1018011,151,65,0,216
"18012",1018012,137,76,10,223
"18013",1018013,150,45,10,205
"18014",1018014,121,0,1,122
"18015",1018015,60,74,5,139
"18016",1018016,151,115,6,272
"18017",1018017,147,127,11,285
"18018",1018018,110,97,9,216
"18019",1018019,152,29,9,190
"18020",1018020,179,93,4,276
"18021",1018021,124,25,6,155
"18022",1018022,199,54,7,260
"18023",1018023,230,19,7,256
"18024",1018024,122,63,11,196
"18025",1018025,129,146,12,287
"18026",1018026,59,170,4,233
"18027",1018027,116,62,6,184
"18028",1018028,53,17,2,72
"18029",1018029,76,186,8,270
"18030",1018030,27,9,2,38
"18031",1018031,228,22,7,257
"18032",1018032,222,20,3,245
"18033",1018033,99,187,13,299
"18034",1018034,55,35,3,93
"18035",1018035,214,36,8,258
"18036",1018036,94,84,6,184
"18037",1018037,186,97,8,291
"18038",1018038,159,146,13,318
"18039",1018039,82,169,13,264
"18040",1018040,120,59,8,187
"18041",1018041,61,99,0,160
"18042",1018042,21,106,0,127
"18043",1018043,338,2,4,344
"18044",1018044,38,236,4,278
"18045",1018045,65,181,4,250
"18046",1018046,124,182,10,316
"18047",1018047,72,130,4,206
"18048",1018048,47,205,4,256
"18049",1018049,112,92,4,208
"18050",1018050,153,86,7,246
"18051",1018051,186,107,16,309
"18052",1018052,66,176,14,256
"18053",1018053,128,94,12,234
"18054",1018054,47,204,7,258
"18055",1018055,6,8,0,14
"18056",1018056,13,1,0,14
"18057",1018057,36,184,16,236
"18058",1018058,135,142,6,283
"18059",1018059,217,20,9,246
"18060",1018060,120,140,7,267
"18061",1018061,115,136,13,264
"18062",1018062,173,85,13,271
"18063",1018063,200,108,12,320
"18064",1018064,147,132,12,291
"18065",1018065,225,8,5,238
"18066",1018066,183,59,13,255
"18067",1018067,155,84,9,248
"18068",1018068,158,27,4,189
"18069",1018069,127,174,4,305
"18070",1018070,27,191,5,223
"18071",1018071,155,43,10,208
"18072",1018072,79,14,1,94
"18073",1018073,214,49,14,277
"18074",1018074,88,143,5,236
"18075",1018075,154,45,13,212
"18076",1018076,140,39,8,187
"18077",1018077,48,214,3,265
"18078",1018078,223,5,0,228
"18079",1018079,119,38,5,162
"18080",1018080,152,41,4,197
"18081",1018081,72,168,3,243
"18082",1018082,73,113,5,191
"18083",1018083,172,131,24,327
"18084",1018084,68,191,16,275
"18085",1018085,144,109,10,263
"18086",1018086,115,129,13,257
"18087",1018087,159,52,12,223
"18088",1018088,113,182,15,310
"18089",1018089,108,18,7,133
"18090",1018090,99,50,4,153
"18091",1018091,160,13,3,176
"18092",1018092,22,55,1,78
"18093",1018093,52,65,8,125
"18094",1018094,198,67,6,271
"18095",1018095,171,64,4,239
"18096",1018096,73,187,10,270
"18097",1018097,182,55,11,248
"18098",1018098,143,77,0,220
"18099",1018099,99,18,2,119
"18100",1018100,46,172,7,225
"18101",1018101,80,9,0,89
"18102",1018102,159,11,2,172
"18103",1018103,159,140,6,305
"18104",1018104,23,18,3,44
"18105",1018105,176,116,9,301
"18106",1018106,29,124,8,161
"18107",1018107,51,258,15,324
"18108",1018108,22,208,4,234
"18109",1018109,119,122,6,247
"18110",1018110,251,20,8,279
"18111",1018111,151,65,7,223
"18112",1018112,152,133,13,298
"18113",1018113,64,58,8,130
"18114",1018114,73,125,10,208
"18115",1018115,141,146,16,303
"18116",1018116,181,62,6,249
"18117",1018117,165,10,5,180
"18118",1018118,133,72,7,212
"18119",1018119,146,33,3,182
"18120",1018120,149,134,17,300
"18121",1018121,42,124,5,171
"18122",1018122,9,11,3,23
"18123",1018123,34,73,7,114
"18124",1018124,148,60,11,219
"18125",1018125,166,69,3,238
"18126",1018126,124,110,14,248
"18127",1018127,139,23,6,168
"18128",1018128,146,56,8,210
"18129",1018129,88,12,1,101
"18130",1018130,238,5,3,246
"18131",1018131,228,77,14,319
"18132",1018132,149,26,3,178
"18133",1018133,38,275,10,323
"18134",1018134,140,20,3,163
"18135",1018135,184,73,9,266
"18136",1018136,4,11,1,16
"18137",1018137,200,13,5,218
"18138",1018138,104,47,8,159
"18139",1018139,194,116,17,327
"18140",1018140,221,121,24,366
"18141",1018141,119,112,13,244
"18142",1018142,117,44,10,171
"18143",1018143,157,119,15,291
"18144",1018144,180,13,4,197
"18145",1018145,113,146,8,267
"18146",1018146,228,40,7,275
"18147",1018147,141,89,10,240
"18148",1018148,44,176,11,231
"18149",1018149,95,105,17,217
"18150",1018150,120,94,5,219
"18151",1018151,143,44,4,191
"18152",1018152,122,16,3,141
"18153",1018153,78,63,14,155
"18154",1018154,187,87,5,279
"18155",1018155,41,175,4,220
"18156",1018156,131,35,6,172
"18157",1018157,134,68,14,216
"18158",1018158,182,76,8,266
"18159",1018159,14,24,1,39
"18160",1018160,37,154,6,197
"18161",1018161,166,55,15,236
"18162",1018162,230,30,4,264
"18163",1018163,165,77,11,253
"18164",1018164,78,90,2,170
"18165",1018165,164,106,25,295
"18166",1018166,142,48,9,199
"18167",1018167,182,1,4,187
"18168",1018168,77,163,3,243
"18169",1018169,145,156,19,320
"18170",1018170,114,83,6,203
"18171",1018171,88,125,3,216
"18172",1018172,129,38,7,174
"18173",1018173,132,18,2,152
"18174",1018174,135,94,13,242
"18175",1018175,181,35,13,229
"18176",1018176,160,86,12,258
"18177",1018177,35,218,8,261
"18178",1018178,65,24,3,92
"18179",1018179,208,32,17,257
"18180",1018180,27,226,9,262
"18181",1018181,158,140,9,307
"18182",1018182,14,194,0,208
"18183",1018183,237,34,9,280
"18184",1018184,258,3,2,263
"18185",1018185,51,46,1,98
"18186",1018186,141,10,1,152
"18187",1018187,47,74,10,131
"18188",1018188,139,14,4,157
"18189",1018189,83,97,4,184
"18190",1018190,43,6,2,51
"18191",1018191,128,106,14,248
"18192",1018192,184,90,3,277
"18193",1018193,88,167,2,257
"18194",1018194,81,161,10,252
"18195",1018195,112,125,5,242
"18196",1018196,70,205,10,285
"18197",1018197,5,24,1,30
"18198",1018198,11,7,1,19
"18199",1018199,56,206,3,265
"18200",1018200,134,81,9,224
"18201",1018201,191,58,8,257
"18202",1018202,198,77,13,288
"18203",1018203,73,223,5,301
"18204",1018204,75,92,17,184
"18205",1018205,74,178,11,263
"18206",1018206,146,16,3,165
"18207",1018207,36,22,3,61
"18208",1018208,19,3,2,24
"18209",1018209,243,67,8,318
"18210",1018210,132,42,5,179
"18211",1018211,141,98,5,244
"18212",1018212,99,99,5,203
"18213",1018213,31,6,2,39
"18214",1018214,235,74,5,314
"18215",1018215,197,28,5,230
"18216",1018216,167,41,13,221
"18217",1018217,8,50,2,60
"18218",1018218,31,259,8,298
"18219",1018219,24,201,1,226
"18220",1018220,137,41,4,182
"18221",1018221,35,167,15,217
"18222",1018222,9,2,0,11
"18223",1018223,210,41,5,256
"18224",1018224,201,36,11,248
"18225",1018225,77,86,8,171
"18226",1018226,26,2,0,28
"18227",1018227,130,151,16,297
"18228",1018228,146,13,6,165
"18229",1018229,142,61,5,208
"18230",1018230,60,237,10,307
"18231",1018231,68,167,21,256
"18232",1018232,170,19,2,191
"18233",1018233,182,73,8,263
"18234",1018234,146,138,9,293
"18235",1018235,90,118,4,212
"18236",1018236,32,134,6,172
"18237",1018237,120,76,19,215
"18238",1018238,70,138,10,218
"18239",1018239,220,29,5,254
"18240",1018240,34,134,7,175
"18241",1018241,194,35,9,238
"18242",1018242,62,233,12,307
"18243",1018243,60,167,6,233
"18244",1018244,184,49,14,247
"18245",1018245,69,191,15,275
"18246",1018246,66,108,3,177
"18247",1018247,179,82,8,269
"18248",1018248,89,168,11,268
"18249",1018249,135,61,12,208
"18250",1018250,84,131,13,228
"18251",1018251,133,97,6,236
"18252",1018252,216,19,6,241
"18253",1018253,56,185,8,249
"18254",1018254,58,227,8,293
"18255",1018255,14,1,0,15
"18256",1018256,201,76,18,295
"18257",1018257,58,214,1,273
"18258",1018258,182,33,7,222
"18259",1018259,103,47,7,157
"18260",1018260,124,61,2,187
"18261",1018261,182,64,12,258
"18262",1018262,281,10,8,299
"18263",1018263,120,178,4,302
"18264",1018264,65,95,5,165
"18265",1018265,193,92,15,300
"18266",1018266,91,116,3,210
"18267",1018267,145,103,15,263
"18268",1018268,123,142,14,279
"18269",1018269,202,61,12,275
"18270",1018270,69,156,12,237
"18271",1018271,275,22,9,306
"18272",1018272,130,28,7,165
"18273",1018273,112,94,7,213
"18274",1018274,210,62,11,283
"18275",1018275,126,58,5,189
"18276",1018276,18,5,0,23
"18277",1018277,20,12,1,33
"18278",1018278,104,113,2,219
"18279",1018279,144,132,18,294
"18280",1018280,228,11,4,243
"18281",1018281,47,169,8,224
"18282",1018282,97,67,4,168
"18283",1018283,145,140,27,312
"18284",1018284,251,19,15,285
"18285",1018285,125,61,9,195
"18286",1018286,30,17,5,52
"18287",1018287,111,161,11,283
"18288",1018288,162,126,7,295
"18289",1018289,208,48,6,262
"18290",1018290,168,32,4,204
"18291",1018291,133,13,6,152
"18292",1018292,14,3,0,17
"18293",1018293,306,8,4,318
"18294",1018294,159,68,11,238
"18295",1018295,20,201,3,224
"18296",1018296,92,78,11,181
"18297",1018297,200,41,9,250
"18298",1018298,69,208,16,293
"18299",1018299,159,72,11,242
"18300",1018300,144,89,8,241
"18301",1018301,56,74,7,137
"18302",1018302,260,11,9,280
"18303",1018303,117,84,11,212
"18304",1018304,54,108,6,168
"18305",1018305,105,140,7,252
"18306",1018306,112,204,7,323
"18307",1018307,69,249,5,323
"18308",1018308,72,176,11,259
"18309",1018309,89,6,2,97
"18310",1018310,61,213,12,286
"18311",1018311,64,70,3,137
"18312",1018312,80,221,11,312
"18313",1018313,159,118,10,287
"18314",1018314,143,109,7,259
"18315",1018315,71,232,6,309
"18316",1018316,80,120,5,205
"18317",1018317,49,241,1,291
"18318",1018318,260,13,5,278
"18319",1018319,191,88,2,281
"18320",1018320,64,150,16,230
"18321",1018321,106,9,2,117
"18322",1018322,88,137,6,231
"18323",1018323,45,134,7,186
"18324",1018324,63,186,19,268
"18325",1018325,25,19,1,45
"18326",1018326,76,19,6,101
"18327",1018327,39,207,4,250
"18328",1018328,113,70,2,185
"18329",1018329,32,39,0,71
"18330",1018330,43,210,2,255
"18331",1018331,264,23,4,291
"18332",1018332,65,107,3,175
"18333",1018333,165,41,6,212
"18334",1018334,122,15,1,138
"18335",1018335,90,52,5,147
"18336",1018336,48,189,11,248
"18337",1018337,113,122,4,239
"18338",1018338,158,93,5,256
"18339",1018339,39,174,4,217
"18340",1018340,82,118,7,207
"18341",1018341,178,63,9,250
"18342",1018342,64,215,10,289
"18343",1018343,257,33,16,306
"18344",1018344,110,90,3,203
"18345",1018345,62,9,2,73
"18346",1018346,271,52,17,340
"18347",1018347,201,34,7,242
"18348",1018348,224,19,4,247
"18349",1018349,231,61,11,303
"18350",1018350,137,127,6,270
"18351",1018351,200,64,5,269
"18352",1018352,91,91,9,191
"18353",1018353,134,17,2,153
"18354",1018354,48,267,3,318
"18355",1018355,64,117,5,186
"18356",1018356,11,11,2,24
"18357",1018357,220,17,9,246
"18358",1018358,101,54,13,168
"18359",1018359,82,150,7,239
"18360",1018360,119,69,3,191
"18361",1018361,85,64,5,154
"18362",1018362,104,231,6,341
"18363",1018363,166,35,5,206
"18364",1018364,173,82,6,261
"18365",1018365,160,88,14,262
"18366",1018366,178,131,5,314
"18367",1018367,92,212,5,309
"18368",1018368,174,53,12,239
"18369",1018369,105,188,15,308
"18370",1018370,28,173,6,207
"18371",1018371,64,179,15,258
"18372",1018372,121,73,10,204
"18373",1018373,33,203,8,244
"18374",1018374,209,111,3,323
"18375",1018375,65,133,22,220
"18376",1018376,90,67,12,169
"18377",1018377,95,183,16,294
"18378",1018378,187,87,9,283
"18379",1018379,150,45,4,199
"18380",1018380,151,82,13,246
"18381",1018381,75,193,3,271
"18382",1018382,95,11,3,109
"18383",1018383,76,103,12,191
"18384",1018384,87,186,16,289
"18385",1018385,19,174,6,199
"18386",1018386,41,236,6,283
"18387",1018387,176,44,3,223
"18388",1018388,173,81,10,264
"18389",1018389,94,190,9,293
"18390",1018390,153,23,3,179
"18391",1018391,93,88,2,183
"18392",1018392,36,271,9,316
"18393",1018393,56,282,11,349
"18394",1018394,53,235,10,298
"18395",1018395,85,161,13,259
"18396",1018396,118,36,13,167
"18397",1018397,65,184,20,269
"18398",1018398,85,192,8,285
"18399",1018399,249,18,8,275
"18400",1018400,69,74,10,153
"18401",1018401,77,129,13,219
"18402",1018402,135,69,5,209
"18403",1018403,68,264,13,345
"18404",1018404,102,16,4,122
"18405",1018405,246,17,2,265
"18406",1018406,38,283,3,324
"18407",1018407,200,54,0,254
"18408",1018408,109,24,3,136
"18409",1018409,150,137,6,293
"18410",1018410,140,11,3,154
"18411",1018411,26,222,12,260
"18412",1018412,85,238,11,334
"18413",1018413,81,137,4,222
"18414",1018414,63,211,18,292
"18415",1018415,22,168,8,198
"18416",1018416,136,43,3,182
"18417",1018417,25,26,1,52
"18418",1018418,80,194,9,283
"18419",1018419,149,64,12,225
"18420",1018420,123,72,8,203
"18421",1018421,26,18,1,45
"18422",1018422,186,83,11,280
"18423",1018423,163,169,7,339
"18424",1018424,152,46,13,211
"18425",1018425,129,28,9,166
"18426",1018426,108,104,6,218
"18427",1018427,41,118,3,162
"18428",1018428,218,26,11,255
"18429",1018429,119,46,5,170
"18430",1018430,136,122,11,269
"18431",1018431,48,155,8,211
"18432",1018432,52,2,1,55
"18433",1018433,187,43,4,234
"18434",1018434,173,103,8,284
"18435",1018435,157,117,20,294
"18436",1018436,81,78,4,163
"18437",1018437,100,185,8,293
"18438",1018438,7,41,2,50
"18439",1018439,211,66,19,296
"18440",1018440,115,73,8,196
"18441",1018441,155,113,17,285
"18442",1018442,18,106,2,126
"18443",1018443,168,11,4,183
"18444",1018444,83,199,7,289
"18445",1018445,6,56,3,65
"18446",1018446,140,57,11,208
"18447",1018447,206,20,6,232
"18448",1018448,167,18,6,191
"18449",1018449,106,65,15,186
"18450",1018450,98,54,6,158
"18451",1018451,130,118,16,264
"18452",1018452,45,80,6,131
"18453",1018453,7,6,0,13
"18454",1018454,180,85,7,272
"18455",1018455,49,63,8,120
"18456",1018456,102,150,2,254
"18457",1018457,222,53,16,291
"18458",1018458,50,187,3,240
"18459",1018459,92,181,19,292
"18460",1018460,40,216,7,263
"18461",1018461,189,65,10,264
"18462",1018462,133,133,6,272
"18463",1018463,165,68,3,236
"18464",1018464,80,164,11,255
"18465",1018465,104,71,4,179
"18466",1018466,109,92,21,222
"18467",1018467,81,7,5,93
"18468",1018468,22,263,6,291
"18469",1018469,61,90,8,159
"18470",1018470,200,31,10,241
"18471",1018471,8,7,2,17
"18472",1018472,141,133,26,300
"18473",1018473,111,159,8,278
"18474",1018474,53,190,4,247
"18475",1018475,88,116,10,214
"18476",1018476,97,74,11,182
"18477",1018477,53,256,4,313
"18478",1018478,167,124,15,306
"18479",1018479,102,177,5,284
"18480",1018480,162,48,3,213
"18481",1018481,96,158,17,271
"18482",1018482,38,63,2,103
"18483",1018483,207,3,8,218
"18484",1018484,90,69,15,174
"18485",1018485,68,266,16,350
"18486",1018486,66,171,5,242
"18487",1018487,33,203,1,237
"18488",1018488,25,193,4,222
"18489",1018489,189,100,9,298
"18490",1018490,90,76,9,175
"18491",1018491,70,157,10,237
"18492",1018492,69,177,5,251
"18493",1018493,43,220,4,267
"18494",1018494,153,89,7,249
"18495",1018495,166,79,11,256
"18496",1018496,14,306,1,321
"18497",1018497,211,65,8,284
"18498",1018498,44,111,1,156
"18499",1018499,146,48,3,197
"18500",1018500,151,58,10,219
"18501",1018501,144,133,15,292
"18502",1018502,62,186,9,257
"18503",1018503,140,60,7,207
"18504",1018504,134,101,24,259
"18505",1018505,126,75,26,227
"18506",1018506,195,60,8,263
"18507",1018507,174,61,5,240
"18508",1018508,77,120,11,208
"18509",1018509,79,170,7,256
"18510",1018510,42,14,4,60
"18511",1018511,145,90,0,235
"18512",1018512,98,69,7,174
"18513",1018513,25,16,5,46
"18514",1018514,144,91,14,249
"18515",1018515,176,126,12,314
"18516",1018516,40,150,4,194
"18517",1018517,29,0,1,30
"18518",1018518,243,18,5,266
"18519",1018519,118,115,9,242
"18520",1018520,123,148,19,290
"18521",1018521,128,110,8,246
"18522",1018522,171,49,7,227
"18523",1018523,84,177,4,265
"18524",1018524,44,181,1,226
"18525",1018525,158,9,18,185
"18526",1018526,143,119,6,268
"18527",1018527,146,30,7,183
"18528",1018528,223,31,13,267
"18529",1018529,12,1,0,13
"18530",1018530,148,145,13,306
"18531",1018531,12,132,4,148
"18532",1018532,133,33,3,169
"18533",1018533,15,59,3,77
"18534",1018534,161,64,13,238
"18535",1018535,45,46,3,94
"18536",1018536,223,4,3,230
"18537",1018537,228,33,9,270
"18538",1018538,6,6,2,14
"18539",1018539,115,114,22,251
"18540",1018540,260,27,3,290
"18541",1018541,110,134,3,247
"18542",1018542,169,72,12,253
"18543",1018543,130,88,1,219
"18544",1018544,250,83,14,347
"18545",1018545,187,71,13,271
"18546",1018546,55,279,7,341
"18547",1018547,7,10,0,17
"18548",1018548,103,148,5,256
"18549",1018549,46,185,5,236
"18550",1018550,188,49,17,254
"18551",1018551,209,98,9,316
"18552",1018552,141,74,12,227
"18553",1018553,258,9,3,270
"18554",1018554,39,121,12,172
"18555",1018555,39,140,2,181
"18556",1018556,45,110,10,165
"18557",1018557,95,110,8,213
"18558",1018558,172,38,13,223
"18559",1018559,160,64,4,228
"18560",1018560,160,127,19,306
"18561",1018561,16,138,4,158
"18562",1018562,117,17,4,138
"18563",1018563,72,78,4,154
"18564",1018564,2,13,1,16
"18565",1018565,179,98,6,283
"18566",1018566,70,79,5,154
"18567",1018567,12,210,7,229
"18568",1018568,36,226,4,266
"18569",1018569,124,32,5,161
"18570",1018570,75,217,12,304
"18571",1018571,114,43,10,167
"18572",1018572,84,148,12,244
"18573",1018573,104,121,2,227
"18574",1018574,88,188,4,280
"18575",1018575,207,63,3,273
"18576",1018576,170,22,2,194
"18577",1018577,51,188,4,243
"18578",1018578,48,69,4,121
"18579",1018579,60,244,10,314
"18580",1018580,100,79,8,187
"18581",1018581,81,211,19,311
"18582",1018582,100,130,9,239
"18583",1018583,136,11,5,152
"18584",1018584,11,10,0,21
"18585",1018585,124,156,21,301
"18586",1018586,87,213,15,315
"18587",1018587,148,55,14,217
"18588",1018588,157,95,12,264
"18589",1018589,134,22,4,160
"18590",1018590,154,66,4,224
"18591",1018591,226,24,6,256
"18592",1018592,72,207,3,282
"18593",1018593,189,91,18,298
"18594",1018594,135,50,2,187
"18595",1018595,251,47,11,309
"18596",1018596,72,43,4,119
"18597",1018597,131,77,16,224
"18598",1018598,194,92,9,295
"18599",1018599,126,138,8,272
"18600",1018600,92,154,5,251
"18601",1018601,157,132,3,292
"18602",1018602,199,52,6,257
"18603",1018603,89,161,3,253
"18604",1018604,70,220,13,303
"18605",1018605,205,78,3,286
"18606",1018606,115,67,8,190
"18607",1018607,118,54,3,175
"18608",1018608,127,56,10,193
"18609",1018609,161,54,5,220
"18610",1018610,103,55,3,161
"18611",1018611,224,41,1,266
"18612",1018612,129,189,4,322
"18613",1018613,124,170,6,300
"18614",1018614,94,34,6,134
"18615",1018615,36,317,3,356
"18616",1018616,91,171,15,277
"18617",1018617,43,250,5,298
"18618",1018618,108,172,12,292
"18619",1018619,14,68,1,83
"18620",1018620,97,53,5,155
"18621",1018621,128,156,3,287
"18622",1018622,196,76,17,289
"18623",1018623,105,56,4,165
"18624",1018624,53,49,5,107
"18625",1018625,60,173,34,267
"18626",1018626,68,28,9,105
"18627",1018627,225,46,9,280
"18628",1018628,155,47,10,212
"18629",1018629,98,133,14,245
"18630",1018630,150,35,3,188
"18631",1018631,233,40,8,281
"18632",1018632,2,2,0,4
"18633",1018633,22,163,6,191
"18634",1018634,120,162,16,298
"18635",1018635,109,69,9,187
"18636",1018636,51,100,6,157
"18637",1018637,116,48,1,165
"18638",1018638,84,160,8,252
"18639",1018639,69,182,15,266
"18640",1018640,156,80,16,252
"18641",1018641,76,156,2,234
"18642",1018642,19,8,0,27
"18643",1018643,93,148,3,244
"18644",1018644,53,237,5,295
"18645",1018645,19,22,3,44
"18646",1018646,92,39,9,140
"18647",1018647,144,71,15,230
"18648",1018648,103,93,5,201
"18649",1018649,10,78,2,90
"18650",1018650,115,194,9,318
"18651",1018651,162,58,9,229
"18652",1018652,196,25,4,225
"18653",1018653,172,101,14,287
"18654",1018654,98,18,4,120
"18655",1018655,45,139,9,193
"18656",1018656,93,95,5,193
"18657",1018657,83,164,13,260
"18658",1018658,25,28,1,54
"18659",1018659,163,36,2,201
"18660",1018660,226,48,8,282
"18661",1018661,156,66,12,234
"18662",1018662,221,28,2,251
"18663",1018663,71,236,6,313
"18664",1018664,12,68,1,81
"18665",1018665,111,124,4,239
"18666",1018666,236,29,6,271
"18667",1018667,126,76,6,208
"18668",1018668,143,81,16,240
"18669",1018669,178,50,5,233
"18670",1018670,44,115,1,160
"18671",1018671,176,116,18,310
"18672",1018672,166,89,3,258
"18673",1018673,64,56,7,127
"18674",1018674,71,134,10,215
"18675",1018675,189,54,11,254
"18676",1018676,142,118,26,286
"18677",1018677,77,190,5,272
"18678",1018678,69,38,1,108
"18679",1018679,36,156,8,200
"18680",1018680,67,139,6,212
"18681",1018681,13,12,1,26
"18682",1018682,70,153,7,230
"18683",1018683,51,24,1,76
"18684",1018684,122,93,14,229
"18685",1018685,138,105,9,252
"18686",1018686,209,36,6,251
"18687",1018687,51,192,8,251
"18688",1018688,210,57,15,282
"18689",1018689,101,105,7,213
"18690",1018690,155,29,7,191
"18691",1018691,67,4,0,71
"18692",1018692,134,122,13,269
"18693",1018693,170,18,11,199
"18694",1018694,181,63,17,261
"18695",1018695,139,50,8,197
"18696",1018696,122,152,11,285
"18697",1018697,160,38,3,201
"18698",1018698,61,207,5,273
"18699",1018699,5,107,3,115
"18700",1018700,125,51,3,179
"18701",1018701,9,48,1,58
"18702",1018702,171,37,12,220
"18703",1018703,53,221,7,281
"18704",1018704,168,62,3,233
"18705",1018705,48,121,12,181
"18706",1018706,166,96,14,276
"18707",1018707,107,172,22,301
"18708",1018708,83,71,10,164
"18709",1018709,46,194,1,241
"18710",1018710,85,79,7,171
"18711",1018711,17,6,2,25
"18712",1018712,125,159,7,291
"18713",1018713,90,200,24,314
"18714",1018714,80,190,9,279
"18715",1018715,184,52,19,255
"18716",1018716,44,30,2,76
"18717",1018717,7,5,0,12
"18718",1018718,23,103,2,128
"18719",1018719,193,20,5,218
"18720",1018720,87,153,9,249
"18721",1018721,274,9,11,294
"18722",1018722,52,254,4,310
"18723",1018723,9,26,1,36
"18724",1018724,25,114,6,145
"18725",1018725,27,193,6,226
"18726",1018726,60,183,4,247
"18727",1018727,168,8,4,180
"18728",1018728,132,150,3,285
"18729",1018729,44,137,10,191
"18730",1018730,45,31,2,78
"18731",1018731,81,72,15,168
"18732",1018732,28,177,0,205
"18733",1018733,55,187,9,251
"18734",1018734,69,192,6,267
"18735",1018735,98,75,7,180
"18736",1018736,77,195,6,278
"18737",1018737,148,16,4,168
"18738",1018738,97,185,14,296
"18739",1018739,112,135,22,269
"18740",1018740,77,150,5,232
"18741",1018741,262,36,12,310
"18742",1018742,131,40,2,173
"18743",1018743,107,178,8,293
"18744",1018744,76,144,3,223
"18745",1018745,40,199,9,248
"18746",1018746,110,96,4,210
"18747",1018747,47,135,8,190
"18748",1018748,42,138,3,183
"18749",1018749,168,54,11,233
"18750",1018750,229,26,11,266
"18751",1018751,117,207,8,332
"18752",1018752,86,96,4,186
"18753",1018753,170,39,8,217
"18754",1018754,201,40,13,254
"18755",1018755,181,31,3,215
"18756",1018756,115,86,4,205
"18757",1018757,16,226,3,245
"18758",1018758,31,53,8,92
"18759",1018759,182,94,7,283
"18760",1018760,32,45,0,77
"18761",1018761,89,186,10,285
"18762",1018762,133,143,8,284
"18763",1018763,116,135,11,262
"18764",1018764,50,149,8,207
"18765",1018765,64,254,12,330
"18766",1018766,32,47,2,81
"18767",1018767,80,79,3,162
"18768",1018768,44,154,8,206
"18769",1018769,108,40,10,158
"18770",1018770,3,3,1,7
"18771",1018771,121,40,4,165
"18772",1018772,7,148,1,156
"18773",1018773,30,225,8,263
"18774",1018774,208,15,4,227
"18775",1018775,158,44,6,208
"18776",1018776,181,86,11,278
"18777",1018777,113,125,7,245
"18778",1018778,58,25,5,88
"18779",1018779,23,12,1,36
"18780",1018780,42,220,6,268
"18781",1018781,165,15,6,186
"18782",1018782,105,91,13,209
"18783",1018783,7,144,0,151
"18784",1018784,173,41,2,216
"18785",1018785,168,82,10,260
"18786",1018786,95,135,27,257
"18787",1018787,45,104,5,154
"18788",1018788,37,212,6,255
"18789",1018789,117,201,6,324
"18790",1018790,164,57,0,221
"18791",1018791,149,77,7,233
"18792",1018792,93,193,9,295
"18793",1018793,45,1,2,48
"18794",1018794,44,179,6,229
"18795",1018795,104,41,8,153
"18796",1018796,146,42,7,195
"18797",1018797,63,71,13,147
"18798",1018798,50,39,1,90
"18799",1018799,207,13,2,222
"18800",1018800,83,52,4,139
"18801",1018801,106,188,12,306
"18802",1018802,151,132,6,289
"18803",1018803,200,100,21,321
"18804",1018804,74,148,19,241
"18805",1018805,88,176,5,269
"18806",1018806,26,232,10,268
"18807",1018807,194,51,3,248
"18808",1018808,185,9,5,199
"18809",1018809,125,100,10,235
"18810",1018810,89,32,2,123
"18811",1018811,117,48,3,168
"18812",1018812,122,11,4,137
"18813",1018813,63,182,13,258
"18814",1018814,120,103,8,231
"18815",1018815,82,53,6,141
"18816",1018816,65,216,6,287
"18817",1018817,132,204,5,341
"18818",1018818,49,21,3,73
"18819",1018819,51,212,16,279
"18820",1018820,219,81,14,314
"18821",1018821,47,153,6,206
"18822",1018822,141,97,9,247
"18823",1018823,114,54,21,189
"18824",1018824,180,13,0,193
"18825",1018825,363,65,12,440
"18826",1018826,140,41,10,191
"18827",1018827,103,176,4,283
"18828",1018828,66,164,5,235
"18829",1018829,183,47,10,240
"18830",1018830,147,125,7,279
"18831",1018831,76,148,4,228
"18832",1018832,170,101,9,280
"18833",1018833,95,67,12,174
"18834",1018834,186,78,14,278
"18835",1018835,159,97,8,264
"18836",1018836,216,22,5,243
"18837",1018837,129,19,5,153
"18838",1018838,124,103,16,243
"18839",1018839,75,219,14,308
"18840",1018840,249,29,7,285
"18841",1018841,43,142,4,189
"18842",1018842,133,47,10,190
"18843",1018843,75,51,2,128
"18844",1018844,110,82,13,205
"18845",1018845,70,134,13,217
"18846",1018846,132,58,1,191
"18847",1018847,105,132,16,253
"18848",1018848,101,38,10,149
"18849",1018849,169,80,3,252
"18850",1018850,211,27,9,247
"18851",1018851,211,66,11,288
"18852",1018852,126,70,1,197
"18853",1018853,25,1,0,26
"18854",1018854,83,28,8,119
"18855",1018855,164,76,12,252
"18856",1018856,85,111,10,206
"18857",1018857,106,36,6,148
"18858",1018858,100,148,17,265
"18859",1018859,167,26,11,204
"18860",1018860,97,80,5,182
"18861",1018861,85,166,22,273
"18862",1018862,98,26,4,128
"18863",1018863,12,63,0,75
"18864",1018864,130,40,5,175
"18865",1018865,157,29,13,199
"18866",1018866,98,201,0,299
"18867",1018867,80,144,6,230
"18868",1018868,116,34,3,153
"18869",1018869,45,151,5,201
"18870",1018870,128,15,4,147
"18871",1018871,86,177,4,267
"18872",1018872,30,252,11,293
"18873",1018873,94,227,7,328
"18874",1018874,53,107,5,165
"18875",1018875,172,40,10,222
"18876",1018876,67,233,12,312
"18877",1018877,174,48,6,228
"18878",1018878,20,8,0,28
"18879",1018879,179,56,16,251
"18880",1018880,65,20,1,86
"18881",1018881,174,21,11,206
"18882",1018882,79,122,6,207
"18883",1018883,256,5,3,264
"18884",1018884,35,203,2,240
"18885",1018885,248,50,15,313
"18886",1018886,17,7,1,25
"18887",1018887,54,116,10,180
"18888",1018888,15,119,5,139
"18889",1018889,115,6,11,132
"18890",1018890,156,75,3,234
"18891",1018891,191,96,21,308
"18892",1018892,56,105,7,168
"18893",1018893,31,271,5,307
"18894",1018894,174,52,7,233
"18895",1018895,180,54,12,246
"18896",1018896,42,254,0,296
"18897",1018897,185,42,4,231
"18898",1018898,134,122,9,265
"18899",1018899,153,24,5,182
"18900",1018900,119,44,8,171
"18901",1018901,110,18,4,132
"18902",1018902,109,120,15,244
"18903",1018903,195,20,11,226
"18904",1018904,53,86,4,143
"18905",1018905,95,156,15,266
"18906",1018906,94,88,11,193
"18907",1018907,128,164,13,305
"18908",1018908,65,57,0,122
"18909",1018909,154,76,6,236
"18910",1018910,44,199,5,248
"18911",1018911,172,150,6,328
"18912",1018912,160,41,3,204
"18913",1018913,118,63,6,187
"18914",1018914,165,23,12,200
"18915",1018915,54,17,5,76
"18916",1018916,91,127,10,228
"18917",1018917,51,66,4,121
"18918",1018918,25,220,13,258
"18919",1018919,104,135,11,250
"18920",1018920,67,227,15,309
"18921",1018921,189,10,2,201
"18922",1018922,199,57,8,264
"18923",1018923,175,105,12,292
"18924",1018924,83,200,10,293
"18925",1018925,87,8,0,95
"18926",1018926,149,98,12,259
"18927",1018927,87,129,13,229
"18928",1018928,99,199,5,303
"18929",1018929,129,69,5,203
"18930",1018930,122,43,8,173
"18931",1018931,31,29,0,60
"18932",1018932,106,114,6,226
"18933",1018933,67,142,6,215
"18934",1018934,251,28,5,284
"18935",1018935,34,121,6,161
"18936",1018936,215,19,6,240
"18937",1018937,108,98,9,215
"18938",1018938,41,185,12,238
"18939",1018939,81,113,11,205
"18940",1018940,43,180,1,224
"18941",1018941,97,119,28,244
"18942",1018942,46,198,9,253
"18943",1018943,83,111,9,203
"18944",1018944,172,43,17,232
"18945",1018945,62,20,2,84
"18946",1018946,109,80,14,203
"18947",1018947,64,134,2,200
"18948",1018948,43,108,6,157
"18949",1018949,70,199,10,279
"18950",1018950,86,243,17,346
"18951",1018951,167,78,10,255
"18952",1018952,165,110,7,282
"18953",1018953,115,127,11,253
"18954",1018954,300,12,7,319
"18955",1018955,44,237,2,283
"18956",1018956,39,123,2,164
"18957",1018957,126,41,4,171
"18958",1018958,342,40,11,393
"18959",1018959,103,211,16,330
"18960",1018960,48,127,3,178
"18961",1018961,148,61,7,216
"18962",1018962,21,10,0,31
"18963",1018963,31,147,3,181
"18964",1018964,213,17,3,233
"18965",1018965,47,33,6,86
"18966",1018966,183,36,3,222
"18967",1018967,108,34,4,146
"18968",1018968,21,37,3,61
"18969",1018969,205,62,3,270
"18970",1018970,46,59,2,107
"18971",1018971,49,22,0,71
"18972",1018972,67,26,1,94
"18973",1018973,110,143,9,262
"18974",1018974,48,50,6,104
"18975",1018975,129,4,2,135
"18976",1018976,150,119,9,278
"18977",1018977,124,48,10,182
"18978",1018978,91,57,26,174
"18979",1018979,225,45,16,286
"18980",1018980,31,241,9,281
"18981",1018981,140,98,5,243
"18982",1018982,225,47,10,282
"18983",1018983,99,128,19,246
"18984",1018984,45,267,4,316
"18985",1018985,42,116,10,168
"18986",1018986,100,111,9,220
"18987",1018987,124,144,8,276
"18988",1018988,168,142,8,318
"18989",1018989,2,8,0,10
"18990",1018990,148,84,1,233
"18991",1018991,152,94,13,259
"18992",1018992,232,59,6,297
"18993",1018993,244,57,8,309
"18994",1018994,48,150,6,204
"18995",1018995,161,50,5,216
"18996",1018996,190,50,5,245
"18997",1018997,138,175,18,331
"18998",1018998,220,101,7,328
"18999",1018999,116,36,9,161
"19000",1019000,64,239,6,309
"19001",1019001,77,27,9,113
"19002",1019002,179,86,18,283
"19003",1019003,61,26,8,95
"19004",1019004,10,14,0,24
"19005",1019005,54,93,6,153
"19006",1019006,169,90,2,261
"19007",1019007,75,136,13,224
"19008",1019008,157,111,21,289
"19009",1019009,202,23,13,238
"19010",1019010,55,229,9,293
"19011",1019011,32,180,10,222
"19012",1019012,109,21,3,133
"19013",1019013,116,32,6,154
"19014",1019014,90,113,17,220
"19015",1019015,170,125,7,302
"19016",1019016,89,222,7,318
"19017",1019017,173,51,5,229
"19018",1019018,17,81,1,99
"19019",1019019,99,101,18,218
"19020",1019020,74,88,2,164
"19021",1019021,72,158,15,245
"19022",1019022,237,41,8,286
"19023",1019023,139,93,12,244
"19024",1019024,137,122,11,270
"19025",1019025,56,38,2,96
"19026",1019026,101,67,4,172
"19027",1019027,183,87,22,292
"19028",1019028,206,39,8,253
"19029",1019029,164,60,8,232
"19030",1019030,148,126,13,287
"19031",1019031,186,35,7,228
"19032",1019032,120,20,2,142
"19033",1019033,97,230,13,340
"19034",1019034,108,162,8,278
"19035",1019035,232,67,6,305
"19036",1019036,89,183,8,280
"19037",1019037,82,134,5,221
"19038",1019038,75,153,5,233
"19039",1019039,175,65,13,253
"19040",1019040,194,86,18,298
"19041",1019041,147,38,10,195
"19042",1019042,88,129,22,239
"19043",1019043,195,62,12,269
"19044",1019044,220,36,6,262
"19045",1019045,226,64,4,294
"19046",1019046,38,3,1,42
"19047",1019047,151,83,7,241
"19048",1019048,168,48,5,221
"19049",1019049,112,90,5,207
"19050",1019050,162,91,4,257
"19051",1019051,39,158,7,204
"19052",1019052,158,50,15,223
"19053",1019053,75,83,10,168
"19054",1019054,69,41,5,115
"19055",1019055,42,96,7,145
"19056",1019056,80,53,5,138
"19057",1019057,21,74,2,97
"19058",1019058,82,58,4,144
"19059",1019059,63,28,4,95
"19060",1019060,78,202,11,291
"19061",1019061,149,88,4,241
"19062",1019062,39,174,7,220
"19063",1019063,5,3,1,9
"19064",1019064,72,61,5,138
"19065",1019065,72,207,3,282
"19066",1019066,117,151,12,280
"19067",1019067,199,57,3,259
"19068",1019068,119,161,6,286
"19069",1019069,28,97,1,126
"19070",1019070,17,14,2,33
"19071",1019071,22,221,2,245
"19072",1019072,162,108,14,284
"19073",1019073,118,203,5,326
"19074",1019074,104,44,12,160
"19075",1019075,109,104,15,228
"19076",1019076,143,130,3,276
"19077",1019077,16,199,8,223
"19078",1019078,200,19,9,228
"19079",1019079,97,142,9,248
"19080",1019080,162,86,8,256
"19081",1019081,19,38,2,59
"19082",1019082,103,156,2,261
"19083",1019083,274,49,9,332
"19084",1019084,296,11,21,328
"19085",1019085,149,61,3,213
"19086",1019086,112,53,6,171
"19087",1019087,35,173,10,218
"19088",1019088,47,143,21,211
"19089",1019089,140,147,20,307
"19090",1019090,224,65,10,299
"19091",1019091,180,81,19,280
"19092",1019092,93,182,8,283
"19093",1019093,203,25,6,234
"19094",1019094,93,65,3,161
"19095",1019095,26,59,0,85
"19096",1019096,233,37,6,276
"19097",1019097,57,95,7,159
"19098",1019098,156,128,29,313
"19099",1019099,123,152,2,277
"19100",1019100,189,89,10,288
"19101",1019101,119,15,0,134
"19102",1019102,63,242,5,310
"19103",1019103,57,183,6,246
"19104",1019104,189,32,16,237
"19105",1019105,169,92,2,263
"19106",1019106,34,232,5,271
"19107",1019107,217,39,7,263
"19108",1019108,44,18,1,63
"19109",1019109,204,46,13,263
"19110",1019110,120,78,8,206
"19111",1019111,83,164,7,254
"19112",1019112,12,10,2,24
"19113",1019113,29,92,9,130
"19114",1019114,81,18,2,101
"19115",1019115,174,20,4,198
"19116",1019116,162,33,4,199
"19117",1019117,157,67,6,230
"19118",1019118,115,192,14,321
"19119",1019119,25,207,11,243
"19120",1019120,94,195,14,303
"19121",1019121,162,104,11,277
"19122",1019122,71,194,10,275
"19123",1019123,75,208,3,286
"19124",1019124,78,164,10,252
"19125",1019125,2,13,4,19
"19126",1019126,61,130,5,196
"19127",1019127,110,181,16,307
"19128",1019128,120,98,12,230
"19129",1019129,61,243,4,308
"19130",1019130,198,59,11,268
"19131",1019131,2,13,0,15
"19132",1019132,124,122,7,253
"19133",1019133,163,43,6,212
"19134",1019134,179,69,4,252
"19135",1019135,24,101,0,125
"19136",1019136,214,53,2,269
"19137",1019137,133,125,11,269
"19138",1019138,314,0,9,323
"19139",1019139,46,103,8,157
"19140",1019140,64,91,11,166
"19141",1019141,82,90,5,177
"19142",1019142,167,58,5,230
"19143",1019143,32,61,3,96
"19144",1019144,79,36,1,116
"19145",1019145,133,55,4,192
"19146",1019146,74,7,2,83
"19147",1019147,73,47,11,131
"19148",1019148,119,27,9,155
"19149",1019149,63,217,8,288
"19150",1019150,174,89,5,268
"19151",1019151,154,23,1,178
"19152",1019152,99,176,6,281
"19153",1019153,92,121,21,234
"19154",1019154,190,93,4,287
"19155",1019155,148,53,9,210
"19156",1019156,157,66,8,231
"19157",1019157,59,254,7,320
"19158",1019158,187,84,12,283
"19159",1019159,158,154,16,328
"19160",1019160,113,37,8,158
"19161",1019161,138,66,4,208
"19162",1019162,57,167,2,226
"19163",1019163,177,50,9,236
"19164",1019164,58,130,7,195
"19165",1019165,185,45,12,242
"19166",1019166,41,5,0,46
"19167",1019167,174,84,5,263
"19168",1019168,67,212,3,282
"19169",1019169,142,80,12,234
"19170",1019170,152,17,9,178
"19171",1019171,20,3,2,25
"19172",1019172,43,174,1,218
"19173",1019173,34,169,6,209
"19174",1019174,210,37,3,250
"19175",1019175,108,106,3,217
"19176",1019176,112,50,11,173
"19177",1019177,99,68,10,177
"19178",1019178,47,102,15,164
"19179",1019179,216,58,9,283
"19180",1019180,38,157,1,196
"19181",1019181,79,99,9,187
"19182",1019182,68,175,9,252
"19183",1019183,57,227,19,303
"19184",1019184,65,53,7,125
"19185",1019185,75,130,6,211
"19186",1019186,178,48,8,234
"19187",1019187,52,226,4,282
"19188",1019188,170,19,1,190
"19189",1019189,184,62,3,249
"19190",1019190,114,140,10,264
"19191",1019191,29,234,8,271
"19192",1019192,124,65,3,192
"19193",1019193,87,139,15,241
"19194",1019194,66,139,10,215
"19195",1019195,124,164,11,299
"19196",1019196,35,238,4,277
"19197",1019197,142,100,6,248
"19198",1019198,57,141,7,205
"19199",1019199,23,45,0,68
"19200",1019200,68,146,6,220
"19201",1019201,31,59,3,93
"19202",1019202,121,9,1,131
"19203",1019203,142,78,9,229
"19204",1019204,39,151,10,200
"19205",1019205,66,206,4,276
"19206",1019206,102,86,12,200
"19207",1019207,24,18,2,44
"19208",1019208,69,136,13,218
"19209",1019209,10,241,6,257
"19210",1019210,120,143,2,265
"19211",1019211,124,79,1,204
"19212",1019212,103,174,13,290
"19213",1019213,193,48,3,244
"19214",1019214,143,106,7,256
"19215",1019215,137,47,4,188
"19216",1019216,13,0,0,13
"19217",1019217,132,143,5,280
"19218",1019218,101,54,5,160
"19219",1019219,67,54,2,123
"19220",1019220,75,101,3,179
"19221",1019221,106,164,13,283
"19222",1019222,86,133,11,230
"19223",1019223,66,193,24,283
"19224",1019224,35,242,17,294
"19225",1019225,29,129,1,159
"19226",1019226,216,25,10,251
"19227",1019227,12,6,3,21
"19228",1019228,114,84,3,201
"19229",1019229,55,130,3,188
"19230",1019230,111,130,9,250
"19231",1019231,203,83,20,306
"19232",1019232,56,153,10,219
"19233",1019233,89,7,1,97
"19234",1019234,85,106,5,196
"19235",1019235,71,36,3,110
"19236",1019236,26,19,1,46
"19237",1019237,159,38,5,202
"19238",1019238,54,184,6,244
"19239",1019239,150,29,7,186
"19240",1019240,99,62,5,166
"19241",1019241,30,172,7,209
"19242",1019242,144,96,6,246
"19243",1019243,119,82,7,208
"19244",1019244,121,177,14,312
"19245",1019245,169,100,13,282
"19246",1019246,69,54,6,129
"19247",1019247,72,224,16,312
"19248",1019248,109,190,1,300
"19249",1019249,172,70,2,244
"19250",1019250,166,73,10,249
"19251",1019251,28,270,5,303
"19252",1019252,89,100,16,205
"19253",1019253,128,131,8,267
"19254",1019254,127,135,8,270
"19255",1019255,109,97,5,211
"19256",1019256,49,248,3,300
"19257",1019257,173,85,20,278
"19258",1019258,157,61,20,238
"19259",1019259,105,114,8,227
"19260",1019260,220,20,12,252
"19261",1019261,48,214,2,264
"19262",1019262,54,164,9,227
"19263",1019263,21,32,1,54
"19264",1019264,201,36,11,248
"19265",1019265,8,98,1,107
"19266",1019266,72,97,7,176
"19267",1019267,103,139,4,246
"19268",1019268,159,57,4,220
"19269",1019269,132,149,1,282
"19270",1019270,74,162,10,246
"19271",1019271,139,109,4,252
"19272",1019272,47,73,8,128
"19273",1019273,44,242,2,288
"19274",1019274,235,27,7,269
"19275",1019275,206,38,16,260
"19276",1019276,155,111,8,274
"19277",1019277,196,15,8,219
"19278",1019278,34,233,6,273
"19279",1019279,124,112,4,240
"19280",1019280,103,20,2,125
"19281",1019281,221,64,10,295
"19282",1019282,183,92,4,279
"19283",1019283,211,62,7,280
"19284",1019284,127,157,8,292
"19285",1019285,31,235,5,271
"19286",1019286,11,3,2,16
"19287",1019287,124,28,5,157
"19288",1019288,85,168,4,257
"19289",1019289,105,102,20,227
"19290",1019290,205,67,20,292
"19291",1019291,59,181,1,241
"19292",1019292,94,9,0,103
"19293",1019293,74,154,8,236
"19294",1019294,175,71,12,258
"19295",1019295,173,52,8,233
"19296",1019296,101,142,18,261
"19297",1019297,190,61,5,256
"19298",1019298,125,64,3,192
"19299",1019299,118,125,10,253
"19300",1019300,17,112,0,129
"19301",1019301,72,178,0,250
"19302",1019302,112,161,9,282
"19303",1019303,20,225,6,251
"19304",1019304,9,2,1,12
"19305",1019305,277,62,17,356
"19306",1019306,84,50,5,139
"19307",1019307,148,44,4,196
"19308",1019308,121,136,15,272
"19309",1019309,167,80,9,256
"19310",1019310,86,168,8,262
"19311",1019311,109,108,22,239
"19312",1019312,113,195,20,328
"19313",1019313,242,28,8,278
"19314",1019314,52,183,4,239
"19315",1019315,109,102,10,221
"19316",1019316,68,33,5,106
"19317",1019317,156,40,10,206
"19318",1019318,146,66,6,218
"19319",1019319,51,157,7,215
"19320",1019320,44,240,5,289
"19321",1019321,272,14,8,294
"19322",1019322,75,167,29,271
"19323",1019323,23,145,2,170
"19324",1019324,197,35,8,240
"19325",1019325,73,106,9,188
"19326",1019326,150,59,6,215
"19327",1019327,184,104,20,308
"19328",1019328,87,131,29,247
"19329",1019329,169,22,7,198
"19330",1019330,51,86,2,139
"19331",1019331,149,17,1,167
"19332",1019332,86,61,8,155
"19333",1019333,162,89,11,262
"19334",1019334,36,218,3,257
"19335",1019335,118,68,7,193
"19336",1019336,66,198,2,266
"19337",1019337,56,251,2,309
"19338",1019338,122,147,9,278
"19339",1019339,152,82,13,247
"19340",1019340,194,47,7,248
"19341",1019341,171,68,7,246
"19342",1019342,145,47,4,196
"19343",1019343,157,1,1,159
"19344",1019344,179,71,6,256
"19345",1019345,15,127,1,143
"19346",1019346,73,168,17,258
"19347",1019347,80,197,18,295
"19348",1019348,165,23,4,192
"19349",1019349,121,29,6,156
"19350",1019350,71,98,11,180
"19351",1019351,109,173,5,287
"19352",1019352,144,42,10,196
"19353",1019353,87,243,17,347
"19354",1019354,20,79,6,105
"19355",1019355,4,4,0,8
"19356",1019356,123,173,15,311
"19357",1019357,153,40,4,197
"19358",1019358,42,251,6,299
"19359",1019359,79,111,3,193
"19360",1019360,163,64,4,231
"19361",1019361,140,24,3,167
"19362",1019362,87,154,8,249
"19363",1019363,109,56,14,179
"19364",1019364,170,54,13,237
"19365",1019365,66,168,9,243
"19366",1019366,81,161,11,253
"19367",1019367,105,99,14,218
"19368",1019368,195,74,12,281
"19369",1019369,107,113,17,237
"19370",1019370,252,41,7,300
"19371",1019371,63,223,14,300
"19372",1019372,93,121,8,222
"19373",1019373,22,57,0,79
"19374",1019374,112,82,7,201
"19375",1019375,42,186,3,231
"19376",1019376,92,38,6,136
"19377",1019377,9,71,3,83
"19378",1019378,85,160,6,251
"19379",1019379,159,77,9,245
"19380",1019380,65,110,5,180
"19381",1019381,118,12,3,133
"19382",1019382,75,123,15,213
"19383",1019383,176,79,18,273
"19384",1019384,95,121,4,220
"19385",1019385,12,234,0,246
"19386",1019386,51,87,5,143
"19387",1019387,130,24,6,160
"19388",1019388,97,60,14,171
"19389",1019389,127,186,16,329
"19390",1019390,186,59,3,248
"19391",1019391,112,63,10,185
"19392",1019392,153,87,11,251
"19393",1019393,149,83,4,236
"19394",1019394,85,51,7,143
"19395",1019395,20,41,1,62
"19396",1019396,47,82,3,132
"19397",1019397,126,103,6,235
"19398",1019398,73,143,10,226
"19399",1019399,152,146,22,320
"19400",1019400,92,145,8,245
"19401",1019401,165,94,17,276
"19402",1019402,84,218,8,310
"19403",1019403,223,21,7,251
"19404",1019404,176,7,11,194
"19405",1019405,171,139,24,334
"19406",1019406,181,106,7,294
"19407",1019407,236,31,8,275
"19408",1019408,152,94,19,265
"19409",1019409,122,51,8,181
"19410",1019410,128,30,3,161
"19411",1019411,42,5,5,52
"19412",1019412,95,76,3,174
"19413",1019413,25,128,2,155
"19414",1019414,101,162,15,278
"19415",1019415,29,58,2,89
"19416",1019416,6,10,1,17
"19417",1019417,31,216,5,252
"19418",1019418,3,27,1,31
"19419",1019419,10,47,1,58
"19420",1019420,69,16,0,85
"19421",1019421,168,90,10,268
"19422",1019422,143,51,6,200
"19423",1019423,60,205,6,271
"19424",1019424,161,35,4,200
"19425",1019425,34,44,2,80
"19426",1019426,186,19,7,212
"19427",1019427,59,169,15,243
"19428",1019428,32,114,4,150
"19429",1019429,34,159,3,196
"19430",1019430,90,123,4,217
"19431",1019431,17,43,0,60
"19432",1019432,188,72,7,267
"19433",1019433,24,15,3,42
"19434",1019434,25,20,2,47
"19435",1019435,158,4,5,167
"19436",1019436,59,286,8,353
"19437",1019437,4,52,1,57
"19438",1019438,136,107,8,251
"19439",1019439,133,18,4,155
"19440",1019440,226,43,9,278
"19441",1019441,202,34,4,240
"19442",1019442,65,142,9,216
"19443",1019443,186,15,9,210
"19444",1019444,117,150,10,277
"19445",1019445,127,77,6,210
"19446",1019446,185,49,8,242
"19447",1019447,80,109,5,194
"19448",1019448,26,33,1,60
"19449",1019449,136,17,9,162
"19450",1019450,31,141,2,174
"19451",1019451,203,28,1,232
"19452",1019452,78,93,27,198
"19453",1019453,177,22,3,202
"19454",1019454,131,139,6,276
"19455",1019455,64,261,6,331
"19456",1019456,55,179,2,236
"19457",1019457,88,41,3,132
"19458",1019458,16,203,2,221
"19459",1019459,117,161,15,293
"19460",1019460,100,139,6,245
"19461",1019461,8,3,0,11
"19462",1019462,158,148,5,311
"19463",1019463,164,86,13,263
"19464",1019464,73,103,14,190
"19465",1019465,83,87,3,173
"19466",1019466,1,4,0,5
"19467",1019467,64,12,1,77
"19468",1019468,154,12,4,170
"19469",1019469,77,16,5,98
"19470",1019470,81,180,13,274
"19471",1019471,44,98,7,149
"19472",1019472,191,31,8,230
"19473",1019473,64,151,5,220
"19474",1019474,159,40,9,208
"19475",1019475,165,22,6,193
"19476",1019476,159,26,4,189
"19477",1019477,119,90,9,218
"19478",1019478,33,119,5,157
"19479",1019479,71,138,14,223
"19480",1019480,108,166,18,292
"19481",1019481,166,115,16,297
"19482",1019482,72,188,5,265
"19483",1019483,63,95,3,161
"19484",1019484,28,231,3,262
"19485",1019485,150,32,8,190
"19486",1019486,32,240,8,280
"19487",1019487,46,213,2,261
"19488",1019488,120,160,17,297
"19489",1019489,89,102,24,215
"19490",1019490,84,145,4,233
"19491",1019491,178,14,7,199
"19492",1019492,129,152,16,297
"19493",1019493,115,154,3,272
"19494",1019494,93,160,13,266
"19495",1019495,93,2,4,99
"19496",1019496,198,79,3,280
"19497",1019497,93,222,10,325
"19498",1019498,77,52,4,133
"19499",1019499,188,72,4,264
"19500",1019500,144,95,8,247
"19501",1019501,32,263,11,306
"19502",1019502,43,5,2,50
"19503",1019503,16,21,1,38
"19504",1019504,132,23,7,162
"19505",1019505,16,219,6,241
"19506",1019506,81,124,3,208
"19507",1019507,80,191,8,279
"19508",1019508,214,69,21,304
"19509",1019509,148,103,11,262
"19510",1019510,181,44,2,227
"19511",1019511,26,13,0,39
"19512",1019512,204,47,5,256
"19513",1019513,311,105,16,432
"19514",1019514,33,89,7,129
"19515",1019515,76,159,12,247
"19516",1019516,81,146,14,241
"19517",1019517,58,109,2,169
"19518",1019518,46,216,11,273
"19519",1019519,116,153,8,277
"19520",1019520,108,5,2,115
"19521",1019521,4,24,1,29
"19522",1019522,66,235,8,309
"19523",1019523,114,62,9,185
"19524",1019524,139,134,6,279
"19525",1019525,81,294,20,395
"19526",1019526,140,87,14,241
"19527",1019527,117,9,1,127
"19528",1019528,25,0,0,25
"19529",1019529,107,133,1,241
"19530",1019530,238,63,1,302
"19531",1019531,36,56,7,99
"19532",1019532,179,54,4,237
"19533",1019533,78,104,11,193
"19534",1019534,182,31,8,221
"19535",1019535,105,70,9,184
"19536",1019536,137,26,6,169
"19537",1019537,137,105,11,253
"19538",1019538,25,65,0,90
"19539",1019539,63,167,13,243
"19540",1019540,131,13,3,147
"19541",1019541,89,134,18,241
"19542",1019542,114,15,2,131
"19543",1019543,138,103,9,250
"19544",1019544,135,66,14,215
"19545",1019545,250,25,3,278
"19546",1019546,155,47,7,209
"19547",1019547,17,134,2,153
"19548",1019548,28,211,2,241
"19549",1019549,101,135,2,238
"19550",1019550,19,144,13,176
"19551",1019551,31,61,1,93
"19552",1019552,96,58,5,159
"19553",1019553,87,114,11,212
"19554",1019554,149,74,6,229
"19555",1019555,157,71,6,234
"19556",1019556,52,175,3,230
"19557",1019557,100,105,5,210
"19558",1019558,60,122,4,186
"19559",1019559,172,34,12,218
"19560",1019560,161,84,20,265
"19561",1019561,41,61,5,107
"19562",1019562,66,2,2,70
"19563",1019563,155,73,5,233
"19564",1019564,172,112,23,307
"19565",1019565,178,86,1,265
"19566",1019566,96,227,3,326
"19567",1019567,34,228,3,265
"19568",1019568,134,49,5,188
"19569",1019569,54,234,2,290
"19570",1019570,128,48,9,185
"19571",1019571,37,248,6,291
"19572",1019572,131,133,18,282
"19573",1019573,144,138,4,286
"19574",1019574,182,85,9,276
"19575",1019575,13,11,2,26
"19576",1019576,118,45,9,172
"19577",1019577,165,90,9,264
"19578",1019578,112,83,6,201
"19579",1019579,100,42,3,145
"19580",1019580,92,42,11,145
"19581",1019581,136,43,4,183
"19582",1019582,121,130,6,257
"19583",1019583,119,89,5,213
"19584",1019584,96,71,17,184
"19585",1019585,116,68,3,187
"19586",1019586,174,58,5,237
"19587",1019587,142,85,7,234
"19588",1019588,22,28,0,50
"19589",1019589,29,162,2,193
"19590",1019590,38,148,0,186
"19591",1019591,57,112,15,184
"19592",1019592,50,249,4,303
"19593",1019593,42,118,9,169
"19594",1019594,128,28,8,164
"19595",1019595,63,3,1,67
"19596",1019596,138,24,2,164
"19597",1019597,231,27,6,264
"19598",1019598,43,96,4,143
"19599",1019599,101,164,2,267
"19600",1019600,42,107,1,150
"19601",1019601,125,85,12,222
"19602",1019602,45,100,5,150
"19603",1019603,207,101,7,315
"19604",1019604,63,173,3,239
"19605",1019605,36,62,2,100
"19606",1019606,233,23,4,260
"19607",1019607,35,214,14,263
"19608",1019608,103,82,3,188
"19609",1019609,35,158,9,202
"19610",1019610,49,39,3,91
"19611",1019611,151,154,21,326
"19612",1019612,125,68,13,206
"19613",1019613,134,106,7,247
"19614",1019614,64,134,7,205
"19615",1019615,291,20,26,337
"19616",1019616,165,71,9,245
"19617",1019617,150,40,5,195
"19618",1019618,45,223,19,287
"19619",1019619,103,207,9,319
"19620",1019620,205,18,8,231
"19621",1019621,67,171,10,248
"19622",1019622,61,88,2,151
"19623",1019623,137,53,3,193
"19624",1019624,220,63,7,290
"19625",1019625,9,4,0,13
"19626",1019626,128,65,9,202
"19627",1019627,140,21,3,164
"19628",1019628,135,42,6,183
"19629",1019629,59,75,6,140
"19630",1019630,102,170,9,281
"19631",1019631,61,47,2,110
"19632",1019632,142,95,9,246
"19633",1019633,196,72,3,271
"19634",1019634,43,21,3,67
"19635",1019635,189,84,18,291
"19636",1019636,183,63,5,251
"19637",1019637,34,90,4,128
"19638",1019638,74,99,6,179
"19639",1019639,96,33,3,132
"19640",1019640,254,21,3,278
"19641",1019641,157,68,6,231
"19642",1019642,181,75,5,261
"19643",1019643,179,11,9,199
"19644",1019644,139,109,9,257
"19645",1019645,122,171,12,305
"19646",1019646,58,255,5,318
"19647",1019647,158,29,12,199
"19648",1019648,61,93,9,163
"19649",1019649,106,178,15,299
"19650",1019650,102,127,8,237
"19651",1019651,57,11,2,70
"19652",1019652,59,265,6,330
"19653",1019653,149,19,1,169
"19654",1019654,204,28,4,236
"19655",1019655,197,32,6,235
"19656",1019656,108,158,5,271
"19657",1019657,104,125,15,244
"19658",1019658,67,168,2,237
"19659",1019659,73,53,3,129
"19660",1019660,43,19,2,64
"19661",1019661,37,254,2,293
"19662",1019662,146,177,21,344
"19663",1019663,48,206,5,259
"19664",1019664,70,180,11,261
"19665",1019665,90,198,9,297
"19666",1019666,39,173,8,220
"19667",1019667,30,118,4,152
"19668",1019668,157,38,6,201
"19669",1019669,126,32,13,171
"19670",1019670,69,223,13,305
"19671",1019671,4,7,0,11
"19672",1019672,181,58,8,247
"19673",1019673,85,376,17,478
"19674",1019674,127,50,6,183
"19675",1019675,117,3,0,120
"19676",1019676,232,96,8,336
"19677",1019677,50,233,15,298
"19678",1019678,178,71,8,257
"19679",1019679,115,94,7,216
"19680",1019680,186,30,4,220
"19681",1019681,138,125,5,268
"19682",1019682,131,17,1,149
"19683",1019683,60,171,3,234
"19684",1019684,80,165,4,249
"19685",1019685,23,191,2,216
"19686",1019686,133,80,13,226
"19687",1019687,82,44,5,131
"19688",1019688,205,92,14,311
"19689",1019689,24,147,2,173
"19690",1019690,100,70,19,189
"19691",1019691,1,23,0,24
"19692",1019692,40,15,2,57
"19693",1019693,97,66,12,175
"19694",1019694,85,221,6,312
"19695",1019695,180,40,6,226
"19696",1019696,156,97,9,262
"19697",1019697,92,3,0,95
"19698",1019698,127,122,10,259
"19699",1019699,204,100,12,316
"19700",1019700,75,208,21,304
"19701",1019701,101,183,7,291
"19702",1019702,140,58,7,205
"19703",1019703,15,72,1,88
"19704",1019704,125,108,10,243
"19705",1019705,137,70,10,217
"19706",1019706,99,48,6,153
"19707",1019707,75,236,4,315
"19708",1019708,96,155,14,265
"19709",1019709,176,9,8,193
"19710",1019710,80,144,16,240
"19711",1019711,162,62,6,230
"19712",1019712,71,182,19,272
"19713",1019713,115,169,24,308
"19714",1019714,282,21,13,316
"19715",1019715,174,67,14,255
"19716",1019716,30,70,2,102
"19717",1019717,47,175,40,262
"19718",1019718,172,84,0,256
"19719",1019719,176,113,11,300
"19720",1019720,100,40,6,146
"19721",1019721,55,10,1,66
"19722",1019722,225,47,3,275
"19723",1019723,171,134,17,322
"19724",1019724,104,54,2,160
"19725",1019725,132,138,8,278
"19726",1019726,46,92,4,142
"19727",1019727,103,184,5,292
"19728",1019728,73,0,1,74
"19729",1019729,32,137,3,172
"19730",1019730,135,21,2,158
"19731",1019731,44,21,2,67
"19732",1019732,262,6,3,271
"19733",1019733,93,196,12,301
"19734",1019734,81,196,8,285
"19735",1019735,160,114,10,284
"19736",1019736,25,159,5,189
"19737",1019737,83,11,3,97
"19738",1019738,127,70,9,206
"19739",1019739,1,14,0,15
"19740",1019740,91,204,18,313
"19741",1019741,131,59,7,197
"19742",1019742,59,206,18,283
"19743",1019743,195,66,4,265
"19744",1019744,4,3,0,7
"19745",1019745,124,91,7,222
"19746",1019746,101,83,1,185
"19747",1019747,149,36,3,188
"19748",1019748,108,178,7,293
"19749",1019749,103,127,4,234
"19750",1019750,59,228,5,292
"19751",1019751,162,71,8,241
"19752",1019752,119,38,3,160
"19753",1019753,72,167,17,256
"19754",1019754,89,32,4,125
"19755",1019755,92,40,4,136
"19756",1019756,65,143,3,211
"19757",1019757,129,78,11,218
"19758",1019758,137,104,6,247
"19759",1019759,132,76,10,218
"19760",1019760,67,207,2,276
"19761",1019761,212,34,4,250
"19762",1019762,134,93,4,231
"19763",1019763,174,15,3,192
"19764",1019764,159,26,7,192
"19765",1019765,121,81,9,211
"19766",1019766,28,222,1,251
"19767",1019767,1,2,0,3
"19768",1019768,193,11,12,216
"19769",1019769,146,104,21,271
"19770",1019770,90,126,4,220
"19771",1019771,146,184,16,346
"19772",1019772,125,144,17,286
"19773",1019773,53,30,3,86
"19774",1019774,6,237,2,245
"19775",1019775,45,99,2,146
"19776",1019776,208,34,8,250
"19777",1019777,73,54,10,137
"19778",1019778,35,149,2,186
"19779",1019779,17,7,4,28
"19780",1019780,35,174,9,218
"19781",1019781,139,44,13,196
"19782",1019782,47,73,0,120
"19783",1019783,58,91,13,162
"19784",1019784,163,66,17,246
"19785",1019785,263,31,8,302
"19786",1019786,118,96,19,233
"19787",1019787,142,137,21,300
"19788",1019788,71,151,6,228
"19789",1019789,99,46,2,147
"19790",1019790,193,41,5,239
"19791",1019791,184,54,13,251
"19792",1019792,138,47,4,189
"19793",1019793,193,79,20,292
"19794",1019794,188,60,17,265
"19795",1019795,80,164,13,257
"19796",1019796,115,61,13,189
"19797",1019797,23,30,4,57
"19798",1019798,52,153,3,208
"19799",1019799,136,93,10,239
"19800",1019800,238,46,14,298
"19801",1019801,43,36,3,82
"19802",1019802,102,177,19,298
"19803",1019803,73,20,3,96
"19804",1019804,150,135,22,307
"19805",1019805,39,249,3,291
"19806",1019806,30,4,0,34
"19807",1019807,116,105,9,230
"19808",1019808,198,51,7,256
"19809",1019809,138,157,7,302
"19810",1019810,52,238,11,301
"19811",1019811,223,76,6,305
"19812",1019812,150,114,11,275
"19813",1019813,0,7,0,7
"19814",1019814,111,204,4,319
"19815",1019815,129,183,8,320
"19816",1019816,144,45,10,199
"19817",1019817,55,89,2,146
"19818",1019818,115,94,6,215
"19819",1019819,45,107,2,154
"19820",1019820,208,30,4,242
"19821",1019821,96,205,10,311
"19822",1019822,170,32,11,213
"19823",1019823,229,30,8,267
"19824",1019824,82,76,3,161
"19825",1019825,144,114,13,271
"19826",1019826,6,0,1,7
"19827",1019827,60,66,4,130
"19828",1019828,13,203,0,216
"19829",1019829,306,4,3,313
"19830",1019830,32,229,12,273
"19831",1019831,86,166,9,261
"19832",1019832,90,36,8,134
"19833",1019833,118,184,6,308
"19834",1019834,185,33,6,224
"19835",1019835,26,238,3,267
"19836",1019836,47,147,9,203
"19837",1019837,118,87,3,208
"19838",1019838,103,51,3,157
"19839",1019839,175,21,10,206
"19840",1019840,42,47,5,94
"19841",1019841,57,199,13,269
"19842",1019842,144,22,1,167
"19843",1019843,5,10,0,15
"19844",1019844,190,17,8,215
"19845",1019845,130,148,7,285
"19846",1019846,128,148,17,293
"19847",1019847,114,37,4,155
"19848",1019848,92,185,7,284
"19849",1019849,114,119,13,246
"19850",1019850,189,70,5,264
"19851",1019851,81,74,3,158
"19852",1019852,25,247,4,276
"19853",1019853,246,69,2,317
"19854",1019854,38,124,12,174
"19855",1019855,147,39,3,189
"19856",1019856,143,23,6,172
"19857",1019857,96,64,8,168
"19858",1019858,135,104,8,247
"19859",1019859,164,180,13,357
"19860",1019860,114,64,7,185
"19861",1019861,13,116,2,131
"19862",1019862,190,15,4,209
"19863",1019863,35,197,0,232
"19864",1019864,171,78,5,254
"19865",1019865,175,82,3,260
"19866",1019866,70,102,13,185
"19867",1019867,111,188,11,310
"19868",1019868,79,165,9,253
"19869",1019869,122,150,25,297
"19870",1019870,175,48,25,248
"19871",1019871,131,76,12,219
"19872",1019872,60,150,2,212
"19873",1019873,162,132,21,315
"19874",1019874,148,73,25,246
"19875",1019875,166,114,13,293
"19876",1019876,66,184,9,259
"19877",1019877,192,80,4,276
"19878",1019878,34,43,4,81
"19879",1019879,161,77,11,249
"19880",1019880,95,74,6,175
"19881",1019881,115,138,9,262
"19882",1019882,76,25,8,109
"19883",1019883,112,54,7,173
"19884",1019884,116,172,8,296
"19885",1019885,59,255,16,330
"19886",1019886,48,15,0,63
"19887",1019887,260,15,9,284
"19888",1019888,202,47,13,262
"19889",1019889,97,121,10,228
"19890",1019890,85,72,3,160
"19891",1019891,137,43,10,190
"19892",1019892,85,119,8,212
"19893",1019893,44,212,3,259
"19894",1019894,189,39,12,240
"19895",1019895,121,26,5,152
"19896",1019896,9,16,0,25
"19897",1019897,92,65,6,163
"19898",1019898,90,27,11,128
"19899",1019899,58,145,12,215
"19900",1019900,26,166,4,196
"19901",1019901,92,131,0,223
"19902",1019902,151,46,7,204
"19903",1019903,151,127,17,295
"19904",1019904,104,159,12,275
"19905",1019905,17,208,1,226
"19906",1019906,130,215,6,351
"19907",1019907,164,80,16,260
"19908",1019908,119,43,2,164
"19909",1019909,148,119,10,277
"19910",1019910,128,109,3,240
"19911",1019911,148,31,6,185
"19912",1019912,114,128,11,253
"19913",1019913,89,35,7,131
"19914",1019914,33,211,3,247
"19915",1019915,97,35,6,138
"19916",1019916,141,49,3,193
"19917",1019917,190,28,2,220
"19918",1019918,98,143,9,250
"19919",1019919,51,202,13,266
"19920",1019920,141,76,10,227
"19921",1019921,120,159,10,289
"19922",1019922,3,8,2,13
"19923",1019923,62,52,2,116
"19924",1019924,151,62,6,219
"19925",1019925,42,211,1,254
"19926",1019926,31,62,0,93
"19927",1019927,70,101,17,188
"19928",1019928,11,58,6,75
"19929",1019929,158,117,14,289
"19930",1019930,90,229,7,326
"19931",1019931,100,142,5,247
"19932",1019932,225,31,11,267
"19933",1019933,106,68,3,177
"19934",1019934,49,119,8,176
"19935",1019935,160,13,4,177
"19936",1019936,126,66,11,203
"19937",1019937,81,87,5,173
"19938",1019938,110,49,8,167
"19939",1019939,46,233,10,289
"19940",1019940,74,331,8,413
"19941",1019941,139,129,2,270
"19942",1019942,61,160,6,227
"19943",1019943,36,270,5,311
"19944",1019944,122,22,8,152
"19945",1019945,43,27,8,78
"19946",1019946,137,79,11,227
"19947",1019947,150,158,22,330
"19948",1019948,109,165,3,277
"19949",1019949,55,195,8,258
"19950",1019950,182,94,9,285
"19951",1019951,142,36,11,189
"19952",1019952,159,58,6,223
"19953",1019953,170,75,5,250
"19954",1019954,186,43,5,234
"19955",1019955,59,200,4,263
"19956",1019956,61,103,3,167
"19957",1019957,23,260,9,292
"19958",1019958,107,123,13,243
"19959",1019959,246,37,10,293
"19960",1019960,139,135,8,282
"19961",1019961,151,20,8,179
"19962",1019962,17,220,3,240
"19963",1019963,248,29,7,284
"19964",1019964,110,153,15,278
"19965",1019965,74,187,16,277
"19966",1019966,138,128,5,271
"19967",1019967,175,118,12,305
"19968",1019968,19,50,1,70
"19969",1019969,161,55,5,221
"19970",1019970,84,232,3,319
"19971",1019971,259,36,15,310
"19972",1019972,34,30,7,71
"19973",1019973,126,15,1,142
"19974",1019974,162,116,3,281
"19975",1019975,173,76,7,256
"19976",1019976,127,74,9,210
"19977",1019977,44,177,6,227
"19978",1019978,77,82,3,162
"19979",1019979,112,195,19,326
"19980",1019980,28,163,8,199
"19981",1019981,12,53,3,68
"19982",1019982,27,259,7,293
"19983",1019983,127,163,2,292
"19984",1019984,83,116,2,201
"19985",1019985,186,34,7,227
"19986",1019986,122,88,6,216
"19987",1019987,100,35,4,139
"19988",1019988,53,151,13,217
"19989",1019989,144,122,12,278
"19990",1019990,48,190,4,242
"19991",1019991,124,114,4,242
"19992",1019992,210,0,0,210
"19993",1019993,174,120,13,307
"19994",1019994,192,62,18,272
"19995",1019995,52,97,7,156
"19996",1019996,51,90,6,147
"19997",1019997,72,143,5,220
"19998",1019998,2,114,1,117
"19999",1019999,241,30,7,278
"20000",1020000,61,246,8,315
"20001",1020001,136,86,19,241
"20002",1020002,212,41,12,265
"20003",1020003,62,165,4,231
"20004",1020004,80,79,4,163
"20005",1020005,124,164,19,307
"20006",1020006,78,108,1,187
"20007",1020007,32,159,2,193
"20008",1020008,146,97,10,253
"20009",1020009,130,138,7,275
"20010",1020010,126,96,2,224
"20011",1020011,44,168,3,215
"20012",1020012,216,58,15,289
"20013",1020013,111,121,16,248
"20014",1020014,54,110,1,165
"20015",1020015,187,18,6,211
"20016",1020016,224,11,18,253
"20017",1020017,16,62,3,81
"20018",1020018,137,97,4,238
"20019",1020019,130,76,2,208
"20020",1020020,112,106,5,223
"20021",1020021,177,104,10,291
"20022",1020022,84,170,6,260
"20023",1020023,96,171,8,275
"20024",1020024,148,66,13,227
"20025",1020025,89,181,19,289
"20026",1020026,44,259,8,311
"20027",1020027,61,99,15,175
"20028",1020028,61,84,8,153
"20029",1020029,186,85,18,289
"20030",1020030,96,108,3,207
"20031",1020031,151,94,3,248
"20032",1020032,120,48,2,170
"20033",1020033,69,88,3,160
"20034",1020034,69,176,3,248
"20035",1020035,60,20,1,81
"20036",1020036,98,172,15,285
"20037",1020037,147,121,2,270
"20038",1020038,100,48,10,158
"20039",1020039,210,32,4,246
"20040",1020040,187,49,10,246
"20041",1020041,48,252,7,307
"20042",1020042,104,210,6,320
"20043",1020043,151,80,3,234
"20044",1020044,132,130,8,270
"20045",1020045,16,86,0,102
"20046",1020046,190,38,8,236
"20047",1020047,88,157,5,250
"20048",1020048,36,70,9,115
"20049",1020049,134,60,4,198
"20050",1020050,232,65,14,311
"20051",1020051,231,57,1,289
"20052",1020052,133,21,7,161
"20053",1020053,176,71,6,253
"20054",1020054,214,77,16,307
"20055",1020055,139,149,14,302
"20056",1020056,155,80,11,246
"20057",1020057,265,20,6,291
"20058",1020058,110,34,5,149
"20059",1020059,125,71,6,202
"20060",1020060,175,138,15,328
"20061",1020061,153,2,2,157
"20062",1020062,82,192,10,284
"20063",1020063,91,37,2,130
"20064",1020064,69,152,13,234
"20065",1020065,0,27,1,28
"20066",1020066,122,181,22,325
"20067",1020067,177,66,13,256
"20068",1020068,86,60,4,150
"20069",1020069,45,178,4,227
"20070",1020070,59,162,1,222
"20071",1020071,155,168,13,336
"20072",1020072,106,40,5,151
"20073",1020073,167,134,22,323
"20074",1020074,39,206,0,245
"20075",1020075,107,110,9,226
"20076",1020076,93,65,10,168
"20077",1020077,42,132,4,178
"20078",1020078,70,168,7,245
"20079",1020079,159,51,2,212
"20080",1020080,233,49,8,290
"20081",1020081,3,14,1,18
"20082",1020082,1,21,0,22
"20083",1020083,230,33,9,272
"20084",1020084,67,217,14,298
"20085",1020085,83,57,2,142
"20086",1020086,146,101,11,258
"20087",1020087,174,26,1,201
"20088",1020088,165,144,13,322
"20089",1020089,80,88,5,173
"20090",1020090,152,46,11,209
"20091",1020091,161,90,11,262
"20092",1020092,154,48,9,211
"20093",1020093,158,131,14,303
"20094",1020094,4,22,2,28
"20095",1020095,27,62,0,89
"20096",1020096,58,131,10,199
"20097",1020097,132,60,10,202
"20098",1020098,165,87,9,261
"20099",1020099,198,77,20,295
"20100",1020100,62,192,9,263
"20101",1020101,173,67,10,250
"20102",1020102,162,40,4,206
"20103",1020103,28,54,6,88
"20104",1020104,131,139,14,284
"20105",1020105,12,8,1,21
"20106",1020106,46,253,7,306
"20107",1020107,21,28,3,52
"20108",1020108,17,128,6,151
"20109",1020109,109,139,5,253
"20110",1020110,69,107,4,180
"20111",1020111,151,60,12,223
"20112",1020112,181,45,7,233
"20113",1020113,77,21,4,102
"20114",1020114,186,72,8,266
"20115",1020115,92,69,2,163
"20116",1020116,16,34,2,52
"20117",1020117,86,55,9,150
"20118",1020118,52,256,17,325
"20119",1020119,25,193,3,221
"20120",1020120,158,99,7,264
"20121",1020121,50,204,13,267
"20122",1020122,78,161,7,246
"20123",1020123,191,54,28,273
"20124",1020124,14,276,1,291
"20125",1020125,138,175,22,335
"20126",1020126,138,66,9,213
"20127",1020127,72,176,10,258
"20128",1020128,137,84,9,230
"20129",1020129,28,31,1,60
"20130",1020130,52,75,12,139
"20131",1020131,86,161,7,254
"20132",1020132,112,184,16,312
"20133",1020133,31,102,5,138
"20134",1020134,124,130,13,267
"20135",1020135,135,8,0,143
"20136",1020136,151,141,3,295
"20137",1020137,235,55,13,303
"20138",1020138,103,44,7,154
"20139",1020139,162,51,2,215
"20140",1020140,57,143,21,221
"20141",1020141,51,15,1,67
"20142",1020142,171,28,3,202
"20143",1020143,96,184,5,285
"20144",1020144,126,109,9,244
"20145",1020145,136,37,6,179
"20146",1020146,50,61,6,117
"20147",1020147,65,35,2,102
"20148",1020148,29,252,1,282
"20149",1020149,24,232,6,262
"20150",1020150,222,17,6,245
"20151",1020151,77,172,6,255
"20152",1020152,9,2,2,13
"20153",1020153,65,194,8,267
"20154",1020154,80,78,5,163
"20155",1020155,46,192,8,246
"20156",1020156,195,53,10,258
"20157",1020157,86,130,11,227
"20158",1020158,145,123,17,285
"20159",1020159,86,182,10,278
"20160",1020160,154,176,6,336
"20161",1020161,220,12,2,234
"20162",1020162,100,76,9,185
"20163",1020163,137,63,0,200
"20164",1020164,139,74,13,226
"20165",1020165,162,25,6,193
"20166",1020166,188,67,17,272
"20167",1020167,169,54,11,234
"20168",1020168,73,185,5,263
"20169",1020169,128,153,7,288
"20170",1020170,78,35,4,117
"20171",1020171,44,89,0,133
"20172",1020172,120,69,10,199
"20173",1020173,114,112,18,244
"20174",1020174,199,88,13,300
"20175",1020175,80,47,3,130
"20176",1020176,38,152,2,192
"20177",1020177,75,104,6,185
"20178",1020178,85,204,4,293
"20179",1020179,100,116,9,225
"20180",1020180,157,68,1,226
"20181",1020181,69,189,4,262
"20182",1020182,119,24,8,151
"20183",1020183,110,153,9,272
"20184",1020184,41,188,5,234
"20185",1020185,66,236,3,305
"20186",1020186,119,204,21,344
"20187",1020187,172,58,12,242
"20188",1020188,120,139,21,280
"20189",1020189,139,103,12,254
"20190",1020190,127,50,9,186
"20191",1020191,32,258,4,294
"20192",1020192,60,161,10,231
"20193",1020193,117,61,9,187
"20194",1020194,53,69,4,126
"20195",1020195,171,95,23,289
"20196",1020196,176,37,10,223
"20197",1020197,51,172,1,224
"20198",1020198,8,9,4,21
"20199",1020199,50,15,3,68
"20200",1020200,87,206,17,310
"20201",1020201,76,29,5,110
"20202",1020202,71,151,5,227
"20203",1020203,143,106,22,271
"20204",1020204,168,51,59,278
"20205",1020205,64,185,2,251
"20206",1020206,205,93,11,309
"20207",1020207,190,98,14,302
"20208",1020208,87,134,18,239
"20209",1020209,80,147,4,231
"20210",1020210,95,15,3,113
"20211",1020211,108,41,3,152
"20212",1020212,95,147,23,265
"20213",1020213,104,52,9,165
"20214",1020214,127,18,7,152
"20215",1020215,89,50,2,141
"20216",1020216,129,123,18,270
"20217",1020217,41,198,5,244
"20218",1020218,42,234,2,278
"20219",1020219,170,122,4,296
"20220",1020220,116,109,9,234
"20221",1020221,133,171,14,318
"20222",1020222,38,58,4,100
"20223",1020223,68,278,8,354
"20224",1020224,97,79,7,183
"20225",1020225,116,86,4,206
"20226",1020226,79,82,4,165
"20227",1020227,98,155,14,267
"20228",1020228,8,2,1,11
"20229",1020229,69,50,5,124
"20230",1020230,102,102,12,216
"20231",1020231,177,97,8,282
"20232",1020232,70,190,4,264
"20233",1020233,113,134,15,262
"20234",1020234,96,95,2,193
"20235",1020235,134,130,10,274
"20236",1020236,131,32,5,168
"20237",1020237,45,106,0,151
"20238",1020238,39,302,10,351
"20239",1020239,240,21,5,266
"20240",1020240,62,221,4,287
"20241",1020241,2,99,3,104
"20242",1020242,141,99,10,250
"20243",1020243,96,71,15,182
"20244",1020244,54,2,1,57
"20245",1020245,49,19,3,71
"20246",1020246,107,135,3,245
"20247",1020247,203,54,10,267
"20248",1020248,58,57,7,122
"20249",1020249,108,64,17,189
"20250",1020250,46,154,10,210
"20251",1020251,65,211,8,284
"20252",1020252,22,166,2,190
"20253",1020253,101,44,7,152
"20254",1020254,263,53,11,327
"20255",1020255,267,21,6,294
"20256",1020256,114,183,6,303
"20257",1020257,247,8,4,259
"20258",1020258,56,237,5,298
"20259",1020259,47,250,5,302
"20260",1020260,84,58,5,147
"20261",1020261,90,177,6,273
"20262",1020262,140,117,7,264
"20263",1020263,133,79,2,214
"20264",1020264,91,156,4,251
"20265",1020265,43,91,6,140
"20266",1020266,61,207,9,277
"20267",1020267,176,67,9,252
"20268",1020268,117,130,10,257
"20269",1020269,155,132,12,299
"20270",1020270,88,143,10,241
"20271",1020271,123,109,14,246
"20272",1020272,231,40,14,285
"20273",1020273,238,86,10,334
"20274",1020274,89,63,4,156
"20275",1020275,94,99,6,199
"20276",1020276,93,143,15,251
"20277",1020277,207,15,1,223
"20278",1020278,187,11,3,201
"20279",1020279,165,72,5,242
"20280",1020280,141,63,13,217
"20281",1020281,128,89,4,221
"20282",1020282,136,24,7,167
"20283",1020283,108,112,23,243
"20284",1020284,29,15,0,44
"20285",1020285,101,129,32,262
"20286",1020286,213,97,12,322
"20287",1020287,120,161,16,297
"20288",1020288,130,22,6,158
"20289",1020289,76,191,4,271
"20290",1020290,53,123,8,184
"20291",1020291,141,104,3,248
"20292",1020292,89,57,9,155
"20293",1020293,106,107,10,223
"20294",1020294,64,149,9,222
"20295",1020295,167,114,15,296
"20296",1020296,181,49,5,235
"20297",1020297,59,76,5,140
"20298",1020298,73,188,8,269
"20299",1020299,232,17,4,253
"20300",1020300,123,81,11,215
"20301",1020301,27,16,2,45
"20302",1020302,195,93,17,305
"20303",1020303,77,105,1,183
"20304",1020304,87,129,5,221
"20305",1020305,96,149,11,256
"20306",1020306,110,203,9,322
"20307",1020307,150,47,4,201
"20308",1020308,113,153,5,271
"20309",1020309,51,175,4,230
"20310",1020310,179,62,23,264
"20311",1020311,153,123,3,279
"20312",1020312,66,169,19,254
"20313",1020313,9,39,5,53
"20314",1020314,92,190,10,292
"20315",1020315,184,68,20,272
"20316",1020316,175,19,5,199
"20317",1020317,40,28,6,74
"20318",1020318,31,135,6,172
"20319",1020319,75,26,2,103
"20320",1020320,207,95,13,315
"20321",1020321,86,158,14,258
"20322",1020322,39,57,4,100
"20323",1020323,113,93,9,215
"20324",1020324,215,71,21,307
"20325",1020325,87,202,5,294
"20326",1020326,8,29,3,40
"20327",1020327,202,19,4,225
"20328",1020328,84,191,5,280
"20329",1020329,165,21,4,190
"20330",1020330,78,55,4,137
"20331",1020331,181,92,19,292
"20332",1020332,20,201,6,227
"20333",1020333,73,182,3,258
"20334",1020334,141,44,17,202
"20335",1020335,132,18,8,158
"20336",1020336,80,50,6,136
"20337",1020337,79,75,8,162
"20338",1020338,38,287,2,327
"20339",1020339,19,234,2,255
"20340",1020340,56,180,3,239
"20341",1020341,159,61,3,223
"20342",1020342,63,141,2,206
"20343",1020343,49,230,6,285
"20344",1020344,80,109,2,191
"20345",1020345,115,6,3,124
"20346",1020346,90,176,9,275
"20347",1020347,167,41,8,216
"20348",1020348,63,85,3,151
"20349",1020349,81,171,9,261
"20350",1020350,8,64,2,74
"20351",1020351,123,73,4,200
"20352",1020352,114,50,5,169
"20353",1020353,39,98,3,140
"20354",1020354,133,66,12,211
"20355",1020355,67,134,6,207
"20356",1020356,107,79,7,193
"20357",1020357,68,20,3,91
"20358",1020358,83,112,5,200
"20359",1020359,144,165,11,320
"20360",1020360,66,124,19,209
"20361",1020361,121,142,6,269
"20362",1020362,34,195,4,233
"20363",1020363,141,109,7,257
"20364",1020364,75,117,4,196
"20365",1020365,20,232,3,255
"20366",1020366,180,70,6,256
"20367",1020367,110,116,21,247
"20368",1020368,93,153,4,250
"20369",1020369,67,56,6,129
"20370",1020370,87,162,6,255
"20371",1020371,175,61,2,238
"20372",1020372,138,92,9,239
"20373",1020373,207,86,12,305
"20374",1020374,145,35,5,185
"20375",1020375,167,55,13,235
"20376",1020376,134,16,3,153
"20377",1020377,49,112,3,164
"20378",1020378,78,152,9,239
"20379",1020379,127,117,15,259
"20380",1020380,107,65,5,177
"20381",1020381,79,190,12,281
"20382",1020382,160,117,12,289
"20383",1020383,166,38,1,205
"20384",1020384,161,96,3,260
"20385",1020385,143,137,7,287
"20386",1020386,95,188,20,303
"20387",1020387,125,142,12,279
"20388",1020388,62,184,3,249
"20389",1020389,140,44,3,187
"20390",1020390,170,36,4,210
"20391",1020391,65,263,12,340
"20392",1020392,121,145,2,268
"20393",1020393,144,46,3,193
"20394",1020394,16,5,3,24
"20395",1020395,37,179,8,224
"20396",1020396,59,188,14,261
"20397",1020397,111,26,5,142
"20398",1020398,49,126,7,182
"20399",1020399,198,167,14,379
"20400",1020400,61,242,8,311
"20401",1020401,15,100,1,116
"20402",1020402,126,66,14,206
"20403",1020403,163,32,3,198
"20404",1020404,58,190,5,253
"20405",1020405,87,23,4,114
"20406",1020406,122,75,8,205
"20407",1020407,163,98,12,273
"20408",1020408,148,124,5,277
"20409",1020409,67,217,4,288
"20410",1020410,110,113,5,228
"20411",1020411,31,154,3,188
"20412",1020412,106,1,1,108
"20413",1020413,160,38,2,200
"20414",1020414,130,65,13,208
"20415",1020415,175,86,16,277
"20416",1020416,92,87,10,189
"20417",1020417,104,213,14,331
"20418",1020418,23,279,10,312
"20419",1020419,58,206,8,272
"20420",1020420,73,202,7,282
"20421",1020421,152,48,11,211
"20422",1020422,137,147,9,293
"20423",1020423,208,2,10,220
"20424",1020424,130,117,10,257
"20425",1020425,112,81,9,202
"20426",1020426,41,218,13,272
"20427",1020427,131,157,19,307
"20428",1020428,58,254,5,317
"20429",1020429,121,24,2,147
"20430",1020430,166,47,11,224
"20431",1020431,13,64,4,81
"20432",1020432,57,160,18,235
"20433",1020433,214,31,9,254
"20434",1020434,49,257,9,315
"20435",1020435,144,16,3,163
"20436",1020436,197,98,15,310
"20437",1020437,26,60,1,87
"20438",1020438,207,56,19,282
"20439",1020439,109,166,11,286
"20440",1020440,209,47,4,260
"20441",1020441,115,112,10,237
"20442",1020442,184,28,9,221
"20443",1020443,99,189,15,303
"20444",1020444,21,22,3,46
"20445",1020445,43,239,23,305
"20446",1020446,134,40,8,182
"20447",1020447,26,8,0,34
"20448",1020448,107,88,39,234
"20449",1020449,56,72,5,133
"20450",1020450,153,79,10,242
"20451",1020451,34,263,10,307
"20452",1020452,58,216,5,279
"20453",1020453,74,210,17,301
"20454",1020454,46,157,3,206
"20455",1020455,142,88,13,243
"20456",1020456,106,129,8,243
"20457",1020457,117,33,4,154
"20458",1020458,28,253,8,289
"20459",1020459,7,4,0,11
"20460",1020460,84,63,4,151
"20461",1020461,162,106,11,279
"20462",1020462,20,10,0,30
"20463",1020463,72,262,9,343
"20464",1020464,23,36,1,60
"20465",1020465,61,211,12,284
"20466",1020466,174,108,8,290
"20467",1020467,30,244,6,280
"20468",1020468,63,204,8,275
"20469",1020469,48,184,6,238
"20470",1020470,218,35,11,264
"20471",1020471,120,126,7,253
"20472",1020472,161,24,8,193
"20473",1020473,62,134,8,204
"20474",1020474,69,193,5,267
"20475",1020475,169,93,19,281
"20476",1020476,132,98,14,244
"20477",1020477,139,11,1,151
"20478",1020478,184,145,11,340
"20479",1020479,154,157,7,318
"20480",1020480,104,157,9,270
"20481",1020481,65,94,9,168
"20482",1020482,63,135,4,202
"20483",1020483,102,108,13,223
"20484",1020484,153,21,12,186
"20485",1020485,88,119,14,221
"20486",1020486,152,70,11,233
"20487",1020487,205,43,8,256
"20488",1020488,194,53,6,253
"20489",1020489,69,111,4,184
"20490",1020490,56,258,3,317
"20491",1020491,76,105,6,187
"20492",1020492,124,167,13,304
"20493",1020493,33,108,12,153
"20494",1020494,53,149,12,214
"20495",1020495,215,10,2,227
"20496",1020496,221,33,13,267
"20497",1020497,234,6,3,243
"20498",1020498,120,72,6,198
"20499",1020499,125,70,6,201
"20500",1020500,154,100,11,265
"20501",1020501,146,80,11,237
"20502",1020502,187,77,4,268
"20503",1020503,34,168,10,212
"20504",1020504,55,263,5,323
"20505",1020505,157,58,8,223
"20506",1020506,6,3,1,10
"20507",1020507,178,52,7,237
"20508",1020508,203,32,3,238
"20509",1020509,90,121,14,225
"20510",1020510,78,169,18,265
"20511",1020511,201,64,3,268
"20512",1020512,40,36,6,82
"20513",1020513,90,154,7,251
"20514",1020514,224,49,10,283
"20515",1020515,17,56,2,75
"20516",1020516,82,2,1,85
"20517",1020517,6,7,0,13
"20518",1020518,94,193,3,290
"20519",1020519,178,26,6,210
"20520",1020520,115,17,5,137
"20521",1020521,88,169,6,263
"20522",1020522,147,97,9,253
"20523",1020523,74,175,5,254
"20524",1020524,164,102,4,270
"20525",1020525,190,71,11,272
"20526",1020526,18,69,4,91
"20527",1020527,64,106,7,177
"20528",1020528,60,258,6,324
"20529",1020529,84,70,3,157
"20530",1020530,164,107,9,280
"20531",1020531,202,77,13,292
"20532",1020532,173,45,5,223
"20533",1020533,160,80,5,245
"20534",1020534,206,53,15,274
"20535",1020535,143,57,6,206
"20536",1020536,27,175,3,205
"20537",1020537,131,94,5,230
"20538",1020538,275,18,5,298
"20539",1020539,43,263,11,317
"20540",1020540,206,21,11,238
"20541",1020541,62,215,3,280
"20542",1020542,202,28,3,233
"20543",1020543,50,197,6,253
"20544",1020544,177,82,9,268
"20545",1020545,52,116,3,171
"20546",1020546,126,99,6,231
"20547",1020547,247,219,15,481
"20548",1020548,52,183,5,240
"20549",1020549,63,98,7,168
"20550",1020550,1,6,0,7
"20551",1020551,204,27,9,240
"20552",1020552,64,133,7,204
"20553",1020553,120,140,13,273
"20554",1020554,194,94,17,305
"20555",1020555,153,16,1,170
"20556",1020556,61,130,6,197
"20557",1020557,254,30,5,289
"20558",1020558,132,125,11,268
"20559",1020559,236,17,17,270
"20560",1020560,115,130,13,258
"20561",1020561,132,80,5,217
"20562",1020562,103,54,11,168
"20563",1020563,148,81,8,237
"20564",1020564,109,38,6,153
"20565",1020565,77,101,5,183
"20566",1020566,86,191,29,306
"20567",1020567,243,41,9,293
"20568",1020568,93,91,16,200
"20569",1020569,100,49,6,155
"20570",1020570,131,118,2,251
"20571",1020571,71,49,5,125
"20572",1020572,45,85,4,134
"20573",1020573,24,6,5,35
"20574",1020574,199,23,3,225
"20575",1020575,231,42,10,283
"20576",1020576,129,76,3,208
"20577",1020577,278,9,1,288
"20578",1020578,42,205,7,254
"20579",1020579,53,207,15,275
"20580",1020580,196,72,4,272
"20581",1020581,95,80,11,186
"20582",1020582,131,107,9,247
"20583",1020583,69,204,11,284
"20584",1020584,30,194,3,227
"20585",1020585,120,46,6,172
"20586",1020586,59,125,9,193
"20587",1020587,147,21,1,169
"20588",1020588,180,28,5,213
"20589",1020589,49,265,12,326
"20590",1020590,172,61,2,235
"20591",1020591,5,26,0,31
"20592",1020592,110,75,4,189
"20593",1020593,42,103,3,148
"20594",1020594,45,40,5,90
"20595",1020595,48,179,7,234
"20596",1020596,154,149,13,316
"20597",1020597,41,213,1,255
"20598",1020598,41,129,6,176
"20599",1020599,160,67,7,234
"20600",1020600,40,248,3,291
"20601",1020601,65,162,6,233
"20602",1020602,113,14,4,131
"20603",1020603,223,33,9,265
"20604",1020604,250,39,5,294
"20605",1020605,100,96,6,202
"20606",1020606,12,6,0,18
"20607",1020607,85,43,6,134
"20608",1020608,142,86,8,236
"20609",1020609,152,124,15,291
"20610",1020610,118,87,14,219
"20611",1020611,66,78,14,158
"20612",1020612,59,230,10,299
"20613",1020613,114,113,10,237
"20614",1020614,53,97,8,158
"20615",1020615,132,93,10,235
"20616",1020616,18,63,0,81
"20617",1020617,25,127,5,157
"20618",1020618,23,17,2,42
"20619",1020619,102,129,7,238
"20620",1020620,151,10,5,166
"20621",1020621,35,142,5,182
"20622",1020622,87,161,15,263
"20623",1020623,133,73,2,208
"20624",1020624,130,94,0,224
"20625",1020625,165,143,16,324
"20626",1020626,84,128,8,220
"20627",1020627,41,221,2,264
"20628",1020628,93,70,5,168
"20629",1020629,74,168,18,260
"20630",1020630,6,17,0,23
"20631",1020631,64,228,5,297
"20632",1020632,205,35,9,249
"20633",1020633,99,176,7,282
"20634",1020634,159,35,12,206
"20635",1020635,74,65,1,140
"20636",1020636,111,133,19,263
"20637",1020637,66,215,12,293
"20638",1020638,145,128,7,280
"20639",1020639,173,66,10,249
"20640",1020640,187,100,8,295
"20641",1020641,50,183,4,237
"20642",1020642,0,1,0,1
"20643",1020643,96,91,2,189
"20644",1020644,38,156,4,198
"20645",1020645,248,47,11,306
"20646",1020646,119,29,2,150
"20647",1020647,75,60,1,136
"20648",1020648,77,163,25,265
"20649",1020649,189,7,4,200
"20650",1020650,63,208,13,284
"20651",1020651,179,189,46,414
"20652",1020652,10,25,4,39
"20653",1020653,145,63,2,210
"20654",1020654,39,89,9,137
"20655",1020655,214,23,2,239
"20656",1020656,114,65,5,184
"20657",1020657,57,207,1,265
"20658",1020658,48,21,0,69
"20659",1020659,54,218,5,277
"20660",1020660,99,173,11,283
"20661",1020661,36,196,2,234
"20662",1020662,137,21,7,165
"20663",1020663,68,153,20,241
"20664",1020664,53,134,3,190
"20665",1020665,99,114,17,230
"20666",1020666,121,114,7,242
"20667",1020667,143,67,6,216
"20668",1020668,87,166,17,270
"20669",1020669,42,21,5,68
"20670",1020670,101,67,9,177
"20671",1020671,140,54,9,203
"20672",1020672,107,114,8,229
"20673",1020673,205,30,9,244
"20674",1020674,122,79,12,213
"20675",1020675,44,36,7,87
"20676",1020676,208,72,12,292
"20677",1020677,82,93,23,198
"20678",1020678,239,50,13,302
"20679",1020679,108,168,12,288
"20680",1020680,94,162,7,263
"20681",1020681,17,115,0,132
"20682",1020682,74,180,12,266
"20683",1020683,153,98,12,263
"20684",1020684,140,195,4,339
"20685",1020685,259,66,13,338
"20686",1020686,256,18,10,284
"20687",1020687,66,177,5,248
"20688",1020688,157,120,22,299
"20689",1020689,159,98,1,258
"20690",1020690,100,38,2,140
"20691",1020691,90,166,14,270
"20692",1020692,109,105,5,219
"20693",1020693,152,61,8,221
"20694",1020694,70,196,12,278
"20695",1020695,30,41,5,76
"20696",1020696,281,3,2,286
"20697",1020697,48,229,10,287
"20698",1020698,54,51,2,107
"20699",1020699,153,83,5,241
"20700",1020700,135,68,15,218
"20701",1020701,135,29,2,166
"20702",1020702,88,81,5,174
"20703",1020703,222,69,16,307
"20704",1020704,120,95,6,221
"20705",1020705,180,72,6,258
"20706",1020706,212,25,9,246
"20707",1020707,242,21,9,272
"20708",1020708,43,5,1,49
"20709",1020709,52,200,27,279
"20710",1020710,74,129,3,206
"20711",1020711,95,51,10,156
"20712",1020712,120,45,10,175
"20713",1020713,70,109,9,188
"20714",1020714,140,48,5,193
"20715",1020715,55,202,4,261
"20716",1020716,64,96,4,164
"20717",1020717,42,283,7,332
"20718",1020718,118,65,6,189
"20719",1020719,114,82,4,200
"20720",1020720,129,147,40,316
"20721",1020721,29,10,3,42
"20722",1020722,213,82,7,302
"20723",1020723,203,74,14,291
"20724",1020724,206,29,6,241
"20725",1020725,23,10,0,33
"20726",1020726,155,72,10,237
"20727",1020727,200,9,4,213
"20728",1020728,167,29,6,202
"20729",1020729,19,108,4,131
"20730",1020730,21,18,1,40
"20731",1020731,61,174,12,247
"20732",1020732,175,120,7,302
"20733",1020733,95,150,2,247
"20734",1020734,112,77,9,198
"20735",1020735,214,53,6,273
"20736",1020736,20,137,0,157
"20737",1020737,163,56,17,236
"20738",1020738,157,19,5,181
"20739",1020739,151,74,5,230
"20740",1020740,188,21,4,213
"20741",1020741,91,167,4,262
"20742",1020742,120,161,12,293
"20743",1020743,63,117,1,181
"20744",1020744,72,56,5,133
"20745",1020745,161,108,11,280
"20746",1020746,210,46,8,264
"20747",1020747,96,171,15,282
"20748",1020748,161,131,11,303
"20749",1020749,34,232,3,269
"20750",1020750,86,41,13,140
"20751",1020751,20,222,4,246
"20752",1020752,202,30,8,240
"20753",1020753,67,104,2,173
"20754",1020754,100,82,6,188
"20755",1020755,178,62,7,247
"20756",1020756,182,104,2,288
"20757",1020757,76,228,12,316
"20758",1020758,145,112,12,269
"20759",1020759,140,11,1,152
"20760",1020760,175,45,22,242
"20761",1020761,109,114,4,227
"20762",1020762,151,154,32,337
"20763",1020763,104,214,4,322
"20764",1020764,61,276,9,346
"20765",1020765,144,91,9,244
"20766",1020766,9,3,0,12
"20767",1020767,63,181,4,248
"20768",1020768,191,52,12,255
"20769",1020769,65,173,24,262
"20770",1020770,120,65,10,195
"20771",1020771,172,2,1,175
"20772",1020772,208,77,7,292
"20773",1020773,232,21,4,257
"20774",1020774,93,90,11,194
"20775",1020775,187,70,1,258
"20776",1020776,129,74,9,212
"20777",1020777,233,4,6,243
"20778",1020778,80,178,0,258
"20779",1020779,103,50,5,158
"20780",1020780,143,75,11,229
"20781",1020781,18,236,3,257
"20782",1020782,246,30,1,277
"20783",1020783,53,63,4,120
"20784",1020784,28,259,3,290
"20785",1020785,132,50,2,184
"20786",1020786,5,86,2,93
"20787",1020787,107,56,9,172
"20788",1020788,62,190,6,258
"20789",1020789,139,63,10,212
"20790",1020790,116,155,10,281
"20791",1020791,29,218,2,249
"20792",1020792,199,62,11,272
"20793",1020793,188,117,13,318
"20794",1020794,116,113,13,242
"20795",1020795,53,118,13,184
"20796",1020796,96,5,1,102
"20797",1020797,186,43,14,243
"20798",1020798,69,150,8,227
"20799",1020799,187,62,10,259
"20800",1020800,192,81,9,282
"20801",1020801,103,194,12,309
"20802",1020802,67,34,3,104
"20803",1020803,137,143,3,283
"20804",1020804,157,10,6,173
"20805",1020805,111,80,9,200
"20806",1020806,129,61,5,195
"20807",1020807,90,180,10,280
"20808",1020808,94,201,8,303
"20809",1020809,152,119,11,282
"20810",1020810,126,175,20,321
"20811",1020811,31,207,5,243
"20812",1020812,119,71,3,193
"20813",1020813,122,97,6,225
"20814",1020814,52,112,2,166
"20815",1020815,70,74,3,147
"20816",1020816,82,129,7,218
"20817",1020817,173,15,6,194
"20818",1020818,199,67,7,273
"20819",1020819,40,200,3,243
"20820",1020820,33,19,0,52
"20821",1020821,78,162,6,246
"20822",1020822,141,178,15,334
"20823",1020823,256,35,3,294
"20824",1020824,160,39,5,204
"20825",1020825,155,40,2,197
"20826",1020826,49,33,1,83
"20827",1020827,43,239,4,286
"20828",1020828,9,47,1,57
"20829",1020829,70,179,7,256
"20830",1020830,90,10,4,104
"20831",1020831,128,196,13,337
"20832",1020832,72,0,0,72
"20833",1020833,151,80,11,242
"20834",1020834,138,85,12,235
"20835",1020835,169,40,3,212
"20836",1020836,159,30,7,196
"20837",1020837,77,12,6,95
"20838",1020838,150,14,0,164
"20839",1020839,151,55,8,214
"20840",1020840,69,189,6,264
"20841",1020841,93,129,28,250
"20842",1020842,161,50,7,218
"20843",1020843,87,111,11,209
"20844",1020844,32,284,4,320
"20845",1020845,243,37,7,287
"20846",1020846,152,49,2,203
"20847",1020847,188,24,7,219
"20848",1020848,61,113,5,179
"20849",1020849,10,249,0,259
"20850",1020850,127,90,5,222
"20851",1020851,21,293,6,320
"20852",1020852,214,14,11,239
"20853",1020853,91,64,3,158
"20854",1020854,200,117,16,333
"20855",1020855,213,81,12,306
"20856",1020856,32,240,4,276
"20857",1020857,84,78,6,168
"20858",1020858,73,190,8,271
"20859",1020859,193,102,11,306
"20860",1020860,111,69,10,190
"20861",1020861,94,143,8,245
"20862",1020862,6,14,3,23
"20863",1020863,75,145,13,233
"20864",1020864,79,169,14,262
"20865",1020865,131,83,12,226
"20866",1020866,139,0,6,145
"20867",1020867,58,188,7,253
"20868",1020868,19,183,3,205
"20869",1020869,105,62,10,177
"20870",1020870,52,187,17,256
"20871",1020871,136,2,1,139
"20872",1020872,46,208,5,259
"20873",1020873,132,87,4,223
"20874",1020874,62,187,15,264
"20875",1020875,168,43,4,215
"20876",1020876,110,15,1,126
"20877",1020877,49,27,0,76
"20878",1020878,85,31,6,122
"20879",1020879,144,63,10,217
"20880",1020880,18,172,3,193
"20881",1020881,139,148,8,295
"20882",1020882,165,14,2,181
"20883",1020883,109,121,10,240
"20884",1020884,189,24,3,216
"20885",1020885,94,171,14,279
"20886",1020886,115,154,9,278
"20887",1020887,29,28,0,57
"20888",1020888,62,195,15,272
"20889",1020889,17,17,2,36
"20890",1020890,83,175,9,267
"20891",1020891,25,212,1,238
"20892",1020892,47,252,6,305
"20893",1020893,82,77,8,167
"20894",1020894,179,51,5,235
"20895",1020895,69,212,13,294
"20896",1020896,177,89,12,278
"20897",1020897,60,188,9,257
"20898",1020898,172,33,8,213
"20899",1020899,61,243,2,306
"20900",1020900,127,174,5,306
"20901",1020901,130,87,6,223
"20902",1020902,186,58,9,253
"20903",1020903,180,74,10,264
"20904",1020904,31,259,4,294
"20905",1020905,80,97,13,190
"20906",1020906,14,23,2,39
"20907",1020907,7,6,0,13
"20908",1020908,230,66,6,302
"20909",1020909,91,171,5,267
"20910",1020910,86,204,17,307
"20911",1020911,56,181,17,254
"20912",1020912,37,276,4,317
"20913",1020913,94,73,13,180
"20914",1020914,162,20,9,191
"20915",1020915,75,54,8,137
"20916",1020916,147,78,5,230
"20917",1020917,19,0,1,20
"20918",1020918,66,213,2,281
"20919",1020919,162,92,11,265
"20920",1020920,48,211,23,282
"20921",1020921,141,92,8,241
"20922",1020922,49,97,11,157
"20923",1020923,134,60,11,205
"20924",1020924,62,168,7,237
"20925",1020925,115,67,5,187
"20926",1020926,118,87,8,213
"20927",1020927,82,202,11,295
"20928",1020928,71,165,3,239
"20929",1020929,113,52,6,171
"20930",1020930,127,47,1,175
"20931",1020931,29,279,10,318
"20932",1020932,4,106,1,111
"20933",1020933,133,97,6,236
"20934",1020934,119,173,6,298
"20935",1020935,153,7,3,163
"20936",1020936,134,51,1,186
"20937",1020937,35,135,0,170
"20938",1020938,177,93,12,282
"20939",1020939,210,60,9,279
"20940",1020940,53,127,6,186
"20941",1020941,87,49,6,142
"20942",1020942,121,37,5,163
"20943",1020943,75,97,1,173
"20944",1020944,93,137,9,239
"20945",1020945,134,107,10,251
"20946",1020946,191,29,5,225
"20947",1020947,62,74,6,142
"20948",1020948,93,176,11,280
"20949",1020949,112,167,14,293
"20950",1020950,37,214,3,254
"20951",1020951,79,146,12,237
"20952",1020952,130,84,17,231
"20953",1020953,10,257,3,270
"20954",1020954,106,71,4,181
"20955",1020955,5,5,0,10
"20956",1020956,139,109,14,262
"20957",1020957,73,252,15,340
"20958",1020958,116,125,10,251
"20959",1020959,115,109,4,228
"20960",1020960,139,139,16,294
"20961",1020961,139,168,17,324
"20962",1020962,53,78,6,137
"20963",1020963,171,61,12,244
"20964",1020964,10,228,5,243
"20965",1020965,105,51,7,163
"20966",1020966,176,63,5,244
"20967",1020967,137,168,26,331
"20968",1020968,66,228,13,307
"20969",1020969,28,41,0,69
"20970",1020970,38,113,6,157
"20971",1020971,197,57,14,268
"20972",1020972,74,196,12,282
"20973",1020973,128,150,12,290
"20974",1020974,104,55,5,164
"20975",1020975,98,47,8,153
"20976",1020976,108,64,1,173
"20977",1020977,73,134,6,213
"20978",1020978,65,142,4,211
"20979",1020979,59,164,11,234
"20980",1020980,110,87,11,208
"20981",1020981,79,94,6,179
"20982",1020982,122,111,5,238
"20983",1020983,122,116,15,253
"20984",1020984,13,2,1,16
"20985",1020985,209,35,10,254
"20986",1020986,154,144,12,310
"20987",1020987,198,74,14,286
"20988",1020988,102,15,2,119
"20989",1020989,32,106,1,139
"20990",1020990,62,12,3,77
"20991",1020991,117,108,7,232
"20992",1020992,21,220,3,244
"20993",1020993,116,100,10,226
"20994",1020994,93,195,3,291
"20995",1020995,100,163,4,267
"20996",1020996,162,78,8,248
"20997",1020997,58,199,4,261
"20998",1020998,53,6,1,60
"20999",1020999,37,214,7,258
"21000",1021000,96,139,16,251
"21001",1021001,29,7,3,39
"21002",1021002,123,164,8,295
"21003",1021003,40,37,1,78
"21004",1021004,177,86,8,271
"21005",1021005,42,212,3,257
"21006",1021006,114,156,16,286
"21007",1021007,89,71,6,166
"21008",1021008,80,29,12,121
"21009",1021009,221,53,5,279
"21010",1021010,88,144,5,237
"21011",1021011,176,94,16,286
"21012",1021012,92,46,3,141
"21013",1021013,9,1,1,11
"21014",1021014,139,112,10,261
"21015",1021015,109,177,5,291
"21016",1021016,87,247,11,345
"21017",1021017,185,53,9,247
"21018",1021018,172,88,8,268
"21019",1021019,105,79,3,187
"21020",1021020,69,135,3,207
"21021",1021021,141,56,2,199
"21022",1021022,151,89,3,243
"21023",1021023,26,241,2,269
"21024",1021024,67,133,8,208
"21025",1021025,74,100,8,182
"21026",1021026,86,159,8,253
"21027",1021027,141,75,12,228
"21028",1021028,149,155,11,315
"21029",1021029,96,124,10,230
"21030",1021030,71,4,4,79
"21031",1021031,198,51,6,255
"21032",1021032,169,49,7,225
"21033",1021033,195,42,9,246
"21034",1021034,65,173,3,241
"21035",1021035,154,37,5,196
"21036",1021036,145,174,18,337
"21037",1021037,98,101,11,210
"21038",1021038,85,40,6,131
"21039",1021039,122,82,7,211
"21040",1021040,223,23,8,254
"21041",1021041,129,147,6,282
"21042",1021042,123,73,3,199
"21043",1021043,53,245,2,300
"21044",1021044,67,143,13,223
"21045",1021045,111,107,9,227
"21046",1021046,139,100,5,244
"21047",1021047,193,32,7,232
"21048",1021048,101,101,9,211
"21049",1021049,134,84,4,222
"21050",1021050,122,123,1,246
"21051",1021051,88,235,5,328
"21052",1021052,396,54,19,469
"21053",1021053,187,32,9,228
"21054",1021054,118,131,10,259
"21055",1021055,140,163,9,312
"21056",1021056,33,322,11,366
"21057",1021057,247,22,1,270
"21058",1021058,40,45,2,87
"21059",1021059,86,109,6,201
"21060",1021060,68,151,1,220
"21061",1021061,125,7,6,138
"21062",1021062,104,51,9,164
"21063",1021063,147,148,14,309
"21064",1021064,147,63,17,227
"21065",1021065,77,53,13,143
"21066",1021066,85,74,7,166
"21067",1021067,105,160,13,278
"21068",1021068,230,28,3,261
"21069",1021069,196,58,8,262
"21070",1021070,102,111,11,224
"21071",1021071,127,40,2,169
"21072",1021072,213,38,9,260
"21073",1021073,176,137,16,329
"21074",1021074,64,141,12,217
"21075",1021075,247,48,11,306
"21076",1021076,175,106,12,293
"21077",1021077,135,82,6,223
"21078",1021078,186,59,9,254
"21079",1021079,155,50,4,209
"21080",1021080,31,226,12,269
"21081",1021081,60,231,4,295
"21082",1021082,23,196,4,223
"21083",1021083,161,88,3,252
"21084",1021084,34,237,6,277
"21085",1021085,59,39,2,100
"21086",1021086,65,164,7,236
"21087",1021087,41,153,2,196
"21088",1021088,97,63,22,182
"21089",1021089,81,228,8,317
"21090",1021090,16,6,1,23
"21091",1021091,28,7,1,36
"21092",1021092,61,43,7,111
"21093",1021093,24,25,2,51
"21094",1021094,69,251,2,322
"21095",1021095,48,267,8,323
"21096",1021096,42,261,10,313
"21097",1021097,219,97,7,323
"21098",1021098,103,63,6,172
"21099",1021099,178,97,9,284
"21100",1021100,89,91,14,194
"21101",1021101,107,25,4,136
"21102",1021102,111,135,8,254
"21103",1021103,217,60,8,285
"21104",1021104,94,159,16,269
"21105",1021105,133,122,5,260
"21106",1021106,153,89,15,257
"21107",1021107,80,160,5,245
"21108",1021108,62,112,5,179
"21109",1021109,139,190,13,342
"21110",1021110,91,202,3,296
"21111",1021111,9,39,2,50
"21112",1021112,42,194,4,240
"21113",1021113,75,148,4,227
"21114",1021114,61,139,6,206
"21115",1021115,173,82,7,262
"21116",1021116,277,25,11,313
"21117",1021117,77,158,9,244
"21118",1021118,36,232,4,272
"21119",1021119,43,241,0,284
"21120",1021120,93,153,13,259
"21121",1021121,174,56,2,232
"21122",1021122,83,85,1,169
"21123",1021123,84,208,2,294
"21124",1021124,279,14,8,301
"21125",1021125,139,120,10,269
"21126",1021126,183,115,8,306
"21127",1021127,49,226,8,283
"21128",1021128,169,51,5,225
"21129",1021129,214,25,8,247
"21130",1021130,88,138,31,257
"21131",1021131,78,155,9,242
"21132",1021132,155,53,5,213
"21133",1021133,273,39,4,316
"21134",1021134,159,99,11,269
"21135",1021135,44,215,14,273
"21136",1021136,77,193,12,282
"21137",1021137,69,204,7,280
"21138",1021138,23,145,4,172
"21139",1021139,93,132,5,230
"21140",1021140,66,116,9,191
"21141",1021141,137,46,12,195
"21142",1021142,61,248,12,321
"21143",1021143,71,199,10,280
"21144",1021144,104,106,6,216
"21145",1021145,28,106,16,150
"21146",1021146,43,56,7,106
"21147",1021147,125,25,5,155
"21148",1021148,225,28,12,265
"21149",1021149,114,109,5,228
"21150",1021150,38,265,9,312
"21151",1021151,74,137,6,217
"21152",1021152,50,169,14,233
"21153",1021153,149,25,5,179
"21154",1021154,78,100,11,189
"21155",1021155,60,202,7,269
"21156",1021156,8,68,0,76
"21157",1021157,151,85,14,250
"21158",1021158,228,130,14,372
"21159",1021159,61,5,6,72
"21160",1021160,188,53,12,253
"21161",1021161,155,79,15,249
"21162",1021162,239,22,8,269
"21163",1021163,158,149,15,322
"21164",1021164,148,49,9,206
"21165",1021165,244,42,9,295
"21166",1021166,61,226,8,295
"21167",1021167,209,23,6,238
"21168",1021168,236,21,8,265
"21169",1021169,95,119,0,214
"21170",1021170,95,40,10,145
"21171",1021171,144,43,4,191
"21172",1021172,127,110,4,241
"21173",1021173,126,71,10,207
"21174",1021174,174,33,15,222
"21175",1021175,130,93,8,231
"21176",1021176,143,42,4,189
"21177",1021177,178,135,10,323
"21178",1021178,121,142,14,277
"21179",1021179,128,169,11,308
"21180",1021180,40,190,0,230
"21181",1021181,28,248,5,281
"21182",1021182,108,217,10,335
"21183",1021183,111,144,9,264
"21184",1021184,126,16,2,144
"21185",1021185,100,114,10,224
"21186",1021186,167,101,6,274
"21187",1021187,48,201,3,252
"21188",1021188,165,62,10,237
"21189",1021189,156,34,3,193
"21190",1021190,19,13,4,36
"21191",1021191,131,131,9,271
"21192",1021192,137,118,10,265
"21193",1021193,32,58,7,97
"21194",1021194,42,213,5,260
"21195",1021195,18,4,1,23
"21196",1021196,167,102,18,287
"21197",1021197,56,211,17,284
"21198",1021198,59,189,6,254
"21199",1021199,121,39,10,170
"21200",1021200,198,17,6,221
"21201",1021201,76,197,1,274
"21202",1021202,66,129,12,207
"21203",1021203,86,171,10,267
"21204",1021204,85,170,4,259
"21205",1021205,138,81,7,226
"21206",1021206,78,142,21,241
"21207",1021207,41,230,8,279
"21208",1021208,55,187,7,249
"21209",1021209,46,202,4,252
"21210",1021210,42,160,11,213
"21211",1021211,149,85,9,243
"21212",1021212,51,133,3,187
"21213",1021213,48,232,11,291
"21214",1021214,123,77,6,206
"21215",1021215,154,51,6,211
"21216",1021216,57,173,8,238
"21217",1021217,32,226,2,260
"21218",1021218,7,7,1,15
"21219",1021219,189,42,4,235
"21220",1021220,40,250,7,297
"21221",1021221,152,25,5,182
"21222",1021222,108,175,6,289
"21223",1021223,197,63,7,267
"21224",1021224,33,117,9,159
"21225",1021225,206,65,8,279
"21226",1021226,50,70,10,130
"21227",1021227,158,28,2,188
"21228",1021228,212,62,11,285
"21229",1021229,159,84,11,254
"21230",1021230,40,149,10,199
"21231",1021231,128,155,16,299
"21232",1021232,41,92,2,135
"21233",1021233,100,74,1,175
"21234",1021234,100,175,11,286
"21235",1021235,152,81,12,245
"21236",1021236,170,15,7,192
"21237",1021237,139,97,12,248
"21238",1021238,116,47,3,166
"21239",1021239,71,180,14,265
"21240",1021240,178,115,16,309
"21241",1021241,71,74,7,152
"21242",1021242,15,97,0,112
"21243",1021243,171,20,5,196
"21244",1021244,10,4,0,14
"21245",1021245,65,41,4,110
"21246",1021246,104,192,10,306
"21247",1021247,248,64,8,320
"21248",1021248,86,160,11,257
"21249",1021249,127,151,10,288
"21250",1021250,30,118,2,150
"21251",1021251,130,7,6,143
"21252",1021252,149,110,15,274
"21253",1021253,47,104,5,156
"21254",1021254,59,114,11,184
"21255",1021255,5,4,1,10
"21256",1021256,186,67,19,272
"21257",1021257,10,75,3,88
"21258",1021258,235,52,13,300
"21259",1021259,153,85,5,243
"21260",1021260,246,42,7,295
"21261",1021261,166,56,7,229
"21262",1021262,172,72,9,253
"21263",1021263,184,88,12,284
"21264",1021264,129,81,14,224
"21265",1021265,86,221,16,323
"21266",1021266,104,140,9,253
"21267",1021267,75,84,10,169
"21268",1021268,77,50,3,130
"21269",1021269,115,34,5,154
"21270",1021270,48,138,12,198
"21271",1021271,125,143,12,280
"21272",1021272,79,136,22,237
"21273",1021273,129,75,25,229
"21274",1021274,47,103,4,154
"21275",1021275,39,48,1,88
"21276",1021276,128,80,9,217
"21277",1021277,109,15,5,129
"21278",1021278,106,172,21,299
"21279",1021279,109,24,4,137
"21280",1021280,138,142,19,299
"21281",1021281,27,6,1,34
"21282",1021282,154,108,17,279
"21283",1021283,136,14,0,150
"21284",1021284,46,277,3,326
"21285",1021285,181,89,2,272
"21286",1021286,122,165,11,298
"21287",1021287,74,210,7,291
"21288",1021288,198,53,4,255
"21289",1021289,94,150,5,249
"21290",1021290,19,0,1,20
"21291",1021291,85,171,46,302
"21292",1021292,128,9,2,139
"21293",1021293,46,127,6,179
"21294",1021294,103,168,9,280
"21295",1021295,67,6,3,76
"21296",1021296,42,147,9,198
"21297",1021297,135,86,12,233
"21298",1021298,102,60,4,166
"21299",1021299,243,9,3,255
"21300",1021300,227,41,10,278
"21301",1021301,55,200,6,261
"21302",1021302,94,109,9,212
"21303",1021303,170,76,11,257
"21304",1021304,184,94,15,293
"21305",1021305,93,72,3,168
"21306",1021306,158,34,4,196
"21307",1021307,160,41,4,205
"21308",1021308,154,34,10,198
"21309",1021309,180,28,2,210
"21310",1021310,82,12,6,100
"21311",1021311,188,66,14,268
"21312",1021312,134,108,12,254
"21313",1021313,85,183,10,278
"21314",1021314,43,203,2,248
"21315",1021315,79,213,4,296
"21316",1021316,148,44,5,197
"21317",1021317,98,96,11,205
"21318",1021318,147,135,6,288
"21319",1021319,58,21,4,83
"21320",1021320,150,73,4,227
"21321",1021321,51,30,0,81
"21322",1021322,193,34,10,237
"21323",1021323,158,84,8,250
"21324",1021324,52,218,16,286
"21325",1021325,49,238,0,287
"21326",1021326,1,6,3,10
"21327",1021327,139,29,11,179
"21328",1021328,175,93,9,277
"21329",1021329,117,161,5,283
"21330",1021330,52,187,19,258
"21331",1021331,40,52,10,102
"21332",1021332,38,285,7,330
"21333",1021333,260,32,16,308
"21334",1021334,54,147,2,203
"21335",1021335,32,5,0,37
"21336",1021336,42,131,4,177
"21337",1021337,172,100,12,284
"21338",1021338,86,157,9,252
"21339",1021339,89,170,17,276
"21340",1021340,62,87,2,151
"21341",1021341,93,176,14,283
"21342",1021342,207,24,10,241
"21343",1021343,122,159,7,288
"21344",1021344,44,116,11,171
"21345",1021345,267,18,10,295
"21346",1021346,57,205,5,267
"21347",1021347,84,160,5,249
"21348",1021348,70,140,8,218
"21349",1021349,185,49,4,238
"21350",1021350,77,130,4,211
"21351",1021351,52,180,17,249
"21352",1021352,17,4,1,22
"21353",1021353,216,33,11,260
"21354",1021354,147,97,10,254
"21355",1021355,90,134,12,236
"21356",1021356,84,165,6,255
"21357",1021357,114,37,6,157
"21358",1021358,96,235,15,346
"21359",1021359,134,8,2,144
"21360",1021360,60,217,4,281
"21361",1021361,46,170,5,221
"21362",1021362,101,146,1,248
"21363",1021363,63,180,19,262
"21364",1021364,55,128,4,187
"21365",1021365,97,163,5,265
"21366",1021366,59,93,11,163
"21367",1021367,144,55,13,212
"21368",1021368,127,159,27,313
"21369",1021369,152,37,4,193
"21370",1021370,75,160,19,254
"21371",1021371,124,50,2,176
"21372",1021372,29,31,3,63
"21373",1021373,35,171,6,212
"21374",1021374,89,115,13,217
"21375",1021375,71,159,19,249
"21376",1021376,101,157,9,267
"21377",1021377,119,42,12,173
"21378",1021378,98,153,13,264
"21379",1021379,147,153,23,323
"21380",1021380,228,18,11,257
"21381",1021381,204,31,7,242
"21382",1021382,27,262,3,292
"21383",1021383,53,245,10,308
"21384",1021384,54,95,0,149
"21385",1021385,104,226,14,344
"21386",1021386,105,70,6,181
"21387",1021387,170,97,3,270
"21388",1021388,236,20,13,269
"21389",1021389,117,62,8,187
"21390",1021390,297,6,5,308
"21391",1021391,98,93,14,205
"21392",1021392,142,22,3,167
"21393",1021393,60,219,16,295
"21394",1021394,52,211,5,268
"21395",1021395,105,24,7,136
"21396",1021396,22,237,2,261
"21397",1021397,34,259,3,296
"21398",1021398,186,23,5,214
"21399",1021399,133,98,11,242
"21400",1021400,62,88,11,161
"21401",1021401,40,26,3,69
"21402",1021402,198,24,8,230
"21403",1021403,210,16,7,233
"21404",1021404,40,181,11,232
"21405",1021405,52,109,8,169
"21406",1021406,142,81,11,234
"21407",1021407,17,21,1,39
"21408",1021408,138,56,8,202
"21409",1021409,51,219,7,277
"21410",1021410,127,149,16,292
"21411",1021411,99,90,20,209
"21412",1021412,200,37,7,244
"21413",1021413,114,84,11,209
"21414",1021414,103,186,12,301
"21415",1021415,267,4,2,273
"21416",1021416,187,30,2,219
"21417",1021417,32,196,6,234
"21418",1021418,24,4,2,30
"21419",1021419,137,91,11,239
"21420",1021420,143,100,9,252
"21421",1021421,135,135,16,286
"21422",1021422,178,83,24,285
"21423",1021423,175,57,26,258
"21424",1021424,7,28,1,36
"21425",1021425,181,92,3,276
"21426",1021426,95,34,5,134
"21427",1021427,17,99,1,117
"21428",1021428,100,46,9,155
"21429",1021429,106,118,28,252
"21430",1021430,22,276,7,305
"21431",1021431,47,84,4,135
"21432",1021432,188,17,4,209
"21433",1021433,120,18,4,142
"21434",1021434,93,188,8,289
"21435",1021435,126,119,19,264
"21436",1021436,52,12,1,65
"21437",1021437,24,202,11,237
"21438",1021438,49,150,5,204
"21439",1021439,187,9,5,201
"21440",1021440,115,49,10,174
"21441",1021441,45,139,6,190
"21442",1021442,97,140,8,245
"21443",1021443,74,147,11,232
"21444",1021444,139,120,11,270
"21445",1021445,125,38,8,171
"21446",1021446,58,224,8,290
"21447",1021447,93,188,15,296
"21448",1021448,223,63,15,301
"21449",1021449,139,56,12,207
"21450",1021450,156,84,9,249
"21451",1021451,197,77,16,290
"21452",1021452,123,144,9,276
"21453",1021453,148,127,25,300
"21454",1021454,172,121,8,301
"21455",1021455,132,81,4,217
"21456",1021456,144,35,5,184
"21457",1021457,4,8,0,12
"21458",1021458,161,126,5,292
"21459",1021459,39,216,2,257
"21460",1021460,149,16,3,168
"21461",1021461,31,17,1,49
"21462",1021462,40,197,8,245
"21463",1021463,109,175,12,296
"21464",1021464,104,29,2,135
"21465",1021465,155,54,5,214
"21466",1021466,143,65,7,215
"21467",1021467,88,114,10,212
"21468",1021468,53,236,12,301
"21469",1021469,98,40,3,141
"21470",1021470,181,15,6,202
"21471",1021471,206,49,10,265
"21472",1021472,68,176,9,253
"21473",1021473,109,89,3,201
"21474",1021474,100,137,17,254
"21475",1021475,159,41,4,204
"21476",1021476,58,80,5,143
"21477",1021477,141,36,3,180
"21478",1021478,90,150,11,251
"21479",1021479,162,53,5,220
"21480",1021480,42,224,5,271
"21481",1021481,165,78,5,248
"21482",1021482,110,88,1,199
"21483",1021483,36,164,1,201
"21484",1021484,147,23,8,178
"21485",1021485,121,189,5,315
"21486",1021486,75,195,22,292
"21487",1021487,181,88,8,277
"21488",1021488,143,14,3,160
"21489",1021489,60,67,7,134
"21490",1021490,8,3,3,14
"21491",1021491,108,0,1,109
"21492",1021492,199,28,9,236
"21493",1021493,193,59,17,269
"21494",1021494,126,67,9,202
"21495",1021495,69,190,4,263
"21496",1021496,22,252,1,275
"21497",1021497,225,73,9,307
"21498",1021498,55,105,15,175
"21499",1021499,112,153,16,281
"21500",1021500,178,42,7,227
"21501",1021501,77,160,2,239
"21502",1021502,154,18,7,179
"21503",1021503,79,73,8,160
"21504",1021504,4,16,1,21
"21505",1021505,195,13,6,214
"21506",1021506,171,53,2,226
"21507",1021507,16,13,1,30
"21508",1021508,129,69,11,209
"21509",1021509,134,20,6,160
"21510",1021510,35,12,5,52
"21511",1021511,37,156,2,195
"21512",1021512,171,103,21,295
"21513",1021513,125,122,7,254
"21514",1021514,75,54,6,135
"21515",1021515,93,36,1,130
"21516",1021516,116,23,4,143
"21517",1021517,99,113,6,218
"21518",1021518,195,14,5,214
"21519",1021519,182,76,14,272
"21520",1021520,156,56,12,224
"21521",1021521,66,146,13,225
"21522",1021522,108,107,4,219
"21523",1021523,76,22,4,102
"21524",1021524,147,85,9,241
"21525",1021525,165,95,8,268
"21526",1021526,97,188,21,306
"21527",1021527,114,15,3,132
"21528",1021528,167,65,8,240
"21529",1021529,85,102,5,192
"21530",1021530,111,67,7,185
"21531",1021531,177,35,3,215
"21532",1021532,143,118,2,263
"21533",1021533,82,1,0,83
"21534",1021534,88,147,5,240
"21535",1021535,3,7,2,12
"21536",1021536,244,42,7,293
"21537",1021537,143,119,7,269
"21538",1021538,210,55,7,272
"21539",1021539,119,97,10,226
"21540",1021540,56,189,6,251
"21541",1021541,137,13,12,162
"21542",1021542,163,50,2,215
"21543",1021543,87,106,2,195
"21544",1021544,201,46,10,257
"21545",1021545,104,99,22,225
"21546",1021546,84,182,12,278
"21547",1021547,162,14,4,180
"21548",1021548,100,91,16,207
"21549",1021549,63,142,9,214
"21550",1021550,22,129,5,156
"21551",1021551,144,41,4,189
"21552",1021552,114,131,1,246
"21553",1021553,56,230,7,293
"21554",1021554,93,52,14,159
"21555",1021555,84,100,0,184
"21556",1021556,103,182,3,288
"21557",1021557,180,83,6,269
"21558",1021558,132,38,1,171
"21559",1021559,196,27,8,231
"21560",1021560,169,112,26,307
"21561",1021561,103,192,5,300
"21562",1021562,136,56,5,197
"21563",1021563,103,180,9,292
"21564",1021564,53,181,5,239
"21565",1021565,111,235,7,353
"21566",1021566,155,86,10,251
"21567",1021567,162,56,7,225
"21568",1021568,132,46,5,183
"21569",1021569,53,110,4,167
"21570",1021570,69,112,4,185
"21571",1021571,163,154,3,320
"21572",1021572,202,16,5,223
"21573",1021573,5,0,0,5
"21574",1021574,180,40,6,226
"21575",1021575,158,49,4,211
"21576",1021576,75,15,0,90
"21577",1021577,58,75,6,139
"21578",1021578,215,105,11,331
"21579",1021579,154,68,9,231
"21580",1021580,225,5,4,234
"21581",1021581,39,153,8,200
"21582",1021582,41,23,4,68
"21583",1021583,197,46,9,252
"21584",1021584,227,34,11,272
"21585",1021585,187,55,12,254
"21586",1021586,23,71,0,94
"21587",1021587,187,75,5,267
"21588",1021588,105,140,6,251
"21589",1021589,78,100,16,194
"21590",1021590,133,114,18,265
"21591",1021591,42,187,6,235
"21592",1021592,150,162,18,330
"21593",1021593,84,141,7,232
"21594",1021594,17,127,3,147
"21595",1021595,149,29,1,179
"21596",1021596,5,47,0,52
"21597",1021597,81,193,11,285
"21598",1021598,114,115,19,248
"21599",1021599,105,85,9,199
"21600",1021600,46,31,1,78
"21601",1021601,123,64,7,194
"21602",1021602,113,29,10,152
"21603",1021603,218,50,12,280
"21604",1021604,177,74,11,262
"21605",1021605,43,236,4,283
"21606",1021606,37,62,3,102
"21607",1021607,117,89,7,213
"21608",1021608,127,34,4,165
"21609",1021609,122,187,9,318
"21610",1021610,175,36,12,223
"21611",1021611,29,13,4,46
"21612",1021612,175,27,5,207
"21613",1021613,51,202,9,262
"21614",1021614,120,116,6,242
"21615",1021615,85,224,8,317
"21616",1021616,115,55,0,170
"21617",1021617,45,50,1,96
"21618",1021618,198,91,20,309
"21619",1021619,141,66,7,214
"21620",1021620,231,30,9,270
"21621",1021621,246,26,11,283
"21622",1021622,81,107,7,195
"21623",1021623,70,201,10,281
"21624",1021624,142,70,5,217
"21625",1021625,44,186,3,233
"21626",1021626,167,54,13,234
"21627",1021627,13,20,2,35
"21628",1021628,8,9,0,17
"21629",1021629,112,111,14,237
"21630",1021630,35,210,14,259
"21631",1021631,53,220,3,276
"21632",1021632,129,79,7,215
"21633",1021633,163,27,16,206
"21634",1021634,159,104,9,272
"21635",1021635,112,125,19,256
"21636",1021636,257,0,0,257
"21637",1021637,1,86,1,88
"21638",1021638,155,33,3,191
"21639",1021639,95,55,8,158
"21640",1021640,10,288,1,299
"21641",1021641,79,15,0,94
"21642",1021642,142,92,36,270
"21643",1021643,62,193,8,263
"21644",1021644,141,71,7,219
"21645",1021645,7,29,1,37
"21646",1021646,25,25,1,51
"21647",1021647,77,101,6,184
"21648",1021648,172,40,3,215
"21649",1021649,112,89,10,211
"21650",1021650,106,66,13,185
"21651",1021651,26,214,4,244
"21652",1021652,72,22,4,98
"21653",1021653,64,38,2,104
"21654",1021654,141,81,10,232
"21655",1021655,219,20,5,244
"21656",1021656,140,39,6,185
"21657",1021657,104,139,24,267
"21658",1021658,231,60,14,305
"21659",1021659,73,171,5,249
"21660",1021660,97,208,20,325
"21661",1021661,129,116,8,253
"21662",1021662,51,42,1,94
"21663",1021663,45,167,12,224
"21664",1021664,112,60,9,181
"21665",1021665,193,42,17,252
"21666",1021666,223,14,6,243
"21667",1021667,159,130,19,308
"21668",1021668,63,21,4,88
"21669",1021669,33,221,7,261
"21670",1021670,160,150,8,318
"21671",1021671,165,69,4,238
"21672",1021672,83,82,18,183
"21673",1021673,144,95,7,246
"21674",1021674,50,201,7,258
"21675",1021675,93,87,8,188
"21676",1021676,144,31,3,178
"21677",1021677,31,5,2,38
"21678",1021678,67,188,3,258
"21679",1021679,65,12,4,81
"21680",1021680,33,187,0,220
"21681",1021681,64,191,2,257
"21682",1021682,29,155,5,189
"21683",1021683,93,18,4,115
"21684",1021684,67,71,4,142
"21685",1021685,117,36,5,158
"21686",1021686,88,128,13,229
"21687",1021687,55,28,7,90
"21688",1021688,84,151,3,238
"21689",1021689,155,115,10,280
"21690",1021690,12,43,0,55
"21691",1021691,102,18,10,130
"21692",1021692,39,140,14,193
"21693",1021693,235,98,23,356
"21694",1021694,49,128,4,181
"21695",1021695,131,119,17,267
"21696",1021696,156,53,6,215
"21697",1021697,123,153,12,288
"21698",1021698,233,17,6,256
"21699",1021699,206,1,20,227
"21700",1021700,59,224,3,286
"21701",1021701,143,24,3,170
"21702",1021702,118,57,6,181
"21703",1021703,99,74,10,183
"21704",1021704,91,202,4,297
"21705",1021705,233,272,18,523
"21706",1021706,10,138,2,150
"21707",1021707,192,93,7,292
"21708",1021708,114,129,11,254
"21709",1021709,38,1,0,39
"21710",1021710,121,77,6,204
"21711",1021711,52,42,1,95
"21712",1021712,33,378,4,415
"21713",1021713,171,45,6,222
"21714",1021714,54,168,4,226
"21715",1021715,160,84,13,257
"21716",1021716,51,180,7,238
"21717",1021717,111,103,10,224
"21718",1021718,93,53,7,153
"21719",1021719,26,105,4,135
"21720",1021720,165,115,10,290
"21721",1021721,176,141,17,334
"21722",1021722,128,88,7,223
"21723",1021723,43,92,10,145
"21724",1021724,81,104,10,195
"21725",1021725,247,26,5,278
"21726",1021726,147,91,1,239
"21727",1021727,53,207,9,269
"21728",1021728,146,105,5,256
"21729",1021729,173,107,16,296
"21730",1021730,51,66,4,121
"21731",1021731,104,120,11,235
"21732",1021732,201,68,5,274
"21733",1021733,18,202,5,225
"21734",1021734,114,85,3,202
"21735",1021735,13,217,2,232
"21736",1021736,72,196,5,273
"21737",1021737,151,73,7,231
"21738",1021738,258,15,21,294
"21739",1021739,129,52,9,190
"21740",1021740,116,41,6,163
"21741",1021741,248,27,9,284
"21742",1021742,90,23,2,115
"21743",1021743,90,107,4,201
"21744",1021744,51,138,5,194
"21745",1021745,11,110,9,130
"21746",1021746,140,46,2,188
"21747",1021747,117,150,7,274
"21748",1021748,69,157,19,245
"21749",1021749,142,68,6,216
"21750",1021750,181,59,10,250
"21751",1021751,112,92,40,244
"21752",1021752,139,90,9,238
"21753",1021753,88,158,15,261
"21754",1021754,97,79,7,183
"21755",1021755,126,79,8,213
"21756",1021756,8,8,0,16
"21757",1021757,225,52,8,285
"21758",1021758,125,38,7,170
"21759",1021759,88,58,6,152
"21760",1021760,247,42,10,299
"21761",1021761,89,160,27,276
"21762",1021762,77,211,7,295
"21763",1021763,19,71,2,92
"21764",1021764,79,179,28,286
"21765",1021765,126,129,11,266
"21766",1021766,43,269,3,315
"21767",1021767,75,177,12,264
"21768",1021768,4,8,0,12
"21769",1021769,38,198,2,238
"21770",1021770,126,69,15,210
"21771",1021771,59,236,14,309
"21772",1021772,114,21,2,137
"21773",1021773,35,136,6,177
"21774",1021774,160,35,8,203
"21775",1021775,77,151,16,244
"21776",1021776,146,39,9,194
"21777",1021777,127,233,24,384
"21778",1021778,214,28,9,251
"21779",1021779,96,39,2,137
"21780",1021780,180,45,3,228
"21781",1021781,48,140,4,192
"21782",1021782,235,37,4,276
"21783",1021783,105,56,5,166
"21784",1021784,124,48,4,176
"21785",1021785,13,143,2,158
"21786",1021786,210,96,9,315
"21787",1021787,151,114,1,266
"21788",1021788,103,45,13,161
"21789",1021789,140,131,15,286
"21790",1021790,21,303,3,327
"21791",1021791,168,52,14,234
"21792",1021792,224,16,4,244
"21793",1021793,169,64,14,247
"21794",1021794,9,18,2,29
"21795",1021795,175,56,12,243
"21796",1021796,88,227,18,333
"21797",1021797,23,40,1,64
"21798",1021798,124,142,17,283
"21799",1021799,110,37,3,150
"21800",1021800,110,34,5,149
"21801",1021801,0,81,2,83
"21802",1021802,155,93,13,261
"21803",1021803,207,41,6,254
"21804",1021804,42,204,3,249
"21805",1021805,53,9,0,62
"21806",1021806,155,40,4,199
"21807",1021807,143,107,16,266
"21808",1021808,97,57,6,160
"21809",1021809,23,213,7,243
"21810",1021810,190,24,11,225
"21811",1021811,72,111,3,186
"21812",1021812,73,146,4,223
"21813",1021813,62,123,4,189
"21814",1021814,170,69,19,258
"21815",1021815,33,6,0,39
"21816",1021816,248,37,9,294
"21817",1021817,6,2,1,9
"21818",1021818,32,293,16,341
"21819",1021819,26,207,4,237
"21820",1021820,62,176,1,239
"21821",1021821,96,103,9,208
"21822",1021822,118,32,7,157
"21823",1021823,101,97,8,206
"21824",1021824,84,151,26,261
"21825",1021825,115,110,5,230
"21826",1021826,220,77,23,320
"21827",1021827,197,22,11,230
"21828",1021828,14,197,4,215
"21829",1021829,125,215,12,352
"21830",1021830,149,125,6,280
"21831",1021831,219,15,4,238
"21832",1021832,216,17,4,237
"21833",1021833,19,325,2,346
"21834",1021834,139,83,7,229
"21835",1021835,238,44,8,290
"21836",1021836,82,62,1,145
"21837",1021837,174,23,4,201
"21838",1021838,62,258,4,324
"21839",1021839,161,25,7,193
"21840",1021840,85,129,10,224
"21841",1021841,140,19,4,163
"21842",1021842,177,86,13,276
"21843",1021843,118,30,4,152
"21844",1021844,177,133,9,319
"21845",1021845,53,143,2,198
"21846",1021846,217,56,12,285
"21847",1021847,27,11,1,39
"21848",1021848,78,26,0,104
"21849",1021849,110,101,9,220
"21850",1021850,177,68,10,255
"21851",1021851,32,34,8,74
"21852",1021852,32,206,3,241
"21853",1021853,50,305,6,361
"21854",1021854,148,60,11,219
"21855",1021855,16,131,0,147
"21856",1021856,82,68,6,156
"21857",1021857,24,1,1,26
"21858",1021858,42,200,4,246
"21859",1021859,79,223,3,305
"21860",1021860,234,42,9,285
"21861",1021861,162,70,7,239
"21862",1021862,135,109,17,261
"21863",1021863,104,47,6,157
"21864",1021864,38,238,4,280
"21865",1021865,97,140,2,239
"21866",1021866,72,210,13,295
"21867",1021867,122,94,8,224
"21868",1021868,82,135,7,224
"21869",1021869,25,261,5,291
"21870",1021870,81,93,13,187
"21871",1021871,133,72,4,209
"21872",1021872,186,0,0,186
"21873",1021873,59,142,12,213
"21874",1021874,168,33,5,206
"21875",1021875,126,63,11,200
"21876",1021876,16,239,4,259
"21877",1021877,175,54,15,244
"21878",1021878,108,33,4,145
"21879",1021879,209,40,13,262
"21880",1021880,34,25,1,60
"21881",1021881,149,114,27,290
"21882",1021882,72,183,18,273
"21883",1021883,133,88,9,230
"21884",1021884,51,214,6,271
"21885",1021885,75,107,10,192
"21886",1021886,102,91,10,203
"21887",1021887,76,222,3,301
"21888",1021888,25,172,4,201
"21889",1021889,89,23,8,120
"21890",1021890,171,49,4,224
"21891",1021891,68,181,11,260
"21892",1021892,85,66,12,163
"21893",1021893,118,126,16,260
"21894",1021894,175,68,6,249
"21895",1021895,119,163,3,285
"21896",1021896,46,232,8,286
"21897",1021897,19,270,4,293
"21898",1021898,81,113,7,201
"21899",1021899,132,157,5,294
"21900",1021900,155,76,7,238
"21901",1021901,98,63,3,164
"21902",1021902,147,25,12,184
"21903",1021903,138,91,8,237
"21904",1021904,65,177,12,254
"21905",1021905,66,85,5,156
"21906",1021906,171,103,9,283
"21907",1021907,137,66,10,213
"21908",1021908,116,51,0,167
"21909",1021909,67,220,8,295
"21910",1021910,90,173,10,273
"21911",1021911,62,113,1,176
"21912",1021912,157,61,12,230
"21913",1021913,76,221,6,303
"21914",1021914,87,32,8,127
"21915",1021915,13,18,1,32
"21916",1021916,96,113,3,212
"21917",1021917,39,233,1,273
"21918",1021918,88,167,10,265
"21919",1021919,114,101,17,232
"21920",1021920,98,182,1,281
"21921",1021921,127,75,14,216
"21922",1021922,173,50,4,227
"21923",1021923,90,144,12,246
"21924",1021924,225,35,1,261
"21925",1021925,79,91,10,180
"21926",1021926,153,96,12,261
"21927",1021927,101,20,4,125
"21928",1021928,124,159,5,288
"21929",1021929,108,82,21,211
"21930",1021930,84,86,1,171
"21931",1021931,192,12,4,208
"21932",1021932,23,248,5,276
"21933",1021933,138,71,5,214
"21934",1021934,39,193,13,245
"21935",1021935,219,12,4,235
"21936",1021936,101,110,7,218
"21937",1021937,33,173,7,213
"21938",1021938,227,61,11,299
"21939",1021939,297,7,6,310
"21940",1021940,105,136,12,253
"21941",1021941,110,117,7,234
"21942",1021942,251,3,0,254
"21943",1021943,113,79,11,203
"21944",1021944,135,22,3,160
"21945",1021945,110,59,5,174
"21946",1021946,52,215,5,272
"21947",1021947,230,23,5,258
"21948",1021948,171,86,20,277
"21949",1021949,50,158,11,219
"21950",1021950,113,97,11,221
"21951",1021951,59,219,14,292
"21952",1021952,105,52,9,166
"21953",1021953,92,61,8,161
"21954",1021954,118,142,7,267
"21955",1021955,55,246,8,309
"21956",1021956,46,203,5,254
"21957",1021957,70,74,11,155
"21958",1021958,150,98,12,260
"21959",1021959,37,271,2,310
"21960",1021960,28,122,0,150
"21961",1021961,142,85,18,245
"21962",1021962,72,3,0,75
"21963",1021963,44,15,2,61
"21964",1021964,138,126,16,280
"21965",1021965,155,10,6,171
"21966",1021966,108,63,8,179
"21967",1021967,176,60,4,240
"21968",1021968,170,74,13,257
"21969",1021969,131,65,7,203
"21970",1021970,79,45,4,128
"21971",1021971,61,204,12,277
"21972",1021972,109,81,12,202
"21973",1021973,123,25,7,155
"21974",1021974,24,170,1,195
"21975",1021975,128,158,7,293
"21976",1021976,134,127,5,266
"21977",1021977,150,124,11,285
"21978",1021978,179,144,15,338
"21979",1021979,122,85,0,207
"21980",1021980,68,287,7,362
"21981",1021981,34,158,6,198
"21982",1021982,227,61,6,294
"21983",1021983,95,14,6,115
"21984",1021984,181,10,13,204
"21985",1021985,150,55,13,218
"21986",1021986,43,166,3,212
"21987",1021987,188,31,5,224
"21988",1021988,141,85,19,245
"21989",1021989,103,206,8,317
"21990",1021990,171,107,16,294
"21991",1021991,119,86,1,206
"21992",1021992,257,27,5,289
"21993",1021993,228,4,0,232
"21994",1021994,46,193,7,246
"21995",1021995,131,145,15,291
"21996",1021996,96,86,12,194
"21997",1021997,23,179,1,203
"21998",1021998,78,143,15,236
"21999",1021999,115,133,4,252
"22000",1022000,7,23,3,33
"22001",1022001,176,56,7,239
"22002",1022002,24,33,4,61
"22003",1022003,138,37,8,183
"22004",1022004,105,56,14,175
"22005",1022005,123,121,19,263
"22006",1022006,133,101,15,249
"22007",1022007,124,121,7,252
"22008",1022008,247,33,12,292
"22009",1022009,73,185,3,261
"22010",1022010,171,76,9,256
"22011",1022011,134,168,8,310
"22012",1022012,184,62,7,253
"22013",1022013,91,107,9,207
"22014",1022014,147,110,11,268
"22015",1022015,61,0,0,61
"22016",1022016,188,121,10,319
"22017",1022017,70,148,2,220
"22018",1022018,210,74,10,294
"22019",1022019,159,57,11,227
"22020",1022020,112,66,7,185
"22021",1022021,215,45,7,267
"22022",1022022,131,67,8,206
"22023",1022023,53,0,1,54
"22024",1022024,54,263,7,324
"22025",1022025,59,181,17,257
"22026",1022026,155,118,7,280
"22027",1022027,185,27,6,218
"22028",1022028,194,14,5,213
"22029",1022029,149,150,21,320
"22030",1022030,59,242,4,305
"22031",1022031,115,82,9,206
"22032",1022032,26,266,8,300
"22033",1022033,109,130,21,260
"22034",1022034,172,112,8,292
"22035",1022035,77,50,1,128
"22036",1022036,186,98,7,291
"22037",1022037,230,34,12,276
"22038",1022038,62,192,10,264
"22039",1022039,60,198,5,263
"22040",1022040,84,177,26,287
"22041",1022041,32,154,6,192
"22042",1022042,31,23,1,55
"22043",1022043,49,213,4,266
"22044",1022044,28,8,5,41
"22045",1022045,9,175,4,188
"22046",1022046,35,301,9,345
"22047",1022047,54,234,15,303
"22048",1022048,156,59,12,227
"22049",1022049,86,152,6,244
"22050",1022050,220,93,6,319
"22051",1022051,40,164,5,209
"22052",1022052,187,95,25,307
"22053",1022053,38,173,17,228
"22054",1022054,49,165,3,217
"22055",1022055,120,82,2,204
"22056",1022056,111,91,15,217
"22057",1022057,2,19,1,22
"22058",1022058,74,66,12,152
"22059",1022059,201,80,16,297
"22060",1022060,98,52,4,154
"22061",1022061,180,129,16,325
"22062",1022062,22,131,5,158
"22063",1022063,118,37,2,157
"22064",1022064,168,41,9,218
"22065",1022065,69,103,13,185
"22066",1022066,21,178,4,203
"22067",1022067,51,415,11,477
"22068",1022068,132,148,3,283
"22069",1022069,53,149,14,216
"22070",1022070,72,199,18,289
"22071",1022071,271,9,3,283
"22072",1022072,170,129,14,313
"22073",1022073,238,25,10,273
"22074",1022074,91,242,4,337
"22075",1022075,96,36,2,134
"22076",1022076,43,136,3,182
"22077",1022077,125,55,2,182
"22078",1022078,154,62,12,228
"22079",1022079,201,30,13,244
"22080",1022080,142,56,10,208
"22081",1022081,192,33,4,229
"22082",1022082,124,50,14,188
"22083",1022083,27,7,1,35
"22084",1022084,87,149,3,239
"22085",1022085,54,30,1,85
"22086",1022086,153,39,9,201
"22087",1022087,167,167,17,351
"22088",1022088,160,83,13,256
"22089",1022089,21,64,0,85
"22090",1022090,168,90,7,265
"22091",1022091,40,157,1,198
"22092",1022092,24,167,6,197
"22093",1022093,87,132,24,243
"22094",1022094,181,36,4,221
"22095",1022095,81,187,7,275
"22096",1022096,233,32,5,270
"22097",1022097,6,58,4,68
"22098",1022098,99,76,2,177
"22099",1022099,84,146,6,236
"22100",1022100,19,143,2,164
"22101",1022101,208,25,5,238
"22102",1022102,151,99,14,264
"22103",1022103,144,153,7,304
"22104",1022104,243,58,6,307
"22105",1022105,190,51,14,255
"22106",1022106,143,126,25,294
"22107",1022107,23,186,4,213
"22108",1022108,204,79,18,301
"22109",1022109,149,164,18,331
"22110",1022110,148,45,5,198
"22111",1022111,206,242,13,461
"22112",1022112,60,5,1,66
"22113",1022113,140,115,18,273
"22114",1022114,140,39,7,186
"22115",1022115,100,175,14,289
"22116",1022116,65,218,2,285
"22117",1022117,60,77,6,143
"22118",1022118,89,104,4,197
"22119",1022119,56,179,6,241
"22120",1022120,90,138,5,233
"22121",1022121,51,249,2,302
"22122",1022122,18,322,6,346
"22123",1022123,226,16,5,247
"22124",1022124,147,78,5,230
"22125",1022125,96,131,11,238
"22126",1022126,119,145,8,272
"22127",1022127,78,154,15,247
"22128",1022128,96,150,7,253
"22129",1022129,67,207,17,291
"22130",1022130,35,214,4,253
"22131",1022131,292,48,15,355
"22132",1022132,19,24,3,46
"22133",1022133,159,50,13,222
"22134",1022134,200,43,12,255
"22135",1022135,87,228,26,341
"22136",1022136,175,20,9,204
"22137",1022137,192,24,3,219
"22138",1022138,144,75,4,223
"22139",1022139,117,106,10,233
"22140",1022140,231,18,2,251
"22141",1022141,49,201,2,252
"22142",1022142,33,95,8,136
"22143",1022143,213,105,14,332
"22144",1022144,145,4,1,150
"22145",1022145,162,4,4,170
"22146",1022146,0,0,0,0
"22147",1022147,60,30,1,91
"22148",1022148,122,72,12,206
"22149",1022149,19,47,1,67
"22150",1022150,77,229,7,313
"22151",1022151,25,215,2,242
"22152",1022152,69,127,8,204
"22153",1022153,227,11,8,246
"22154",1022154,115,54,10,179
"22155",1022155,47,261,2,310
"22156",1022156,76,125,12,213
"22157",1022157,156,78,11,245
"22158",1022158,147,60,4,211
"22159",1022159,61,57,0,118
"22160",1022160,71,126,6,203
"22161",1022161,67,143,3,213
"22162",1022162,58,9,0,67
"22163",1022163,115,50,5,170
"22164",1022164,38,5,2,45
"22165",1022165,171,29,10,210
"22166",1022166,15,12,1,28
"22167",1022167,103,84,3,190
"22168",1022168,56,210,17,283
"22169",1022169,100,52,4,156
"22170",1022170,101,35,4,140
"22171",1022171,46,220,5,271
"22172",1022172,193,56,10,259
"22173",1022173,179,52,10,241
"22174",1022174,139,43,8,190
"22175",1022175,170,83,6,259
"22176",1022176,201,61,7,269
"22177",1022177,52,48,0,100
"22178",1022178,15,206,2,223
"22179",1022179,19,187,3,209
"22180",1022180,145,79,8,232
"22181",1022181,48,163,7,218
"22182",1022182,61,179,5,245
"22183",1022183,91,54,5,150
"22184",1022184,95,57,6,158
"22185",1022185,175,98,5,278
"22186",1022186,36,204,7,247
"22187",1022187,166,43,10,219
"22188",1022188,49,66,7,122
"22189",1022189,63,131,1,195
"22190",1022190,65,199,7,271
"22191",1022191,85,109,11,205
"22192",1022192,144,40,8,192
"22193",1022193,264,22,9,295
"22194",1022194,133,105,14,252
"22195",1022195,12,5,2,19
"22196",1022196,131,41,0,172
"22197",1022197,139,84,9,232
"22198",1022198,75,251,10,336
"22199",1022199,158,128,4,290
"22200",1022200,94,44,1,139
"22201",1022201,122,116,3,241
"22202",1022202,154,12,4,170
"22203",1022203,38,81,1,120
"22204",1022204,117,44,5,166
"22205",1022205,52,127,12,191
"22206",1022206,87,140,9,236
"22207",1022207,74,68,5,147
"22208",1022208,124,65,18,207
"22209",1022209,154,105,20,279
"22210",1022210,51,250,3,304
"22211",1022211,85,43,5,133
"22212",1022212,25,5,0,30
"22213",1022213,131,21,3,155
"22214",1022214,88,167,7,262
"22215",1022215,180,74,15,269
"22216",1022216,62,22,2,86
"22217",1022217,182,24,6,212
"22218",1022218,148,80,9,237
"22219",1022219,84,95,7,186
"22220",1022220,149,54,7,210
"22221",1022221,117,31,2,150
"22222",1022222,188,66,17,271
"22223",1022223,147,1,0,148
"22224",1022224,149,91,6,246
"22225",1022225,199,110,11,320
"22226",1022226,148,81,7,236
"22227",1022227,143,126,14,283
"22228",1022228,61,217,7,285
"22229",1022229,196,63,9,268
"22230",1022230,81,180,10,271
"22231",1022231,94,94,7,195
"22232",1022232,9,33,2,44
"22233",1022233,236,19,3,258
"22234",1022234,22,72,1,95
"22235",1022235,180,37,4,221
"22236",1022236,75,162,3,240
"22237",1022237,17,63,0,80
"22238",1022238,47,62,2,111
"22239",1022239,124,109,2,235
"22240",1022240,184,82,9,275
"22241",1022241,287,32,1,320
"22242",1022242,156,59,18,233
"22243",1022243,181,2,4,187
"22244",1022244,57,10,1,68
"22245",1022245,59,265,4,328
"22246",1022246,43,154,12,209
"22247",1022247,218,89,9,316
"22248",1022248,168,119,5,292
"22249",1022249,93,180,15,288
"22250",1022250,140,92,17,249
"22251",1022251,76,108,5,189
"22252",1022252,58,191,19,268
"22253",1022253,84,105,4,193
"22254",1022254,245,46,12,303
"22255",1022255,42,177,2,221
"22256",1022256,153,74,4,231
"22257",1022257,166,36,8,210
"22258",1022258,5,35,0,40
"22259",1022259,124,54,6,184
"22260",1022260,95,17,1,113
"22261",1022261,44,199,4,247
"22262",1022262,141,116,6,263
"22263",1022263,165,91,11,267
"22264",1022264,155,150,7,312
"22265",1022265,4,88,0,92
"22266",1022266,28,7,1,36
"22267",1022267,59,71,5,135
"22268",1022268,86,186,26,298
"22269",1022269,115,149,12,276
"22270",1022270,119,175,9,303
"22271",1022271,159,127,6,292
"22272",1022272,67,98,4,169
"22273",1022273,141,130,7,278
"22274",1022274,56,175,6,237
"22275",1022275,76,3,1,80
"22276",1022276,134,4,0,138
"22277",1022277,105,221,5,331
"22278",1022278,44,237,4,285
"22279",1022279,71,205,4,280
"22280",1022280,132,24,6,162
"22281",1022281,44,210,3,257
"22282",1022282,46,48,1,95
"22283",1022283,38,210,1,249
"22284",1022284,212,89,25,326
"22285",1022285,79,86,3,168
"22286",1022286,67,225,4,296
"22287",1022287,46,42,4,92
"22288",1022288,179,33,6,218
"22289",1022289,94,144,3,241
"22290",1022290,97,193,16,306
"22291",1022291,7,10,0,17
"22292",1022292,174,61,12,247
"22293",1022293,82,144,8,234
"22294",1022294,228,43,11,282
"22295",1022295,92,14,5,111
"22296",1022296,88,172,15,275
"22297",1022297,192,57,3,252
"22298",1022298,37,249,12,298
"22299",1022299,190,71,9,270
"22300",1022300,126,12,5,143
"22301",1022301,75,118,4,197
"22302",1022302,91,148,5,244
"22303",1022303,183,46,10,239
"22304",1022304,253,21,13,287
"22305",1022305,250,44,9,303
"22306",1022306,137,83,9,229
"22307",1022307,73,15,3,91
"22308",1022308,30,5,0,35
"22309",1022309,57,174,16,247
"22310",1022310,82,128,4,214
"22311",1022311,218,35,8,261
"22312",1022312,239,43,8,290
"22313",1022313,211,44,9,264
"22314",1022314,66,139,3,208
"22315",1022315,77,5,0,82
"22316",1022316,88,195,6,289
"22317",1022317,31,150,10,191
"22318",1022318,95,163,17,275
"22319",1022319,121,34,8,163
"22320",1022320,83,84,2,169
"22321",1022321,44,191,8,243
"22322",1022322,108,99,14,221
"22323",1022323,73,124,7,204
"22324",1022324,24,245,8,277
"22325",1022325,15,105,1,121
"22326",1022326,127,67,3,197
"22327",1022327,50,241,7,298
"22328",1022328,36,136,5,177
"22329",1022329,113,141,13,267
"22330",1022330,69,162,14,245
"22331",1022331,94,181,13,288
"22332",1022332,151,71,11,233
"22333",1022333,163,83,11,257
"22334",1022334,51,164,6,221
"22335",1022335,146,90,3,239
"22336",1022336,82,162,7,251
"22337",1022337,110,27,2,139
"22338",1022338,178,73,6,257
"22339",1022339,58,152,9,219
"22340",1022340,216,51,7,274
"22341",1022341,214,39,14,267
"22342",1022342,211,53,7,271
"22343",1022343,77,15,6,98
"22344",1022344,81,185,16,282
"22345",1022345,125,172,10,307
"22346",1022346,155,105,4,264
"22347",1022347,139,130,12,281
"22348",1022348,121,88,10,219
"22349",1022349,9,48,0,57
"22350",1022350,153,8,4,165
"22351",1022351,94,87,0,181
"22352",1022352,284,17,16,317
"22353",1022353,22,211,1,234
"22354",1022354,163,98,5,266
"22355",1022355,40,24,5,69
"22356",1022356,143,42,8,193
"22357",1022357,81,182,7,270
"22358",1022358,161,85,6,252
"22359",1022359,235,29,7,271
"22360",1022360,31,158,9,198
"22361",1022361,78,154,2,234
"22362",1022362,82,149,9,240
"22363",1022363,46,228,0,274
"22364",1022364,171,31,8,210
"22365",1022365,176,69,2,247
"22366",1022366,128,66,4,198
"22367",1022367,100,77,6,183
"22368",1022368,100,52,2,154
"22369",1022369,84,70,3,157
"22370",1022370,47,63,5,115
"22371",1022371,59,184,5,248
"22372",1022372,158,133,11,302
"22373",1022373,184,17,8,209
"22374",1022374,84,208,15,307
"22375",1022375,108,126,13,247
"22376",1022376,105,134,2,241
"22377",1022377,62,169,18,249
"22378",1022378,86,208,14,308
"22379",1022379,110,205,11,326
"22380",1022380,34,208,10,252
"22381",1022381,50,133,1,184
"22382",1022382,171,90,9,270
"22383",1022383,186,63,1,250
"22384",1022384,218,13,2,233
"22385",1022385,57,248,7,312
"22386",1022386,52,197,11,260
"22387",1022387,130,136,7,273
"22388",1022388,60,74,4,138
"22389",1022389,110,113,9,232
"22390",1022390,235,30,10,275
"22391",1022391,174,13,10,197
"22392",1022392,187,88,8,283
"22393",1022393,71,66,9,146
"22394",1022394,139,27,3,169
"22395",1022395,95,128,7,230
"22396",1022396,149,96,16,261
"22397",1022397,70,125,4,199
"22398",1022398,138,64,20,222
"22399",1022399,73,188,6,267
"22400",1022400,35,46,8,89
"22401",1022401,111,190,7,308
"22402",1022402,216,11,10,237
"22403",1022403,84,58,4,146
"22404",1022404,238,59,9,306
"22405",1022405,220,97,28,345
"22406",1022406,90,153,10,253
"22407",1022407,67,112,10,189
"22408",1022408,28,282,9,319
"22409",1022409,159,13,4,176
"22410",1022410,9,7,0,16
"22411",1022411,177,31,6,214
"22412",1022412,145,106,8,259
"22413",1022413,7,81,0,88
"22414",1022414,148,34,2,184
"22415",1022415,119,78,17,214
"22416",1022416,211,42,9,262
"22417",1022417,87,157,10,254
"22418",1022418,140,64,9,213
"22419",1022419,178,95,5,278
"22420",1022420,193,91,22,306
"22421",1022421,20,41,4,65
"22422",1022422,82,165,15,262
"22423",1022423,150,21,10,181
"22424",1022424,106,45,5,156
"22425",1022425,22,244,0,266
"22426",1022426,109,81,16,206
"22427",1022427,184,92,12,288
"22428",1022428,184,92,14,290
"22429",1022429,84,96,3,183
"22430",1022430,40,9,4,53
"22431",1022431,117,157,17,291
"22432",1022432,148,45,8,201
"22433",1022433,47,100,12,159
"22434",1022434,113,186,10,309
"22435",1022435,203,29,11,243
"22436",1022436,71,221,8,300
"22437",1022437,53,66,6,125
"22438",1022438,98,79,15,192
"22439",1022439,201,15,8,224
"22440",1022440,165,5,0,170
"22441",1022441,156,98,7,261
"22442",1022442,166,12,8,186
"22443",1022443,76,78,5,159
"22444",1022444,160,68,3,231
"22445",1022445,30,256,3,289
"22446",1022446,111,46,6,163
"22447",1022447,101,120,14,235
"22448",1022448,194,49,8,251
"22449",1022449,39,118,7,164
"22450",1022450,136,56,8,200
"22451",1022451,58,139,6,203
"22452",1022452,177,82,6,265
"22453",1022453,176,29,6,211
"22454",1022454,18,1,3,22
"22455",1022455,89,171,2,262
"22456",1022456,43,201,2,246
"22457",1022457,134,70,4,208
"22458",1022458,46,241,3,290
"22459",1022459,95,168,5,268
"22460",1022460,25,206,3,234
"22461",1022461,12,132,2,146
"22462",1022462,90,71,6,167
"22463",1022463,113,68,9,190
"22464",1022464,76,177,12,265
"22465",1022465,69,264,3,336
"22466",1022466,9,10,0,19
"22467",1022467,141,91,19,251
"22468",1022468,35,4,1,40
"22469",1022469,178,137,22,337
"22470",1022470,68,165,6,239
"22471",1022471,125,160,9,294
"22472",1022472,143,114,14,271
"22473",1022473,86,178,8,272
"22474",1022474,90,112,7,209
"22475",1022475,225,59,7,291
"22476",1022476,45,165,1,211
"22477",1022477,67,253,4,324
"22478",1022478,49,205,4,258
"22479",1022479,21,155,6,182
"22480",1022480,152,77,10,239
"22481",1022481,34,172,6,212
"22482",1022482,20,291,3,314
"22483",1022483,113,113,12,238
"22484",1022484,151,99,16,266
"22485",1022485,112,171,5,288
"22486",1022486,164,100,14,278
"22487",1022487,71,100,2,173
"22488",1022488,207,40,13,260
"22489",1022489,23,99,1,123
"22490",1022490,76,29,6,111
"22491",1022491,82,27,2,111
"22492",1022492,99,44,5,148
"22493",1022493,13,2,2,17
"22494",1022494,92,39,6,137
"22495",1022495,166,95,9,270
"22496",1022496,85,54,6,145
"22497",1022497,142,75,10,227
"22498",1022498,169,27,10,206
"22499",1022499,78,152,15,245
"22500",1022500,242,35,5,282
"22501",1022501,89,146,7,242
"22502",1022502,174,49,8,231
"22503",1022503,156,70,11,237
"22504",1022504,102,92,4,198
"22505",1022505,40,245,17,302
"22506",1022506,172,23,11,206
"22507",1022507,118,37,6,161
"22508",1022508,142,113,11,266
"22509",1022509,183,59,9,251
"22510",1022510,82,76,7,165
"22511",1022511,52,21,4,77
"22512",1022512,152,95,9,256
"22513",1022513,98,170,10,278
"22514",1022514,188,64,20,272
"22515",1022515,82,190,23,295
"22516",1022516,101,59,3,163
"22517",1022517,105,64,5,174
"22518",1022518,121,178,10,309
"22519",1022519,23,36,1,60
"22520",1022520,57,216,19,292
"22521",1022521,48,60,5,113
"22522",1022522,15,157,3,175
"22523",1022523,91,57,10,158
"22524",1022524,53,209,4,266
"22525",1022525,40,262,5,307
"22526",1022526,52,224,4,280
"22527",1022527,111,166,11,288
"22528",1022528,121,133,8,262
"22529",1022529,38,63,1,102
"22530",1022530,138,87,7,232
"22531",1022531,76,177,7,260
"22532",1022532,95,269,3,367
"22533",1022533,150,30,15,195
"22534",1022534,93,178,13,284
"22535",1022535,76,48,5,129
"22536",1022536,150,94,10,254
"22537",1022537,73,191,11,275
"22538",1022538,46,11,2,59
"22539",1022539,95,38,7,140
"22540",1022540,58,24,1,83
"22541",1022541,86,167,14,267
"22542",1022542,38,156,25,219
"22543",1022543,187,45,11,243
"22544",1022544,169,57,10,236
"22545",1022545,64,108,13,185
"22546",1022546,84,50,7,141
"22547",1022547,74,118,11,203
"22548",1022548,131,150,7,288
"22549",1022549,155,93,9,257
"22550",1022550,149,37,1,187
"22551",1022551,184,68,6,258
"22552",1022552,170,16,5,191
"22553",1022553,143,75,5,223
"22554",1022554,91,1,0,92
"22555",1022555,143,112,13,268
"22556",1022556,158,51,6,215
"22557",1022557,165,57,18,240
"22558",1022558,146,72,5,223
"22559",1022559,80,209,4,293
"22560",1022560,149,98,6,253
"22561",1022561,45,235,4,284
"22562",1022562,129,110,15,254
"22563",1022563,73,184,8,265
"22564",1022564,100,92,5,197
"22565",1022565,201,75,5,281
"22566",1022566,159,105,9,273
"22567",1022567,91,168,5,264
"22568",1022568,102,83,7,192
"22569",1022569,93,215,4,312
"22570",1022570,39,221,1,261
"22571",1022571,40,154,2,196
"22572",1022572,118,33,5,156
"22573",1022573,32,215,5,252
"22574",1022574,51,212,4,267
"22575",1022575,169,15,6,190
"22576",1022576,63,215,12,290
"22577",1022577,40,11,0,51
"22578",1022578,58,129,8,195
"22579",1022579,8,43,0,51
"22580",1022580,112,93,8,213
"22581",1022581,111,142,10,263
"22582",1022582,202,38,13,253
"22583",1022583,71,173,19,263
"22584",1022584,47,216,4,267
"22585",1022585,161,140,20,321
"22586",1022586,27,39,0,66
"22587",1022587,52,183,6,241
"22588",1022588,100,102,2,204
"22589",1022589,93,86,11,190
"22590",1022590,22,87,8,117
"22591",1022591,153,15,4,172
"22592",1022592,100,75,6,181
"22593",1022593,257,33,13,303
"22594",1022594,75,175,5,255
"22595",1022595,167,137,16,320
"22596",1022596,121,109,14,244
"22597",1022597,113,22,3,138
"22598",1022598,154,198,19,371
"22599",1022599,163,75,11,249
"22600",1022600,174,97,4,275
"22601",1022601,27,270,6,303
"22602",1022602,82,116,6,204
"22603",1022603,128,165,16,309
"22604",1022604,156,87,10,253
"22605",1022605,111,29,6,146
"22606",1022606,178,110,14,302
"22607",1022607,49,260,8,317
"22608",1022608,79,230,8,317
"22609",1022609,72,188,9,269
"22610",1022610,128,48,9,185
"22611",1022611,161,58,6,225
"22612",1022612,12,4,0,16
"22613",1022613,27,25,1,53
"22614",1022614,100,80,13,193
"22615",1022615,37,159,8,204
"22616",1022616,50,100,1,151
"22617",1022617,136,63,10,209
"22618",1022618,210,44,12,266
"22619",1022619,195,57,15,267
"22620",1022620,61,92,5,158
"22621",1022621,21,122,2,145
"22622",1022622,97,179,7,283
"22623",1022623,10,19,2,31
"22624",1022624,179,23,3,205
"22625",1022625,49,201,1,251
"22626",1022626,129,14,1,144
"22627",1022627,120,146,14,280
"22628",1022628,83,163,5,251
"22629",1022629,90,164,9,263
"22630",1022630,29,62,2,93
"22631",1022631,168,26,3,197
"22632",1022632,50,164,1,215
"22633",1022633,88,18,6,112
"22634",1022634,10,164,3,177
"22635",1022635,233,26,13,272
"22636",1022636,75,189,13,277
"22637",1022637,25,109,2,136
"22638",1022638,70,92,3,165
"22639",1022639,215,42,6,263
"22640",1022640,149,65,5,219
"22641",1022641,98,84,11,193
"22642",1022642,20,6,0,26
"22643",1022643,94,70,6,170
"22644",1022644,32,35,6,73
"22645",1022645,136,105,7,248
"22646",1022646,26,214,3,243
"22647",1022647,126,118,9,253
"22648",1022648,42,209,5,256
"22649",1022649,105,8,1,114
"22650",1022650,145,143,16,304
"22651",1022651,5,2,0,7
"22652",1022652,95,70,9,174
"22653",1022653,59,93,4,156
"22654",1022654,93,99,7,199
"22655",1022655,140,30,16,186
"22656",1022656,100,156,10,266
"22657",1022657,133,48,4,185
"22658",1022658,120,43,9,172
"22659",1022659,83,147,6,236
"22660",1022660,150,137,15,302
"22661",1022661,63,249,9,321
"22662",1022662,158,129,13,300
"22663",1022663,192,19,1,212
"22664",1022664,63,171,7,241
"22665",1022665,136,9,2,147
"22666",1022666,95,17,3,115
"22667",1022667,61,420,12,493
"22668",1022668,121,137,6,264
"22669",1022669,162,74,16,252
"22670",1022670,146,118,11,275
"22671",1022671,40,284,4,328
"22672",1022672,105,126,25,256
"22673",1022673,137,97,17,251
"22674",1022674,139,60,3,202
"22675",1022675,119,184,16,319
"22676",1022676,95,225,6,326
"22677",1022677,53,269,3,325
"22678",1022678,54,185,0,239
"22679",1022679,14,5,1,20
"22680",1022680,4,3,2,9
"22681",1022681,124,169,7,300
"22682",1022682,102,42,5,149
"22683",1022683,73,265,19,357
"22684",1022684,36,204,9,249
"22685",1022685,134,224,10,368
"22686",1022686,114,120,19,253
"22687",1022687,161,70,6,237
"22688",1022688,163,98,6,267
"22689",1022689,68,198,11,277
"22690",1022690,213,29,8,250
"22691",1022691,69,167,16,252
"22692",1022692,150,43,2,195
"22693",1022693,235,43,22,300
"22694",1022694,5,3,3,11
"22695",1022695,202,74,13,289
"22696",1022696,101,47,7,155
"22697",1022697,140,97,12,249
"22698",1022698,84,122,2,208
"22699",1022699,86,8,3,97
"22700",1022700,113,79,9,201
"22701",1022701,36,222,3,261
"22702",1022702,141,83,5,229
"22703",1022703,25,213,14,252
"22704",1022704,21,5,0,26
"22705",1022705,20,26,1,47
"22706",1022706,118,144,26,288
"22707",1022707,226,27,7,260
"22708",1022708,20,195,12,227
"22709",1022709,100,218,12,330
"22710",1022710,116,80,6,202
"22711",1022711,69,195,11,275
"22712",1022712,120,107,23,250
"22713",1022713,62,124,5,191
"22714",1022714,176,66,8,250
"22715",1022715,72,209,6,287
"22716",1022716,35,33,6,74
"22717",1022717,166,78,8,252
"22718",1022718,111,122,3,236
"22719",1022719,105,103,10,218
"22720",1022720,52,223,2,277
"22721",1022721,182,132,16,330
"22722",1022722,116,89,16,221
"22723",1022723,208,2,0,210
"22724",1022724,70,117,11,198
"22725",1022725,93,157,8,258
"22726",1022726,104,61,8,173
"22727",1022727,72,130,9,211
"22728",1022728,55,52,10,117
"22729",1022729,82,71,2,155
"22730",1022730,284,15,7,306
"22731",1022731,126,19,5,150
"22732",1022732,88,239,11,338
"22733",1022733,21,233,0,254
"22734",1022734,168,25,3,196
"22735",1022735,150,124,15,289
"22736",1022736,14,317,8,339
"22737",1022737,129,10,3,142
"22738",1022738,117,100,8,225
"22739",1022739,182,51,2,235
"22740",1022740,116,50,1,167
"22741",1022741,246,38,1,285
"22742",1022742,91,76,15,182
"22743",1022743,64,50,7,121
"22744",1022744,94,135,9,238
"22745",1022745,135,0,0,135
"22746",1022746,181,54,10,245
"22747",1022747,58,168,4,230
"22748",1022748,129,23,5,157
"22749",1022749,65,77,8,150
"22750",1022750,120,169,10,299
"22751",1022751,189,36,13,238
"22752",1022752,145,127,17,289
"22753",1022753,86,199,19,304
"22754",1022754,74,167,1,242
"22755",1022755,35,219,2,256
"22756",1022756,5,16,1,22
"22757",1022757,11,9,1,21
"22758",1022758,2,4,0,6
"22759",1022759,122,179,25,326
"22760",1022760,169,75,4,248
"22761",1022761,93,80,10,183
"22762",1022762,69,114,5,188
"22763",1022763,181,48,8,237
"22764",1022764,119,139,10,268
"22765",1022765,14,221,2,237
"22766",1022766,71,194,10,275
"22767",1022767,84,156,11,251
"22768",1022768,200,52,9,261
"22769",1022769,108,105,10,223
"22770",1022770,185,73,8,266
"22771",1022771,84,177,5,266
"22772",1022772,90,52,2,144
"22773",1022773,159,81,10,250
"22774",1022774,201,16,4,221
"22775",1022775,76,30,2,108
"22776",1022776,171,72,14,257
"22777",1022777,123,66,5,194
"22778",1022778,92,194,5,291
"22779",1022779,266,69,3,338
"22780",1022780,90,193,16,299
"22781",1022781,77,133,0,210
"22782",1022782,240,27,4,271
"22783",1022783,99,17,6,122
"22784",1022784,107,142,4,253
"22785",1022785,4,5,0,9
"22786",1022786,73,164,6,243
"22787",1022787,56,106,11,173
"22788",1022788,211,34,5,250
"22789",1022789,23,277,3,303
"22790",1022790,181,70,16,267
"22791",1022791,105,55,5,165
"22792",1022792,39,53,3,95
"22793",1022793,208,50,4,262
"22794",1022794,76,196,7,279
"22795",1022795,157,60,14,231
"22796",1022796,49,150,19,218
"22797",1022797,157,19,1,177
"22798",1022798,147,176,10,333
"22799",1022799,151,72,6,229
"22800",1022800,57,265,3,325
"22801",1022801,102,189,1,292
"22802",1022802,231,29,3,263
"22803",1022803,89,91,6,186
"22804",1022804,128,72,5,205
"22805",1022805,149,79,6,234
"22806",1022806,138,49,1,188
"22807",1022807,71,144,3,218
"22808",1022808,175,74,14,263
"22809",1022809,241,42,11,294
"22810",1022810,47,261,1,309
"22811",1022811,108,61,8,177
"22812",1022812,79,89,4,172
"22813",1022813,31,217,12,260
"22814",1022814,272,44,11,327
"22815",1022815,19,114,8,141
"22816",1022816,167,48,5,220
"22817",1022817,249,26,13,288
"22818",1022818,165,140,26,331
"22819",1022819,34,15,3,52
"22820",1022820,140,50,6,196
"22821",1022821,13,77,1,91
"22822",1022822,25,243,15,283
"22823",1022823,131,64,12,207
"22824",1022824,116,115,8,239
"22825",1022825,171,33,4,208
"22826",1022826,178,122,14,314
"22827",1022827,134,107,6,247
"22828",1022828,62,87,3,152
"22829",1022829,42,85,3,130
"22830",1022830,36,273,5,314
"22831",1022831,36,263,13,312
"22832",1022832,95,185,8,288
"22833",1022833,16,210,2,228
"22834",1022834,93,214,9,316
"22835",1022835,212,61,13,286
"22836",1022836,204,60,0,264
"22837",1022837,96,174,10,280
"22838",1022838,5,1,1,7
"22839",1022839,136,134,9,279
"22840",1022840,208,75,14,297
"22841",1022841,59,77,3,139
"22842",1022842,107,184,13,304
"22843",1022843,120,93,6,219
"22844",1022844,85,216,18,319
"22845",1022845,161,19,1,181
"22846",1022846,3,1,0,4
"22847",1022847,90,57,6,153
"22848",1022848,36,249,4,289
"22849",1022849,174,32,5,211
"22850",1022850,112,49,9,170
"22851",1022851,136,115,9,260
"22852",1022852,139,64,12,215
"22853",1022853,33,181,8,222
"22854",1022854,136,39,4,179
"22855",1022855,164,73,15,252
"22856",1022856,18,235,9,262
"22857",1022857,302,10,14,326
"22858",1022858,81,15,10,106
"22859",1022859,92,100,9,201
"22860",1022860,35,150,1,186
"22861",1022861,128,43,2,173
"22862",1022862,76,189,13,278
"22863",1022863,70,103,2,175
"22864",1022864,46,214,5,265
"22865",1022865,67,87,3,157
"22866",1022866,216,49,10,275
"22867",1022867,189,29,4,222
"22868",1022868,25,42,3,70
"22869",1022869,43,210,5,258
"22870",1022870,119,75,5,199
"22871",1022871,149,34,7,190
"22872",1022872,73,126,8,207
"22873",1022873,161,58,9,228
"22874",1022874,175,107,22,304
"22875",1022875,87,141,2,230
"22876",1022876,87,168,13,268
"22877",1022877,171,47,1,219
"22878",1022878,56,67,2,125
"22879",1022879,73,35,6,114
"22880",1022880,181,27,9,217
"22881",1022881,52,7,2,61
"22882",1022882,54,226,10,290
"22883",1022883,49,173,5,227
"22884",1022884,174,96,14,284
"22885",1022885,109,111,7,227
"22886",1022886,35,202,6,243
"22887",1022887,171,73,4,248
"22888",1022888,195,26,10,231
"22889",1022889,161,103,16,280
"22890",1022890,115,135,7,257
"22891",1022891,112,154,10,276
"22892",1022892,192,55,7,254
"22893",1022893,128,24,5,157
"22894",1022894,64,107,7,178
"22895",1022895,58,40,7,105
"22896",1022896,53,245,15,313
"22897",1022897,156,49,8,213
"22898",1022898,25,248,5,278
"22899",1022899,148,51,3,202
"22900",1022900,199,21,6,226
"22901",1022901,134,55,1,190
"22902",1022902,142,86,11,239
"22903",1022903,46,182,10,238
"22904",1022904,115,161,11,287
"22905",1022905,20,24,3,47
"22906",1022906,74,141,3,218
"22907",1022907,224,27,4,255
"22908",1022908,88,98,0,186
"22909",1022909,186,1,0,187
"22910",1022910,140,48,8,196
"22911",1022911,98,59,4,161
"22912",1022912,86,122,21,229
"22913",1022913,102,26,4,132
"22914",1022914,85,18,5,108
"22915",1022915,122,186,6,314
"22916",1022916,85,111,2,198
"22917",1022917,54,109,2,165
"22918",1022918,84,55,3,142
"22919",1022919,72,134,8,214
"22920",1022920,116,99,14,229
"22921",1022921,107,83,4,194
"22922",1022922,139,119,4,262
"22923",1022923,80,177,16,273
"22924",1022924,57,149,4,210
"22925",1022925,89,41,13,143
"22926",1022926,158,19,2,179
"22927",1022927,60,110,7,177
"22928",1022928,217,64,11,292
"22929",1022929,37,199,1,237
"22930",1022930,164,58,6,228
"22931",1022931,211,54,11,276
"22932",1022932,62,94,4,160
"22933",1022933,202,28,4,234
"22934",1022934,140,12,2,154
"22935",1022935,32,49,5,86
"22936",1022936,182,50,11,243
"22937",1022937,183,18,5,206
"22938",1022938,181,30,2,213
"22939",1022939,122,103,10,235
"22940",1022940,154,152,6,312
"22941",1022941,28,18,0,46
"22942",1022942,3,4,0,7
"22943",1022943,140,29,12,181
"22944",1022944,203,12,4,219
"22945",1022945,78,160,9,247
"22946",1022946,50,187,19,256
"22947",1022947,74,148,27,249
"22948",1022948,142,147,12,301
"22949",1022949,110,98,3,211
"22950",1022950,140,32,8,180
"22951",1022951,43,51,11,105
"22952",1022952,36,193,4,233
"22953",1022953,187,31,9,227
"22954",1022954,146,28,4,178
"22955",1022955,37,178,1,216
"22956",1022956,96,86,6,188
"22957",1022957,154,77,11,242
"22958",1022958,68,267,11,346
"22959",1022959,182,52,19,253
"22960",1022960,143,43,5,191
"22961",1022961,144,74,0,218
"22962",1022962,93,126,12,231
"22963",1022963,50,75,4,129
"22964",1022964,24,131,0,155
"22965",1022965,119,95,4,218
"22966",1022966,194,20,5,219
"22967",1022967,132,62,3,197
"22968",1022968,37,287,2,326
"22969",1022969,19,92,1,112
"22970",1022970,133,144,7,284
"22971",1022971,256,16,11,283
"22972",1022972,74,95,9,178
"22973",1022973,88,93,14,195
"22974",1022974,70,155,1,226
"22975",1022975,200,47,8,255
"22976",1022976,61,163,11,235
"22977",1022977,68,203,24,295
"22978",1022978,67,142,10,219
"22979",1022979,68,198,14,280
"22980",1022980,216,52,12,280
"22981",1022981,134,135,26,295
"22982",1022982,152,165,9,326
"22983",1022983,124,45,4,173
"22984",1022984,62,172,3,237
"22985",1022985,99,161,12,272
"22986",1022986,130,57,10,197
"22987",1022987,156,88,0,244
"22988",1022988,80,218,9,307
"22989",1022989,98,177,13,288
"22990",1022990,173,66,10,249
"22991",1022991,42,67,7,116
"22992",1022992,149,24,12,185
"22993",1022993,77,21,12,110
"22994",1022994,209,50,12,271
"22995",1022995,41,16,1,58
"22996",1022996,90,29,7,126
"22997",1022997,96,70,7,173
"22998",1022998,21,7,0,28
"22999",1022999,53,143,17,213
"23000",1023000,55,227,4,286
"23001",1023001,90,197,18,305
"23002",1023002,131,44,4,179
"23003",1023003,76,128,4,208
"23004",1023004,30,185,4,219
"23005",1023005,5,92,3,100
"23006",1023006,206,117,18,341
"23007",1023007,85,4,1,90
"23008",1023008,35,137,5,177
"23009",1023009,78,143,14,235
"23010",1023010,95,172,19,286
"23011",1023011,184,46,14,244
"23012",1023012,65,91,6,162
"23013",1023013,213,21,6,240
"23014",1023014,169,137,8,314
"23015",1023015,123,22,3,148
"23016",1023016,180,15,8,203
"23017",1023017,144,117,6,267
"23018",1023018,72,183,8,263
"23019",1023019,130,105,7,242
"23020",1023020,30,73,0,103
"23021",1023021,78,164,16,258
"23022",1023022,130,47,1,178
"23023",1023023,177,109,12,298
"23024",1023024,143,46,8,197
"23025",1023025,144,120,7,271
"23026",1023026,94,193,17,304
"23027",1023027,91,153,21,265
"23028",1023028,34,288,6,328
"23029",1023029,69,138,8,215
"23030",1023030,59,101,3,163
"23031",1023031,103,62,13,178
"23032",1023032,44,58,5,107
"23033",1023033,135,141,6,282
"23034",1023034,85,99,19,203
"23035",1023035,119,161,5,285
"23036",1023036,113,58,12,183
"23037",1023037,40,185,1,226
"23038",1023038,97,89,0,186
"23039",1023039,65,30,1,96
"23040",1023040,196,32,9,237
"23041",1023041,79,52,10,141
"23042",1023042,107,47,15,169
"23043",1023043,220,47,18,285
"23044",1023044,98,137,4,239
"23045",1023045,102,108,9,219
"23046",1023046,255,27,8,290
"23047",1023047,110,98,12,220
"23048",1023048,172,89,8,269
"23049",1023049,182,80,8,270
"23050",1023050,70,83,17,170
"23051",1023051,115,168,11,294
"23052",1023052,80,210,7,297
"23053",1023053,150,93,14,257
"23054",1023054,156,73,8,237
"23055",1023055,43,244,8,295
"23056",1023056,194,121,15,330
"23057",1023057,118,112,12,242
"23058",1023058,36,59,6,101
"23059",1023059,63,148,4,215
"23060",1023060,26,155,7,188
"23061",1023061,137,85,1,223
"23062",1023062,101,87,5,193
"23063",1023063,165,27,4,196
"23064",1023064,209,301,13,523
"23065",1023065,168,32,4,204
"23066",1023066,146,86,11,243
"23067",1023067,161,93,4,258
"23068",1023068,150,124,9,283
"23069",1023069,102,176,13,291
"23070",1023070,37,205,7,249
"23071",1023071,95,167,16,278
"23072",1023072,261,69,16,346
"23073",1023073,192,76,5,273
"23074",1023074,45,36,2,83
"23075",1023075,13,184,4,201
"23076",1023076,208,99,23,330
"23077",1023077,176,89,15,280
"23078",1023078,176,58,13,247
"23079",1023079,156,51,5,212
"23080",1023080,196,55,7,258
"23081",1023081,206,74,17,297
"23082",1023082,89,65,7,161
"23083",1023083,193,41,9,243
"23084",1023084,89,148,21,258
"23085",1023085,200,107,12,319
"23086",1023086,188,84,8,280
"23087",1023087,127,75,1,203
"23088",1023088,177,42,1,220
"23089",1023089,92,184,17,293
"23090",1023090,7,223,2,232
"23091",1023091,45,13,2,60
"23092",1023092,83,251,4,338
"23093",1023093,117,150,11,278
"23094",1023094,87,186,12,285
"23095",1023095,92,178,12,282
"23096",1023096,45,0,2,47
"23097",1023097,64,82,2,148
"23098",1023098,119,106,22,247
"23099",1023099,131,151,7,289
"23100",1023100,55,98,12,165
"23101",1023101,75,182,9,266
"23102",1023102,173,132,10,315
"23103",1023103,157,44,11,212
"23104",1023104,154,45,4,203
"23105",1023105,64,157,6,227
"23106",1023106,157,17,6,180
"23107",1023107,44,211,8,263
"23108",1023108,6,10,0,16
"23109",1023109,142,122,14,278
"23110",1023110,173,25,4,202
"23111",1023111,156,120,11,287
"23112",1023112,129,63,12,204
"23113",1023113,140,53,8,201
"23114",1023114,154,85,9,248
"23115",1023115,128,106,7,241
"23116",1023116,97,84,9,190
"23117",1023117,54,178,15,247
"23118",1023118,173,44,3,220
"23119",1023119,143,20,7,170
"23120",1023120,51,172,6,229
"23121",1023121,168,42,6,216
"23122",1023122,194,32,14,240
"23123",1023123,132,119,6,257
"23124",1023124,93,126,7,226
"23125",1023125,65,105,6,176
"23126",1023126,68,89,6,163
"23127",1023127,199,97,11,307
"23128",1023128,146,74,5,225
"23129",1023129,207,59,14,280
"23130",1023130,73,185,18,276
"23131",1023131,89,87,13,189
"23132",1023132,199,89,19,307
"23133",1023133,104,69,7,180
"23134",1023134,113,34,7,154
"23135",1023135,51,7,5,63
"23136",1023136,145,18,3,166
"23137",1023137,135,66,4,205
"23138",1023138,120,86,5,211
"23139",1023139,121,101,3,225
"23140",1023140,158,49,7,214
"23141",1023141,86,43,12,141
"23142",1023142,149,116,15,280
"23143",1023143,49,267,4,320
"23144",1023144,48,156,8,212
"23145",1023145,81,130,22,233
"23146",1023146,197,50,12,259
"23147",1023147,34,152,10,196
"23148",1023148,66,190,7,263
"23149",1023149,168,63,14,245
"23150",1023150,8,20,3,31
"23151",1023151,199,74,15,288
"23152",1023152,108,163,19,290
"23153",1023153,74,153,12,239
"23154",1023154,155,124,16,295
"23155",1023155,198,48,3,249
"23156",1023156,119,131,5,255
"23157",1023157,52,175,15,242
"23158",1023158,42,218,10,270
"23159",1023159,70,183,2,255
"23160",1023160,59,119,0,178
"23161",1023161,92,8,0,100
"23162",1023162,160,63,11,234
"23163",1023163,124,123,13,260
"23164",1023164,188,70,10,268
"23165",1023165,64,82,6,152
"23166",1023166,56,200,7,263
"23167",1023167,193,29,8,230
"23168",1023168,108,113,3,224
"23169",1023169,55,234,15,304
"23170",1023170,109,65,8,182
"23171",1023171,58,158,14,230
"23172",1023172,39,293,4,336
"23173",1023173,176,64,6,246
"23174",1023174,53,21,1,75
"23175",1023175,139,117,11,267
"23176",1023176,162,19,8,189
"23177",1023177,112,102,5,219
"23178",1023178,232,55,9,296
"23179",1023179,153,76,10,239
"23180",1023180,34,216,3,253
"23181",1023181,176,48,4,228
"23182",1023182,16,3,1,20
"23183",1023183,70,160,3,233
"23184",1023184,109,134,20,263
"23185",1023185,95,68,12,175
"23186",1023186,152,136,18,306
"23187",1023187,117,28,5,150
"23188",1023188,140,48,3,191
"23189",1023189,90,189,21,300
"23190",1023190,132,75,8,215
"23191",1023191,127,57,7,191
"23192",1023192,70,255,5,330
"23193",1023193,106,184,4,294
"23194",1023194,11,13,0,24
"23195",1023195,54,237,11,302
"23196",1023196,3,23,1,27
"23197",1023197,144,159,6,309
"23198",1023198,123,73,11,207
"23199",1023199,192,31,4,227
"23200",1023200,67,212,11,290
"23201",1023201,86,25,5,116
"23202",1023202,101,42,9,152
"23203",1023203,191,40,8,239
"23204",1023204,39,244,3,286
"23205",1023205,121,89,6,216
"23206",1023206,172,124,4,300
"23207",1023207,105,23,6,134
"23208",1023208,164,32,2,198
"23209",1023209,136,113,11,260
"23210",1023210,112,128,5,245
"23211",1023211,84,29,6,119
"23212",1023212,51,81,15,147
"23213",1023213,15,60,0,75
"23214",1023214,140,22,7,169
"23215",1023215,9,147,2,158
"23216",1023216,196,61,9,266
"23217",1023217,42,106,8,156
"23218",1023218,139,138,23,300
"23219",1023219,69,223,6,298
"23220",1023220,83,188,8,279
"23221",1023221,113,176,11,300
"23222",1023222,81,161,8,250
"23223",1023223,5,97,3,105
"23224",1023224,55,235,11,301
"23225",1023225,127,138,13,278
"23226",1023226,141,45,14,200
"23227",1023227,94,8,2,104
"23228",1023228,156,94,11,261
"23229",1023229,185,62,16,263
"23230",1023230,161,66,10,237
"23231",1023231,152,64,7,223
"23232",1023232,198,103,5,306
"23233",1023233,49,12,1,62
"23234",1023234,187,64,17,268
"23235",1023235,49,232,4,285
"23236",1023236,21,303,6,330
"23237",1023237,225,29,11,265
"23238",1023238,153,55,7,215
"23239",1023239,16,14,1,31
"23240",1023240,126,82,6,214
"23241",1023241,59,124,7,190
"23242",1023242,51,95,3,149
"23243",1023243,113,74,4,191
"23244",1023244,68,165,5,238
"23245",1023245,43,26,5,74
"23246",1023246,26,247,4,277
"23247",1023247,100,155,8,263
"23248",1023248,211,28,2,241
"23249",1023249,87,52,4,143
"23250",1023250,119,174,6,299
"23251",1023251,100,113,18,231
"23252",1023252,61,33,6,100
"23253",1023253,118,39,5,162
"23254",1023254,157,125,21,303
"23255",1023255,153,80,11,244
"23256",1023256,31,144,0,175
"23257",1023257,55,163,12,230
"23258",1023258,63,41,8,112
"23259",1023259,159,81,3,243
"23260",1023260,125,57,6,188
"23261",1023261,129,7,2,138
"23262",1023262,105,98,11,214
"23263",1023263,163,26,2,191
"23264",1023264,132,96,5,233
"23265",1023265,94,176,10,280
"23266",1023266,189,49,4,242
"23267",1023267,15,96,3,114
"23268",1023268,113,110,1,224
"23269",1023269,75,219,7,301
"23270",1023270,154,62,2,218
"23271",1023271,149,172,5,326
"23272",1023272,47,140,9,196
"23273",1023273,181,64,8,253
"23274",1023274,45,166,4,215
"23275",1023275,6,9,2,17
"23276",1023276,94,52,3,149
"23277",1023277,146,163,10,319
"23278",1023278,205,45,5,255
"23279",1023279,75,116,9,200
"23280",1023280,200,74,12,286
"23281",1023281,59,109,14,182
"23282",1023282,69,136,6,211
"23283",1023283,69,224,10,303
"23284",1023284,203,36,10,249
"23285",1023285,132,73,16,221
"23286",1023286,17,272,9,298
"23287",1023287,9,5,1,15
"23288",1023288,204,88,8,300
"23289",1023289,202,56,12,270
"23290",1023290,40,228,3,271
"23291",1023291,187,32,13,232
"23292",1023292,126,91,3,220
"23293",1023293,202,95,16,313
"23294",1023294,37,34,5,76
"23295",1023295,125,13,6,144
"23296",1023296,9,10,2,21
"23297",1023297,95,34,18,147
"23298",1023298,178,73,13,264
"23299",1023299,92,80,11,183
"23300",1023300,198,101,9,308
"23301",1023301,52,119,7,178
"23302",1023302,198,24,11,233
"23303",1023303,83,167,17,267
"23304",1023304,158,91,9,258
"23305",1023305,133,106,10,249
"23306",1023306,151,63,6,220
"23307",1023307,202,14,8,224
"23308",1023308,68,98,7,173
"23309",1023309,147,128,5,280
"23310",1023310,144,151,10,305
"23311",1023311,119,49,4,172
"23312",1023312,84,176,13,273
"23313",1023313,82,92,3,177
"23314",1023314,153,75,6,234
"23315",1023315,120,29,5,154
"23316",1023316,26,287,5,318
"23317",1023317,65,166,3,234
"23318",1023318,145,151,15,311
"23319",1023319,74,206,11,291
"23320",1023320,53,1,0,54
"23321",1023321,51,223,4,278
"23322",1023322,102,145,8,255
"23323",1023323,88,167,2,257
"23324",1023324,152,137,19,308
"23325",1023325,170,94,6,270
"23326",1023326,89,131,2,222
"23327",1023327,105,193,11,309
"23328",1023328,156,70,6,232
"23329",1023329,54,60,1,115
"23330",1023330,46,163,2,211
"23331",1023331,45,191,12,248
"23332",1023332,111,109,7,227
"23333",1023333,95,148,8,251
"23334",1023334,127,75,8,210
"23335",1023335,42,239,6,287
"23336",1023336,172,74,6,252
"23337",1023337,48,264,4,316
"23338",1023338,147,94,5,246
"23339",1023339,29,34,5,68
"23340",1023340,43,75,1,119
"23341",1023341,86,153,8,247
"23342",1023342,68,196,13,277
"23343",1023343,136,67,6,209
"23344",1023344,54,254,2,310
"23345",1023345,50,23,2,75
"23346",1023346,75,96,2,173
"23347",1023347,68,178,5,251
"23348",1023348,166,43,6,215
"23349",1023349,69,44,3,116
"23350",1023350,91,178,4,273
"23351",1023351,212,42,6,260
"23352",1023352,135,29,3,167
"23353",1023353,89,151,11,251
"23354",1023354,27,291,6,324
"23355",1023355,76,85,11,172
"23356",1023356,45,174,2,221
"23357",1023357,89,170,8,267
"23358",1023358,53,139,6,198
"23359",1023359,113,4,5,122
"23360",1023360,126,58,8,192
"23361",1023361,32,65,5,102
"23362",1023362,37,79,4,120
"23363",1023363,183,15,4,202
"23364",1023364,23,36,1,60
"23365",1023365,70,117,16,203
"23366",1023366,234,22,7,263
"23367",1023367,32,120,3,155
"23368",1023368,49,196,6,251
"23369",1023369,96,71,9,176
"23370",1023370,163,135,27,325
"23371",1023371,80,129,2,211
"23372",1023372,84,104,6,194
"23373",1023373,125,76,7,208
"23374",1023374,57,176,2,235
"23375",1023375,163,59,9,231
"23376",1023376,116,109,11,236
"23377",1023377,91,175,4,270
"23378",1023378,118,79,16,213
"23379",1023379,77,37,4,118
"23380",1023380,3,7,1,11
"23381",1023381,165,100,12,277
"23382",1023382,62,184,9,255
"23383",1023383,70,124,18,212
"23384",1023384,120,142,14,276
"23385",1023385,156,87,18,261
"23386",1023386,56,144,6,206
"23387",1023387,71,259,9,339
"23388",1023388,102,125,16,243
"23389",1023389,39,154,11,204
"23390",1023390,91,55,3,149
"23391",1023391,51,236,15,302
"23392",1023392,93,126,14,233
"23393",1023393,103,153,10,266
"23394",1023394,95,75,12,182
"23395",1023395,3,2,2,7
"23396",1023396,108,52,6,166
"23397",1023397,81,66,4,151
"23398",1023398,108,160,17,285
"23399",1023399,164,87,18,269
"23400",1023400,281,9,2,292
"23401",1023401,55,137,3,195
"23402",1023402,78,129,4,211
"23403",1023403,60,142,2,204
"23404",1023404,29,219,5,253
"23405",1023405,113,43,8,164
"23406",1023406,10,48,0,58
"23407",1023407,73,178,9,260
"23408",1023408,165,64,21,250
"23409",1023409,237,21,7,265
"23410",1023410,84,117,20,221
"23411",1023411,60,68,4,132
"23412",1023412,200,43,11,254
"23413",1023413,309,6,4,319
"23414",1023414,33,12,0,45
"23415",1023415,53,143,14,210
"23416",1023416,165,76,9,250
"23417",1023417,111,120,11,242
"23418",1023418,86,166,0,252
"23419",1023419,80,104,14,198
"23420",1023420,51,217,6,274
"23421",1023421,174,95,12,281
"23422",1023422,84,35,3,122
"23423",1023423,16,56,2,74
"23424",1023424,14,125,8,147
"23425",1023425,29,36,3,68
"23426",1023426,37,40,2,79
"23427",1023427,58,208,11,277
"23428",1023428,127,92,4,223
"23429",1023429,112,41,10,163
"23430",1023430,38,144,4,186
"23431",1023431,261,53,6,320
"23432",1023432,48,186,10,244
"23433",1023433,1,2,1,4
"23434",1023434,30,90,1,121
"23435",1023435,174,118,16,308
"23436",1023436,138,33,4,175
"23437",1023437,214,79,9,302
"23438",1023438,149,79,12,240
"23439",1023439,221,23,7,251
"23440",1023440,106,141,14,261
"23441",1023441,182,82,14,278
"23442",1023442,135,93,5,233
"23443",1023443,24,260,1,285
"23444",1023444,136,68,6,210
"23445",1023445,92,132,8,232
"23446",1023446,168,67,10,245
"23447",1023447,186,30,9,225
"23448",1023448,156,145,19,320
"23449",1023449,131,139,8,278
"23450",1023450,2,2,0,4
"23451",1023451,185,17,7,209
"23452",1023452,157,64,15,236
"23453",1023453,229,41,9,279
"23454",1023454,73,221,2,296
"23455",1023455,143,62,11,216
"23456",1023456,155,66,12,233
"23457",1023457,182,83,15,280
"23458",1023458,187,95,13,295
"23459",1023459,75,199,20,294
"23460",1023460,177,116,8,301
"23461",1023461,127,49,4,180
"23462",1023462,10,168,1,179
"23463",1023463,127,46,7,180
"23464",1023464,146,48,3,197
"23465",1023465,103,145,9,257
"23466",1023466,65,184,9,258
"23467",1023467,70,218,13,301
"23468",1023468,65,206,7,278
"23469",1023469,125,59,2,186
"23470",1023470,126,45,2,173
"23471",1023471,115,166,6,287
"23472",1023472,184,36,11,231
"23473",1023473,85,49,8,142
"23474",1023474,30,143,7,180
"23475",1023475,42,184,9,235
"23476",1023476,62,123,14,199
"23477",1023477,217,44,9,270
"23478",1023478,11,215,7,233
"23479",1023479,132,46,5,183
"23480",1023480,154,64,9,227
"23481",1023481,247,17,7,271
"23482",1023482,135,116,3,254
"23483",1023483,159,53,4,216
"23484",1023484,110,169,2,281
"23485",1023485,36,118,3,157
"23486",1023486,137,46,3,186
"23487",1023487,119,191,14,324
"23488",1023488,40,116,6,162
"23489",1023489,198,108,14,320
"23490",1023490,141,79,2,222
"23491",1023491,86,93,8,187
"23492",1023492,161,9,4,174
"23493",1023493,89,30,1,120
"23494",1023494,50,252,3,305
"23495",1023495,65,113,12,190
"23496",1023496,76,303,6,385
"23497",1023497,165,40,11,216
"23498",1023498,146,40,12,198
"23499",1023499,64,200,7,271
"23500",1023500,171,124,12,307
"23501",1023501,114,204,10,328
"23502",1023502,151,60,12,223
"23503",1023503,39,208,1,248
"23504",1023504,89,138,1,228
"23505",1023505,222,135,13,370
"23506",1023506,127,13,4,144
"23507",1023507,203,50,8,261
"23508",1023508,117,6,1,124
"23509",1023509,54,18,2,74
"23510",1023510,39,216,17,272
"23511",1023511,95,104,4,203
"23512",1023512,134,15,1,150
"23513",1023513,38,65,1,104
"23514",1023514,64,58,4,126
"23515",1023515,112,43,3,158
"23516",1023516,169,72,6,247
"23517",1023517,67,186,6,259
"23518",1023518,66,130,10,206
"23519",1023519,196,29,7,232
"23520",1023520,55,127,7,189
"23521",1023521,142,42,9,193
"23522",1023522,240,238,11,489
"23523",1023523,83,121,0,204
"23524",1023524,97,61,1,159
"23525",1023525,171,5,0,176
"23526",1023526,55,135,9,199
"23527",1023527,182,117,9,308
"23528",1023528,221,96,12,329
"23529",1023529,72,20,9,101
"23530",1023530,154,9,2,165
"23531",1023531,121,116,5,242
"23532",1023532,79,105,3,187
"23533",1023533,96,169,5,270
"23534",1023534,149,48,8,205
"23535",1023535,104,69,8,181
"23536",1023536,80,71,8,159
"23537",1023537,86,165,11,262
"23538",1023538,5,19,1,25
"23539",1023539,63,214,9,286
"23540",1023540,206,46,7,259
"23541",1023541,256,22,4,282
"23542",1023542,77,125,15,217
"23543",1023543,127,45,9,181
"23544",1023544,138,74,8,220
"23545",1023545,1,20,0,21
"23546",1023546,40,84,9,133
"23547",1023547,152,57,9,218
"23548",1023548,197,65,8,270
"23549",1023549,29,203,5,237
"23550",1023550,190,28,3,221
"23551",1023551,98,152,20,270
"23552",1023552,154,85,6,245
"23553",1023553,90,175,10,275
"23554",1023554,162,76,3,241
"23555",1023555,195,34,6,235
"23556",1023556,140,164,17,321
"23557",1023557,296,37,3,336
"23558",1023558,103,179,13,295
"23559",1023559,184,42,10,236
"23560",1023560,67,183,7,257
"23561",1023561,25,126,3,154
"23562",1023562,197,48,5,250
"23563",1023563,6,73,0,79
"23564",1023564,148,71,13,232
"23565",1023565,140,112,16,268
"23566",1023566,115,33,4,152
"23567",1023567,123,106,11,240
"23568",1023568,32,164,3,199
"23569",1023569,3,7,1,11
"23570",1023570,141,5,9,155
"23571",1023571,81,243,11,335
"23572",1023572,146,70,4,220
"23573",1023573,178,31,6,215
"23574",1023574,170,8,0,178
"23575",1023575,27,10,5,42
"23576",1023576,69,263,17,349
"23577",1023577,65,69,9,143
"23578",1023578,190,33,6,229
"23579",1023579,157,63,11,231
"23580",1023580,98,109,2,209
"23581",1023581,150,30,5,185
"23582",1023582,194,32,4,230
"23583",1023583,159,2,2,163
"23584",1023584,77,158,8,243
"23585",1023585,155,78,20,253
"23586",1023586,88,156,9,253
"23587",1023587,126,154,7,287
"23588",1023588,182,38,6,226
"23589",1023589,109,164,8,281
"23590",1023590,140,17,3,160
"23591",1023591,97,17,1,115
"23592",1023592,13,123,4,140
"23593",1023593,61,163,12,236
"23594",1023594,31,243,7,281
"23595",1023595,44,153,8,205
"23596",1023596,139,180,17,336
"23597",1023597,75,89,20,184
"23598",1023598,124,87,15,226
"23599",1023599,23,174,6,203
"23600",1023600,202,64,9,275
"23601",1023601,126,74,12,212
"23602",1023602,130,114,8,252
"23603",1023603,109,191,15,315
"23604",1023604,35,30,1,66
"23605",1023605,152,25,5,182
"23606",1023606,93,136,12,241
"23607",1023607,171,116,19,306
"23608",1023608,57,198,9,264
"23609",1023609,187,29,5,221
"23610",1023610,156,97,11,264
"23611",1023611,130,68,4,202
"23612",1023612,17,272,6,295
"23613",1023613,90,87,9,186
"23614",1023614,48,218,13,279
"23615",1023615,150,35,1,186
"23616",1023616,25,20,1,46
"23617",1023617,149,46,7,202
"23618",1023618,121,171,15,307
"23619",1023619,75,100,3,178
"23620",1023620,36,204,3,243
"23621",1023621,161,27,0,188
"23622",1023622,79,116,7,202
"23623",1023623,155,60,4,219
"23624",1023624,150,42,11,203
"23625",1023625,146,38,5,189
"23626",1023626,155,147,5,307
"23627",1023627,6,7,0,13
"23628",1023628,174,71,21,266
"23629",1023629,68,26,6,100
"23630",1023630,77,165,7,249
"23631",1023631,98,108,6,212
"23632",1023632,167,129,10,306
"23633",1023633,119,149,18,286
"23634",1023634,130,149,6,285
"23635",1023635,108,191,9,308
"23636",1023636,79,168,23,270
"23637",1023637,175,44,7,226
"23638",1023638,54,177,7,238
"23639",1023639,139,68,5,212
"23640",1023640,242,97,16,355
"23641",1023641,42,67,6,115
"23642",1023642,190,48,7,245
"23643",1023643,155,94,7,256
"23644",1023644,263,19,8,290
"23645",1023645,150,45,12,207
"23646",1023646,195,78,6,279
"23647",1023647,100,29,2,131
"23648",1023648,61,191,17,269
"23649",1023649,120,150,5,275
"23650",1023650,147,158,30,335
"23651",1023651,165,64,16,245
"23652",1023652,169,75,2,246
"23653",1023653,136,29,7,172
"23654",1023654,66,223,12,301
"23655",1023655,94,59,2,155
"23656",1023656,151,39,8,198
"23657",1023657,86,177,6,269
"23658",1023658,115,151,9,275
"23659",1023659,234,42,11,287
"23660",1023660,162,45,8,215
"23661",1023661,48,182,7,237
"23662",1023662,48,100,3,151
"23663",1023663,92,83,2,177
"23664",1023664,181,98,10,289
"23665",1023665,41,121,9,171
"23666",1023666,79,25,2,106
"23667",1023667,24,286,3,313
"23668",1023668,109,99,9,217
"23669",1023669,86,187,23,296
"23670",1023670,129,142,10,281
"23671",1023671,119,30,8,157
"23672",1023672,257,47,17,321
"23673",1023673,83,170,12,265
"23674",1023674,2,5,1,8
"23675",1023675,61,134,10,205
"23676",1023676,88,50,7,145
"23677",1023677,65,84,4,153
"23678",1023678,121,92,3,216
"23679",1023679,89,101,9,199
"23680",1023680,120,96,16,232
"23681",1023681,195,72,24,291
"23682",1023682,57,17,3,77
"23683",1023683,171,72,13,256
"23684",1023684,73,37,5,115
"23685",1023685,7,118,1,126
"23686",1023686,67,121,6,194
"23687",1023687,245,49,13,307
"23688",1023688,76,176,9,261
"23689",1023689,161,68,25,254
"23690",1023690,162,100,21,283
"23691",1023691,2,4,2,8
"23692",1023692,41,108,6,155
"23693",1023693,244,21,4,269
"23694",1023694,120,28,3,151
"23695",1023695,206,82,1,289
"23696",1023696,193,72,15,280
"23697",1023697,122,90,8,220
"23698",1023698,50,113,3,166
"23699",1023699,32,6,2,40
"23700",1023700,89,38,4,131
"23701",1023701,121,75,7,203
"23702",1023702,80,22,2,104
"23703",1023703,68,141,7,216
"23704",1023704,104,169,15,288
"23705",1023705,49,176,3,228
"23706",1023706,58,165,6,229
"23707",1023707,30,218,9,257
"23708",1023708,303,5,6,314
"23709",1023709,165,136,13,314
"23710",1023710,9,225,4,238
"23711",1023711,130,84,1,215
"23712",1023712,115,93,4,212
"23713",1023713,58,97,5,160
"23714",1023714,71,106,2,179
"23715",1023715,62,260,7,329
"23716",1023716,77,78,21,176
"23717",1023717,235,19,6,260
"23718",1023718,185,29,5,219
"23719",1023719,63,165,4,232
"23720",1023720,121,129,12,262
"23721",1023721,4,60,2,66
"23722",1023722,122,105,10,237
"23723",1023723,212,64,22,298
"23724",1023724,61,147,3,211
"23725",1023725,168,18,5,191
"23726",1023726,144,102,18,264
"23727",1023727,80,195,19,294
"23728",1023728,204,26,1,231
"23729",1023729,98,21,8,127
"23730",1023730,71,185,6,262
"23731",1023731,136,125,6,267
"23732",1023732,154,123,11,288
"23733",1023733,120,126,12,258
"23734",1023734,54,257,14,325
"23735",1023735,113,157,12,282
"23736",1023736,79,76,4,159
"23737",1023737,90,217,3,310
"23738",1023738,166,150,7,323
"23739",1023739,137,55,22,214
"23740",1023740,131,23,6,160
"23741",1023741,10,4,0,14
"23742",1023742,82,28,2,112
"23743",1023743,43,23,5,71
"23744",1023744,146,23,3,172
"23745",1023745,42,208,5,255
"23746",1023746,118,174,22,314
"23747",1023747,103,150,26,279
"23748",1023748,132,161,11,304
"23749",1023749,68,97,9,174
"23750",1023750,83,35,8,126
"23751",1023751,75,59,4,138
"23752",1023752,14,3,4,21
"23753",1023753,65,31,4,100
"23754",1023754,254,48,13,315
"23755",1023755,201,20,7,228
"23756",1023756,31,146,9,186
"23757",1023757,150,61,8,219
"23758",1023758,103,164,16,283
"23759",1023759,145,52,7,204
"23760",1023760,76,214,7,297
"23761",1023761,99,174,14,287
"23762",1023762,214,68,9,291
"23763",1023763,165,33,13,211
"23764",1023764,95,150,19,264
"23765",1023765,134,110,9,253
"23766",1023766,28,124,2,154
"23767",1023767,88,203,6,297
"23768",1023768,67,238,7,312
"23769",1023769,94,107,10,211
"23770",1023770,38,174,2,214
"23771",1023771,184,104,13,301
"23772",1023772,91,137,6,234
"23773",1023773,136,135,7,278
"23774",1023774,156,143,12,311
"23775",1023775,163,63,3,229
"23776",1023776,152,53,11,216
"23777",1023777,199,68,7,274
"23778",1023778,45,168,5,218
"23779",1023779,13,3,3,19
"23780",1023780,10,80,0,90
"23781",1023781,59,205,16,280
"23782",1023782,38,94,9,141
"23783",1023783,36,45,0,81
"23784",1023784,194,49,7,250
"23785",1023785,14,40,1,55
"23786",1023786,185,67,7,259
"23787",1023787,25,3,1,29
"23788",1023788,210,59,8,277
"23789",1023789,173,31,5,209
"23790",1023790,155,93,9,257
"23791",1023791,118,22,1,141
"23792",1023792,149,71,5,225
"23793",1023793,73,206,9,288
"23794",1023794,173,136,10,319
"23795",1023795,87,137,7,231
"23796",1023796,185,86,3,274
"23797",1023797,101,99,9,209
"23798",1023798,214,58,12,284
"23799",1023799,18,241,5,264
"23800",1023800,242,33,22,297
"23801",1023801,52,263,4,319
"23802",1023802,94,245,7,346
"23803",1023803,41,33,4,78
"23804",1023804,107,90,16,213
"23805",1023805,136,165,10,311
"23806",1023806,55,101,0,156
"23807",1023807,37,237,14,288
"23808",1023808,158,87,11,256
"23809",1023809,63,40,7,110
"23810",1023810,159,92,10,261
"23811",1023811,19,6,0,25
"23812",1023812,32,47,3,82
"23813",1023813,173,38,8,219
"23814",1023814,22,28,0,50
"23815",1023815,77,156,13,246
"23816",1023816,47,206,17,270
"23817",1023817,88,170,16,274
"23818",1023818,231,55,12,298
"23819",1023819,135,99,10,244
"23820",1023820,34,149,8,191
"23821",1023821,78,6,4,88
"23822",1023822,46,82,11,139
"23823",1023823,143,87,8,238
"23824",1023824,18,34,3,55
"23825",1023825,29,216,5,250
"23826",1023826,107,87,3,197
"23827",1023827,85,184,17,286
"23828",1023828,180,36,10,226
"23829",1023829,32,10,2,44
"23830",1023830,79,125,4,208
"23831",1023831,20,3,1,24
"23832",1023832,98,20,10,128
"23833",1023833,164,38,4,206
"23834",1023834,23,210,3,236
"23835",1023835,54,126,8,188
"23836",1023836,69,145,1,215
"23837",1023837,111,59,5,175
"23838",1023838,98,286,7,391
"23839",1023839,62,249,5,316
"23840",1023840,78,175,22,275
"23841",1023841,137,82,2,221
"23842",1023842,191,25,5,221
"23843",1023843,142,44,8,194
"23844",1023844,95,107,1,203
"23845",1023845,15,13,0,28
"23846",1023846,220,57,15,292
"23847",1023847,103,93,6,202
"23848",1023848,184,45,3,232
"23849",1023849,40,166,5,211
"23850",1023850,204,56,16,276
"23851",1023851,163,97,8,268
"23852",1023852,43,239,2,284
"23853",1023853,38,43,1,82
"23854",1023854,87,195,7,289
"23855",1023855,61,104,17,182
"23856",1023856,127,119,24,270
"23857",1023857,26,245,8,279
"23858",1023858,46,256,4,306
"23859",1023859,98,96,5,199
"23860",1023860,157,27,5,189
"23861",1023861,147,108,17,272
"23862",1023862,45,10,3,58
"23863",1023863,192,37,8,237
"23864",1023864,25,5,1,31
"23865",1023865,92,90,15,197
"23866",1023866,48,169,8,225
"23867",1023867,28,120,10,158
"23868",1023868,54,185,9,248
"23869",1023869,82,105,20,207
"23870",1023870,72,160,5,237
"23871",1023871,135,38,10,183
"23872",1023872,214,80,8,302
"23873",1023873,144,71,16,231
"23874",1023874,157,81,9,247
"23875",1023875,62,197,9,268
"23876",1023876,21,173,5,199
"23877",1023877,55,84,9,148
"23878",1023878,232,29,12,273
"23879",1023879,42,28,0,70
"23880",1023880,127,101,15,243
"23881",1023881,18,75,3,96
"23882",1023882,137,169,7,313
"23883",1023883,196,17,5,218
"23884",1023884,54,27,8,89
"23885",1023885,184,78,14,276
"23886",1023886,42,11,2,55
"23887",1023887,148,63,4,215
"23888",1023888,165,56,6,227
"23889",1023889,101,95,2,198
"23890",1023890,45,122,17,184
"23891",1023891,73,213,1,287
"23892",1023892,184,36,4,224
"23893",1023893,119,122,8,249
"23894",1023894,101,58,4,163
"23895",1023895,145,99,7,251
"23896",1023896,189,68,3,260
"23897",1023897,150,104,14,268
"23898",1023898,90,1,0,91
"23899",1023899,104,74,5,183
"23900",1023900,104,120,5,229
"23901",1023901,60,118,9,187
"23902",1023902,8,2,0,10
"23903",1023903,91,55,2,148
"23904",1023904,183,33,8,224
"23905",1023905,64,184,13,261
"23906",1023906,128,103,23,254
"23907",1023907,69,226,2,297
"23908",1023908,145,44,16,205
"23909",1023909,22,0,0,22
"23910",1023910,162,38,5,205
"23911",1023911,101,184,10,295
"23912",1023912,6,2,0,8
"23913",1023913,71,17,0,88
"23914",1023914,89,197,7,293
"23915",1023915,155,91,7,253
"23916",1023916,69,97,14,180
"23917",1023917,126,139,18,283
"23918",1023918,108,117,7,232
"23919",1023919,158,76,4,238
"23920",1023920,67,186,9,262
"23921",1023921,172,102,5,279
"23922",1023922,106,103,4,213
"23923",1023923,182,86,9,277
"23924",1023924,119,64,4,187
"23925",1023925,80,101,6,187
"23926",1023926,170,12,4,186
"23927",1023927,72,40,12,124
"23928",1023928,250,2,1,253
"23929",1023929,139,92,13,244
"23930",1023930,31,229,2,262
"23931",1023931,120,159,16,295
"23932",1023932,199,15,2,216
"23933",1023933,133,56,1,190
"23934",1023934,178,69,12,259
"23935",1023935,55,127,9,191
"23936",1023936,50,6,3,59
"23937",1023937,37,4,2,43
"23938",1023938,244,42,7,293
"23939",1023939,65,253,3,321
"23940",1023940,98,61,4,163
"23941",1023941,37,31,7,75
"23942",1023942,76,138,3,217
"23943",1023943,63,236,6,305
"23944",1023944,23,290,3,316
"23945",1023945,115,164,5,284
"23946",1023946,80,26,4,110
"23947",1023947,38,260,9,307
"23948",1023948,98,203,17,318
"23949",1023949,34,136,5,175
"23950",1023950,97,172,11,280
"23951",1023951,69,27,5,101
"23952",1023952,39,11,1,51
"23953",1023953,236,31,7,274
"23954",1023954,150,105,17,272
"23955",1023955,84,237,5,326
"23956",1023956,19,19,2,40
"23957",1023957,119,74,12,205
"23958",1023958,254,12,6,272
"23959",1023959,62,38,2,102
"23960",1023960,132,40,8,180
"23961",1023961,82,206,10,298
"23962",1023962,100,86,7,193
"23963",1023963,59,126,2,187
"23964",1023964,205,65,7,277
"23965",1023965,98,173,13,284
"23966",1023966,62,152,12,226
"23967",1023967,106,172,8,286
"23968",1023968,68,77,7,152
"23969",1023969,88,43,3,134
"23970",1023970,16,25,0,41
"23971",1023971,82,91,5,178
"23972",1023972,146,74,12,232
"23973",1023973,53,271,9,333
"23974",1023974,95,82,12,189
"23975",1023975,30,33,1,64
"23976",1023976,136,157,12,305
"23977",1023977,95,104,1,200
"23978",1023978,145,134,11,290
"23979",1023979,43,154,11,208
"23980",1023980,140,86,5,231
"23981",1023981,139,118,6,263
"23982",1023982,187,36,7,230
"23983",1023983,110,91,15,216
"23984",1023984,92,130,12,234
"23985",1023985,191,46,6,243
"23986",1023986,96,42,2,140
"23987",1023987,245,17,5,267
"23988",1023988,142,127,4,273
"23989",1023989,55,112,4,171
"23990",1023990,150,17,9,176
"23991",1023991,33,226,4,263
"23992",1023992,171,88,14,273
"23993",1023993,117,127,14,258
"23994",1023994,23,146,4,173
"23995",1023995,166,136,15,317
"23996",1023996,65,187,7,259
"23997",1023997,87,196,15,298
"23998",1023998,43,220,4,267
"23999",1023999,48,107,2,157
"24000",1024000,63,86,5,154
"24001",1024001,150,106,18,274
"24002",1024002,121,132,6,259
"24003",1024003,142,35,2,179
"24004",1024004,222,27,8,257
"24005",1024005,149,112,9,270
"24006",1024006,63,138,18,219
"24007",1024007,181,41,8,230
"24008",1024008,98,107,13,218
"24009",1024009,92,163,6,261
"24010",1024010,142,131,8,281
"24011",1024011,149,81,10,240
"24012",1024012,154,112,17,283
"24013",1024013,110,6,6,122
"24014",1024014,86,84,15,185
"24015",1024015,124,94,18,236
"24016",1024016,89,1,2,92
"24017",1024017,41,82,1,124
"24018",1024018,174,63,6,243
"24019",1024019,170,115,14,299
"24020",1024020,100,27,9,136
"24021",1024021,138,143,16,297
"24022",1024022,79,12,4,95
"24023",1024023,156,151,6,313
"24024",1024024,200,57,8,265
"24025",1024025,146,24,6,176
"24026",1024026,20,121,8,149
"24027",1024027,250,20,10,280
"24028",1024028,141,116,10,267
"24029",1024029,189,64,5,258
"24030",1024030,206,3,0,209
"24031",1024031,71,131,6,208
"24032",1024032,160,79,17,256
"24033",1024033,133,69,2,204
"24034",1024034,50,105,2,157
"24035",1024035,181,72,10,263
"24036",1024036,68,232,7,307
"24037",1024037,13,141,2,156
"24038",1024038,160,110,23,293
"24039",1024039,140,38,12,190
"24040",1024040,23,189,5,217
"24041",1024041,38,228,4,270
"24042",1024042,216,34,3,253
"24043",1024043,8,24,3,35
"24044",1024044,34,133,9,176
"24045",1024045,135,52,3,190
"24046",1024046,60,172,8,240
"24047",1024047,15,64,2,81
"24048",1024048,105,166,19,290
"24049",1024049,138,101,6,245
"24050",1024050,58,145,8,211
"24051",1024051,49,279,13,341
"24052",1024052,166,101,6,273
"24053",1024053,72,77,1,150
"24054",1024054,131,100,11,242
"24055",1024055,11,25,1,37
"24056",1024056,112,101,2,215
"24057",1024057,77,168,7,252
"24058",1024058,74,27,8,109
"24059",1024059,24,205,5,234
"24060",1024060,171,31,5,207
"24061",1024061,59,26,5,90
"24062",1024062,130,142,13,285
"24063",1024063,208,19,5,232
"24064",1024064,88,197,14,299
"24065",1024065,44,161,11,216
"24066",1024066,24,129,4,157
"24067",1024067,83,163,25,271
"24068",1024068,115,91,7,213
"24069",1024069,57,197,6,260
"24070",1024070,129,78,10,217
"24071",1024071,164,104,2,270
"24072",1024072,224,72,17,313
"24073",1024073,151,128,12,291
"24074",1024074,104,92,2,198
"24075",1024075,64,94,2,160
"24076",1024076,17,131,2,150
"24077",1024077,128,117,6,251
"24078",1024078,158,105,7,270
"24079",1024079,54,258,0,312
"24080",1024080,29,223,4,256
"24081",1024081,191,100,19,310
"24082",1024082,132,49,2,183
"24083",1024083,49,190,6,245
"24084",1024084,118,106,9,233
"24085",1024085,24,35,1,60
"24086",1024086,169,71,9,249
"24087",1024087,236,45,7,288
"24088",1024088,107,44,3,154
"24089",1024089,90,214,10,314
"24090",1024090,91,161,6,258
"24091",1024091,33,57,1,91
"24092",1024092,158,31,9,198
"24093",1024093,132,81,9,222
"24094",1024094,111,28,1,140
"24095",1024095,41,255,6,302
"24096",1024096,34,10,0,44
"24097",1024097,59,133,8,200
"24098",1024098,69,111,6,186
"24099",1024099,27,236,3,266
"24100",1024100,146,84,7,237
"24101",1024101,91,58,11,160
"24102",1024102,207,48,6,261
"24103",1024103,146,73,11,230
"24104",1024104,108,104,10,222
"24105",1024105,223,27,2,252
"24106",1024106,53,141,8,202
"24107",1024107,0,0,2,2
"24108",1024108,78,173,8,259
"24109",1024109,24,149,7,180
"24110",1024110,191,92,7,290
"24111",1024111,223,42,8,273
"24112",1024112,26,150,2,178
"24113",1024113,130,103,8,241
"24114",1024114,66,172,23,261
"24115",1024115,69,162,7,238
"24116",1024116,133,97,18,248
"24117",1024117,87,120,7,214
"24118",1024118,132,82,6,220
"24119",1024119,52,124,6,182
"24120",1024120,6,4,1,11
"24121",1024121,136,101,6,243
"24122",1024122,180,138,20,338
"24123",1024123,73,203,13,289
"24124",1024124,35,180,16,231
"24125",1024125,225,51,13,289
"24126",1024126,104,161,5,270
"24127",1024127,58,21,7,86
"24128",1024128,47,205,12,264
"24129",1024129,161,69,8,238
"24130",1024130,134,63,8,205
"24131",1024131,201,51,8,260
"24132",1024132,184,41,2,227
"24133",1024133,129,6,1,136
"24134",1024134,14,18,1,33
"24135",1024135,125,160,22,307
"24136",1024136,217,62,8,287
"24137",1024137,67,189,8,264
"24138",1024138,24,28,1,53
"24139",1024139,5,5,0,10
"24140",1024140,0,5,1,6
"24141",1024141,162,112,6,280
"24142",1024142,145,52,3,200
"24143",1024143,100,100,8,208
"24144",1024144,156,116,8,280
"24145",1024145,47,14,0,61
"24146",1024146,189,64,4,257
"24147",1024147,29,272,6,307
"24148",1024148,5,5,1,11
"24149",1024149,176,102,22,300
"24150",1024150,26,67,0,93
"24151",1024151,146,64,4,214
"24152",1024152,66,109,13,188
"24153",1024153,188,30,6,224
"24154",1024154,176,72,15,263
"24155",1024155,127,139,23,289
"24156",1024156,123,122,12,257
"24157",1024157,132,111,12,255
"24158",1024158,18,144,6,168
"24159",1024159,185,32,8,225
"24160",1024160,130,103,5,238
"24161",1024161,116,104,7,227
"24162",1024162,100,84,13,197
"24163",1024163,87,149,17,253
"24164",1024164,89,131,8,228
"24165",1024165,193,44,12,249
"24166",1024166,106,76,9,191
"24167",1024167,105,63,6,174
"24168",1024168,158,67,11,236
"24169",1024169,199,93,1,293
"24170",1024170,82,141,5,228
"24171",1024171,214,99,11,324
"24172",1024172,28,15,1,44
"24173",1024173,136,97,9,242
"24174",1024174,15,0,0,15
"24175",1024175,78,59,8,145
"24176",1024176,18,1,2,21
"24177",1024177,25,254,4,283
"24178",1024178,98,62,4,164
"24179",1024179,139,24,5,168
"24180",1024180,169,14,8,191
"24181",1024181,189,99,7,295
"24182",1024182,21,120,5,146
"24183",1024183,93,39,6,138
"24184",1024184,166,107,12,285
"24185",1024185,54,178,8,240
"24186",1024186,114,95,2,211
"24187",1024187,3,63,1,67
"24188",1024188,80,117,12,209
"24189",1024189,160,46,3,209
"24190",1024190,47,155,7,209
"24191",1024191,187,108,9,304
"24192",1024192,80,35,15,130
"24193",1024193,196,60,12,268
"24194",1024194,82,106,3,191
"24195",1024195,38,226,12,276
"24196",1024196,104,101,2,207
"24197",1024197,56,241,12,309
"24198",1024198,63,190,7,260
"24199",1024199,37,15,2,54
"24200",1024200,31,133,2,166
"24201",1024201,174,73,13,260
"24202",1024202,164,65,3,232
"24203",1024203,143,41,4,188
"24204",1024204,39,116,5,160
"24205",1024205,29,11,3,43
"24206",1024206,23,178,6,207
"24207",1024207,66,120,3,189
"24208",1024208,67,191,3,261
"24209",1024209,36,223,5,264
"24210",1024210,31,7,2,40
"24211",1024211,46,227,11,284
"24212",1024212,138,79,15,232
"24213",1024213,61,130,2,193
"24214",1024214,45,41,4,90
"24215",1024215,75,126,13,214
"24216",1024216,80,122,5,207
"24217",1024217,64,27,5,96
"24218",1024218,84,40,5,129
"24219",1024219,68,88,11,167
"24220",1024220,51,219,1,271
"24221",1024221,145,27,5,177
"24222",1024222,70,177,5,252
"24223",1024223,174,15,6,195
"24224",1024224,143,171,5,319
"24225",1024225,210,61,13,284
"24226",1024226,63,135,11,209
"24227",1024227,67,40,2,109
"24228",1024228,76,141,10,227
"24229",1024229,2,2,3,7
"24230",1024230,29,282,18,329
"24231",1024231,67,76,1,144
"24232",1024232,249,2,3,254
"24233",1024233,32,257,12,301
"24234",1024234,9,62,4,75
"24235",1024235,105,200,9,314
"24236",1024236,64,136,7,207
"24237",1024237,41,160,13,214
"24238",1024238,257,230,22,509
"24239",1024239,105,88,8,201
"24240",1024240,31,23,2,56
"24241",1024241,96,182,10,288
"24242",1024242,152,182,6,340
"24243",1024243,89,39,3,131
"24244",1024244,144,26,4,174
"24245",1024245,90,103,11,204
"24246",1024246,87,7,0,94
"24247",1024247,81,44,6,131
"24248",1024248,89,68,5,162
"24249",1024249,139,138,12,289
"24250",1024250,70,204,17,291
"24251",1024251,208,43,6,257
"24252",1024252,181,49,12,242
"24253",1024253,130,158,13,301
"24254",1024254,71,207,11,289
"24255",1024255,4,7,0,11
"24256",1024256,220,28,10,258
"24257",1024257,47,203,10,260
"24258",1024258,157,49,10,216
"24259",1024259,148,53,1,202
"24260",1024260,66,195,10,271
"24261",1024261,97,124,10,231
"24262",1024262,151,121,3,275
"24263",1024263,155,46,5,206
"24264",1024264,163,17,4,184
"24265",1024265,77,102,6,185
"24266",1024266,212,54,4,270
"24267",1024267,73,52,5,130
"24268",1024268,147,87,10,244
"24269",1024269,111,60,2,173
"24270",1024270,25,240,9,274
"24271",1024271,63,93,9,165
"24272",1024272,86,50,2,138
"24273",1024273,96,193,12,301
"24274",1024274,98,122,11,231
"24275",1024275,53,71,3,127
"24276",1024276,114,56,14,184
"24277",1024277,173,22,4,199
"24278",1024278,63,149,7,219
"24279",1024279,123,269,13,405
"24280",1024280,242,41,10,293
"24281",1024281,68,173,15,256
"24282",1024282,149,71,7,227
"24283",1024283,122,79,5,206
"24284",1024284,137,37,2,176
"24285",1024285,211,41,10,262
"24286",1024286,41,166,4,211
"24287",1024287,12,99,7,118
"24288",1024288,189,43,4,236
"24289",1024289,198,80,13,291
"24290",1024290,154,76,5,235
"24291",1024291,75,257,12,344
"24292",1024292,84,167,5,256
"24293",1024293,55,122,11,188
"24294",1024294,20,13,0,33
"24295",1024295,50,29,4,83
"24296",1024296,105,146,13,264
"24297",1024297,65,213,4,282
"24298",1024298,132,210,25,367
"24299",1024299,109,55,4,168
"24300",1024300,165,21,4,190
"24301",1024301,9,153,4,166
"24302",1024302,97,190,6,293
"24303",1024303,45,112,7,164
"24304",1024304,308,15,7,330
"24305",1024305,75,16,3,94
"24306",1024306,185,38,8,231
"24307",1024307,214,37,4,255
"24308",1024308,45,11,4,60
"24309",1024309,159,130,15,304
"24310",1024310,116,11,5,132
"24311",1024311,66,104,11,181
"24312",1024312,7,34,2,43
"24313",1024313,187,56,10,253
"24314",1024314,143,57,8,208
"24315",1024315,38,103,9,150
"24316",1024316,147,58,2,207
"24317",1024317,91,174,3,268
"24318",1024318,88,148,14,250
"24319",1024319,166,74,10,250
"24320",1024320,27,217,4,248
"24321",1024321,174,108,8,290
"24322",1024322,100,80,12,192
"24323",1024323,106,140,11,257
"24324",1024324,49,220,6,275
"24325",1024325,180,123,14,317
"24326",1024326,37,205,6,248
"24327",1024327,213,54,7,274
"24328",1024328,182,33,6,221
"24329",1024329,194,28,16,238
"24330",1024330,195,12,2,209
"24331",1024331,56,115,7,178
"24332",1024332,104,65,5,174
"24333",1024333,108,153,7,268
"24334",1024334,62,107,12,181
"24335",1024335,155,51,9,215
"24336",1024336,28,260,3,291
"24337",1024337,27,210,2,239
"24338",1024338,9,65,1,75
"24339",1024339,139,124,6,269
"24340",1024340,135,135,3,273
"24341",1024341,194,48,13,255
"24342",1024342,51,128,5,184
"24343",1024343,95,56,8,159
"24344",1024344,190,30,5,225
"24345",1024345,39,83,4,126
"24346",1024346,149,103,23,275
"24347",1024347,224,101,9,334
"24348",1024348,198,46,8,252
"24349",1024349,114,159,19,292
"24350",1024350,137,125,9,271
"24351",1024351,70,183,11,264
"24352",1024352,44,64,9,117
"24353",1024353,135,80,7,222
"24354",1024354,88,169,11,268
"24355",1024355,66,42,9,117
"24356",1024356,208,39,4,251
"24357",1024357,98,89,3,190
"24358",1024358,37,202,5,244
"24359",1024359,80,193,13,286
"24360",1024360,148,34,2,184
"24361",1024361,127,23,5,155
"24362",1024362,102,114,4,220
"24363",1024363,63,54,5,122
"24364",1024364,192,43,7,242
"24365",1024365,137,52,5,194
"24366",1024366,54,69,2,125
"24367",1024367,153,60,5,218
"24368",1024368,63,193,4,260
"24369",1024369,202,65,3,270
"24370",1024370,117,102,1,220
"24371",1024371,160,38,3,201
"24372",1024372,54,56,7,117
"24373",1024373,147,82,2,231
"24374",1024374,127,83,14,224
"24375",1024375,65,229,2,296
"24376",1024376,88,66,5,159
"24377",1024377,115,88,9,212
"24378",1024378,82,98,3,183
"24379",1024379,174,69,10,253
"24380",1024380,155,114,11,280
"24381",1024381,50,46,5,101
"24382",1024382,88,99,6,193
"24383",1024383,177,147,17,341
"24384",1024384,160,105,22,287
"24385",1024385,32,25,0,57
"24386",1024386,131,39,18,188
"24387",1024387,103,75,9,187
"24388",1024388,139,148,0,287
"24389",1024389,131,51,5,187
"24390",1024390,75,133,10,218
"24391",1024391,99,129,10,238
"24392",1024392,205,55,2,262
"24393",1024393,154,0,0,154
"24394",1024394,201,32,8,241
"24395",1024395,163,132,9,304
"24396",1024396,35,122,1,158
"24397",1024397,127,26,3,156
"24398",1024398,139,65,4,208
"24399",1024399,167,109,21,297
"24400",1024400,107,110,16,233
"24401",1024401,3,3,1,7
"24402",1024402,103,148,5,256
"24403",1024403,54,181,8,243
"24404",1024404,72,144,4,220
"24405",1024405,145,131,9,285
"24406",1024406,123,21,9,153
"24407",1024407,150,99,3,252
"24408",1024408,7,34,1,42
"24409",1024409,86,125,26,237
"24410",1024410,92,121,16,229
"24411",1024411,95,88,16,199
"24412",1024412,61,131,6,198
"24413",1024413,69,171,23,263
"24414",1024414,129,57,5,191
"24415",1024415,75,181,3,259
"24416",1024416,146,40,7,193
"24417",1024417,236,29,5,270
"24418",1024418,74,57,2,133
"24419",1024419,239,96,8,343
"24420",1024420,45,102,10,157
"24421",1024421,83,179,12,274
"24422",1024422,42,5,2,49
"24423",1024423,184,97,12,293
"24424",1024424,51,77,1,129
"24425",1024425,143,100,5,248
"24426",1024426,99,61,14,174
"24427",1024427,127,27,4,158
"24428",1024428,129,96,5,230
"24429",1024429,75,159,7,241
"24430",1024430,28,221,9,258
"24431",1024431,132,53,7,192
"24432",1024432,85,128,7,220
"24433",1024433,89,174,13,276
"24434",1024434,72,144,5,221
"24435",1024435,43,118,5,166
"24436",1024436,42,209,15,266
"24437",1024437,139,107,20,266
"24438",1024438,14,24,1,39
"24439",1024439,106,2,0,108
"24440",1024440,144,35,15,194
"24441",1024441,50,136,4,190
"24442",1024442,49,38,1,88
"24443",1024443,87,198,5,290
"24444",1024444,44,209,6,259
"24445",1024445,122,7,5,134
"24446",1024446,164,32,9,205
"24447",1024447,113,234,8,355
"24448",1024448,164,56,4,224
"24449",1024449,149,81,16,246
"24450",1024450,183,84,11,278
"24451",1024451,137,104,3,244
"24452",1024452,94,26,8,128
"24453",1024453,21,71,1,93
"24454",1024454,204,39,4,247
"24455",1024455,60,178,5,243
"24456",1024456,176,59,7,242
"24457",1024457,133,69,1,203
"24458",1024458,100,39,7,146
"24459",1024459,74,26,5,105
"24460",1024460,53,217,3,273
"24461",1024461,153,73,5,231
"24462",1024462,83,32,2,117
"24463",1024463,106,153,16,275
"24464",1024464,128,107,15,250
"24465",1024465,47,171,2,220
"24466",1024466,48,148,7,203
"24467",1024467,98,29,6,133
"24468",1024468,179,4,2,185
"24469",1024469,22,153,22,197
"24470",1024470,35,241,8,284
"24471",1024471,23,19,4,46
"24472",1024472,120,47,8,175
"24473",1024473,213,28,6,247
"24474",1024474,98,65,4,167
"24475",1024475,150,41,10,201
"24476",1024476,188,36,2,226
"24477",1024477,203,78,3,284
"24478",1024478,41,161,3,205
"24479",1024479,96,162,7,265
"24480",1024480,133,100,12,245
"24481",1024481,227,118,24,369
"24482",1024482,62,201,5,268
"24483",1024483,173,127,9,309
"24484",1024484,28,22,3,53
"24485",1024485,60,217,13,290
"24486",1024486,101,44,2,147
"24487",1024487,85,152,21,258
"24488",1024488,204,55,5,264
"24489",1024489,36,86,4,126
"24490",1024490,50,49,5,104
"24491",1024491,117,137,5,259
"24492",1024492,186,68,8,262
"24493",1024493,96,76,6,178
"24494",1024494,47,89,1,137
"24495",1024495,35,240,8,283
"24496",1024496,90,129,11,230
"24497",1024497,46,257,6,309
"24498",1024498,39,199,5,243
"24499",1024499,43,98,8,149
"24500",1024500,85,76,9,170
"24501",1024501,222,29,10,261
"24502",1024502,148,97,7,252
"24503",1024503,204,29,4,237
"24504",1024504,99,172,15,286
"24505",1024505,131,140,10,281
"24506",1024506,171,66,11,248
"24507",1024507,108,44,2,154
"24508",1024508,13,216,1,230
"24509",1024509,145,43,0,188
"24510",1024510,194,60,12,266
"24511",1024511,75,6,1,82
"24512",1024512,195,67,10,272
"24513",1024513,140,33,3,176
"24514",1024514,80,141,18,239
"24515",1024515,145,61,8,214
"24516",1024516,186,132,3,321
"24517",1024517,69,164,31,264
"24518",1024518,148,165,7,320
"24519",1024519,306,10,0,316
"24520",1024520,137,87,13,237
"24521",1024521,63,284,4,351
"24522",1024522,260,74,14,348
"24523",1024523,43,135,6,184
"24524",1024524,146,66,6,218
"24525",1024525,96,83,2,181
"24526",1024526,201,38,10,249
"24527",1024527,191,27,8,226
"24528",1024528,144,133,12,289
"24529",1024529,33,190,11,234
"24530",1024530,25,29,2,56
"24531",1024531,189,50,12,251
"24532",1024532,242,37,7,286
"24533",1024533,50,119,8,177
"24534",1024534,117,58,11,186
"24535",1024535,142,91,8,241
"24536",1024536,73,213,12,298
"24537",1024537,105,93,4,202
"24538",1024538,127,7,2,136
"24539",1024539,118,18,4,140
"24540",1024540,136,26,5,167
"24541",1024541,194,11,5,210
"24542",1024542,163,105,16,284
"24543",1024543,74,240,7,321
"24544",1024544,230,89,13,332
"24545",1024545,41,125,14,180
"24546",1024546,102,108,5,215
"24547",1024547,87,179,14,280
"24548",1024548,5,2,1,8
"24549",1024549,38,224,18,280
"24550",1024550,63,25,8,96
"24551",1024551,74,64,7,145
"24552",1024552,154,43,12,209
"24553",1024553,33,231,4,268
"24554",1024554,23,14,0,37
"24555",1024555,9,208,4,221
"24556",1024556,140,119,2,261
"24557",1024557,12,65,1,78
"24558",1024558,114,114,18,246
"24559",1024559,158,122,1,281
"24560",1024560,9,31,2,42
"24561",1024561,97,183,8,288
"24562",1024562,10,17,1,28
"24563",1024563,145,142,17,304
"24564",1024564,26,93,4,123
"24565",1024565,183,43,12,238
"24566",1024566,65,240,0,305
"24567",1024567,134,50,12,196
"24568",1024568,68,134,8,210
"24569",1024569,147,63,6,216
"24570",1024570,140,15,6,161
"24571",1024571,205,66,12,283
"24572",1024572,150,71,13,234
"24573",1024573,145,55,10,210
"24574",1024574,209,103,11,323
"24575",1024575,23,240,2,265
"24576",1024576,6,234,4,244
"24577",1024577,27,118,10,155
"24578",1024578,151,176,18,345
"24579",1024579,148,72,5,225
"24580",1024580,136,84,12,232
"24581",1024581,135,99,18,252
"24582",1024582,187,33,24,244
"24583",1024583,51,173,14,238
"24584",1024584,216,24,3,243
"24585",1024585,67,214,1,282
"24586",1024586,188,44,4,236
"24587",1024587,140,64,4,208
"24588",1024588,56,223,11,290
"24589",1024589,106,128,19,253
"24590",1024590,90,93,6,189
"24591",1024591,49,253,3,305
"24592",1024592,87,109,21,217
"24593",1024593,64,143,8,215
"24594",1024594,92,177,3,272
"24595",1024595,92,139,5,236
"24596",1024596,155,118,6,279
"24597",1024597,203,87,9,299
"24598",1024598,192,47,13,252
"24599",1024599,174,85,7,266
"24600",1024600,69,155,12,236
"24601",1024601,45,127,13,185
"24602",1024602,87,196,6,289
"24603",1024603,193,36,8,237
"24604",1024604,174,59,10,243
"24605",1024605,207,118,20,345
"24606",1024606,99,56,10,165
"24607",1024607,147,83,12,242
"24608",1024608,24,109,0,133
"24609",1024609,130,67,5,202
"24610",1024610,82,189,18,289
"24611",1024611,40,93,4,137
"24612",1024612,203,13,3,219
"24613",1024613,177,85,7,269
"24614",1024614,240,47,4,291
"24615",1024615,94,190,10,294
"24616",1024616,79,92,5,176
"24617",1024617,166,80,9,255
"24618",1024618,15,2,0,17
"24619",1024619,129,13,6,148
"24620",1024620,94,3,1,98
"24621",1024621,166,101,12,279
"24622",1024622,196,92,22,310
"24623",1024623,56,50,3,109
"24624",1024624,167,45,7,219
"24625",1024625,76,167,14,257
"24626",1024626,16,190,6,212
"24627",1024627,37,18,0,55
"24628",1024628,172,76,9,257
"24629",1024629,175,84,13,272
"24630",1024630,52,98,3,153
"24631",1024631,73,174,10,257
"24632",1024632,193,17,5,215
"24633",1024633,87,82,13,182
"24634",1024634,69,27,3,99
"24635",1024635,45,145,12,202
"24636",1024636,54,181,10,245
"24637",1024637,25,201,2,228
"24638",1024638,53,34,10,97
"24639",1024639,125,42,6,173
"24640",1024640,169,55,6,230
"24641",1024641,21,29,1,51
"24642",1024642,18,28,2,48
"24643",1024643,73,238,2,313
"24644",1024644,205,48,15,268
"24645",1024645,154,152,13,319
"24646",1024646,164,68,7,239
"24647",1024647,160,77,7,244
"24648",1024648,105,95,2,202
"24649",1024649,42,167,2,211
"24650",1024650,218,53,4,275
"24651",1024651,59,34,9,102
"24652",1024652,71,152,12,235
"24653",1024653,109,190,5,304
"24654",1024654,123,75,8,206
"24655",1024655,99,191,12,302
"24656",1024656,79,10,2,91
"24657",1024657,44,178,15,237
"24658",1024658,57,61,4,122
"24659",1024659,79,193,12,284
"24660",1024660,28,173,4,205
"24661",1024661,94,84,17,195
"24662",1024662,190,38,9,237
"24663",1024663,166,30,8,204
"24664",1024664,199,17,9,225
"24665",1024665,180,15,6,201
"24666",1024666,30,74,1,105
"24667",1024667,67,169,6,242
"24668",1024668,128,30,6,164
"24669",1024669,197,37,11,245
"24670",1024670,156,28,3,187
"24671",1024671,151,62,31,244
"24672",1024672,104,49,1,154
"24673",1024673,44,246,6,296
"24674",1024674,63,210,12,285
"24675",1024675,70,214,20,304
"24676",1024676,3,4,0,7
"24677",1024677,49,230,7,286
"24678",1024678,193,69,17,279
"24679",1024679,96,46,4,146
"24680",1024680,123,90,13,226
"24681",1024681,120,116,13,249
"24682",1024682,76,153,12,241
"24683",1024683,115,14,4,133
"24684",1024684,106,85,6,197
"24685",1024685,54,247,19,320
"24686",1024686,193,28,6,227
"24687",1024687,226,31,9,266
"24688",1024688,194,36,9,239
"24689",1024689,185,67,5,257
"24690",1024690,85,186,10,281
"24691",1024691,89,34,4,127
"24692",1024692,201,13,6,220
"24693",1024693,67,145,24,236
"24694",1024694,180,64,3,247
"24695",1024695,196,26,8,230
"24696",1024696,129,149,26,304
"24697",1024697,77,49,7,133
"24698",1024698,121,36,6,163
"24699",1024699,156,66,7,229
"24700",1024700,92,128,4,224
"24701",1024701,114,51,8,173
"24702",1024702,70,6,2,78
"24703",1024703,28,6,1,35
"24704",1024704,108,2,1,111
"24705",1024705,11,2,0,13
"24706",1024706,137,105,11,253
"24707",1024707,129,81,9,219
"24708",1024708,136,60,6,202
"24709",1024709,165,86,17,268
"24710",1024710,53,13,5,71
"24711",1024711,124,101,11,236
"24712",1024712,89,181,12,282
"24713",1024713,194,105,14,313
"24714",1024714,196,34,10,240
"24715",1024715,236,2,2,240
"24716",1024716,154,47,6,207
"24717",1024717,228,38,9,275
"24718",1024718,43,173,6,222
"24719",1024719,149,49,7,205
"24720",1024720,127,103,9,239
"24721",1024721,54,12,2,68
"24722",1024722,247,2,1,250
"24723",1024723,63,14,6,83
"24724",1024724,87,161,7,255
"24725",1024725,92,167,11,270
"24726",1024726,61,190,8,259
"24727",1024727,179,69,2,250
"24728",1024728,113,62,2,177
"24729",1024729,5,20,0,25
"24730",1024730,192,55,12,259
"24731",1024731,146,143,13,302
"24732",1024732,113,45,5,163
"24733",1024733,82,155,8,245
"24734",1024734,12,368,2,382
"24735",1024735,162,123,16,301
"24736",1024736,145,6,2,153
"24737",1024737,129,79,4,212
"24738",1024738,211,95,23,329
"24739",1024739,5,1,0,6
"24740",1024740,130,76,8,214
"24741",1024741,7,27,1,35
"24742",1024742,139,99,15,253
"24743",1024743,7,118,4,129
"24744",1024744,59,159,1,219
"24745",1024745,202,66,24,292
"24746",1024746,43,16,4,63
"24747",1024747,12,39,1,52
"24748",1024748,114,77,9,200
"24749",1024749,181,37,9,227
"24750",1024750,192,12,6,210
"24751",1024751,148,125,10,283
"24752",1024752,104,123,5,232
"24753",1024753,77,209,6,292
"24754",1024754,10,169,5,184
"24755",1024755,84,61,3,148
"24756",1024756,149,137,22,308
"24757",1024757,172,56,6,234
"24758",1024758,149,16,4,169
"24759",1024759,20,5,1,26
"24760",1024760,99,53,5,157
"24761",1024761,161,61,6,228
"24762",1024762,231,89,14,334
"24763",1024763,147,100,13,260
"24764",1024764,32,130,3,165
"24765",1024765,13,7,0,20
"24766",1024766,161,92,5,258
"24767",1024767,104,31,2,137
"24768",1024768,77,91,12,180
"24769",1024769,122,75,5,202
"24770",1024770,186,50,5,241
"24771",1024771,79,106,6,191
"24772",1024772,19,223,3,245
"24773",1024773,105,37,5,147
"24774",1024774,19,18,3,40
"24775",1024775,213,1,3,217
"24776",1024776,85,31,1,117
"24777",1024777,111,110,6,227
"24778",1024778,115,55,3,173
"24779",1024779,142,179,12,333
"24780",1024780,103,63,20,186
"24781",1024781,138,41,3,182
"24782",1024782,75,189,16,280
"24783",1024783,76,101,3,180
"24784",1024784,105,43,4,152
"24785",1024785,105,2,3,110
"24786",1024786,177,83,10,270
"24787",1024787,123,20,5,148
"24788",1024788,88,10,2,100
"24789",1024789,62,117,12,191
"24790",1024790,63,88,4,155
"24791",1024791,243,45,13,301
"24792",1024792,53,60,4,117
"24793",1024793,56,210,4,270
"24794",1024794,244,32,7,283
"24795",1024795,102,37,4,143
"24796",1024796,79,86,10,175
"24797",1024797,46,57,1,104
"24798",1024798,106,180,9,295
"24799",1024799,112,200,6,318
"24800",1024800,95,15,2,112
"24801",1024801,41,78,7,126
"24802",1024802,161,76,17,254
"24803",1024803,76,83,5,164
"24804",1024804,39,156,4,199
"24805",1024805,125,59,12,196
"24806",1024806,80,157,13,250
"24807",1024807,126,173,7,306
"24808",1024808,112,89,3,204
"24809",1024809,79,141,3,223
"24810",1024810,33,216,12,261
"24811",1024811,21,236,5,262
"24812",1024812,6,3,0,9
"24813",1024813,237,45,6,288
"24814",1024814,162,58,5,225
"24815",1024815,86,214,3,303
"24816",1024816,114,108,6,228
"24817",1024817,255,109,14,378
"24818",1024818,78,96,5,179
"24819",1024819,39,232,17,288
"24820",1024820,251,61,7,319
"24821",1024821,43,234,8,285
"24822",1024822,7,1,0,8
"24823",1024823,190,101,5,296
"24824",1024824,88,162,11,261
"24825",1024825,147,9,1,157
"24826",1024826,35,271,9,315
"24827",1024827,93,69,11,173
"24828",1024828,109,44,6,159
"24829",1024829,83,151,8,242
"24830",1024830,46,44,0,90
"24831",1024831,63,207,7,277
"24832",1024832,59,244,4,307
"24833",1024833,79,126,9,214
"24834",1024834,118,139,14,271
"24835",1024835,142,127,19,288
"24836",1024836,122,93,7,222
"24837",1024837,176,77,4,257
"24838",1024838,77,88,12,177
"24839",1024839,211,34,8,253
"24840",1024840,34,51,3,88
"24841",1024841,56,81,2,139
"24842",1024842,104,201,3,308
"24843",1024843,115,100,8,223
"24844",1024844,38,246,8,292
"24845",1024845,169,10,2,181
"24846",1024846,10,1,0,11
"24847",1024847,157,93,6,256
"24848",1024848,57,48,3,108
"24849",1024849,129,79,2,210
"24850",1024850,28,294,7,329
"24851",1024851,99,169,19,287
"24852",1024852,102,30,3,135
"24853",1024853,122,89,16,227
"24854",1024854,159,99,15,273
"24855",1024855,83,42,2,127
"24856",1024856,206,31,7,244
"24857",1024857,223,13,4,240
"24858",1024858,28,206,6,240
"24859",1024859,124,129,11,264
"24860",1024860,207,79,13,299
"24861",1024861,186,74,13,273
"24862",1024862,190,31,5,226
"24863",1024863,220,84,13,317
"24864",1024864,58,220,5,283
"24865",1024865,210,18,8,236
"24866",1024866,58,230,7,295
"24867",1024867,18,238,1,257
"24868",1024868,141,10,3,154
"24869",1024869,7,1,2,10
"24870",1024870,85,201,9,295
"24871",1024871,69,181,11,261
"24872",1024872,134,94,18,246
"24873",1024873,151,116,7,274
"24874",1024874,146,61,11,218
"24875",1024875,68,84,7,159
"24876",1024876,93,26,1,120
"24877",1024877,96,96,18,210
"24878",1024878,177,53,7,237
"24879",1024879,116,74,11,201
"24880",1024880,154,129,1,284
"24881",1024881,65,250,8,323
"24882",1024882,176,31,11,218
"24883",1024883,180,101,16,297
"24884",1024884,109,155,2,266
"24885",1024885,41,268,6,315
"24886",1024886,192,105,14,311
"24887",1024887,134,99,1,234
"24888",1024888,68,64,1,133
"24889",1024889,21,276,5,302
"24890",1024890,89,78,4,171
"24891",1024891,124,89,3,216
"24892",1024892,203,69,8,280
"24893",1024893,119,100,2,221
"24894",1024894,44,146,12,202
"24895",1024895,91,203,17,311
"24896",1024896,87,177,4,268
"24897",1024897,178,4,2,184
"24898",1024898,18,85,3,106
"24899",1024899,160,125,13,298
"24900",1024900,149,51,4,204
"24901",1024901,81,75,3,159
"24902",1024902,37,51,5,93
"24903",1024903,58,28,2,88
"24904",1024904,185,62,5,252
"24905",1024905,54,135,5,194
"24906",1024906,101,65,4,170
"24907",1024907,27,5,2,34
"24908",1024908,127,51,2,180
"24909",1024909,225,76,13,314
"24910",1024910,127,88,1,216
"24911",1024911,183,81,8,272
"24912",1024912,114,127,10,251
"24913",1024913,182,97,7,286
"24914",1024914,64,265,12,341
"24915",1024915,138,132,5,275
"24916",1024916,84,124,35,243
"24917",1024917,4,7,1,12
"24918",1024918,105,94,4,203
"24919",1024919,170,80,9,259
"24920",1024920,27,50,1,78
"24921",1024921,31,187,4,222
"24922",1024922,135,125,12,272
"24923",1024923,120,167,6,293
"24924",1024924,143,69,8,220
"24925",1024925,205,29,9,243
"24926",1024926,169,110,16,295
"24927",1024927,165,49,12,226
"24928",1024928,76,159,18,253
"24929",1024929,96,60,1,157
"24930",1024930,76,203,11,290
"24931",1024931,10,210,5,225
"24932",1024932,100,66,7,173
"24933",1024933,136,196,11,343
"24934",1024934,154,62,7,223
"24935",1024935,206,54,6,266
"24936",1024936,50,101,2,153
"24937",1024937,213,21,8,242
"24938",1024938,47,223,10,280
"24939",1024939,231,71,26,328
"24940",1024940,150,64,9,223
"24941",1024941,33,228,7,268
"24942",1024942,67,211,8,286
"24943",1024943,151,87,8,246
"24944",1024944,84,210,5,299
"24945",1024945,59,254,11,324
"24946",1024946,20,0,2,22
"24947",1024947,166,86,14,266
"24948",1024948,112,235,8,355
"24949",1024949,68,132,8,208
"24950",1024950,136,68,11,215
"24951",1024951,29,10,2,41
"24952",1024952,82,52,8,142
"24953",1024953,18,156,2,176
"24954",1024954,110,86,9,205
"24955",1024955,68,250,10,328
"24956",1024956,105,122,0,227
"24957",1024957,57,229,2,288
"24958",1024958,153,71,14,238
"24959",1024959,165,88,12,265
"24960",1024960,105,74,7,186
"24961",1024961,111,54,15,180
"24962",1024962,164,55,7,226
"24963",1024963,36,11,5,52
"24964",1024964,179,53,7,239
"24965",1024965,55,212,10,277
"24966",1024966,174,117,20,311
"24967",1024967,124,145,8,277
"24968",1024968,30,281,6,317
"24969",1024969,78,111,6,195
"24970",1024970,80,109,8,197
"24971",1024971,28,106,6,140
"24972",1024972,17,1,1,19
"24973",1024973,111,27,3,141
"24974",1024974,92,160,9,261
"24975",1024975,103,82,5,190
"24976",1024976,45,202,5,252
"24977",1024977,26,215,5,246
"24978",1024978,169,27,2,198
"24979",1024979,142,74,7,223
"24980",1024980,214,18,3,235
"24981",1024981,51,241,6,298
"24982",1024982,80,158,9,247
"24983",1024983,103,110,6,219
"24984",1024984,84,68,1,153
"24985",1024985,214,28,3,245
"24986",1024986,41,39,4,84
"24987",1024987,227,32,3,262
"24988",1024988,49,202,16,267
"24989",1024989,40,202,2,244
"24990",1024990,113,16,3,132
"24991",1024991,185,31,12,228
"24992",1024992,72,176,6,254
"24993",1024993,135,93,7,235
"24994",1024994,3,24,0,27
"24995",1024995,90,169,11,270
"24996",1024996,48,284,6,338
"24997",1024997,51,234,9,294
"24998",1024998,185,110,5,300
"24999",1024999,33,14,1,48
"25000",1025000,56,162,17,235
"25001",1025001,111,194,14,319
"25002",1025002,159,111,14,284
"25003",1025003,80,143,3,226
"25004",1025004,38,251,13,302
"25005",1025005,111,42,7,160
"25006",1025006,62,220,8,290
"25007",1025007,27,82,7,116
"25008",1025008,152,186,5,343
"25009",1025009,83,106,4,193
"25010",1025010,75,168,3,246
"25011",1025011,152,118,18,288
"25012",1025012,44,235,2,281
"25013",1025013,223,32,12,267
"25014",1025014,39,163,12,214
"25015",1025015,187,56,1,244
"25016",1025016,120,106,4,230
"25017",1025017,73,141,8,222
"25018",1025018,68,184,15,267
"25019",1025019,223,82,15,320
"25020",1025020,79,167,12,258
"25021",1025021,111,63,2,176
"25022",1025022,140,73,6,219
"25023",1025023,49,172,2,223
"25024",1025024,113,140,7,260
"25025",1025025,188,44,7,239
"25026",1025026,121,104,2,227
"25027",1025027,147,11,1,159
"25028",1025028,124,71,3,198
"25029",1025029,22,111,4,137
"25030",1025030,77,81,2,160
"25031",1025031,139,67,12,218
"25032",1025032,106,46,5,157
"25033",1025033,109,104,12,225
"25034",1025034,96,152,8,256
"25035",1025035,145,124,14,283
"25036",1025036,59,175,5,239
"25037",1025037,91,122,5,218
"25038",1025038,87,187,0,274
"25039",1025039,231,37,8,276
"25040",1025040,193,46,8,247
"25041",1025041,22,243,1,266
"25042",1025042,166,56,12,234
"25043",1025043,94,152,3,249
"25044",1025044,40,225,7,272
"25045",1025045,73,159,6,238
"25046",1025046,198,15,2,215
"25047",1025047,22,85,1,108
"25048",1025048,46,65,3,114
"25049",1025049,15,0,0,15
"25050",1025050,69,136,12,217
"25051",1025051,108,138,16,262
"25052",1025052,49,128,9,186
"25053",1025053,172,45,6,223
"25054",1025054,40,123,3,166
"25055",1025055,187,57,7,251
"25056",1025056,21,15,1,37
"25057",1025057,50,132,1,183
"25058",1025058,54,278,4,336
"25059",1025059,130,83,11,224
"25060",1025060,172,112,8,292
"25061",1025061,99,136,9,244
"25062",1025062,157,87,9,253
"25063",1025063,35,218,0,253
"25064",1025064,143,55,9,207
"25065",1025065,105,65,4,174
"25066",1025066,161,51,20,232
"25067",1025067,67,107,10,184
"25068",1025068,95,151,20,266
"25069",1025069,154,135,1,290
"25070",1025070,82,174,11,267
"25071",1025071,131,148,12,291
"25072",1025072,26,141,2,169
"25073",1025073,76,43,6,125
"25074",1025074,65,126,1,192
"25075",1025075,158,100,7,265
"25076",1025076,94,191,5,290
"25077",1025077,141,92,5,238
"25078",1025078,163,30,11,204
"25079",1025079,95,161,9,265
"25080",1025080,61,141,6,208
"25081",1025081,140,110,9,259
"25082",1025082,201,66,18,285
"25083",1025083,9,18,3,30
"25084",1025084,45,220,8,273
"25085",1025085,116,99,15,230
"25086",1025086,126,46,4,176
"25087",1025087,188,37,1,226
"25088",1025088,59,245,20,324
"25089",1025089,45,263,3,311
"25090",1025090,185,68,8,261
"25091",1025091,163,127,7,297
"25092",1025092,158,91,11,260
"25093",1025093,119,140,4,263
"25094",1025094,137,72,5,214
"25095",1025095,39,261,1,301
"25096",1025096,9,37,4,50
"25097",1025097,91,230,4,325
"25098",1025098,109,47,3,159
"25099",1025099,101,148,8,257
"25100",1025100,159,102,9,270
"25101",1025101,12,112,15,139
"25102",1025102,97,177,6,280
"25103",1025103,117,101,9,227
"25104",1025104,69,67,3,139
"25105",1025105,137,96,23,256
"25106",1025106,114,109,6,229
"25107",1025107,55,23,5,83
"25108",1025108,145,67,1,213
"25109",1025109,90,67,5,162
"25110",1025110,220,66,13,299
"25111",1025111,138,49,5,192
"25112",1025112,112,106,1,219
"25113",1025113,64,220,10,294
"25114",1025114,57,178,8,243
"25115",1025115,97,219,7,323
"25116",1025116,96,141,15,252
"25117",1025117,162,85,10,257
"25118",1025118,101,89,1,191
"25119",1025119,89,202,7,298
"25120",1025120,172,69,5,246
"25121",1025121,23,134,5,162
"25122",1025122,119,49,7,175
"25123",1025123,39,239,11,289
"25124",1025124,128,80,16,224
"25125",1025125,46,10,1,57
"25126",1025126,12,16,1,29
"25127",1025127,153,43,3,199
"25128",1025128,55,126,2,183
"25129",1025129,203,43,8,254
"25130",1025130,53,153,11,217
"25131",1025131,116,107,17,240
"25132",1025132,189,84,21,294
"25133",1025133,167,81,16,264
"25134",1025134,178,33,11,222
"25135",1025135,169,81,14,264
"25136",1025136,109,178,6,293
"25137",1025137,45,253,12,310
"25138",1025138,64,123,4,191
"25139",1025139,62,122,11,195
"25140",1025140,13,12,1,26
"25141",1025141,31,61,1,93
"25142",1025142,73,122,2,197
"25143",1025143,96,138,15,249
"25144",1025144,30,20,2,52
"25145",1025145,107,17,0,124
"25146",1025146,176,10,17,203
"25147",1025147,20,152,4,176
"25148",1025148,130,50,6,186
"25149",1025149,180,79,16,275
"25150",1025150,55,176,1,232
"25151",1025151,117,134,13,264
"25152",1025152,161,120,8,289
"25153",1025153,83,141,9,233
"25154",1025154,162,145,9,316
"25155",1025155,79,97,3,179
"25156",1025156,98,57,7,162
"25157",1025157,83,172,16,271
"25158",1025158,25,229,7,261
"25159",1025159,173,18,9,200
"25160",1025160,96,165,25,286
"25161",1025161,157,104,10,271
"25162",1025162,76,221,23,320
"25163",1025163,109,140,11,260
"25164",1025164,120,15,16,151
"25165",1025165,126,29,4,159
"25166",1025166,216,29,5,250
"25167",1025167,193,12,6,211
"25168",1025168,72,136,12,220
"25169",1025169,141,52,11,204
"25170",1025170,30,232,5,267
"25171",1025171,193,20,3,216
"25172",1025172,98,109,8,215
"25173",1025173,173,96,15,284
"25174",1025174,92,97,2,191
"25175",1025175,170,14,2,186
"25176",1025176,193,33,7,233
"25177",1025177,122,127,12,261
"25178",1025178,129,61,8,198
"25179",1025179,193,44,15,252
"25180",1025180,189,14,4,207
"25181",1025181,154,106,19,279
"25182",1025182,153,87,7,247
"25183",1025183,49,202,8,259
"25184",1025184,202,4,2,208
"25185",1025185,97,46,6,149
"25186",1025186,157,148,12,317
"25187",1025187,117,10,1,128
"25188",1025188,122,85,11,218
"25189",1025189,107,158,5,270
"25190",1025190,170,44,8,222
"25191",1025191,237,52,2,291
"25192",1025192,85,13,2,100
"25193",1025193,163,39,3,205
"25194",1025194,4,3,1,8
"25195",1025195,288,21,5,314
"25196",1025196,94,162,14,270
"25197",1025197,38,35,0,73
"25198",1025198,104,71,12,187
"25199",1025199,94,104,10,208
"25200",1025200,229,16,4,249
"25201",1025201,15,190,6,211
"25202",1025202,91,147,7,245
"25203",1025203,132,115,8,255
"25204",1025204,51,121,8,180
"25205",1025205,165,63,8,236
"25206",1025206,105,125,14,244
"25207",1025207,176,53,7,236
"25208",1025208,180,28,6,214
"25209",1025209,183,91,21,295
"25210",1025210,164,69,0,233
"25211",1025211,240,28,2,270
"25212",1025212,200,81,10,291
"25213",1025213,9,40,0,49
"25214",1025214,109,27,5,141
"25215",1025215,161,88,10,259
"25216",1025216,59,269,8,336
"25217",1025217,109,166,15,290
"25218",1025218,55,161,10,226
"25219",1025219,176,33,14,223
"25220",1025220,162,55,4,221
"25221",1025221,46,246,5,297
"25222",1025222,129,97,5,231
"25223",1025223,56,10,3,69
"25224",1025224,120,126,2,248
"25225",1025225,243,21,6,270
"25226",1025226,38,199,8,245
"25227",1025227,186,84,14,284
"25228",1025228,182,33,6,221
"25229",1025229,145,87,14,246
"25230",1025230,208,33,8,249
"25231",1025231,195,43,8,246
"25232",1025232,259,60,10,329
"25233",1025233,186,82,5,273
"25234",1025234,110,127,9,246
"25235",1025235,202,72,17,291
"25236",1025236,78,68,6,152
"25237",1025237,5,31,0,36
"25238",1025238,116,8,0,124
"25239",1025239,149,28,5,182
"25240",1025240,38,257,4,299
"25241",1025241,88,190,18,296
"25242",1025242,46,25,6,77
"25243",1025243,182,78,2,262
"25244",1025244,111,154,15,280
"25245",1025245,43,37,1,81
"25246",1025246,120,406,31,557
"25247",1025247,35,16,1,52
"25248",1025248,150,131,16,297
"25249",1025249,158,110,14,282
"25250",1025250,151,161,14,326
"25251",1025251,118,160,19,297
"25252",1025252,120,135,7,262
"25253",1025253,35,57,2,94
"25254",1025254,47,139,7,193
"25255",1025255,61,143,23,227
"25256",1025256,57,14,1,72
"25257",1025257,95,29,7,131
"25258",1025258,42,93,0,135
"25259",1025259,187,79,9,275
"25260",1025260,149,123,13,285
"25261",1025261,128,39,13,180
"25262",1025262,110,173,9,292
"25263",1025263,165,53,7,225
"25264",1025264,12,2,2,16
"25265",1025265,46,168,24,238
"25266",1025266,69,95,6,170
"25267",1025267,123,75,9,207
"25268",1025268,112,195,14,321
"25269",1025269,179,44,4,227
"25270",1025270,197,71,3,271
"25271",1025271,146,63,7,216
"25272",1025272,80,187,1,268
"25273",1025273,178,109,23,310
"25274",1025274,33,266,8,307
"25275",1025275,111,114,12,237
"25276",1025276,50,120,15,185
"25277",1025277,125,164,13,302
"25278",1025278,50,207,11,268
"25279",1025279,71,42,2,115
"25280",1025280,17,147,3,167
"25281",1025281,87,55,11,153
"25282",1025282,48,198,2,248
"25283",1025283,86,148,2,236
"25284",1025284,216,66,16,298
"25285",1025285,72,195,9,276
"25286",1025286,103,53,8,164
"25287",1025287,215,23,8,246
"25288",1025288,172,69,4,245
"25289",1025289,91,246,3,340
"25290",1025290,59,148,7,214
"25291",1025291,117,58,5,180
"25292",1025292,140,101,9,250
"25293",1025293,62,137,3,202
"25294",1025294,33,210,3,246
"25295",1025295,194,4,13,211
"25296",1025296,156,141,14,311
"25297",1025297,61,188,10,259
"25298",1025298,142,42,2,186
"25299",1025299,24,277,9,310
"25300",1025300,161,126,4,291
"25301",1025301,3,6,1,10
"25302",1025302,149,60,5,214
"25303",1025303,190,24,9,223
"25304",1025304,227,16,4,247
"25305",1025305,150,92,11,253
"25306",1025306,78,33,2,113
"25307",1025307,71,189,11,271
"25308",1025308,89,41,1,131
"25309",1025309,90,133,2,225
"25310",1025310,180,62,4,246
"25311",1025311,176,29,17,222
"25312",1025312,133,186,6,325
"25313",1025313,12,3,2,17
"25314",1025314,61,167,7,235
"25315",1025315,37,219,13,269
"25316",1025316,60,139,10,209
"25317",1025317,123,167,11,301
"25318",1025318,23,142,3,168
"25319",1025319,80,122,5,207
"25320",1025320,111,178,16,305
"25321",1025321,30,0,0,30
"25322",1025322,209,27,14,250
"25323",1025323,107,24,4,135
"25324",1025324,160,93,8,261
"25325",1025325,164,115,7,286
"25326",1025326,78,169,13,260
"25327",1025327,108,156,13,277
"25328",1025328,91,32,3,126
"25329",1025329,62,215,2,279
"25330",1025330,251,7,4,262
"25331",1025331,207,33,15,255
"25332",1025332,115,127,4,246
"25333",1025333,55,210,7,272
"25334",1025334,175,20,7,202
"25335",1025335,58,127,4,189
"25336",1025336,30,224,4,258
"25337",1025337,110,135,14,259
"25338",1025338,141,73,5,219
"25339",1025339,95,134,10,239
"25340",1025340,217,72,6,295
"25341",1025341,131,47,3,181
"25342",1025342,115,103,9,227
"25343",1025343,162,111,15,288
"25344",1025344,224,73,5,302
"25345",1025345,136,43,7,186
"25346",1025346,43,1,0,44
"25347",1025347,27,52,5,84
"25348",1025348,46,277,5,328
"25349",1025349,94,168,18,280
"25350",1025350,110,108,13,231
"25351",1025351,54,21,5,80
"25352",1025352,6,4,0,10
"25353",1025353,186,20,2,208
"25354",1025354,65,181,3,249
"25355",1025355,43,106,3,152
"25356",1025356,209,41,4,254
"25357",1025357,151,98,6,255
"25358",1025358,143,150,8,301
"25359",1025359,88,204,14,306
"25360",1025360,163,106,6,275
"25361",1025361,20,29,2,51
"25362",1025362,171,59,2,232
"25363",1025363,162,143,4,309
"25364",1025364,206,23,5,234
"25365",1025365,6,4,0,10
"25366",1025366,177,33,7,217
"25367",1025367,95,109,3,207
"25368",1025368,117,167,11,295
"25369",1025369,101,85,9,195
"25370",1025370,110,132,7,249
"25371",1025371,213,14,1,228
"25372",1025372,130,118,3,251
"25373",1025373,48,174,3,225
"25374",1025374,49,7,0,56
"25375",1025375,53,241,1,295
"25376",1025376,181,33,18,232
"25377",1025377,80,88,4,172
"25378",1025378,107,128,3,238
"25379",1025379,150,59,7,216
"25380",1025380,17,226,3,246
"25381",1025381,42,167,9,218
"25382",1025382,27,14,0,41
"25383",1025383,113,27,2,142
"25384",1025384,88,91,11,190
"25385",1025385,187,102,11,300
"25386",1025386,19,13,0,32
"25387",1025387,250,59,7,316
"25388",1025388,219,29,6,254
"25389",1025389,89,0,0,89
"25390",1025390,81,151,10,242
"25391",1025391,6,103,0,109
"25392",1025392,27,241,2,270
"25393",1025393,159,70,9,238
"25394",1025394,165,140,16,321
"25395",1025395,49,120,11,180
"25396",1025396,4,4,0,8
"25397",1025397,29,11,0,40
"25398",1025398,66,230,7,303
"25399",1025399,115,112,4,231
"25400",1025400,186,39,6,231
"25401",1025401,131,76,4,211
"25402",1025402,200,67,12,279
"25403",1025403,213,60,21,294
"25404",1025404,65,76,2,143
"25405",1025405,76,254,8,338
"25406",1025406,146,110,6,262
"25407",1025407,52,250,10,312
"25408",1025408,32,218,2,252
"25409",1025409,120,153,16,289
"25410",1025410,99,224,6,329
"25411",1025411,44,164,10,218
"25412",1025412,178,102,13,293
"25413",1025413,25,188,4,217
"25414",1025414,73,157,1,231
"25415",1025415,130,65,15,210
"25416",1025416,115,125,20,260
"25417",1025417,59,214,5,278
"25418",1025418,168,82,2,252
"25419",1025419,127,28,5,160
"25420",1025420,53,40,2,95
"25421",1025421,134,39,2,175
"25422",1025422,119,149,10,278
"25423",1025423,105,111,17,233
"25424",1025424,105,171,8,284
"25425",1025425,63,8,0,71
"25426",1025426,100,96,5,201
"25427",1025427,92,78,6,176
"25428",1025428,133,41,8,182
"25429",1025429,103,139,18,260
"25430",1025430,75,207,9,291
"25431",1025431,109,74,15,198
"25432",1025432,32,187,4,223
"25433",1025433,211,70,3,284
"25434",1025434,85,122,6,213
"25435",1025435,33,109,8,150
"25436",1025436,70,67,6,143
"25437",1025437,48,98,19,165
"25438",1025438,118,110,15,243
"25439",1025439,19,79,5,103
"25440",1025440,22,257,5,284
"25441",1025441,108,149,8,265
"25442",1025442,160,91,3,254
"25443",1025443,42,85,0,127
"25444",1025444,121,34,1,156
"25445",1025445,69,4,2,75
"25446",1025446,65,182,3,250
"25447",1025447,101,109,7,217
"25448",1025448,136,45,6,187
"25449",1025449,55,159,4,218
"25450",1025450,78,125,6,209
"25451",1025451,32,164,21,217
"25452",1025452,235,39,17,291
"25453",1025453,47,23,4,74
"25454",1025454,40,164,8,212
"25455",1025455,210,14,16,240
"25456",1025456,92,2,0,94
"25457",1025457,77,176,8,261
"25458",1025458,14,225,2,241
"25459",1025459,150,34,12,196
"25460",1025460,23,185,10,218
"25461",1025461,117,131,8,256
"25462",1025462,278,4,3,285
"25463",1025463,9,15,2,26
"25464",1025464,20,131,1,152
"25465",1025465,137,26,4,167
"25466",1025466,71,202,12,285
"25467",1025467,159,101,2,262
"25468",1025468,89,192,7,288
"25469",1025469,187,28,8,223
"25470",1025470,151,138,4,293
"25471",1025471,191,33,11,235
"25472",1025472,25,232,2,259
"25473",1025473,162,125,13,300
"25474",1025474,31,236,8,275
"25475",1025475,191,31,6,228
"25476",1025476,96,55,3,154
"25477",1025477,174,114,22,310
"25478",1025478,230,40,10,280
"25479",1025479,142,112,17,271
"25480",1025480,89,202,10,301
"25481",1025481,40,167,3,210
"25482",1025482,103,98,8,209
"25483",1025483,53,17,0,70
"25484",1025484,116,25,6,147
"25485",1025485,84,69,12,165
"25486",1025486,46,84,1,131
"25487",1025487,113,157,7,277
"25488",1025488,10,7,1,18
"25489",1025489,64,183,13,260
"25490",1025490,201,63,15,279
"25491",1025491,136,43,8,187
"25492",1025492,11,26,2,39
"25493",1025493,194,129,18,341
"25494",1025494,139,94,3,236
"25495",1025495,103,137,8,248
"25496",1025496,102,144,11,257
"25497",1025497,116,44,5,165
"25498",1025498,67,87,7,161
"25499",1025499,59,75,12,146
"25500",1025500,111,117,5,233
"25501",1025501,101,95,7,203
"25502",1025502,27,94,1,122
"25503",1025503,175,47,9,231
"25504",1025504,180,56,5,241
"25505",1025505,5,10,0,15
"25506",1025506,169,38,11,218
"25507",1025507,103,207,10,320
"25508",1025508,125,40,4,169
"25509",1025509,136,64,9,209
"25510",1025510,117,88,2,207
"25511",1025511,160,84,8,252
"25512",1025512,162,45,6,213
"25513",1025513,167,82,4,253
"25514",1025514,30,304,5,339
"25515",1025515,83,133,0,216
"25516",1025516,92,155,6,253
"25517",1025517,38,27,2,67
"25518",1025518,27,205,0,232
"25519",1025519,173,125,12,310
"25520",1025520,77,77,15,169
"25521",1025521,102,163,6,271
"25522",1025522,202,34,9,245
"25523",1025523,40,51,6,97
"25524",1025524,151,55,3,209
"25525",1025525,230,48,12,290
"25526",1025526,179,49,5,233
"25527",1025527,161,102,6,269
"25528",1025528,28,131,6,165
"25529",1025529,35,218,3,256
"25530",1025530,6,18,1,25
"25531",1025531,117,103,12,232
"25532",1025532,197,65,11,273
"25533",1025533,49,154,11,214
"25534",1025534,18,22,3,43
"25535",1025535,167,43,4,214
"25536",1025536,49,172,9,230
"25537",1025537,2,4,2,8
"25538",1025538,161,98,15,274
"25539",1025539,48,162,4,214
"25540",1025540,216,78,26,320
"25541",1025541,21,24,2,47
"25542",1025542,29,23,1,53
"25543",1025543,28,2,0,30
"25544",1025544,58,138,5,201
"25545",1025545,85,197,10,292
"25546",1025546,157,42,3,202
"25547",1025547,81,161,16,258
"25548",1025548,121,29,5,155
"25549",1025549,177,32,8,217
"25550",1025550,213,35,14,262
"25551",1025551,182,65,11,258
"25552",1025552,148,79,7,234
"25553",1025553,119,109,8,236
"25554",1025554,92,165,6,263
"25555",1025555,56,46,7,109
"25556",1025556,90,104,5,199
"25557",1025557,131,19,9,159
"25558",1025558,36,37,6,79
"25559",1025559,254,59,9,322
"25560",1025560,181,29,6,216
"25561",1025561,83,166,15,264
"25562",1025562,49,19,2,70
"25563",1025563,127,38,3,168
"25564",1025564,223,36,15,274
"25565",1025565,29,62,6,97
"25566",1025566,125,107,12,244
"25567",1025567,17,17,1,35
"25568",1025568,54,53,9,116
"25569",1025569,136,310,21,467
"25570",1025570,171,94,11,276
"25571",1025571,39,119,4,162
"25572",1025572,195,28,7,230
"25573",1025573,98,53,7,158
"25574",1025574,60,190,8,258
"25575",1025575,14,270,4,288
"25576",1025576,121,127,19,267
"25577",1025577,103,163,15,281
"25578",1025578,114,214,17,345
"25579",1025579,176,40,8,224
"25580",1025580,111,47,2,160
"25581",1025581,253,64,11,328
"25582",1025582,80,252,12,344
"25583",1025583,64,123,6,193
"25584",1025584,17,103,6,126
"25585",1025585,125,54,3,182
"25586",1025586,55,190,5,250
"25587",1025587,42,25,7,74
"25588",1025588,154,109,18,281
"25589",1025589,103,136,9,248
"25590",1025590,58,256,11,325
"25591",1025591,154,32,6,192
"25592",1025592,177,60,1,238
"25593",1025593,93,166,18,277
"25594",1025594,210,47,12,269
"25595",1025595,13,10,0,23
"25596",1025596,200,23,1,224
"25597",1025597,108,47,9,164
"25598",1025598,112,107,12,231
"25599",1025599,135,88,10,233
"25600",1025600,166,35,4,205
"25601",1025601,84,167,23,274
"25602",1025602,179,89,21,289
"25603",1025603,43,250,7,300
"25604",1025604,40,242,2,284
"25605",1025605,127,144,17,288
"25606",1025606,140,58,7,205
"25607",1025607,60,214,10,284
"25608",1025608,76,222,4,302
"25609",1025609,131,80,1,212
"25610",1025610,116,91,7,214
"25611",1025611,74,191,18,283
"25612",1025612,71,216,2,289
"25613",1025613,121,111,8,240
"25614",1025614,108,97,9,214
"25615",1025615,37,256,7,300
"25616",1025616,106,103,10,219
"25617",1025617,57,124,0,181
"25618",1025618,147,104,13,264
"25619",1025619,114,64,7,185
"25620",1025620,148,0,0,148
"25621",1025621,139,69,21,229
"25622",1025622,2,0,0,2
"25623",1025623,48,48,13,109
"25624",1025624,147,75,4,226
"25625",1025625,104,25,4,133
"25626",1025626,113,142,7,262
"25627",1025627,59,173,2,234
"25628",1025628,12,18,1,31
"25629",1025629,14,36,1,51
"25630",1025630,79,165,9,253
"25631",1025631,64,260,4,328
"25632",1025632,28,234,3,265
"25633",1025633,141,42,10,193
"25634",1025634,38,59,2,99
"25635",1025635,4,39,3,46
"25636",1025636,57,185,4,246
"25637",1025637,203,27,8,238
"25638",1025638,74,87,5,166
"25639",1025639,44,295,4,343
"25640",1025640,74,70,3,147
"25641",1025641,160,70,15,245
"25642",1025642,175,78,4,257
"25643",1025643,16,249,6,271
"25644",1025644,109,120,6,235
"25645",1025645,7,30,3,40
"25646",1025646,57,242,8,307
"25647",1025647,53,120,22,195
"25648",1025648,35,211,4,250
"25649",1025649,80,99,6,185
"25650",1025650,91,109,7,207
"25651",1025651,71,236,16,323
"25652",1025652,105,161,12,278
"25653",1025653,162,97,9,268
"25654",1025654,192,74,7,273
"25655",1025655,145,93,7,245
"25656",1025656,59,124,8,191
"25657",1025657,70,135,6,211
"25658",1025658,103,91,2,196
"25659",1025659,129,62,14,205
"25660",1025660,79,178,14,271
"25661",1025661,138,81,10,229
"25662",1025662,110,89,4,203
"25663",1025663,12,14,0,26
"25664",1025664,80,173,5,258
"25665",1025665,148,76,6,230
"25666",1025666,72,44,5,121
"25667",1025667,123,189,10,322
"25668",1025668,92,130,4,226
"25669",1025669,149,109,1,259
"25670",1025670,38,16,0,54
"25671",1025671,109,39,12,160
"25672",1025672,80,200,2,282
"25673",1025673,41,21,2,64
"25674",1025674,73,123,11,207
"25675",1025675,121,56,3,180
"25676",1025676,72,251,12,335
"25677",1025677,159,116,12,287
"25678",1025678,67,203,7,277
"25679",1025679,6,19,0,25
"25680",1025680,132,51,12,195
"25681",1025681,116,32,2,150
"25682",1025682,185,118,12,315
"25683",1025683,42,69,10,121
"25684",1025684,194,71,10,275
"25685",1025685,158,117,22,297
"25686",1025686,244,29,4,277
"25687",1025687,151,72,4,227
"25688",1025688,139,59,18,216
"25689",1025689,155,13,0,168
"25690",1025690,70,190,19,279
"25691",1025691,145,53,7,205
"25692",1025692,18,317,4,339
"25693",1025693,118,52,2,172
"25694",1025694,63,119,4,186
"25695",1025695,209,47,6,262
"25696",1025696,40,212,2,254
"25697",1025697,243,28,7,278
"25698",1025698,72,155,3,230
"25699",1025699,170,28,6,204
"25700",1025700,184,54,5,243
"25701",1025701,191,85,2,278
"25702",1025702,60,229,8,297
"25703",1025703,159,158,12,329
"25704",1025704,198,31,4,233
"25705",1025705,124,135,14,273
"25706",1025706,83,199,10,292
"25707",1025707,156,89,6,251
"25708",1025708,83,19,8,110
"25709",1025709,269,17,2,288
"25710",1025710,209,85,16,310
"25711",1025711,90,139,11,240
"25712",1025712,146,102,13,261
"25713",1025713,55,118,4,177
"25714",1025714,71,36,4,111
"25715",1025715,104,126,13,243
"25716",1025716,35,151,6,192
"25717",1025717,67,209,7,283
"25718",1025718,129,85,20,234
"25719",1025719,119,28,10,157
"25720",1025720,124,85,17,226
"25721",1025721,90,206,6,302
"25722",1025722,88,133,10,231
"25723",1025723,71,68,7,146
"25724",1025724,24,110,7,141
"25725",1025725,100,96,11,207
"25726",1025726,12,181,3,196
"25727",1025727,209,105,11,325
"25728",1025728,30,39,5,74
"25729",1025729,104,94,12,210
"25730",1025730,83,160,4,247
"25731",1025731,108,150,14,272
"25732",1025732,84,125,4,213
"25733",1025733,52,167,9,228
"25734",1025734,20,320,2,342
"25735",1025735,64,190,10,264
"25736",1025736,98,147,11,256
"25737",1025737,172,76,4,252
"25738",1025738,179,32,7,218
"25739",1025739,81,114,4,199
"25740",1025740,30,5,0,35
"25741",1025741,10,74,0,84
"25742",1025742,177,7,7,191
"25743",1025743,204,88,22,314
"25744",1025744,44,267,7,318
"25745",1025745,128,224,14,366
"25746",1025746,228,43,14,285
"25747",1025747,41,244,8,293
"25748",1025748,233,27,4,264
"25749",1025749,67,257,8,332
"25750",1025750,69,174,10,253
"25751",1025751,116,54,6,176
"25752",1025752,49,19,8,76
"25753",1025753,157,65,10,232
"25754",1025754,62,83,2,147
"25755",1025755,108,201,17,326
"25756",1025756,107,57,4,168
"25757",1025757,99,115,10,224
"25758",1025758,120,150,4,274
"25759",1025759,7,4,0,11
"25760",1025760,115,173,9,297
"25761",1025761,157,53,3,213
"25762",1025762,214,39,4,257
"25763",1025763,41,68,7,116
"25764",1025764,175,70,11,256
"25765",1025765,178,29,9,216
"25766",1025766,183,62,8,253
"25767",1025767,93,164,18,275
"25768",1025768,35,217,3,255
"25769",1025769,126,192,10,328
"25770",1025770,72,196,13,281
"25771",1025771,57,175,15,247
"25772",1025772,35,184,4,223
"25773",1025773,1,9,1,11
"25774",1025774,241,37,17,295
"25775",1025775,251,30,8,289
"25776",1025776,21,171,3,195
"25777",1025777,39,4,1,44
"25778",1025778,257,11,8,276
"25779",1025779,34,267,7,308
"25780",1025780,257,27,18,302
"25781",1025781,170,49,3,222
"25782",1025782,162,142,19,323
"25783",1025783,143,141,15,299
"25784",1025784,138,113,15,266
"25785",1025785,111,83,8,202
"25786",1025786,71,6,2,79
"25787",1025787,162,57,8,227
"25788",1025788,34,240,10,284
"25789",1025789,121,147,7,275
"25790",1025790,132,67,4,203
"25791",1025791,56,196,11,263
"25792",1025792,13,176,2,191
"25793",1025793,80,158,3,241
"25794",1025794,115,31,3,149
"25795",1025795,28,312,3,343
"25796",1025796,176,48,3,227
"25797",1025797,209,15,5,229
"25798",1025798,113,91,17,221
"25799",1025799,157,86,14,257
"25800",1025800,213,74,33,320
"25801",1025801,79,94,7,180
"25802",1025802,47,206,5,258
"25803",1025803,45,222,12,279
"25804",1025804,56,76,6,138
"25805",1025805,122,56,7,185
"25806",1025806,25,179,6,210
"25807",1025807,82,189,8,279
"25808",1025808,56,226,2,284
"25809",1025809,151,35,7,193
"25810",1025810,49,167,2,218
"25811",1025811,53,115,14,182
"25812",1025812,89,3,0,92
"25813",1025813,55,111,6,172
"25814",1025814,122,15,10,147
"25815",1025815,135,152,8,295
"25816",1025816,37,38,5,80
"25817",1025817,159,53,2,214
"25818",1025818,207,30,4,241
"25819",1025819,139,56,8,203
"25820",1025820,186,86,7,279
"25821",1025821,146,156,10,312
"25822",1025822,0,0,0,0
"25823",1025823,18,250,1,269
"25824",1025824,160,17,2,179
"25825",1025825,57,185,6,248
"25826",1025826,138,150,16,304
"25827",1025827,55,203,11,269
"25828",1025828,136,62,2,200
"25829",1025829,192,28,6,226
"25830",1025830,144,48,7,199
"25831",1025831,97,114,8,219
"25832",1025832,118,166,19,303
"25833",1025833,42,193,3,238
"25834",1025834,156,102,8,266
"25835",1025835,108,67,11,186
"25836",1025836,85,174,5,264
"25837",1025837,199,98,20,317
"25838",1025838,134,37,7,178
"25839",1025839,82,175,5,262
"25840",1025840,140,142,12,294
"25841",1025841,185,79,9,273
"25842",1025842,83,64,17,164
"25843",1025843,47,86,1,134
"25844",1025844,202,52,7,261
"25845",1025845,128,123,9,260
"25846",1025846,170,90,6,266
"25847",1025847,144,40,12,196
"25848",1025848,66,129,3,198
"25849",1025849,81,32,2,115
"25850",1025850,36,256,5,297
"25851",1025851,46,155,9,210
"25852",1025852,69,173,7,249
"25853",1025853,186,79,9,274
"25854",1025854,90,60,1,151
"25855",1025855,263,47,15,325
"25856",1025856,205,70,2,277
"25857",1025857,76,364,19,459
"25858",1025858,92,84,17,193
"25859",1025859,158,102,8,268
"25860",1025860,54,50,2,106
"25861",1025861,30,42,6,78
"25862",1025862,147,121,10,278
"25863",1025863,127,307,26,460
"25864",1025864,61,41,8,110
"25865",1025865,62,138,4,204
"25866",1025866,23,210,2,235
"25867",1025867,152,97,7,256
"25868",1025868,280,32,5,317
"25869",1025869,143,71,15,229
"25870",1025870,153,76,4,233
"25871",1025871,77,142,13,232
"25872",1025872,121,110,12,243
"25873",1025873,31,120,1,152
"25874",1025874,56,203,6,265
"25875",1025875,125,162,18,305
"25876",1025876,110,98,6,214
"25877",1025877,96,66,11,173
"25878",1025878,92,168,12,272
"25879",1025879,89,73,6,168
"25880",1025880,91,49,8,148
"25881",1025881,54,20,6,80
"25882",1025882,148,79,5,232
"25883",1025883,210,58,7,275
"25884",1025884,111,163,5,279
"25885",1025885,114,148,5,267
"25886",1025886,151,91,10,252
"25887",1025887,46,31,2,79
"25888",1025888,18,12,1,31
"25889",1025889,160,177,3,340
"25890",1025890,104,160,4,268
"25891",1025891,180,48,10,238
"25892",1025892,142,48,15,205
"25893",1025893,77,239,5,321
"25894",1025894,30,75,6,111
"25895",1025895,105,17,2,124
"25896",1025896,93,76,5,174
"25897",1025897,137,63,8,208
"25898",1025898,103,65,7,175
"25899",1025899,129,102,8,239
"25900",1025900,176,35,9,220
"25901",1025901,73,83,2,158
"25902",1025902,6,1,0,7
"25903",1025903,104,134,8,246
"25904",1025904,8,4,1,13
"25905",1025905,168,22,7,197
"25906",1025906,171,59,13,243
"25907",1025907,49,134,11,194
"25908",1025908,248,261,24,533
"25909",1025909,166,33,4,203
"25910",1025910,193,27,6,226
"25911",1025911,308,91,16,415
"25912",1025912,96,83,6,185
"25913",1025913,61,131,10,202
"25914",1025914,142,112,17,271
"25915",1025915,24,126,2,152
"25916",1025916,39,291,10,340
"25917",1025917,145,136,12,293
"25918",1025918,165,160,10,335
"25919",1025919,150,76,5,231
"25920",1025920,115,167,15,297
"25921",1025921,172,115,12,299
"25922",1025922,156,128,12,296
"25923",1025923,134,116,5,255
"25924",1025924,105,159,9,273
"25925",1025925,94,59,0,153
"25926",1025926,163,63,26,252
"25927",1025927,167,33,12,212
"25928",1025928,150,119,6,275
"25929",1025929,27,21,6,54
"25930",1025930,27,171,4,202
"25931",1025931,182,67,5,254
"25932",1025932,37,234,6,277
"25933",1025933,131,41,3,175
"25934",1025934,46,52,5,103
"25935",1025935,123,66,3,192
"25936",1025936,200,91,23,314
"25937",1025937,90,139,13,242
"25938",1025938,9,42,5,56
"25939",1025939,180,24,12,216
"25940",1025940,85,212,10,307
"25941",1025941,164,108,3,275
"25942",1025942,200,9,8,217
"25943",1025943,169,16,0,185
"25944",1025944,123,123,10,256
"25945",1025945,26,4,0,30
"25946",1025946,127,31,5,163
"25947",1025947,148,23,3,174
"25948",1025948,178,113,14,305
"25949",1025949,164,85,8,257
"25950",1025950,71,172,24,267
"25951",1025951,84,147,10,241
"25952",1025952,89,120,15,224
"25953",1025953,34,61,2,97
"25954",1025954,41,238,9,288
"25955",1025955,137,92,12,241
"25956",1025956,126,93,11,230
"25957",1025957,37,125,8,170
"25958",1025958,142,141,13,296
"25959",1025959,224,51,11,286
"25960",1025960,56,60,5,121
"25961",1025961,1,2,0,3
"25962",1025962,104,16,8,128
"25963",1025963,8,23,1,32
"25964",1025964,118,76,2,196
"25965",1025965,23,251,7,281
"25966",1025966,161,14,6,181
"25967",1025967,91,202,2,295
"25968",1025968,121,122,5,248
"25969",1025969,69,86,2,157
"25970",1025970,41,218,3,262
"25971",1025971,52,311,1,364
"25972",1025972,88,65,3,156
"25973",1025973,81,68,6,155
"25974",1025974,154,14,2,170
"25975",1025975,178,13,2,193
"25976",1025976,48,9,1,58
"25977",1025977,193,37,10,240
"25978",1025978,56,178,18,252
"25979",1025979,106,109,4,219
"25980",1025980,59,95,19,173
"25981",1025981,134,91,8,233
"25982",1025982,66,12,1,79
"25983",1025983,164,113,5,282
"25984",1025984,116,73,4,193
"25985",1025985,113,114,4,231
"25986",1025986,17,10,2,29
"25987",1025987,155,43,6,204
"25988",1025988,143,130,12,285
"25989",1025989,84,137,8,229
"25990",1025990,97,201,11,309
"25991",1025991,243,6,1,250
"25992",1025992,6,40,2,48
"25993",1025993,146,80,12,238
"25994",1025994,45,49,3,97
"25995",1025995,138,108,6,252
"25996",1025996,151,150,12,313
"25997",1025997,37,265,3,305
"25998",1025998,104,12,4,120
"25999",1025999,88,113,15,216
"26000",1026000,124,38,7,169
"26001",1026001,138,107,8,253
"26002",1026002,115,151,20,286
"26003",1026003,137,138,8,283
"26004",1026004,147,117,23,287
"26005",1026005,115,19,1,135
"26006",1026006,169,140,5,314
"26007",1026007,11,10,1,22
"26008",1026008,139,67,1,207
"26009",1026009,19,159,0,178
"26010",1026010,55,47,6,108
"26011",1026011,129,13,3,145
"26012",1026012,44,141,1,186
"26013",1026013,5,15,1,21
"26014",1026014,92,16,5,113
"26015",1026015,146,60,7,213
"26016",1026016,75,189,10,274
"26017",1026017,142,115,8,265
"26018",1026018,163,77,4,244
"26019",1026019,100,186,5,291
"26020",1026020,161,91,9,261
"26021",1026021,165,106,4,275
"26022",1026022,33,279,6,318
"26023",1026023,115,100,15,230
"26024",1026024,171,72,7,250
"26025",1026025,13,88,4,105
"26026",1026026,77,19,2,98
"26027",1026027,102,175,3,280
"26028",1026028,184,71,13,268
"26029",1026029,22,254,1,277
"26030",1026030,78,76,10,164
"26031",1026031,178,68,13,259
"26032",1026032,57,86,6,149
"26033",1026033,51,188,14,253
"26034",1026034,140,58,8,206
"26035",1026035,30,154,6,190
"26036",1026036,109,32,9,150
"26037",1026037,74,149,21,244
"26038",1026038,140,72,17,229
"26039",1026039,89,199,14,302
"26040",1026040,154,30,2,186
"26041",1026041,132,36,8,176
"26042",1026042,40,204,6,250
"26043",1026043,130,38,8,176
"26044",1026044,118,136,7,261
"26045",1026045,175,87,7,269
"26046",1026046,155,68,7,230
"26047",1026047,157,27,4,188
"26048",1026048,76,12,3,91
"26049",1026049,105,88,17,210
"26050",1026050,90,77,14,181
"26051",1026051,17,187,1,205
"26052",1026052,5,50,1,56
"26053",1026053,200,47,12,259
"26054",1026054,169,13,2,184
"26055",1026055,196,48,12,256
"26056",1026056,287,29,3,319
"26057",1026057,116,81,7,204
"26058",1026058,202,75,22,299
"26059",1026059,110,27,3,140
"26060",1026060,60,234,8,302
"26061",1026061,111,93,12,216
"26062",1026062,52,97,10,159
"26063",1026063,191,33,7,231
"26064",1026064,86,194,18,298
"26065",1026065,199,26,6,231
"26066",1026066,185,76,18,279
"26067",1026067,150,110,1,261
"26068",1026068,79,168,9,256
"26069",1026069,51,238,14,303
"26070",1026070,79,99,13,191
"26071",1026071,35,2,3,40
"26072",1026072,147,37,1,185
"26073",1026073,8,117,2,127
"26074",1026074,27,140,8,175
"26075",1026075,98,160,5,263
"26076",1026076,49,40,9,98
"26077",1026077,84,70,2,156
"26078",1026078,69,205,5,279
"26079",1026079,47,130,2,179
"26080",1026080,132,157,16,305
"26081",1026081,56,50,3,109
"26082",1026082,59,186,4,249
"26083",1026083,153,43,7,203
"26084",1026084,195,70,3,268
"26085",1026085,162,47,7,216
"26086",1026086,123,30,12,165
"26087",1026087,1,23,0,24
"26088",1026088,80,144,1,225
"26089",1026089,126,26,3,155
"26090",1026090,75,156,4,235
"26091",1026091,68,118,14,200
"26092",1026092,11,4,3,18
"26093",1026093,170,51,12,233
"26094",1026094,238,12,6,256
"26095",1026095,24,0,0,24
"26096",1026096,11,7,0,18
"26097",1026097,126,47,19,192
"26098",1026098,84,198,6,288
"26099",1026099,189,71,5,265
"26100",1026100,4,50,0,54
"26101",1026101,16,17,0,33
"26102",1026102,23,228,5,256
"26103",1026103,39,197,7,243
"26104",1026104,66,112,0,178
"26105",1026105,279,19,6,304
"26106",1026106,73,165,8,246
"26107",1026107,94,71,8,173
"26108",1026108,17,98,0,115
"26109",1026109,36,166,4,206
"26110",1026110,128,205,11,344
"26111",1026111,66,61,6,133
"26112",1026112,133,67,13,213
"26113",1026113,51,131,25,207
"26114",1026114,74,78,7,159
"26115",1026115,190,69,14,273
"26116",1026116,147,115,11,273
"26117",1026117,110,160,5,275
"26118",1026118,115,88,11,214
"26119",1026119,129,71,8,208
"26120",1026120,33,231,3,267
"26121",1026121,154,65,12,231
"26122",1026122,145,64,12,221
"26123",1026123,163,66,3,232
"26124",1026124,188,52,7,247
"26125",1026125,145,89,12,246
"26126",1026126,210,66,17,293
"26127",1026127,3,8,0,11
"26128",1026128,160,108,2,270
"26129",1026129,71,196,7,274
"26130",1026130,41,133,8,182
"26131",1026131,47,202,9,258
"26132",1026132,143,36,4,183
"26133",1026133,209,55,7,271
"26134",1026134,31,226,7,264
"26135",1026135,162,23,10,195
"26136",1026136,152,44,8,204
"26137",1026137,136,47,8,191
"26138",1026138,117,193,13,323
"26139",1026139,117,81,3,201
"26140",1026140,137,166,15,318
"26141",1026141,93,176,2,271
"26142",1026142,124,85,8,217
"26143",1026143,56,252,12,320
"26144",1026144,49,217,1,267
"26145",1026145,61,130,18,209
"26146",1026146,146,161,10,317
"26147",1026147,37,18,4,59
"26148",1026148,149,134,10,293
"26149",1026149,121,112,6,239
"26150",1026150,5,11,0,16
"26151",1026151,193,55,4,252
"26152",1026152,89,103,2,194
"26153",1026153,62,170,8,240
"26154",1026154,70,114,27,211
"26155",1026155,36,213,5,254
"26156",1026156,79,180,2,261
"26157",1026157,106,112,4,222
"26158",1026158,43,226,3,272
"26159",1026159,149,54,3,206
"26160",1026160,87,117,1,205
"26161",1026161,58,183,6,247
"26162",1026162,144,148,20,312
"26163",1026163,142,32,6,180
"26164",1026164,181,74,12,267
"26165",1026165,186,52,6,244
"26166",1026166,208,39,2,249
"26167",1026167,29,261,1,291
"26168",1026168,141,126,19,286
"26169",1026169,76,204,11,291
"26170",1026170,68,249,5,322
"26171",1026171,140,129,5,274
"26172",1026172,63,148,5,216
"26173",1026173,116,130,3,249
"26174",1026174,157,104,12,273
"26175",1026175,11,18,2,31
"26176",1026176,4,2,4,10
"26177",1026177,37,17,1,55
"26178",1026178,6,67,7,80
"26179",1026179,158,138,11,307
"26180",1026180,24,382,2,408
"26181",1026181,13,133,6,152
"26182",1026182,68,166,2,236
"26183",1026183,91,128,7,226
"26184",1026184,40,153,4,197
"26185",1026185,176,92,13,281
"26186",1026186,83,119,2,204
"26187",1026187,117,111,17,245
"26188",1026188,111,161,14,286
"26189",1026189,195,102,4,301
"26190",1026190,108,51,10,169
"26191",1026191,184,11,2,197
"26192",1026192,103,133,20,256
"26193",1026193,157,99,11,267
"26194",1026194,60,170,13,243
"26195",1026195,57,13,1,71
"26196",1026196,84,177,16,277
"26197",1026197,149,51,11,211
"26198",1026198,136,166,5,307
"26199",1026199,37,109,3,149
"26200",1026200,41,21,3,65
"26201",1026201,127,97,21,245
"26202",1026202,131,92,7,230
"26203",1026203,146,105,7,258
"26204",1026204,125,0,0,125
"26205",1026205,178,120,4,302
"26206",1026206,65,95,12,172
"26207",1026207,60,221,11,292
"26208",1026208,32,162,4,198
"26209",1026209,82,171,13,266
"26210",1026210,202,124,16,342
"26211",1026211,89,187,13,289
"26212",1026212,7,0,1,8
"26213",1026213,59,15,3,77
"26214",1026214,112,10,9,131
"26215",1026215,3,8,0,11
"26216",1026216,41,56,6,103
"26217",1026217,19,213,6,238
"26218",1026218,149,142,10,301
"26219",1026219,9,130,4,143
"26220",1026220,27,53,6,86
"26221",1026221,57,58,6,121
"26222",1026222,83,129,2,214
"26223",1026223,48,175,9,232
"26224",1026224,108,159,12,279
"26225",1026225,91,170,9,270
"26226",1026226,152,117,10,279
"26227",1026227,120,182,8,310
"26228",1026228,134,60,11,205
"26229",1026229,20,289,1,310
"26230",1026230,39,149,11,199
"26231",1026231,44,81,3,128
"26232",1026232,168,68,11,247
"26233",1026233,55,22,7,84
"26234",1026234,118,57,3,178
"26235",1026235,45,282,11,338
"26236",1026236,37,242,10,289
"26237",1026237,162,60,9,231
"26238",1026238,212,80,8,300
"26239",1026239,72,238,12,322
"26240",1026240,50,34,2,86
"26241",1026241,166,33,7,206
"26242",1026242,60,116,8,184
"26243",1026243,156,153,11,320
"26244",1026244,171,14,13,198
"26245",1026245,192,97,9,298
"26246",1026246,25,254,1,280
"26247",1026247,125,13,2,140
"26248",1026248,22,147,3,172
"26249",1026249,112,7,3,122
"26250",1026250,135,101,7,243
"26251",1026251,198,46,11,255
"26252",1026252,178,6,6,190
"26253",1026253,70,158,7,235
"26254",1026254,162,31,9,202
"26255",1026255,59,256,6,321
"26256",1026256,140,156,14,310
"26257",1026257,70,105,13,188
"26258",1026258,111,83,2,196
"26259",1026259,19,0,0,19
"26260",1026260,127,67,13,207
"26261",1026261,208,82,11,301
"26262",1026262,54,187,9,250
"26263",1026263,81,187,12,280
"26264",1026264,149,103,18,270
"26265",1026265,93,186,5,284
"26266",1026266,125,79,14,218
"26267",1026267,154,18,4,176
"26268",1026268,66,209,5,280
"26269",1026269,139,9,4,152
"26270",1026270,20,217,1,238
"26271",1026271,29,21,2,52
"26272",1026272,34,259,4,297
"26273",1026273,176,49,4,229
"26274",1026274,211,90,15,316
"26275",1026275,92,143,8,243
"26276",1026276,53,149,5,207
"26277",1026277,1,14,0,15
"26278",1026278,5,41,2,48
"26279",1026279,47,183,1,231
"26280",1026280,120,132,11,263
"26281",1026281,191,82,13,286
"26282",1026282,171,10,4,185
"26283",1026283,151,53,5,209
"26284",1026284,102,203,15,320
"26285",1026285,76,67,8,151
"26286",1026286,183,60,8,251
"26287",1026287,46,177,16,239
"26288",1026288,58,10,0,68
"26289",1026289,148,76,6,230
"26290",1026290,124,80,3,207
"26291",1026291,23,211,4,238
"26292",1026292,61,177,12,250
"26293",1026293,248,56,11,315
"26294",1026294,2,35,0,37
"26295",1026295,87,75,3,165
"26296",1026296,115,170,8,293
"26297",1026297,39,28,0,67
"26298",1026298,79,158,11,248
"26299",1026299,171,103,9,283
"26300",1026300,50,45,1,96
"26301",1026301,231,38,6,275
"26302",1026302,10,4,0,14
"26303",1026303,156,50,5,211
"26304",1026304,166,31,2,199
"26305",1026305,267,38,8,313
"26306",1026306,173,93,14,280
"26307",1026307,274,108,30,412
"26308",1026308,75,166,12,253
"26309",1026309,22,27,2,51
"26310",1026310,36,156,9,201
"26311",1026311,194,29,6,229
"26312",1026312,90,116,7,213
"26313",1026313,202,41,5,248
"26314",1026314,129,128,13,270
"26315",1026315,84,16,1,101
"26316",1026316,28,280,5,313
"26317",1026317,35,236,7,278
"26318",1026318,76,240,9,325
"26319",1026319,68,95,16,179
"26320",1026320,54,206,7,267
"26321",1026321,80,215,21,316
"26322",1026322,139,90,15,244
"26323",1026323,30,225,1,256
"26324",1026324,134,110,6,250
"26325",1026325,67,204,3,274
"26326",1026326,103,169,9,281
"26327",1026327,34,1,1,36
"26328",1026328,68,164,4,236
"26329",1026329,16,30,1,47
"26330",1026330,171,80,9,260
"26331",1026331,60,189,4,253
"26332",1026332,206,78,2,286
"26333",1026333,219,13,3,235
"26334",1026334,139,58,3,200
"26335",1026335,201,28,4,233
"26336",1026336,46,164,12,222
"26337",1026337,89,203,12,304
"26338",1026338,113,121,3,237
"26339",1026339,46,238,2,286
"26340",1026340,91,77,3,171
"26341",1026341,16,9,0,25
"26342",1026342,99,349,15,463
"26343",1026343,136,63,5,204
"26344",1026344,111,143,13,267
"26345",1026345,32,136,0,168
"26346",1026346,150,138,14,302
"26347",1026347,152,28,1,181
"26348",1026348,153,37,8,198
"26349",1026349,62,148,7,217
"26350",1026350,113,142,10,265
"26351",1026351,136,113,8,257
"26352",1026352,95,146,3,244
"26353",1026353,117,73,4,194
"26354",1026354,126,110,12,248
"26355",1026355,89,82,7,178
"26356",1026356,58,12,6,76
"26357",1026357,41,226,6,273
"26358",1026358,178,87,11,276
"26359",1026359,42,243,11,296
"26360",1026360,152,52,3,207
"26361",1026361,208,51,7,266
"26362",1026362,156,101,17,274
"26363",1026363,48,104,4,156
"26364",1026364,134,106,1,241
"26365",1026365,171,90,21,282
"26366",1026366,157,52,7,216
"26367",1026367,150,41,6,197
"26368",1026368,20,9,0,29
"26369",1026369,23,90,0,113
"26370",1026370,126,125,3,254
"26371",1026371,164,67,12,243
"26372",1026372,75,18,3,96
"26373",1026373,62,74,2,138
"26374",1026374,142,45,6,193
"26375",1026375,147,82,8,237
"26376",1026376,34,83,6,123
"26377",1026377,61,188,5,254
"26378",1026378,98,178,6,282
"26379",1026379,154,27,10,191
"26380",1026380,158,42,7,207
"26381",1026381,56,61,1,118
"26382",1026382,139,128,7,274
"26383",1026383,117,151,6,274
"26384",1026384,187,111,19,317
"26385",1026385,153,44,8,205
"26386",1026386,197,84,8,289
"26387",1026387,30,8,0,38
"26388",1026388,111,123,9,243
"26389",1026389,86,98,11,195
"26390",1026390,61,134,2,197
"26391",1026391,179,46,7,232
"26392",1026392,87,147,7,241
"26393",1026393,155,92,9,256
"26394",1026394,151,151,12,314
"26395",1026395,80,161,7,248
"26396",1026396,51,167,6,224
"26397",1026397,84,113,12,209
"26398",1026398,39,223,6,268
"26399",1026399,26,199,4,229
"26400",1026400,105,172,9,286
"26401",1026401,127,94,2,223
"26402",1026402,13,96,4,113
"26403",1026403,50,219,10,279
"26404",1026404,228,87,13,328
"26405",1026405,86,113,1,200
"26406",1026406,158,51,13,222
"26407",1026407,108,111,21,240
"26408",1026408,23,48,4,75
"26409",1026409,42,196,10,248
"26410",1026410,159,65,12,236
"26411",1026411,119,154,10,283
"26412",1026412,119,46,17,182
"26413",1026413,13,113,2,128
"26414",1026414,212,66,6,284
"26415",1026415,23,4,0,27
"26416",1026416,142,111,7,260
"26417",1026417,216,59,16,291
"26418",1026418,74,24,3,101
"26419",1026419,128,56,12,196
"26420",1026420,139,125,9,273
"26421",1026421,36,220,1,257
"26422",1026422,116,60,5,181
"26423",1026423,87,42,4,133
"26424",1026424,37,169,6,212
"26425",1026425,62,144,4,210
"26426",1026426,167,82,11,260
"26427",1026427,87,184,8,279
"26428",1026428,112,117,14,243
"26429",1026429,173,92,6,271
"26430",1026430,164,22,3,189
"26431",1026431,27,107,1,135
"26432",1026432,149,92,6,247
"26433",1026433,161,50,4,215
"26434",1026434,115,134,13,262
"26435",1026435,118,67,18,203
"26436",1026436,69,48,2,119
"26437",1026437,172,74,17,263
"26438",1026438,108,150,10,268
"26439",1026439,54,74,3,131
"26440",1026440,37,296,6,339
"26441",1026441,84,222,10,316
"26442",1026442,38,196,3,237
"26443",1026443,132,101,10,243
"26444",1026444,173,52,2,227
"26445",1026445,44,217,0,261
"26446",1026446,51,58,11,120
"26447",1026447,172,54,13,239
"26448",1026448,56,195,13,264
"26449",1026449,181,37,14,232
"26450",1026450,62,230,7,299
"26451",1026451,48,225,3,276
"26452",1026452,160,65,9,234
"26453",1026453,71,144,5,220
"26454",1026454,108,84,7,199
"26455",1026455,89,178,7,274
"26456",1026456,40,61,8,109
"26457",1026457,104,162,8,274
"26458",1026458,75,154,7,236
"26459",1026459,43,99,5,147
"26460",1026460,131,136,6,273
"26461",1026461,115,164,12,291
"26462",1026462,93,48,4,145
"26463",1026463,151,49,5,205
"26464",1026464,124,168,7,299
"26465",1026465,216,71,16,303
"26466",1026466,154,37,5,196
"26467",1026467,55,246,22,323
"26468",1026468,178,94,9,281
"26469",1026469,122,145,6,273
"26470",1026470,208,31,6,245
"26471",1026471,156,36,12,204
"26472",1026472,163,55,11,229
"26473",1026473,25,5,0,30
"26474",1026474,153,50,8,211
"26475",1026475,165,15,5,185
"26476",1026476,62,5,0,67
"26477",1026477,49,111,5,165
"26478",1026478,40,36,3,79
"26479",1026479,67,247,2,316
"26480",1026480,33,247,1,281
"26481",1026481,35,250,21,306
"26482",1026482,90,165,23,278
"26483",1026483,139,24,4,167
"26484",1026484,42,277,6,325
"26485",1026485,116,99,0,215
"26486",1026486,74,200,9,283
"26487",1026487,96,68,7,171
"26488",1026488,83,230,12,325
"26489",1026489,161,52,3,216
"26490",1026490,90,159,14,263
"26491",1026491,104,18,8,130
"26492",1026492,76,78,6,160
"26493",1026493,70,139,19,228
"26494",1026494,139,41,5,185
"26495",1026495,169,80,10,259
"26496",1026496,141,67,9,217
"26497",1026497,70,231,1,302
"26498",1026498,88,41,6,135
"26499",1026499,66,142,4,212
"26500",1026500,178,18,2,198
"26501",1026501,100,125,10,235
"26502",1026502,34,18,3,55
"26503",1026503,30,164,2,196
"26504",1026504,81,217,7,305
"26505",1026505,139,71,5,215
"26506",1026506,144,50,8,202
"26507",1026507,141,108,9,258
"26508",1026508,62,109,2,173
"26509",1026509,0,0,0,0
"26510",1026510,174,54,3,231
"26511",1026511,160,29,14,203
"26512",1026512,48,148,9,205
"26513",1026513,94,118,17,229
"26514",1026514,164,60,5,229
"26515",1026515,83,182,11,276
"26516",1026516,166,52,8,226
"26517",1026517,106,85,3,194
"26518",1026518,191,16,6,213
"26519",1026519,72,74,14,160
"26520",1026520,81,200,13,294
"26521",1026521,92,185,4,281
"26522",1026522,203,58,11,272
"26523",1026523,175,92,7,274
"26524",1026524,72,230,7,309
"26525",1026525,98,68,6,172
"26526",1026526,72,76,1,149
"26527",1026527,194,2,8,204
"26528",1026528,120,25,1,146
"26529",1026529,86,107,8,201
"26530",1026530,120,23,11,154
"26531",1026531,83,73,3,159
"26532",1026532,24,179,10,213
"26533",1026533,25,225,8,258
"26534",1026534,66,93,7,166
"26535",1026535,53,231,9,293
"26536",1026536,183,23,6,212
"26537",1026537,100,210,11,321
"26538",1026538,229,51,11,291
"26539",1026539,76,196,11,283
"26540",1026540,38,98,8,144
"26541",1026541,101,191,8,300
"26542",1026542,25,80,2,107
"26543",1026543,2,1,1,4
"26544",1026544,229,24,8,261
"26545",1026545,31,148,6,185
"26546",1026546,60,191,9,260
"26547",1026547,126,44,1,171
"26548",1026548,84,174,21,279
"26549",1026549,107,135,7,249
"26550",1026550,133,117,4,254
"26551",1026551,193,26,3,222
"26552",1026552,131,64,9,204
"26553",1026553,259,49,6,314
"26554",1026554,140,65,9,214
"26555",1026555,75,124,6,205
"26556",1026556,103,55,13,171
"26557",1026557,65,226,3,294
"26558",1026558,51,23,2,76
"26559",1026559,5,2,1,8
"26560",1026560,20,88,1,109
"26561",1026561,130,61,8,199
"26562",1026562,115,105,12,232
"26563",1026563,104,24,11,139
"26564",1026564,107,81,4,192
"26565",1026565,101,112,3,216
"26566",1026566,18,19,3,40
"26567",1026567,53,344,3,400
"26568",1026568,121,42,9,172
"26569",1026569,124,102,17,243
"26570",1026570,216,54,9,279
"26571",1026571,250,78,5,333
"26572",1026572,178,169,10,357
"26573",1026573,116,157,12,285
"26574",1026574,159,138,3,300
"26575",1026575,71,222,20,313
"26576",1026576,183,44,5,232
"26577",1026577,123,43,10,176
"26578",1026578,194,122,15,331
"26579",1026579,203,15,2,220
"26580",1026580,61,124,0,185
"26581",1026581,144,74,17,235
"26582",1026582,147,178,13,338
"26583",1026583,152,94,15,261
"26584",1026584,152,15,2,169
"26585",1026585,83,171,4,258
"26586",1026586,203,36,17,256
"26587",1026587,77,33,3,113
"26588",1026588,146,113,10,269
"26589",1026589,64,183,8,255
"26590",1026590,48,239,15,302
"26591",1026591,170,28,15,213
"26592",1026592,101,161,14,276
"26593",1026593,20,187,3,210
"26594",1026594,86,131,18,235
"26595",1026595,79,212,14,305
"26596",1026596,126,162,13,301
"26597",1026597,193,73,10,276
"26598",1026598,78,177,3,258
"26599",1026599,72,90,17,179
"26600",1026600,176,81,3,260
"26601",1026601,149,103,4,256
"26602",1026602,127,42,12,181
"26603",1026603,125,57,13,195
"26604",1026604,52,13,2,67
"26605",1026605,58,149,9,216
"26606",1026606,93,134,10,237
"26607",1026607,253,29,6,288
"26608",1026608,158,48,4,210
"26609",1026609,35,44,7,86
"26610",1026610,98,80,16,194
"26611",1026611,150,117,9,276
"26612",1026612,105,176,7,288
"26613",1026613,60,109,0,169
"26614",1026614,187,70,9,266
"26615",1026615,158,138,5,301
"26616",1026616,220,43,11,274
"26617",1026617,54,35,4,93
"26618",1026618,132,125,6,263
"26619",1026619,215,78,12,305
"26620",1026620,181,44,4,229
"26621",1026621,11,198,2,211
"26622",1026622,124,134,6,264
"26623",1026623,85,76,7,168
"26624",1026624,69,170,15,254
"26625",1026625,100,117,6,223
"26626",1026626,58,144,5,207
"26627",1026627,97,207,3,307
"26628",1026628,156,169,16,341
"26629",1026629,9,75,3,87
"26630",1026630,32,215,6,253
"26631",1026631,65,107,11,183
"26632",1026632,166,51,10,227
"26633",1026633,7,67,0,74
"26634",1026634,99,152,8,259
"26635",1026635,138,89,5,232
"26636",1026636,140,0,0,140
"26637",1026637,216,41,5,262
"26638",1026638,147,51,4,202
"26639",1026639,171,101,7,279
"26640",1026640,109,62,20,191
"26641",1026641,76,184,1,261
"26642",1026642,127,113,11,251
"26643",1026643,87,173,5,265
"26644",1026644,102,80,3,185
"26645",1026645,102,164,8,274
"26646",1026646,84,187,6,277
"26647",1026647,186,106,7,299
"26648",1026648,217,77,9,303
"26649",1026649,112,118,5,235
"26650",1026650,117,86,6,209
"26651",1026651,134,151,19,304
"26652",1026652,37,143,4,184
"26653",1026653,42,165,10,217
"26654",1026654,7,11,2,20
"26655",1026655,217,42,12,271
"26656",1026656,80,58,1,139
"26657",1026657,197,72,4,273
"26658",1026658,60,72,4,136
"26659",1026659,160,47,5,212
"26660",1026660,119,107,8,234
"26661",1026661,209,44,5,258
"26662",1026662,127,36,5,168
"26663",1026663,173,80,9,262
"26664",1026664,136,159,16,311
"26665",1026665,94,47,10,151
"26666",1026666,133,60,10,203
"26667",1026667,49,193,5,247
"26668",1026668,161,47,5,213
"26669",1026669,144,72,12,228
"26670",1026670,69,57,5,131
"26671",1026671,176,96,14,286
"26672",1026672,82,185,2,269
"26673",1026673,106,63,6,175
"26674",1026674,48,159,1,208
"26675",1026675,127,115,6,248
"26676",1026676,108,104,10,222
"26677",1026677,143,96,7,246
"26678",1026678,36,7,0,43
"26679",1026679,49,166,7,222
"26680",1026680,56,172,9,237
"26681",1026681,152,17,9,178
"26682",1026682,160,30,5,195
"26683",1026683,33,23,2,58
"26684",1026684,95,88,11,194
"26685",1026685,250,48,11,309
"26686",1026686,202,80,7,289
"26687",1026687,14,109,10,133
"26688",1026688,45,96,7,148
"26689",1026689,127,142,10,279
"26690",1026690,52,248,8,308
"26691",1026691,149,51,21,221
"26692",1026692,36,43,3,82
"26693",1026693,98,217,1,316
"26694",1026694,180,69,11,260
"26695",1026695,114,136,13,263
"26696",1026696,122,158,18,298
"26697",1026697,78,167,9,254
"26698",1026698,59,132,11,202
"26699",1026699,65,107,7,179
"26700",1026700,101,126,18,245
"26701",1026701,23,148,3,174
"26702",1026702,78,99,13,190
"26703",1026703,90,170,8,268
"26704",1026704,149,98,9,256
"26705",1026705,37,274,6,317
"26706",1026706,123,52,9,184
"26707",1026707,28,202,6,236
"26708",1026708,60,78,4,142
"26709",1026709,27,252,13,292
"26710",1026710,41,13,1,55
"26711",1026711,198,26,12,236
"26712",1026712,50,237,17,304
"26713",1026713,68,172,9,249
"26714",1026714,83,65,5,153
"26715",1026715,83,116,12,211
"26716",1026716,99,161,11,271
"26717",1026717,105,203,16,324
"26718",1026718,191,44,10,245
"26719",1026719,37,181,13,231
"26720",1026720,99,87,6,192
"26721",1026721,32,43,4,79
"26722",1026722,177,217,25,419
"26723",1026723,42,195,3,240
"26724",1026724,119,29,3,151
"26725",1026725,64,182,10,256
"26726",1026726,60,197,16,273
"26727",1026727,74,228,6,308
"26728",1026728,174,91,4,269
"26729",1026729,77,173,1,251
"26730",1026730,64,232,22,318
"26731",1026731,66,131,13,210
"26732",1026732,249,40,16,305
"26733",1026733,92,166,6,264
"26734",1026734,108,109,21,238
"26735",1026735,213,80,17,310
"26736",1026736,40,238,4,282
"26737",1026737,131,40,6,177
"26738",1026738,57,228,18,303
"26739",1026739,48,263,6,317
"26740",1026740,37,31,11,79
"26741",1026741,150,113,18,281
"26742",1026742,160,79,6,245
"26743",1026743,170,37,5,212
"26744",1026744,134,2,2,138
"26745",1026745,60,256,8,324
"26746",1026746,89,13,3,105
"26747",1026747,107,162,9,278
"26748",1026748,152,108,4,264
"26749",1026749,134,83,20,237
"26750",1026750,91,177,10,278
"26751",1026751,105,126,5,236
"26752",1026752,219,79,10,308
"26753",1026753,23,11,3,37
"26754",1026754,197,32,6,235
"26755",1026755,155,58,9,222
"26756",1026756,128,25,4,157
"26757",1026757,186,12,4,202
"26758",1026758,84,232,8,324
"26759",1026759,171,70,12,253
"26760",1026760,99,50,6,155
"26761",1026761,74,96,3,173
"26762",1026762,89,179,13,281
"26763",1026763,6,42,2,50
"26764",1026764,27,254,1,282
"26765",1026765,11,41,1,53
"26766",1026766,80,104,1,185
"26767",1026767,11,31,0,42
"26768",1026768,22,182,2,206
"26769",1026769,241,51,14,306
"26770",1026770,178,69,7,254
"26771",1026771,155,26,9,190
"26772",1026772,151,9,6,166
"26773",1026773,51,134,4,189
"26774",1026774,154,84,6,244
"26775",1026775,151,35,6,192
"26776",1026776,105,142,6,253
"26777",1026777,98,166,8,272
"26778",1026778,40,137,0,177
"26779",1026779,22,119,1,142
"26780",1026780,60,28,4,92
"26781",1026781,62,254,9,325
"26782",1026782,200,17,8,225
"26783",1026783,221,23,3,247
"26784",1026784,76,181,9,266
"26785",1026785,138,128,20,286
"26786",1026786,63,159,4,226
"26787",1026787,143,27,7,177
"26788",1026788,122,97,12,231
"26789",1026789,58,208,3,269
"26790",1026790,173,44,9,226
"26791",1026791,14,14,1,29
"26792",1026792,184,31,3,218
"26793",1026793,113,218,13,344
"26794",1026794,195,30,6,231
"26795",1026795,109,182,11,302
"26796",1026796,107,111,5,223
"26797",1026797,27,16,0,43
"26798",1026798,167,74,7,248
"26799",1026799,26,99,1,126
"26800",1026800,110,124,10,244
"26801",1026801,217,72,8,297
"26802",1026802,190,38,11,239
"26803",1026803,189,160,12,361
"26804",1026804,112,70,10,192
"26805",1026805,101,112,4,217
"26806",1026806,43,212,1,256
"26807",1026807,84,181,3,268
"26808",1026808,178,106,26,310
"26809",1026809,91,179,5,275
"26810",1026810,95,22,5,122
"26811",1026811,70,130,3,203
"26812",1026812,58,188,16,262
"26813",1026813,121,114,10,245
"26814",1026814,216,33,8,257
"26815",1026815,84,83,4,171
"26816",1026816,107,78,10,195
"26817",1026817,69,260,5,334
"26818",1026818,42,133,16,191
"26819",1026819,169,19,6,194
"26820",1026820,227,86,4,317
"26821",1026821,182,98,9,289
"26822",1026822,104,58,9,171
"26823",1026823,229,24,4,257
"26824",1026824,205,65,10,280
"26825",1026825,124,174,15,313
"26826",1026826,53,269,4,326
"26827",1026827,115,138,6,259
"26828",1026828,83,209,6,298
"26829",1026829,111,66,7,184
"26830",1026830,31,35,11,77
"26831",1026831,113,99,10,222
"26832",1026832,195,53,12,260
"26833",1026833,35,138,5,178
"26834",1026834,7,11,1,19
"26835",1026835,97,12,1,110
"26836",1026836,144,130,18,292
"26837",1026837,179,60,10,249
"26838",1026838,22,136,8,166
"26839",1026839,139,178,10,327
"26840",1026840,94,229,18,341
"26841",1026841,17,194,1,212
"26842",1026842,168,53,7,228
"26843",1026843,120,183,5,308
"26844",1026844,215,68,21,304
"26845",1026845,199,128,26,353
"26846",1026846,116,194,8,318
"26847",1026847,183,24,3,210
"26848",1026848,209,62,7,278
"26849",1026849,16,10,2,28
"26850",1026850,4,69,1,74
"26851",1026851,23,265,4,292
"26852",1026852,182,33,9,224
"26853",1026853,107,71,4,182
"26854",1026854,108,91,8,207
"26855",1026855,24,22,1,47
"26856",1026856,35,242,9,286
"26857",1026857,85,57,5,147
"26858",1026858,28,299,9,336
"26859",1026859,173,90,12,275
"26860",1026860,144,103,3,250
"26861",1026861,89,148,7,244
"26862",1026862,82,59,4,145
"26863",1026863,151,45,12,208
"26864",1026864,38,171,6,215
"26865",1026865,242,63,10,315
"26866",1026866,90,86,4,180
"26867",1026867,96,96,24,216
"26868",1026868,70,138,18,226
"26869",1026869,159,71,15,245
"26870",1026870,211,41,17,269
"26871",1026871,235,27,4,266
"26872",1026872,199,46,14,259
"26873",1026873,113,65,8,186
"26874",1026874,45,244,5,294
"26875",1026875,61,225,4,290
"26876",1026876,53,184,4,241
"26877",1026877,98,85,3,186
"26878",1026878,232,21,4,257
"26879",1026879,73,165,31,269
"26880",1026880,114,106,7,227
"26881",1026881,145,94,18,257
"26882",1026882,196,99,7,302
"26883",1026883,18,3,0,21
"26884",1026884,117,136,12,265
"26885",1026885,84,228,4,316
"26886",1026886,71,189,12,272
"26887",1026887,124,14,3,141
"26888",1026888,94,179,6,279
"26889",1026889,120,151,9,280
"26890",1026890,103,88,7,198
"26891",1026891,25,236,5,266
"26892",1026892,121,33,3,157
"26893",1026893,76,144,3,223
"26894",1026894,132,0,0,132
"26895",1026895,199,50,11,260
"26896",1026896,194,88,7,289
"26897",1026897,1,10,0,11
"26898",1026898,23,29,3,55
"26899",1026899,97,133,3,233
"26900",1026900,73,123,3,199
"26901",1026901,190,99,9,298
"26902",1026902,162,33,4,199
"26903",1026903,213,50,9,272
"26904",1026904,166,90,7,263
"26905",1026905,10,283,0,293
"26906",1026906,37,88,2,127
"26907",1026907,24,14,4,42
"26908",1026908,11,122,3,136
"26909",1026909,106,110,17,233
"26910",1026910,34,136,14,184
"26911",1026911,10,7,0,17
"26912",1026912,44,207,4,255
"26913",1026913,58,21,7,86
"26914",1026914,81,145,9,235
"26915",1026915,119,105,6,230
"26916",1026916,106,28,19,153
"26917",1026917,50,101,7,158
"26918",1026918,143,64,4,211
"26919",1026919,151,26,5,182
"26920",1026920,81,100,15,196
"26921",1026921,92,122,12,226
"26922",1026922,101,107,4,212
"26923",1026923,59,209,5,273
"26924",1026924,20,219,6,245
"26925",1026925,111,37,5,153
"26926",1026926,19,206,1,226
"26927",1026927,84,92,20,196
"26928",1026928,184,63,12,259
"26929",1026929,151,16,3,170
"26930",1026930,8,0,0,8
"26931",1026931,171,25,10,206
"26932",1026932,85,243,11,339
"26933",1026933,96,102,14,212
"26934",1026934,120,100,3,223
"26935",1026935,24,249,2,275
"26936",1026936,14,62,1,77
"26937",1026937,79,117,15,211
"26938",1026938,151,38,7,196
"26939",1026939,125,175,15,315
"26940",1026940,41,41,4,86
"26941",1026941,68,10,2,80
"26942",1026942,150,65,5,220
"26943",1026943,47,123,7,177
"26944",1026944,65,101,2,168
"26945",1026945,134,29,3,166
"26946",1026946,157,89,16,262
"26947",1026947,91,177,7,275
"26948",1026948,60,52,4,116
"26949",1026949,215,25,5,245
"26950",1026950,43,137,1,181
"26951",1026951,217,110,12,339
"26952",1026952,61,172,6,239
"26953",1026953,139,18,3,160
"26954",1026954,73,251,15,339
"26955",1026955,115,90,11,216
"26956",1026956,193,53,8,254
"26957",1026957,18,1,0,19
"26958",1026958,60,109,7,176
"26959",1026959,100,153,11,264
"26960",1026960,30,61,0,91
"26961",1026961,77,108,3,188
"26962",1026962,114,113,14,241
"26963",1026963,192,63,10,265
"26964",1026964,131,48,5,184
"26965",1026965,122,23,4,149
"26966",1026966,132,40,3,175
"26967",1026967,61,243,1,305
"26968",1026968,114,22,11,147
"26969",1026969,110,60,17,187
"26970",1026970,230,38,9,277
"26971",1026971,55,147,14,216
"26972",1026972,170,98,11,279
"26973",1026973,95,175,11,281
"26974",1026974,70,93,8,171
"26975",1026975,177,113,8,298
"26976",1026976,138,31,4,173
"26977",1026977,146,38,9,193
"26978",1026978,57,167,7,231
"26979",1026979,96,181,15,292
"26980",1026980,133,112,11,256
"26981",1026981,51,197,14,262
"26982",1026982,16,24,0,40
"26983",1026983,4,3,0,7
"26984",1026984,98,27,4,129
"26985",1026985,15,10,2,27
"26986",1026986,71,98,1,170
"26987",1026987,65,0,1,66
"26988",1026988,95,77,5,177
"26989",1026989,95,122,14,231
"26990",1026990,143,113,5,261
"26991",1026991,45,156,7,208
"26992",1026992,98,193,7,298
"26993",1026993,78,187,9,274
"26994",1026994,195,4,7,206
"26995",1026995,101,156,7,264
"26996",1026996,215,44,6,265
"26997",1026997,52,162,6,220
"26998",1026998,210,101,12,323
"26999",1026999,55,277,3,335
"27000",1027000,72,229,10,311
"27001",1027001,167,53,4,224
"27002",1027002,126,145,4,275
"27003",1027003,54,174,8,236
"27004",1027004,67,124,4,195
"27005",1027005,30,139,5,174
"27006",1027006,90,182,18,290
"27007",1027007,191,57,14,262
"27008",1027008,103,57,8,168
"27009",1027009,155,95,1,251
"27010",1027010,113,85,1,199
"27011",1027011,119,74,13,206
"27012",1027012,67,55,9,131
"27013",1027013,53,170,20,243
"27014",1027014,176,15,6,197
"27015",1027015,199,88,5,292
"27016",1027016,110,160,12,282
"27017",1027017,47,163,1,211
"27018",1027018,175,46,4,225
"27019",1027019,65,41,6,112
"27020",1027020,63,66,8,137
"27021",1027021,157,53,9,219
"27022",1027022,133,78,6,217
"27023",1027023,186,227,6,419
"27024",1027024,102,38,8,148
"27025",1027025,62,236,2,300
"27026",1027026,41,233,4,278
"27027",1027027,65,46,1,112
"27028",1027028,42,185,8,235
"27029",1027029,76,11,1,88
"27030",1027030,228,34,14,276
"27031",1027031,117,176,18,311
"27032",1027032,30,45,0,75
"27033",1027033,246,16,3,265
"27034",1027034,134,155,14,303
"27035",1027035,204,54,10,268
"27036",1027036,62,37,4,103
"27037",1027037,62,268,12,342
"27038",1027038,142,0,4,146
"27039",1027039,159,98,9,266
"27040",1027040,57,208,2,267
"27041",1027041,70,183,3,256
"27042",1027042,46,204,15,265
"27043",1027043,168,21,5,194
"27044",1027044,127,144,10,281
"27045",1027045,281,8,9,298
"27046",1027046,21,188,2,211
"27047",1027047,256,24,12,292
"27048",1027048,83,60,3,146
"27049",1027049,77,172,11,260
"27050",1027050,168,93,16,277
"27051",1027051,81,7,2,90
"27052",1027052,51,171,4,226
"27053",1027053,145,130,8,283
"27054",1027054,81,162,3,246
"27055",1027055,155,74,14,243
"27056",1027056,160,174,8,342
"27057",1027057,129,81,12,222
"27058",1027058,123,172,18,313
"27059",1027059,129,79,11,219
"27060",1027060,38,218,4,260
"27061",1027061,74,182,4,260
"27062",1027062,143,139,18,300
"27063",1027063,166,91,26,283
"27064",1027064,154,59,8,221
"27065",1027065,101,219,8,328
"27066",1027066,46,134,4,184
"27067",1027067,209,21,7,237
"27068",1027068,174,115,16,305
"27069",1027069,150,114,22,286
"27070",1027070,160,32,6,198
"27071",1027071,144,96,14,254
"27072",1027072,122,107,4,233
"27073",1027073,99,12,7,118
"27074",1027074,105,107,4,216
"27075",1027075,151,49,6,206
"27076",1027076,118,169,12,299
"27077",1027077,204,82,17,303
"27078",1027078,81,95,8,184
"27079",1027079,30,5,1,36
"27080",1027080,75,68,2,145
"27081",1027081,62,182,12,256
"27082",1027082,122,40,10,172
"27083",1027083,156,38,6,200
"27084",1027084,229,28,5,262
"27085",1027085,152,101,11,264
"27086",1027086,138,316,15,469
"27087",1027087,95,108,3,206
"27088",1027088,7,38,2,47
"27089",1027089,84,78,3,165
"27090",1027090,220,36,7,263
"27091",1027091,223,77,9,309
"27092",1027092,128,105,6,239
"27093",1027093,56,210,2,268
"27094",1027094,117,229,10,356
"27095",1027095,36,189,4,229
"27096",1027096,121,56,3,180
"27097",1027097,107,52,6,165
"27098",1027098,46,157,10,213
"27099",1027099,124,168,3,295
"27100",1027100,148,89,5,242
"27101",1027101,147,73,14,234
"27102",1027102,19,174,4,197
"27103",1027103,39,249,7,295
"27104",1027104,17,17,2,36
"27105",1027105,84,123,5,212
"27106",1027106,70,165,12,247
"27107",1027107,81,62,2,145
"27108",1027108,85,158,6,249
"27109",1027109,131,127,2,260
"27110",1027110,26,261,2,289
"27111",1027111,28,249,3,280
"27112",1027112,124,137,16,277
"27113",1027113,63,236,6,305
"27114",1027114,111,183,6,300
"27115",1027115,57,184,8,249
"27116",1027116,172,42,3,217
"27117",1027117,54,152,12,218
"27118",1027118,46,235,9,290
"27119",1027119,46,149,7,202
"27120",1027120,43,291,3,337
"27121",1027121,119,103,9,231
"27122",1027122,124,90,25,239
"27123",1027123,69,170,7,246
"27124",1027124,6,2,1,9
"27125",1027125,162,85,19,266
"27126",1027126,76,178,10,264
"27127",1027127,67,31,6,104
"27128",1027128,168,72,4,244
"27129",1027129,47,156,10,213
"27130",1027130,86,156,7,249
"27131",1027131,69,227,21,317
"27132",1027132,66,27,7,100
"27133",1027133,214,48,3,265
"27134",1027134,63,163,4,230
"27135",1027135,96,191,8,295
"27136",1027136,91,7,2,100
"27137",1027137,33,257,4,294
"27138",1027138,202,92,17,311
"27139",1027139,94,136,1,231
"27140",1027140,63,100,15,178
"27141",1027141,195,34,5,234
"27142",1027142,150,61,5,216
"27143",1027143,123,74,13,210
"27144",1027144,155,75,11,241
"27145",1027145,48,244,7,299
"27146",1027146,144,169,21,334
"27147",1027147,47,129,8,184
"27148",1027148,177,69,8,254
"27149",1027149,59,80,2,141
"27150",1027150,130,110,6,246
"27151",1027151,104,82,11,197
"27152",1027152,144,80,15,239
"27153",1027153,49,30,1,80
"27154",1027154,185,16,2,203
"27155",1027155,137,73,4,214
"27156",1027156,15,36,3,54
"27157",1027157,53,151,15,219
"27158",1027158,221,58,8,287
"27159",1027159,115,157,8,280
"27160",1027160,234,32,5,271
"27161",1027161,131,37,4,172
"27162",1027162,172,82,13,267
"27163",1027163,65,112,4,181
"27164",1027164,187,31,6,224
"27165",1027165,137,148,10,295
"27166",1027166,155,44,6,205
"27167",1027167,135,92,5,232
"27168",1027168,177,37,4,218
"27169",1027169,165,40,3,208
"27170",1027170,44,244,7,295
"27171",1027171,113,83,13,209
"27172",1027172,185,33,1,219
"27173",1027173,188,79,12,279
"27174",1027174,27,193,6,226
"27175",1027175,127,72,3,202
"27176",1027176,97,75,3,175
"27177",1027177,25,48,10,83
"27178",1027178,145,149,11,305
"27179",1027179,86,168,6,260
"27180",1027180,204,20,3,227
"27181",1027181,86,223,9,318
"27182",1027182,149,158,16,323
"27183",1027183,18,103,3,124
"27184",1027184,87,136,4,227
"27185",1027185,60,10,1,71
"27186",1027186,66,179,6,251
"27187",1027187,183,82,13,278
"27188",1027188,84,57,13,154
"27189",1027189,68,73,5,146
"27190",1027190,16,32,1,49
"27191",1027191,197,51,8,256
"27192",1027192,140,66,6,212
"27193",1027193,68,162,25,255
"27194",1027194,89,150,25,264
"27195",1027195,92,6,0,98
"27196",1027196,21,189,7,217
"27197",1027197,67,131,7,205
"27198",1027198,239,6,1,246
"27199",1027199,96,19,2,117
"27200",1027200,16,168,0,184
"27201",1027201,156,50,26,232
"27202",1027202,91,126,3,220
"27203",1027203,207,41,8,256
"27204",1027204,116,48,7,171
"27205",1027205,84,177,1,262
"27206",1027206,246,22,10,278
"27207",1027207,85,66,2,153
"27208",1027208,76,152,6,234
"27209",1027209,80,199,19,298
"27210",1027210,254,44,6,304
"27211",1027211,182,101,14,297
"27212",1027212,33,300,6,339
"27213",1027213,61,184,0,245
"27214",1027214,78,10,1,89
"27215",1027215,78,191,10,279
"27216",1027216,109,121,11,241
"27217",1027217,86,118,2,206
"27218",1027218,83,70,4,157
"27219",1027219,124,120,8,252
"27220",1027220,15,304,3,322
"27221",1027221,56,228,2,286
"27222",1027222,69,35,6,110
"27223",1027223,85,79,16,180
"27224",1027224,121,156,17,294
"27225",1027225,204,63,12,279
"27226",1027226,190,105,6,301
"27227",1027227,160,121,10,291
"27228",1027228,113,135,8,256
"27229",1027229,86,115,5,206
"27230",1027230,87,161,11,259
"27231",1027231,102,113,1,216
"27232",1027232,138,60,10,208
"27233",1027233,149,30,8,187
"27234",1027234,153,71,3,227
"27235",1027235,117,62,1,180
"27236",1027236,22,192,6,220
"27237",1027237,83,140,11,234
"27238",1027238,221,27,7,255
"27239",1027239,151,173,6,330
"27240",1027240,134,18,6,158
"27241",1027241,208,67,14,289
"27242",1027242,170,48,5,223
"27243",1027243,118,122,4,244
"27244",1027244,23,92,2,117
"27245",1027245,21,167,2,190
"27246",1027246,132,8,21,161
"27247",1027247,129,55,10,194
"27248",1027248,34,243,2,279
"27249",1027249,70,51,4,125
"27250",1027250,161,23,5,189
"27251",1027251,36,12,1,49
"27252",1027252,34,190,1,225
"27253",1027253,113,129,7,249
"27254",1027254,125,57,6,188
"27255",1027255,60,336,14,410
"27256",1027256,249,0,0,249
"27257",1027257,152,31,9,192
"27258",1027258,220,41,9,270
"27259",1027259,164,14,15,193
"27260",1027260,76,4,0,80
"27261",1027261,89,202,5,296
"27262",1027262,132,11,2,145
"27263",1027263,9,11,0,20
"27264",1027264,139,2,0,141
"27265",1027265,122,164,27,313
"27266",1027266,137,160,21,318
"27267",1027267,22,64,1,87
"27268",1027268,61,97,15,173
"27269",1027269,6,17,0,23
"27270",1027270,78,31,8,117
"27271",1027271,109,82,11,202
"27272",1027272,94,165,7,266
"27273",1027273,92,122,11,225
"27274",1027274,109,43,8,160
"27275",1027275,15,149,4,168
"27276",1027276,86,82,6,174
"27277",1027277,56,170,5,231
"27278",1027278,162,138,14,314
"27279",1027279,165,58,21,244
"27280",1027280,80,110,5,195
"27281",1027281,138,95,15,248
"27282",1027282,170,35,16,221
"27283",1027283,4,7,0,11
"27284",1027284,136,65,5,206
"27285",1027285,12,4,0,16
"27286",1027286,16,16,2,34
"27287",1027287,194,58,13,265
"27288",1027288,65,155,2,222
"27289",1027289,99,39,5,143
"27290",1027290,48,228,11,287
"27291",1027291,191,23,7,221
"27292",1027292,126,124,7,257
"27293",1027293,46,123,8,177
"27294",1027294,77,161,10,248
"27295",1027295,72,84,9,165
"27296",1027296,46,119,2,167
"27297",1027297,157,1,3,161
"27298",1027298,123,168,17,308
"27299",1027299,14,32,2,48
"27300",1027300,170,30,4,204
"27301",1027301,273,25,5,303
"27302",1027302,43,83,3,129
"27303",1027303,94,161,10,265
"27304",1027304,120,140,7,267
"27305",1027305,64,10,0,74
"27306",1027306,271,9,4,284
"27307",1027307,38,176,1,215
"27308",1027308,126,177,16,319
"27309",1027309,109,157,15,281
"27310",1027310,190,45,7,242
"27311",1027311,233,112,16,361
"27312",1027312,83,165,5,253
"27313",1027313,59,220,2,281
"27314",1027314,37,14,4,55
"27315",1027315,172,39,5,216
"27316",1027316,140,24,6,170
"27317",1027317,44,229,11,284
"27318",1027318,153,141,19,313
"27319",1027319,133,63,7,203
"27320",1027320,31,37,2,70
"27321",1027321,128,72,5,205
"27322",1027322,140,28,9,177
"27323",1027323,73,127,13,213
"27324",1027324,150,53,7,210
"27325",1027325,101,113,5,219
"27326",1027326,121,73,2,196
"27327",1027327,29,6,1,36
"27328",1027328,68,222,10,300
"27329",1027329,160,91,6,257
"27330",1027330,97,12,3,112
"27331",1027331,96,209,7,312
"27332",1027332,92,19,8,119
"27333",1027333,131,33,4,168
"27334",1027334,129,50,15,194
"27335",1027335,94,175,9,278
"27336",1027336,159,28,5,192
"27337",1027337,52,21,2,75
"27338",1027338,191,112,8,311
"27339",1027339,74,160,6,240
"27340",1027340,125,104,13,242
"27341",1027341,170,95,11,276
"27342",1027342,114,232,15,361
"27343",1027343,207,36,5,248
"27344",1027344,120,58,10,188
"27345",1027345,32,3,0,35
"27346",1027346,64,109,8,181
"27347",1027347,130,89,8,227
"27348",1027348,104,82,14,200
"27349",1027349,63,171,18,252
"27350",1027350,89,140,24,253
"27351",1027351,56,22,0,78
"27352",1027352,27,165,6,198
"27353",1027353,138,167,3,308
"27354",1027354,99,137,6,242
"27355",1027355,155,33,7,195
"27356",1027356,18,122,3,143
"27357",1027357,84,53,8,145
"27358",1027358,40,89,7,136
"27359",1027359,85,281,6,372
"27360",1027360,111,179,23,313
"27361",1027361,91,172,6,269
"27362",1027362,11,15,0,26
"27363",1027363,61,229,7,297
"27364",1027364,82,206,8,296
"27365",1027365,135,44,6,185
"27366",1027366,22,200,5,227
"27367",1027367,153,152,6,311
"27368",1027368,109,121,5,235
"27369",1027369,25,164,6,195
"27370",1027370,111,93,10,214
"27371",1027371,110,94,9,213
"27372",1027372,191,27,5,223
"27373",1027373,15,24,1,40
"27374",1027374,121,95,3,219
"27375",1027375,27,227,3,257
"27376",1027376,76,228,6,310
"27377",1027377,131,117,8,256
"27378",1027378,191,62,11,264
"27379",1027379,40,248,2,290
"27380",1027380,73,101,6,180
"27381",1027381,195,30,5,230
"27382",1027382,173,42,2,217
"27383",1027383,153,48,12,213
"27384",1027384,190,50,4,244
"27385",1027385,162,69,10,241
"27386",1027386,2,2,0,4
"27387",1027387,41,189,6,236
"27388",1027388,177,90,12,279
"27389",1027389,182,22,7,211
"27390",1027390,199,109,12,320
"27391",1027391,106,42,6,154
"27392",1027392,101,192,4,297
"27393",1027393,123,43,4,170
"27394",1027394,157,57,7,221
"27395",1027395,65,182,6,253
"27396",1027396,68,224,18,310
"27397",1027397,64,80,8,152
"27398",1027398,39,193,0,232
"27399",1027399,73,81,1,155
"27400",1027400,145,141,13,299
"27401",1027401,16,61,2,79
"27402",1027402,16,5,0,21
"27403",1027403,39,43,3,85
"27404",1027404,121,37,1,159
"27405",1027405,67,63,9,139
"27406",1027406,72,85,5,162
"27407",1027407,78,218,8,304
"27408",1027408,75,186,13,274
"27409",1027409,64,166,17,247
"27410",1027410,37,250,4,291
"27411",1027411,79,149,20,248
"27412",1027412,14,4,0,18
"27413",1027413,176,37,4,217
"27414",1027414,88,197,12,297
"27415",1027415,130,66,4,200
"27416",1027416,18,174,2,194
"27417",1027417,253,21,8,282
"27418",1027418,58,238,8,304
"27419",1027419,38,75,6,119
"27420",1027420,109,117,7,233
"27421",1027421,207,28,3,238
"27422",1027422,47,142,9,198
"27423",1027423,6,72,2,80
"27424",1027424,41,130,7,178
"27425",1027425,63,213,11,287
"27426",1027426,49,152,11,212
"27427",1027427,57,242,7,306
"27428",1027428,95,85,11,191
"27429",1027429,146,42,30,218
"27430",1027430,57,195,2,254
"27431",1027431,184,82,6,272
"27432",1027432,151,56,4,211
"27433",1027433,63,137,8,208
"27434",1027434,49,132,10,191
"27435",1027435,52,94,8,154
"27436",1027436,175,38,7,220
"27437",1027437,116,1,1,118
"27438",1027438,163,88,16,267
"27439",1027439,115,122,8,245
"27440",1027440,64,121,9,194
"27441",1027441,91,159,7,257
"27442",1027442,23,1,1,25
"27443",1027443,143,14,3,160
"27444",1027444,62,218,6,286
"27445",1027445,166,37,11,214
"27446",1027446,173,101,16,290
"27447",1027447,122,166,13,301
"27448",1027448,204,60,13,277
"27449",1027449,115,125,9,249
"27450",1027450,98,159,8,265
"27451",1027451,128,132,14,274
"27452",1027452,224,11,6,241
"27453",1027453,126,17,1,144
"27454",1027454,38,247,3,288
"27455",1027455,147,102,10,259
"27456",1027456,61,182,10,253
"27457",1027457,57,215,8,280
"27458",1027458,97,119,3,219
"27459",1027459,75,77,5,157
"27460",1027460,19,135,5,159
"27461",1027461,88,112,5,205
"27462",1027462,107,62,6,175
"27463",1027463,114,149,12,275
"27464",1027464,60,46,0,106
"27465",1027465,217,50,11,278
"27466",1027466,68,169,3,240
"27467",1027467,87,4,2,93
"27468",1027468,132,80,8,220
"27469",1027469,144,99,7,250
"27470",1027470,131,145,11,287
"27471",1027471,50,255,11,316
"27472",1027472,264,14,7,285
"27473",1027473,107,131,23,261
"27474",1027474,118,73,4,195
"27475",1027475,227,73,12,312
"27476",1027476,95,117,3,215
"27477",1027477,86,61,1,148
"27478",1027478,151,86,4,241
"27479",1027479,48,194,3,245
"27480",1027480,182,97,8,287
"27481",1027481,42,222,11,275
"27482",1027482,97,77,18,192
"27483",1027483,21,1,1,23
"27484",1027484,94,171,10,275
"27485",1027485,238,48,6,292
"27486",1027486,61,14,2,77
"27487",1027487,158,100,5,263
"27488",1027488,151,111,5,267
"27489",1027489,93,125,18,236
"27490",1027490,86,172,4,262
"27491",1027491,191,79,4,274
"27492",1027492,231,50,1,282
"27493",1027493,73,118,3,194
"27494",1027494,55,68,7,130
"27495",1027495,96,116,12,224
"27496",1027496,183,46,12,241
"27497",1027497,146,106,10,262
"27498",1027498,165,70,7,242
"27499",1027499,132,19,3,154
"27500",1027500,146,163,12,321
"27501",1027501,90,181,10,281
"27502",1027502,98,173,5,276
"27503",1027503,41,37,6,84
"27504",1027504,5,1,0,6
"27505",1027505,200,58,5,263
"27506",1027506,72,201,5,278
"27507",1027507,91,150,4,245
"27508",1027508,76,130,7,213
"27509",1027509,21,32,1,54
"27510",1027510,78,213,4,295
"27511",1027511,81,135,16,232
"27512",1027512,41,33,4,78
"27513",1027513,95,45,6,146
"27514",1027514,116,74,13,203
"27515",1027515,173,127,24,324
"27516",1027516,81,95,6,182
"27517",1027517,16,4,0,20
"27518",1027518,58,172,6,236
"27519",1027519,91,179,9,279
"27520",1027520,113,30,5,148
"27521",1027521,43,46,1,90
"27522",1027522,117,137,12,266
"27523",1027523,79,118,10,207
"27524",1027524,83,250,2,335
"27525",1027525,97,70,2,169
"27526",1027526,205,39,5,249
"27527",1027527,239,33,10,282
"27528",1027528,154,84,12,250
"27529",1027529,202,40,9,251
"27530",1027530,47,207,3,257
"27531",1027531,102,221,9,332
"27532",1027532,164,102,17,283
"27533",1027533,104,141,9,254
"27534",1027534,61,143,5,209
"27535",1027535,208,19,6,233
"27536",1027536,198,72,7,277
"27537",1027537,70,220,3,293
"27538",1027538,6,16,0,22
"27539",1027539,99,129,6,234
"27540",1027540,204,71,13,288
"27541",1027541,108,146,7,261
"27542",1027542,54,190,11,255
"27543",1027543,194,77,16,287
"27544",1027544,63,136,6,205
"27545",1027545,14,102,3,119
"27546",1027546,94,157,12,263
"27547",1027547,112,159,6,277
"27548",1027548,93,113,7,213
"27549",1027549,150,107,4,261
"27550",1027550,115,25,1,141
"27551",1027551,190,83,18,291
"27552",1027552,109,136,8,253
"27553",1027553,103,56,11,170
"27554",1027554,172,32,5,209
"27555",1027555,116,146,7,269
"27556",1027556,59,222,11,292
"27557",1027557,62,51,4,117
"27558",1027558,229,21,9,259
"27559",1027559,206,50,4,260
"27560",1027560,159,123,12,294
"27561",1027561,177,49,12,238
"27562",1027562,106,162,9,277
"27563",1027563,110,183,8,301
"27564",1027564,179,74,9,262
"27565",1027565,5,9,2,16
"27566",1027566,75,142,7,224
"27567",1027567,85,159,10,254
"27568",1027568,41,203,10,254
"27569",1027569,228,32,14,274
"27570",1027570,60,123,8,191
"27571",1027571,148,117,18,283
"27572",1027572,17,50,0,67
"27573",1027573,49,81,4,134
"27574",1027574,55,182,7,244
"27575",1027575,9,4,1,14
"27576",1027576,41,156,5,202
"27577",1027577,167,75,21,263
"27578",1027578,31,49,0,80
"27579",1027579,133,57,5,195
"27580",1027580,19,194,1,214
"27581",1027581,87,17,4,108
"27582",1027582,11,82,0,93
"27583",1027583,46,203,8,257
"27584",1027584,68,274,5,347
"27585",1027585,123,171,18,312
"27586",1027586,116,118,3,237
"27587",1027587,88,94,4,186
"27588",1027588,26,216,3,245
"27589",1027589,57,45,10,112
"27590",1027590,82,232,5,319
"27591",1027591,85,91,3,179
"27592",1027592,204,37,4,245
"27593",1027593,31,9,2,42
"27594",1027594,60,147,3,210
"27595",1027595,31,2,1,34
"27596",1027596,104,136,4,244
"27597",1027597,118,124,5,247
"27598",1027598,165,29,6,200
"27599",1027599,129,96,7,232
"27600",1027600,64,146,10,220
"27601",1027601,12,58,1,71
"27602",1027602,135,106,8,249
"27603",1027603,84,128,5,217
"27604",1027604,201,36,5,242
"27605",1027605,94,194,12,300
"27606",1027606,138,110,3,251
"27607",1027607,119,97,8,224
"27608",1027608,196,47,13,256
"27609",1027609,78,96,12,186
"27610",1027610,42,183,9,234
"27611",1027611,153,25,11,189
"27612",1027612,28,122,10,160
"27613",1027613,58,204,11,273
"27614",1027614,178,51,7,236
"27615",1027615,138,28,8,174
"27616",1027616,156,122,8,286
"27617",1027617,91,97,4,192
"27618",1027618,84,193,13,290
"27619",1027619,155,46,3,204
"27620",1027620,26,278,13,317
"27621",1027621,82,179,7,268
"27622",1027622,101,32,4,137
"27623",1027623,260,31,6,297
"27624",1027624,172,92,6,270
"27625",1027625,26,177,2,205
"27626",1027626,177,30,3,210
"27627",1027627,23,181,5,209
"27628",1027628,88,107,10,205
"27629",1027629,71,228,3,302
"27630",1027630,102,10,4,116
"27631",1027631,74,398,6,478
"27632",1027632,25,80,5,110
"27633",1027633,156,103,10,269
"27634",1027634,37,134,0,171
"27635",1027635,140,121,10,271
"27636",1027636,107,141,12,260
"27637",1027637,53,35,5,93
"27638",1027638,46,40,4,90
"27639",1027639,192,42,7,241
"27640",1027640,110,87,11,208
"27641",1027641,30,53,5,88
"27642",1027642,96,118,4,218
"27643",1027643,187,23,3,213
"27644",1027644,99,148,10,257
"27645",1027645,127,173,12,312
"27646",1027646,214,59,3,276
"27647",1027647,173,26,10,209
"27648",1027648,234,15,8,257
"27649",1027649,180,35,9,224
"27650",1027650,4,30,0,34
"27651",1027651,3,57,7,67
"27652",1027652,153,48,11,212
"27653",1027653,87,182,6,275
"27654",1027654,80,139,3,222
"27655",1027655,262,51,7,320
"27656",1027656,228,25,9,262
"27657",1027657,107,134,8,249
"27658",1027658,129,106,8,243
"27659",1027659,113,118,4,235
"27660",1027660,63,133,8,204
"27661",1027661,153,90,10,253
"27662",1027662,98,87,17,202
"27663",1027663,8,116,3,127
"27664",1027664,187,94,6,287
"27665",1027665,24,210,1,235
"27666",1027666,40,20,0,60
"27667",1027667,99,45,10,154
"27668",1027668,16,6,0,22
"27669",1027669,50,4,0,54
"27670",1027670,138,73,10,221
"27671",1027671,49,75,5,129
"27672",1027672,27,164,2,193
"27673",1027673,104,40,6,150
"27674",1027674,134,50,9,193
"27675",1027675,1,25,0,26
"27676",1027676,76,189,3,268
"27677",1027677,194,53,3,250
"27678",1027678,56,190,5,251
"27679",1027679,185,65,11,261
"27680",1027680,90,20,0,110
"27681",1027681,27,26,1,54
"27682",1027682,187,61,5,253
"27683",1027683,81,55,7,143
"27684",1027684,293,11,34,338
"27685",1027685,31,29,7,67
"27686",1027686,147,53,1,201
"27687",1027687,15,7,3,25
"27688",1027688,20,248,3,271
"27689",1027689,158,22,3,183
"27690",1027690,236,7,15,258
"27691",1027691,177,44,8,229
"27692",1027692,61,171,5,237
"27693",1027693,68,168,6,242
"27694",1027694,123,34,4,161
"27695",1027695,145,47,2,194
"27696",1027696,97,133,5,235
"27697",1027697,70,165,5,240
"27698",1027698,31,223,1,255
"27699",1027699,47,5,2,54
"27700",1027700,82,132,2,216
"27701",1027701,175,18,7,200
"27702",1027702,79,163,9,251
"27703",1027703,329,1,1,331
"27704",1027704,78,111,5,194
"27705",1027705,42,149,9,200
"27706",1027706,172,67,7,246
"27707",1027707,187,114,8,309
"27708",1027708,13,88,4,105
"27709",1027709,168,44,7,219
"27710",1027710,178,90,13,281
"27711",1027711,35,249,3,287
"27712",1027712,35,3,4,42
"27713",1027713,142,57,21,220
"27714",1027714,110,81,1,192
"27715",1027715,64,170,8,242
"27716",1027716,254,46,9,309
"27717",1027717,246,21,5,272
"27718",1027718,34,112,4,150
"27719",1027719,43,7,3,53
"27720",1027720,166,127,24,317
"27721",1027721,168,27,10,205
"27722",1027722,97,94,6,197
"27723",1027723,158,67,5,230
"27724",1027724,164,33,14,211
"27725",1027725,75,217,9,301
"27726",1027726,143,69,10,222
"27727",1027727,195,39,7,241
"27728",1027728,140,79,8,227
"27729",1027729,80,203,18,301
"27730",1027730,26,17,1,44
"27731",1027731,190,70,7,267
"27732",1027732,11,14,1,26
"27733",1027733,150,69,4,223
"27734",1027734,75,139,5,219
"27735",1027735,85,87,5,177
"27736",1027736,19,5,2,26
"27737",1027737,63,195,5,263
"27738",1027738,98,60,2,160
"27739",1027739,191,79,11,281
"27740",1027740,122,127,12,261
"27741",1027741,198,82,5,285
"27742",1027742,73,23,0,96
"27743",1027743,118,164,13,295
"27744",1027744,7,6,1,14
"27745",1027745,175,35,2,212
"27746",1027746,80,83,2,165
"27747",1027747,37,233,1,271
"27748",1027748,78,143,8,229
"27749",1027749,136,109,17,262
"27750",1027750,34,242,9,285
"27751",1027751,163,77,8,248
"27752",1027752,94,3,3,100
"27753",1027753,23,354,3,380
"27754",1027754,158,30,7,195
"27755",1027755,109,177,22,308
"27756",1027756,99,155,5,259
"27757",1027757,112,74,8,194
"27758",1027758,173,126,12,311
"27759",1027759,134,73,17,224
"27760",1027760,196,42,12,250
"27761",1027761,52,249,4,305
"27762",1027762,179,92,6,277
"27763",1027763,61,225,9,295
"27764",1027764,147,107,8,262
"27765",1027765,210,9,6,225
"27766",1027766,175,44,3,222
"27767",1027767,29,273,6,308
"27768",1027768,125,38,5,168
"27769",1027769,88,59,3,150
"27770",1027770,115,155,3,273
"27771",1027771,28,2,0,30
"27772",1027772,238,10,4,252
"27773",1027773,55,206,9,270
"27774",1027774,35,262,2,299
"27775",1027775,22,240,4,266
"27776",1027776,59,88,2,149
"27777",1027777,81,34,7,122
"27778",1027778,102,175,7,284
"27779",1027779,125,52,4,181
"27780",1027780,89,0,0,89
"27781",1027781,23,202,4,229
"27782",1027782,89,10,3,102
"27783",1027783,112,95,11,218
"27784",1027784,179,103,15,297
"27785",1027785,123,81,7,211
"27786",1027786,64,196,5,265
"27787",1027787,121,50,6,177
"27788",1027788,169,65,15,249
"27789",1027789,110,120,4,234
"27790",1027790,152,85,2,239
"27791",1027791,66,19,6,91
"27792",1027792,27,17,2,46
"27793",1027793,119,61,6,186
"27794",1027794,71,117,12,200
"27795",1027795,61,104,8,173
"27796",1027796,34,209,6,249
"27797",1027797,93,92,2,187
"27798",1027798,200,66,6,272
"27799",1027799,165,38,7,210
"27800",1027800,164,58,9,231
"27801",1027801,10,24,0,34
"27802",1027802,70,39,8,117
"27803",1027803,148,27,5,180
"27804",1027804,159,79,11,249
"27805",1027805,172,108,10,290
"27806",1027806,191,54,7,252
"27807",1027807,149,126,7,282
"27808",1027808,253,55,8,316
"27809",1027809,127,67,4,198
"27810",1027810,20,212,5,237
"27811",1027811,204,47,7,258
"27812",1027812,72,154,16,242
"27813",1027813,106,12,5,123
"27814",1027814,82,184,13,279
"27815",1027815,182,90,9,281
"27816",1027816,60,110,10,180
"27817",1027817,87,45,10,142
"27818",1027818,199,72,8,279
"27819",1027819,34,223,6,263
"27820",1027820,124,108,10,242
"27821",1027821,63,270,6,339
"27822",1027822,31,262,7,300
"27823",1027823,137,80,15,232
"27824",1027824,43,220,2,265
"27825",1027825,146,91,5,242
"27826",1027826,164,115,14,293
"27827",1027827,61,222,3,286
"27828",1027828,24,216,6,246
"27829",1027829,274,13,8,295
"27830",1027830,151,51,8,210
"27831",1027831,237,25,9,271
"27832",1027832,135,67,8,210
"27833",1027833,147,100,10,257
"27834",1027834,126,96,7,229
"27835",1027835,217,39,17,273
"27836",1027836,154,68,7,229
"27837",1027837,59,179,21,259
"27838",1027838,158,42,9,209
"27839",1027839,143,99,4,246
"27840",1027840,162,74,11,247
"27841",1027841,83,41,0,124
"27842",1027842,31,277,2,310
"27843",1027843,116,59,4,179
"27844",1027844,79,125,1,205
"27845",1027845,83,169,2,254
"27846",1027846,140,59,15,214
"27847",1027847,111,41,10,162
"27848",1027848,74,138,10,222
"27849",1027849,151,144,13,308
"27850",1027850,127,98,17,242
"27851",1027851,178,48,12,238
"27852",1027852,241,21,4,266
"27853",1027853,192,35,9,236
"27854",1027854,67,169,15,251
"27855",1027855,79,176,4,259
"27856",1027856,67,137,8,212
"27857",1027857,149,98,9,256
"27858",1027858,122,95,8,225
"27859",1027859,115,117,6,238
"27860",1027860,238,66,11,315
"27861",1027861,39,106,2,147
"27862",1027862,171,51,6,228
"27863",1027863,189,50,10,249
"27864",1027864,114,135,8,257
"27865",1027865,138,59,4,201
"27866",1027866,166,63,9,238
"27867",1027867,86,27,7,120
"27868",1027868,58,217,2,277
"27869",1027869,119,94,9,222
"27870",1027870,75,47,4,126
"27871",1027871,70,113,8,191
"27872",1027872,70,170,7,247
"27873",1027873,169,83,13,265
"27874",1027874,99,29,7,135
"27875",1027875,60,280,4,344
"27876",1027876,152,135,12,299
"27877",1027877,85,103,3,191
"27878",1027878,77,201,7,285
"27879",1027879,63,214,3,280
"27880",1027880,132,76,3,211
"27881",1027881,153,46,2,201
"27882",1027882,231,22,7,260
"27883",1027883,60,167,9,236
"27884",1027884,50,40,1,91
"27885",1027885,44,187,5,236
"27886",1027886,191,26,5,222
"27887",1027887,221,20,8,249
"27888",1027888,151,121,5,277
"27889",1027889,40,72,2,114
"27890",1027890,183,128,18,329
"27891",1027891,283,7,8,298
"27892",1027892,171,136,10,317
"27893",1027893,82,24,2,108
"27894",1027894,179,69,6,254
"27895",1027895,140,84,28,252
"27896",1027896,197,52,11,260
"27897",1027897,80,126,8,214
"27898",1027898,112,162,10,284
"27899",1027899,183,17,6,206
"27900",1027900,203,111,16,330
"27901",1027901,212,55,8,275
"27902",1027902,95,37,9,141
"27903",1027903,149,159,21,329
"27904",1027904,130,187,16,333
"27905",1027905,184,103,6,293
"27906",1027906,104,179,16,299
"27907",1027907,175,67,14,256
"27908",1027908,138,140,13,291
"27909",1027909,16,197,5,218
"27910",1027910,219,58,14,291
"27911",1027911,90,123,27,240
"27912",1027912,142,87,7,236
"27913",1027913,98,91,9,198
"27914",1027914,20,7,1,28
"27915",1027915,260,34,9,303
"27916",1027916,51,128,13,192
"27917",1027917,184,44,10,238
"27918",1027918,78,200,8,286
"27919",1027919,74,45,2,121
"27920",1027920,14,119,2,135
"27921",1027921,167,76,18,261
"27922",1027922,29,161,3,193
"27923",1027923,136,91,9,236
"27924",1027924,165,53,3,221
"27925",1027925,78,189,8,275
"27926",1027926,95,72,6,173
"27927",1027927,148,84,7,239
"27928",1027928,108,142,8,258
"27929",1027929,124,49,5,178
"27930",1027930,179,103,20,302
"27931",1027931,91,252,2,345
"27932",1027932,9,2,0,11
"27933",1027933,70,164,14,248
"27934",1027934,78,146,9,233
"27935",1027935,218,0,0,218
"27936",1027936,226,50,7,283
"27937",1027937,70,252,6,328
"27938",1027938,56,160,6,222
"27939",1027939,108,42,6,156
"27940",1027940,133,140,13,286
"27941",1027941,146,107,5,258
"27942",1027942,139,66,7,212
"27943",1027943,50,22,7,79
"27944",1027944,100,183,8,291
"27945",1027945,9,20,2,31
"27946",1027946,21,202,12,235
"27947",1027947,82,26,7,115
"27948",1027948,113,146,20,279
"27949",1027949,111,35,4,150
"27950",1027950,157,54,5,216
"27951",1027951,321,35,10,366
"27952",1027952,114,0,0,114
"27953",1027953,60,254,1,315
"27954",1027954,67,196,7,270
"27955",1027955,178,71,4,253
"27956",1027956,144,174,7,325
"27957",1027957,114,107,6,227
"27958",1027958,111,132,7,250
"27959",1027959,178,84,9,271
"27960",1027960,81,35,5,121
"27961",1027961,75,29,7,111
"27962",1027962,44,133,3,180
"27963",1027963,92,209,11,312
"27964",1027964,75,212,8,295
"27965",1027965,222,12,7,241
"27966",1027966,74,124,9,207
"27967",1027967,52,125,3,180
"27968",1027968,82,58,2,142
"27969",1027969,100,108,9,217
"27970",1027970,53,168,12,233
"27971",1027971,20,270,11,301
"27972",1027972,43,242,6,291
"27973",1027973,18,79,3,100
"27974",1027974,106,155,13,274
"27975",1027975,47,226,11,284
"27976",1027976,62,174,5,241
"27977",1027977,61,280,4,345
"27978",1027978,12,119,3,134
"27979",1027979,200,21,6,227
"27980",1027980,131,62,11,204
"27981",1027981,38,131,3,172
"27982",1027982,213,17,3,233
"27983",1027983,87,246,11,344
"27984",1027984,0,6,0,6
"27985",1027985,158,36,13,207
"27986",1027986,92,143,14,249
"27987",1027987,49,202,3,254
"27988",1027988,127,41,3,171
"27989",1027989,167,47,4,218
"27990",1027990,271,5,4,280
"27991",1027991,31,142,4,177
"27992",1027992,106,121,13,240
"27993",1027993,235,31,6,272
"27994",1027994,212,43,9,264
"27995",1027995,49,68,2,119
"27996",1027996,140,66,6,212
"27997",1027997,45,197,5,247
"27998",1027998,79,197,10,286
"27999",1027999,112,22,0,134
"28000",1028000,42,50,0,92
"28001",1028001,187,108,7,302
"28002",1028002,142,55,5,202
"28003",1028003,181,130,12,323
"28004",1028004,134,14,4,152
"28005",1028005,69,164,2,235
"28006",1028006,25,105,1,131
"28007",1028007,44,43,3,90
"28008",1028008,161,96,10,267
"28009",1028009,197,47,4,248
"28010",1028010,193,48,4,245
"28011",1028011,129,196,15,340
"28012",1028012,228,109,9,346
"28013",1028013,199,86,14,299
"28014",1028014,34,93,4,131
"28015",1028015,204,15,6,225
"28016",1028016,163,62,3,228
"28017",1028017,138,113,10,261
"28018",1028018,135,98,13,246
"28019",1028019,138,40,11,189
"28020",1028020,52,104,3,159
"28021",1028021,151,15,4,170
"28022",1028022,122,39,5,166
"28023",1028023,58,125,2,185
"28024",1028024,2,4,0,6
"28025",1028025,75,222,6,303
"28026",1028026,79,147,6,232
"28027",1028027,245,38,16,299
"28028",1028028,80,116,9,205
"28029",1028029,153,49,9,211
"28030",1028030,99,59,11,169
"28031",1028031,180,103,26,309
"28032",1028032,63,230,3,296
"28033",1028033,95,127,10,232
"28034",1028034,21,246,2,269
"28035",1028035,154,101,8,263
"28036",1028036,157,103,10,270
"28037",1028037,43,225,5,273
"28038",1028038,101,153,9,263
"28039",1028039,9,12,0,21
"28040",1028040,214,9,4,227
"28041",1028041,56,262,6,324
"28042",1028042,172,106,8,286
"28043",1028043,125,85,14,224
"28044",1028044,43,242,3,288
"28045",1028045,162,63,12,237
"28046",1028046,41,112,11,164
"28047",1028047,40,256,3,299
"28048",1028048,99,149,21,269
"28049",1028049,133,116,2,251
"28050",1028050,51,194,6,251
"28051",1028051,129,41,4,174
"28052",1028052,90,152,14,256
"28053",1028053,51,141,3,195
"28054",1028054,131,98,4,233
"28055",1028055,29,232,3,264
"28056",1028056,88,73,1,162
"28057",1028057,53,182,6,241
"28058",1028058,148,50,3,201
"28059",1028059,193,83,12,288
"28060",1028060,46,212,11,269
"28061",1028061,71,109,4,184
"28062",1028062,126,56,13,195
"28063",1028063,104,185,12,301
"28064",1028064,43,63,2,108
"28065",1028065,68,26,2,96
"28066",1028066,107,88,9,204
"28067",1028067,24,73,6,103
"28068",1028068,47,132,6,185
"28069",1028069,70,147,14,231
"28070",1028070,125,22,4,151
"28071",1028071,43,213,4,260
"28072",1028072,159,71,7,237
"28073",1028073,50,192,10,252
"28074",1028074,144,17,3,164
"28075",1028075,50,217,15,282
"28076",1028076,153,88,1,242
"28077",1028077,144,64,13,221
"28078",1028078,137,66,16,219
"28079",1028079,49,17,4,70
"28080",1028080,203,111,9,323
"28081",1028081,179,11,9,199
"28082",1028082,168,73,5,246
"28083",1028083,143,170,5,318
"28084",1028084,159,88,20,267
"28085",1028085,170,59,6,235
"28086",1028086,182,70,19,271
"28087",1028087,23,3,1,27
"28088",1028088,5,10,1,16
"28089",1028089,182,23,0,205
"28090",1028090,119,61,9,189
"28091",1028091,15,118,2,135
"28092",1028092,48,189,10,247
"28093",1028093,4,1,0,5
"28094",1028094,154,58,14,226
"28095",1028095,130,46,7,183
"28096",1028096,146,18,8,172
"28097",1028097,76,69,7,152
"28098",1028098,67,17,0,84
"28099",1028099,200,26,8,234
"28100",1028100,52,167,4,223
"28101",1028101,192,32,26,250
"28102",1028102,66,94,8,168
"28103",1028103,61,220,5,286
"28104",1028104,168,109,15,292
"28105",1028105,213,4,3,220
"28106",1028106,83,175,6,264
"28107",1028107,133,155,12,300
"28108",1028108,38,133,9,180
"28109",1028109,128,95,11,234
"28110",1028110,140,168,15,323
"28111",1028111,99,190,5,294
"28112",1028112,53,156,9,218
"28113",1028113,119,123,7,249
"28114",1028114,146,94,21,261
"28115",1028115,141,46,8,195
"28116",1028116,211,8,7,226
"28117",1028117,40,175,8,223
"28118",1028118,228,61,9,298
"28119",1028119,143,137,0,280
"28120",1028120,59,205,9,273
"28121",1028121,115,64,2,181
"28122",1028122,140,111,4,255
"28123",1028123,164,69,3,236
"28124",1028124,71,140,10,221
"28125",1028125,84,164,17,265
"28126",1028126,28,67,4,99
"28127",1028127,188,28,5,221
"28128",1028128,48,257,4,309
"28129",1028129,184,13,3,200
"28130",1028130,216,17,14,247
"28131",1028131,104,30,3,137
"28132",1028132,46,78,6,130
"28133",1028133,104,106,18,228
"28134",1028134,123,110,36,269
"28135",1028135,140,44,7,191
"28136",1028136,74,101,6,181
"28137",1028137,2,4,0,6
"28138",1028138,126,38,8,172
"28139",1028139,25,201,8,234
"28140",1028140,94,135,24,253
"28141",1028141,123,154,7,284
"28142",1028142,127,147,27,301
"28143",1028143,73,54,6,133
"28144",1028144,66,44,2,112
"28145",1028145,58,237,6,301
"28146",1028146,29,160,7,196
"28147",1028147,135,74,6,215
"28148",1028148,76,91,6,173
"28149",1028149,158,38,9,205
"28150",1028150,46,73,1,120
"28151",1028151,258,7,8,273
"28152",1028152,20,287,2,309
"28153",1028153,125,181,5,311
"28154",1028154,155,11,1,167
"28155",1028155,204,1,0,205
"28156",1028156,152,48,8,208
"28157",1028157,114,180,12,306
"28158",1028158,257,19,5,281
"28159",1028159,98,102,4,204
"28160",1028160,243,8,3,254
"28161",1028161,174,52,4,230
"28162",1028162,72,133,8,213
"28163",1028163,196,50,12,258
"28164",1028164,191,35,7,233
"28165",1028165,98,97,6,201
"28166",1028166,50,111,8,169
"28167",1028167,45,71,2,118
"28168",1028168,12,236,5,253
"28169",1028169,67,187,11,265
"28170",1028170,52,232,13,297
"28171",1028171,77,101,10,188
"28172",1028172,84,22,3,109
"28173",1028173,107,157,9,273
"28174",1028174,106,99,16,221
"28175",1028175,72,113,3,188
"28176",1028176,17,107,2,126
"28177",1028177,160,121,7,288
"28178",1028178,79,154,4,237
"28179",1028179,145,94,9,248
"28180",1028180,60,280,3,343
"28181",1028181,105,66,6,177
"28182",1028182,53,150,10,213
"28183",1028183,8,23,0,31
"28184",1028184,207,48,6,261
"28185",1028185,162,30,5,197
"28186",1028186,92,111,2,205
"28187",1028187,87,130,6,223
"28188",1028188,20,200,3,223
"28189",1028189,109,106,6,221
"28190",1028190,197,42,11,250
"28191",1028191,41,27,1,69
"28192",1028192,110,89,7,206
"28193",1028193,173,10,17,200
"28194",1028194,55,31,2,88
"28195",1028195,139,44,5,188
"28196",1028196,150,112,11,273
"28197",1028197,221,54,11,286
"28198",1028198,121,80,6,207
"28199",1028199,62,171,3,236
"28200",1028200,52,57,0,109
"28201",1028201,84,1,1,86
"28202",1028202,12,9,1,22
"28203",1028203,105,204,16,325
"28204",1028204,57,29,3,89
"28205",1028205,140,50,9,199
"28206",1028206,23,214,3,240
"28207",1028207,11,30,2,43
"28208",1028208,78,218,13,309
"28209",1028209,110,116,6,232
"28210",1028210,134,65,9,208
"28211",1028211,218,96,14,328
"28212",1028212,38,260,3,301
"28213",1028213,192,38,11,241
"28214",1028214,54,113,2,169
"28215",1028215,117,135,10,262
"28216",1028216,195,6,0,201
"28217",1028217,116,59,5,180
"28218",1028218,157,60,18,235
"28219",1028219,91,9,3,103
"28220",1028220,105,156,7,268
"28221",1028221,92,97,15,204
"28222",1028222,107,138,10,255
"28223",1028223,106,127,16,249
"28224",1028224,203,24,7,234
"28225",1028225,51,239,1,291
"28226",1028226,178,97,7,282
"28227",1028227,34,173,13,220
"28228",1028228,21,259,2,282
"28229",1028229,107,143,14,264
"28230",1028230,162,60,4,226
"28231",1028231,10,63,1,74
"28232",1028232,168,126,3,297
"28233",1028233,76,215,14,305
"28234",1028234,117,86,8,211
"28235",1028235,42,211,5,258
"28236",1028236,196,40,5,241
"28237",1028237,124,175,13,312
"28238",1028238,57,66,4,127
"28239",1028239,57,262,4,323
"28240",1028240,63,34,3,100
"28241",1028241,48,168,3,219
"28242",1028242,103,27,4,134
"28243",1028243,228,55,27,310
"28244",1028244,150,60,5,215
"28245",1028245,140,87,13,240
"28246",1028246,33,115,6,154
"28247",1028247,79,70,0,149
"28248",1028248,156,47,6,209
"28249",1028249,150,115,11,276
"28250",1028250,172,14,3,189
"28251",1028251,73,57,9,139
"28252",1028252,134,186,15,335
"28253",1028253,210,31,6,247
"28254",1028254,48,113,9,170
"28255",1028255,67,167,10,244
"28256",1028256,62,78,6,146
"28257",1028257,37,221,5,263
"28258",1028258,257,15,12,284
"28259",1028259,104,84,17,205
"28260",1028260,54,174,5,233
"28261",1028261,184,60,9,253
"28262",1028262,73,12,3,88
"28263",1028263,133,79,16,228
"28264",1028264,77,155,9,241
"28265",1028265,92,107,6,205
"28266",1028266,181,80,6,267
"28267",1028267,34,61,4,99
"28268",1028268,97,79,5,181
"28269",1028269,57,77,11,145
"28270",1028270,170,103,15,288
"28271",1028271,89,48,3,140
"28272",1028272,42,195,6,243
"28273",1028273,73,43,10,126
"28274",1028274,155,112,8,275
"28275",1028275,63,173,6,242
"28276",1028276,227,35,10,272
"28277",1028277,163,74,6,243
"28278",1028278,84,145,5,234
"28279",1028279,171,32,6,209
"28280",1028280,130,95,17,242
"28281",1028281,116,101,7,224
"28282",1028282,31,267,6,304
"28283",1028283,152,86,15,253
"28284",1028284,105,188,15,308
"28285",1028285,100,132,8,240
"28286",1028286,150,33,12,195
"28287",1028287,81,140,6,227
"28288",1028288,65,131,3,199
"28289",1028289,29,91,7,127
"28290",1028290,109,62,3,174
"28291",1028291,197,126,11,334
"28292",1028292,86,168,10,264
"28293",1028293,177,67,9,253
"28294",1028294,67,179,3,249
"28295",1028295,67,175,17,259
"28296",1028296,173,32,11,216
"28297",1028297,163,128,12,303
"28298",1028298,77,131,6,214
"28299",1028299,72,165,7,244
"28300",1028300,90,126,10,226
"28301",1028301,47,143,10,200
"28302",1028302,122,193,12,327
"28303",1028303,192,69,8,269
"28304",1028304,58,16,2,76
"28305",1028305,110,69,8,187
"28306",1028306,155,48,7,210
"28307",1028307,113,154,8,275
"28308",1028308,69,205,9,283
"28309",1028309,79,207,10,296
"28310",1028310,140,159,23,322
"28311",1028311,39,170,3,212
"28312",1028312,15,29,1,45
"28313",1028313,171,52,5,228
"28314",1028314,126,142,11,279
"28315",1028315,156,72,8,236
"28316",1028316,163,38,7,208
"28317",1028317,38,255,5,298
"28318",1028318,33,150,3,186
"28319",1028319,36,192,10,238
"28320",1028320,145,21,3,169
"28321",1028321,2,67,1,70
"28322",1028322,195,19,7,221
"28323",1028323,81,177,11,269
"28324",1028324,37,200,8,245
"28325",1028325,125,24,4,153
"28326",1028326,189,9,5,203
"28327",1028327,16,7,0,23
"28328",1028328,140,55,9,204
"28329",1028329,142,49,5,196
"28330",1028330,184,119,15,318
"28331",1028331,66,165,5,236
"28332",1028332,130,147,4,281
"28333",1028333,193,55,12,260
"28334",1028334,101,12,5,118
"28335",1028335,82,78,3,163
"28336",1028336,139,104,7,250
"28337",1028337,118,178,11,307
"28338",1028338,172,22,10,204
"28339",1028339,74,186,22,282
"28340",1028340,132,29,5,166
"28341",1028341,100,81,7,188
"28342",1028342,75,101,9,185
"28343",1028343,49,215,14,278
"28344",1028344,104,20,7,131
"28345",1028345,74,126,8,208
"28346",1028346,181,30,10,221
"28347",1028347,99,167,7,273
"28348",1028348,53,186,1,240
"28349",1028349,171,115,22,308
"28350",1028350,124,68,4,196
"28351",1028351,147,10,4,161
"28352",1028352,75,243,10,328
"28353",1028353,147,72,18,237
"28354",1028354,150,73,1,224
"28355",1028355,86,168,10,264
"28356",1028356,146,19,2,167
"28357",1028357,21,265,4,290
"28358",1028358,54,61,4,119
"28359",1028359,12,135,6,153
"28360",1028360,52,149,4,205
"28361",1028361,109,69,8,186
"28362",1028362,93,29,6,128
"28363",1028363,211,38,8,257
"28364",1028364,5,215,1,221
"28365",1028365,97,143,8,248
"28366",1028366,63,11,3,77
"28367",1028367,136,161,17,314
"28368",1028368,92,24,2,118
"28369",1028369,187,18,4,209
"28370",1028370,19,74,2,95
"28371",1028371,44,259,17,320
"28372",1028372,137,92,9,238
"28373",1028373,10,211,2,223
"28374",1028374,97,117,16,230
"28375",1028375,147,161,22,330
"28376",1028376,134,35,7,176
"28377",1028377,188,18,5,211
"28378",1028378,169,87,7,263
"28379",1028379,79,79,9,167
"28380",1028380,159,119,3,281
"28381",1028381,160,83,11,254
"28382",1028382,44,202,4,250
"28383",1028383,124,159,11,294
"28384",1028384,136,100,3,239
"28385",1028385,92,20,5,117
"28386",1028386,192,38,3,233
"28387",1028387,121,38,3,162
"28388",1028388,144,21,3,168
"28389",1028389,233,16,5,254
"28390",1028390,41,198,16,255
"28391",1028391,178,124,12,314
"28392",1028392,83,150,10,243
"28393",1028393,29,243,6,278
"28394",1028394,210,14,3,227
"28395",1028395,22,93,2,117
"28396",1028396,68,205,14,287
"28397",1028397,146,44,4,194
"28398",1028398,202,36,4,242
"28399",1028399,110,100,12,222
"28400",1028400,229,84,6,319
"28401",1028401,88,197,16,301
"28402",1028402,178,44,12,234
"28403",1028403,1,6,0,7
"28404",1028404,152,111,10,273
"28405",1028405,179,64,4,247
"28406",1028406,121,41,10,172
"28407",1028407,10,71,0,81
"28408",1028408,185,73,4,262
"28409",1028409,1,36,2,39
"28410",1028410,134,196,19,349
"28411",1028411,227,41,7,275
"28412",1028412,119,148,15,282
"28413",1028413,73,6,2,81
"28414",1028414,33,29,7,69
"28415",1028415,56,246,18,320
"28416",1028416,122,178,2,302
"28417",1028417,40,176,1,217
"28418",1028418,98,157,11,266
"28419",1028419,103,208,15,326
"28420",1028420,67,184,4,255
"28421",1028421,102,64,15,181
"28422",1028422,227,27,6,260
"28423",1028423,91,171,13,275
"28424",1028424,51,133,24,208
"28425",1028425,223,47,8,278
"28426",1028426,130,74,4,208
"28427",1028427,89,92,8,189
"28428",1028428,74,104,6,184
"28429",1028429,190,98,11,299
"28430",1028430,129,127,12,268
"28431",1028431,185,63,15,263
"28432",1028432,58,212,11,281
"28433",1028433,44,82,4,130
"28434",1028434,15,57,0,72
"28435",1028435,44,137,5,186
"28436",1028436,175,60,12,247
"28437",1028437,16,219,8,243
"28438",1028438,62,129,15,206
"28439",1028439,61,105,2,168
"28440",1028440,136,59,11,206
"28441",1028441,20,170,5,195
"28442",1028442,31,249,0,280
"28443",1028443,39,92,1,132
"28444",1028444,186,91,6,283
"28445",1028445,179,47,7,233
"28446",1028446,41,234,6,281
"28447",1028447,204,27,7,238
"28448",1028448,147,101,8,256
"28449",1028449,15,31,2,48
"28450",1028450,105,132,14,251
"28451",1028451,40,201,5,246
"28452",1028452,174,92,18,284
"28453",1028453,38,218,3,259
"28454",1028454,55,165,8,228
"28455",1028455,59,204,3,266
"28456",1028456,121,51,5,177
"28457",1028457,256,180,11,447
"28458",1028458,28,263,8,299
"28459",1028459,51,125,2,178
"28460",1028460,75,177,15,267
"28461",1028461,187,101,22,310
"28462",1028462,137,61,10,208
"28463",1028463,18,27,3,48
"28464",1028464,52,220,2,274
"28465",1028465,45,85,0,130
"28466",1028466,156,63,10,229
"28467",1028467,84,96,10,190
"28468",1028468,174,40,8,222
"28469",1028469,90,82,2,174
"28470",1028470,147,101,2,250
"28471",1028471,46,168,12,226
"28472",1028472,182,85,19,286
"28473",1028473,191,108,6,305
"28474",1028474,198,16,6,220
"28475",1028475,47,58,8,113
"28476",1028476,46,94,8,148
"28477",1028477,177,87,16,280
"28478",1028478,27,212,9,248
"28479",1028479,143,73,7,223
"28480",1028480,207,42,11,260
"28481",1028481,49,28,3,80
"28482",1028482,189,32,4,225
"28483",1028483,74,84,0,158
"28484",1028484,163,37,10,210
"28485",1028485,73,190,10,273
"28486",1028486,111,47,14,172
"28487",1028487,33,220,2,255
"28488",1028488,29,165,3,197
"28489",1028489,194,111,10,315
"28490",1028490,193,45,9,247
"28491",1028491,134,76,8,218
"28492",1028492,44,209,3,256
"28493",1028493,174,45,2,221
"28494",1028494,11,6,2,19
"28495",1028495,135,154,13,302
"28496",1028496,233,26,5,264
"28497",1028497,111,172,16,299
"28498",1028498,164,113,8,285
"28499",1028499,131,36,10,177
"28500",1028500,40,8,1,49
"28501",1028501,101,32,3,136
"28502",1028502,219,117,9,345
"28503",1028503,107,180,10,297
"28504",1028504,136,161,10,307
"28505",1028505,68,143,2,213
"28506",1028506,103,99,3,205
"28507",1028507,82,101,4,187
"28508",1028508,191,30,9,230
"28509",1028509,183,29,7,219
"28510",1028510,121,110,2,233
"28511",1028511,35,15,8,58
"28512",1028512,15,28,5,48
"28513",1028513,111,50,7,168
"28514",1028514,92,17,2,111
"28515",1028515,31,143,2,176
"28516",1028516,24,147,2,173
"28517",1028517,128,54,11,193
"28518",1028518,146,103,7,256
"28519",1028519,92,156,3,251
"28520",1028520,37,92,2,131
"28521",1028521,44,202,13,259
"28522",1028522,158,294,13,465
"28523",1028523,88,135,8,231
"28524",1028524,90,97,1,188
"28525",1028525,94,216,12,322
"28526",1028526,101,206,7,314
"28527",1028527,91,76,9,176
"28528",1028528,151,28,4,183
"28529",1028529,90,119,1,210
"28530",1028530,132,3,2,137
"28531",1028531,120,192,21,333
"28532",1028532,113,164,8,285
"28533",1028533,58,48,5,111
"28534",1028534,136,72,6,214
"28535",1028535,36,33,4,73
"28536",1028536,32,4,1,37
"28537",1028537,40,41,1,82
"28538",1028538,125,130,8,263
"28539",1028539,46,147,7,200
"28540",1028540,170,38,6,214
"28541",1028541,50,278,6,334
"28542",1028542,16,27,1,44
"28543",1028543,13,193,1,207
"28544",1028544,143,154,5,302
"28545",1028545,77,115,12,204
"28546",1028546,45,22,5,72
"28547",1028547,60,110,12,182
"28548",1028548,102,67,8,177
"28549",1028549,210,41,10,261
"28550",1028550,77,213,10,300
"28551",1028551,176,65,8,249
"28552",1028552,115,179,16,310
"28553",1028553,159,89,13,261
"28554",1028554,31,125,7,163
"28555",1028555,34,263,2,299
"28556",1028556,178,26,7,211
"28557",1028557,219,100,9,328
"28558",1028558,108,135,9,252
"28559",1028559,190,24,11,225
"28560",1028560,85,177,3,265
"28561",1028561,36,178,6,220
"28562",1028562,89,22,3,114
"28563",1028563,54,231,9,294
"28564",1028564,174,72,13,259
"28565",1028565,75,187,26,288
"28566",1028566,53,215,3,271
"28567",1028567,172,38,12,222
"28568",1028568,172,30,12,214
"28569",1028569,21,3,1,25
"28570",1028570,168,10,9,187
"28571",1028571,195,25,3,223
"28572",1028572,184,52,13,249
"28573",1028573,69,189,5,263
"28574",1028574,143,36,7,186
"28575",1028575,173,74,3,250
"28576",1028576,228,56,9,293
"28577",1028577,80,79,17,176
"28578",1028578,142,108,4,254
"28579",1028579,89,2,0,91
"28580",1028580,11,4,0,15
"28581",1028581,191,26,3,220
"28582",1028582,217,77,14,308
"28583",1028583,120,199,20,339
"28584",1028584,36,224,4,264
"28585",1028585,60,214,12,286
"28586",1028586,57,17,2,76
"28587",1028587,68,24,6,98
"28588",1028588,140,82,6,228
"28589",1028589,10,10,2,22
"28590",1028590,106,124,5,235
"28591",1028591,166,68,10,244
"28592",1028592,139,70,0,209
"28593",1028593,141,108,17,266
"28594",1028594,69,171,3,243
"28595",1028595,29,59,4,92
"28596",1028596,58,171,17,246
"28597",1028597,35,12,2,49
"28598",1028598,101,90,17,208
"28599",1028599,176,51,7,234
"28600",1028600,45,230,3,278
"28601",1028601,181,47,4,232
"28602",1028602,185,73,9,267
"28603",1028603,23,121,8,152
"28604",1028604,166,117,13,296
"28605",1028605,109,102,11,222
"28606",1028606,174,70,17,261
"28607",1028607,134,45,11,190
"28608",1028608,167,52,5,224
"28609",1028609,168,16,5,189
"28610",1028610,111,149,7,267
"28611",1028611,8,18,2,28
"28612",1028612,85,122,16,223
"28613",1028613,96,102,9,207
"28614",1028614,132,90,5,227
"28615",1028615,217,46,5,268
"28616",1028616,133,42,6,181
"28617",1028617,73,187,11,271
"28618",1028618,206,3,3,212
"28619",1028619,179,50,11,240
"28620",1028620,19,0,0,19
"28621",1028621,85,174,4,263
"28622",1028622,61,205,22,288
"28623",1028623,88,134,3,225
"28624",1028624,235,61,4,300
"28625",1028625,63,192,5,260
"28626",1028626,124,75,3,202
"28627",1028627,176,40,16,232
"28628",1028628,40,275,2,317
"28629",1028629,106,29,4,139
"28630",1028630,155,30,4,189
"28631",1028631,243,14,5,262
"28632",1028632,132,81,7,220
"28633",1028633,72,255,9,336
"28634",1028634,183,56,9,248
"28635",1028635,96,157,3,256
"28636",1028636,72,174,8,254
"28637",1028637,132,86,17,235
"28638",1028638,235,34,6,275
"28639",1028639,130,165,18,313
"28640",1028640,174,42,9,225
"28641",1028641,131,131,13,275
"28642",1028642,108,176,12,296
"28643",1028643,135,59,5,199
"28644",1028644,127,139,9,275
"28645",1028645,74,132,16,222
"28646",1028646,64,160,13,237
"28647",1028647,131,117,8,256
"28648",1028648,58,165,10,233
"28649",1028649,106,191,14,311
"28650",1028650,40,134,10,184
"28651",1028651,153,32,3,188
"28652",1028652,63,189,9,261
"28653",1028653,198,25,9,232
"28654",1028654,4,3,0,7
"28655",1028655,260,39,11,310
"28656",1028656,27,39,5,71
"28657",1028657,44,240,5,289
"28658",1028658,84,86,7,177
"28659",1028659,166,8,5,179
"28660",1028660,109,77,12,198
"28661",1028661,142,83,4,229
"28662",1028662,32,224,4,260
"28663",1028663,179,54,6,239
"28664",1028664,184,144,8,336
"28665",1028665,205,50,6,261
"28666",1028666,190,73,6,269
"28667",1028667,90,59,4,153
"28668",1028668,145,192,11,348
"28669",1028669,53,165,5,223
"28670",1028670,169,54,14,237
"28671",1028671,173,96,6,275
"28672",1028672,169,61,5,235
"28673",1028673,178,83,17,278
"28674",1028674,83,127,16,226
"28675",1028675,74,216,18,308
"28676",1028676,199,39,11,249
"28677",1028677,125,54,10,189
"28678",1028678,13,3,1,17
"28679",1028679,203,89,6,298
"28680",1028680,125,119,9,253
"28681",1028681,26,162,5,193
"28682",1028682,111,54,3,168
"28683",1028683,165,43,1,209
"28684",1028684,119,157,15,291
"28685",1028685,191,69,22,282
"28686",1028686,138,10,5,153
"28687",1028687,166,41,12,219
"28688",1028688,212,12,10,234
"28689",1028689,126,12,0,138
"28690",1028690,166,20,8,194
"28691",1028691,178,108,8,294
"28692",1028692,202,56,13,271
"28693",1028693,154,154,12,320
"28694",1028694,53,7,2,62
"28695",1028695,185,7,15,207
"28696",1028696,62,138,13,213
"28697",1028697,136,186,11,333
"28698",1028698,193,103,14,310
"28699",1028699,87,50,4,141
"28700",1028700,64,127,3,194
"28701",1028701,76,246,4,326
"28702",1028702,62,164,11,237
"28703",1028703,136,35,7,178
"28704",1028704,9,2,1,12
"28705",1028705,175,49,12,236
"28706",1028706,66,209,8,283
"28707",1028707,115,56,6,177
"28708",1028708,80,209,0,289
"28709",1028709,90,30,2,122
"28710",1028710,185,61,8,254
"28711",1028711,87,59,1,147
"28712",1028712,143,32,4,179
"28713",1028713,113,78,19,210
"28714",1028714,142,86,7,235
"28715",1028715,3,11,2,16
"28716",1028716,24,247,2,273
"28717",1028717,44,28,4,76
"28718",1028718,45,238,4,287
"28719",1028719,8,5,0,13
"28720",1028720,122,45,5,172
"28721",1028721,186,70,7,263
"28722",1028722,114,66,11,191
"28723",1028723,162,113,8,283
"28724",1028724,106,149,19,274
"28725",1028725,143,75,18,236
"28726",1028726,71,169,1,241
"28727",1028727,119,31,5,155
"28728",1028728,5,73,2,80
"28729",1028729,99,104,11,214
"28730",1028730,195,30,4,229
"28731",1028731,46,224,9,279
"28732",1028732,73,61,10,144
"28733",1028733,104,57,16,177
"28734",1028734,197,82,11,290
"28735",1028735,107,190,7,304
"28736",1028736,136,114,13,263
"28737",1028737,169,94,9,272
"28738",1028738,169,109,13,291
"28739",1028739,140,281,13,434
"28740",1028740,65,196,3,264
"28741",1028741,50,182,10,242
"28742",1028742,131,83,11,225
"28743",1028743,174,37,5,216
"28744",1028744,76,217,4,297
"28745",1028745,235,52,6,293
"28746",1028746,120,77,3,200
"28747",1028747,123,110,4,237
"28748",1028748,126,18,2,146
"28749",1028749,53,221,10,284
"28750",1028750,14,7,0,21
"28751",1028751,14,287,0,301
"28752",1028752,99,201,15,315
"28753",1028753,152,77,8,237
"28754",1028754,148,110,8,266
"28755",1028755,175,67,8,250
"28756",1028756,153,89,17,259
"28757",1028757,59,246,11,316
"28758",1028758,111,68,7,186
"28759",1028759,148,59,21,228
"28760",1028760,105,40,2,147
"28761",1028761,210,27,9,246
"28762",1028762,224,231,54,509
"28763",1028763,82,124,8,214
"28764",1028764,11,75,2,88
"28765",1028765,156,87,17,260
"28766",1028766,138,133,6,277
"28767",1028767,69,161,9,239
"28768",1028768,58,239,22,319
"28769",1028769,171,34,11,216
"28770",1028770,80,80,1,161
"28771",1028771,76,147,17,240
"28772",1028772,195,29,9,233
"28773",1028773,154,78,4,236
"28774",1028774,176,18,10,204
"28775",1028775,59,230,1,290
"28776",1028776,13,3,1,17
"28777",1028777,48,162,8,218
"28778",1028778,45,298,13,356
"28779",1028779,31,230,6,267
"28780",1028780,61,60,2,123
"28781",1028781,42,14,2,58
"28782",1028782,97,168,11,276
"28783",1028783,173,71,9,253
"28784",1028784,71,234,9,314
"28785",1028785,47,266,5,318
"28786",1028786,68,200,20,288
"28787",1028787,222,18,9,249
"28788",1028788,157,104,18,279
"28789",1028789,127,46,15,188
"28790",1028790,235,27,10,272
"28791",1028791,56,171,10,237
"28792",1028792,223,18,3,244
"28793",1028793,155,122,7,284
"28794",1028794,6,82,3,91
"28795",1028795,174,44,7,225
"28796",1028796,190,53,5,248
"28797",1028797,182,28,8,218
"28798",1028798,206,12,4,222
"28799",1028799,98,152,17,267
"28800",1028800,173,27,3,203
"28801",1028801,201,10,4,215
"28802",1028802,130,97,10,237
"28803",1028803,100,85,3,188
"28804",1028804,108,96,7,211
"28805",1028805,42,94,2,138
"28806",1028806,49,207,21,277
"28807",1028807,80,100,13,193
"28808",1028808,147,107,3,257
"28809",1028809,21,152,2,175
"28810",1028810,71,149,8,228
"28811",1028811,52,200,2,254
"28812",1028812,145,20,5,170
"28813",1028813,80,45,12,137
"28814",1028814,104,103,3,210
"28815",1028815,201,39,11,251
"28816",1028816,109,136,8,253
"28817",1028817,202,50,7,259
"28818",1028818,49,230,2,281
"28819",1028819,90,167,9,266
"28820",1028820,110,31,3,144
"28821",1028821,99,192,4,295
"28822",1028822,152,52,5,209
"28823",1028823,5,22,0,27
"28824",1028824,187,115,9,311
"28825",1028825,122,66,3,191
"28826",1028826,58,68,5,131
"28827",1028827,34,176,4,214
"28828",1028828,139,194,11,344
"28829",1028829,39,266,9,314
"28830",1028830,115,39,5,159
"28831",1028831,100,165,12,277
"28832",1028832,32,128,8,168
"28833",1028833,59,96,2,157
"28834",1028834,38,102,4,144
"28835",1028835,229,41,7,277
"28836",1028836,50,9,1,60
"28837",1028837,205,20,9,234
"28838",1028838,132,141,10,283
"28839",1028839,49,220,6,275
"28840",1028840,38,273,4,315
"28841",1028841,191,212,5,408
"28842",1028842,84,164,40,288
"28843",1028843,76,152,14,242
"28844",1028844,87,176,9,272
"28845",1028845,173,31,5,209
"28846",1028846,172,118,12,302
"28847",1028847,203,61,13,277
"28848",1028848,30,182,2,214
"28849",1028849,2,23,2,27
"28850",1028850,250,20,6,276
"28851",1028851,173,106,13,292
"28852",1028852,123,59,6,188
"28853",1028853,197,50,16,263
"28854",1028854,167,8,2,177
"28855",1028855,19,10,0,29
"28856",1028856,86,147,8,241
"28857",1028857,195,45,9,249
"28858",1028858,201,56,11,268
"28859",1028859,153,56,5,214
"28860",1028860,176,62,9,247
"28861",1028861,172,78,12,262
"28862",1028862,104,126,10,240
"28863",1028863,97,145,1,243
"28864",1028864,17,108,3,128
"28865",1028865,92,176,12,280
"28866",1028866,67,186,10,263
"28867",1028867,129,180,15,324
"28868",1028868,87,32,3,122
"28869",1028869,101,176,13,290
"28870",1028870,158,88,11,257
"28871",1028871,117,78,2,197
"28872",1028872,157,66,5,228
"28873",1028873,81,167,18,266
"28874",1028874,46,224,13,283
"28875",1028875,97,145,12,254
"28876",1028876,26,4,0,30
"28877",1028877,51,130,10,191
"28878",1028878,131,29,5,165
"28879",1028879,98,44,5,147
"28880",1028880,136,105,10,251
"28881",1028881,108,77,2,187
"28882",1028882,58,126,3,187
"28883",1028883,166,87,9,262
"28884",1028884,130,134,0,264
"28885",1028885,12,191,4,207
"28886",1028886,126,127,9,262
"28887",1028887,110,35,3,148
"28888",1028888,83,212,15,310
"28889",1028889,51,20,1,72
"28890",1028890,48,40,5,93
"28891",1028891,141,50,8,199
"28892",1028892,64,26,6,96
"28893",1028893,113,109,6,228
"28894",1028894,81,6,2,89
"28895",1028895,158,101,7,266
"28896",1028896,224,94,12,330
"28897",1028897,236,78,18,332
"28898",1028898,157,19,3,179
"28899",1028899,244,17,7,268
"28900",1028900,171,68,5,244
"28901",1028901,45,14,4,63
"28902",1028902,41,194,6,241
"28903",1028903,191,13,2,206
"28904",1028904,55,196,1,252
"28905",1028905,91,146,8,245
"28906",1028906,136,124,5,265
"28907",1028907,137,93,2,232
"28908",1028908,284,77,10,371
"28909",1028909,23,194,7,224
"28910",1028910,211,65,16,292
"28911",1028911,118,172,10,300
"28912",1028912,187,53,4,244
"28913",1028913,48,54,1,103
"28914",1028914,26,12,3,41
"28915",1028915,78,220,5,303
"28916",1028916,129,0,0,129
"28917",1028917,79,26,3,108
"28918",1028918,244,16,6,266
"28919",1028919,165,86,18,269
"28920",1028920,51,209,9,269
"28921",1028921,99,149,8,256
"28922",1028922,168,9,0,177
"28923",1028923,54,218,4,276
"28924",1028924,80,149,9,238
"28925",1028925,94,164,17,275
"28926",1028926,89,163,4,256
"28927",1028927,272,23,18,313
"28928",1028928,53,133,6,192
"28929",1028929,154,51,9,214
"28930",1028930,91,89,11,191
"28931",1028931,28,21,3,52
"28932",1028932,120,123,11,254
"28933",1028933,202,42,16,260
"28934",1028934,57,67,1,125
"28935",1028935,120,94,13,227
"28936",1028936,142,166,2,310
"28937",1028937,208,66,9,283
"28938",1028938,241,36,5,282
"28939",1028939,217,46,10,273
"28940",1028940,147,79,1,227
"28941",1028941,54,244,5,303
"28942",1028942,361,77,50,488
"28943",1028943,137,106,8,251
"28944",1028944,186,118,7,311
"28945",1028945,114,132,17,263
"28946",1028946,236,65,19,320
"28947",1028947,52,247,9,308
"28948",1028948,81,73,4,158
"28949",1028949,138,94,17,249
"28950",1028950,55,156,7,218
"28951",1028951,25,23,3,51
"28952",1028952,3,6,0,9
"28953",1028953,13,88,2,103
"28954",1028954,195,75,7,277
"28955",1028955,131,89,6,226
"28956",1028956,35,4,3,42
"28957",1028957,94,172,12,278
"28958",1028958,193,95,22,310
"28959",1028959,110,137,6,253
"28960",1028960,183,72,10,265
"28961",1028961,24,283,2,309
"28962",1028962,31,176,5,212
"28963",1028963,119,0,0,119
"28964",1028964,95,152,13,260
"28965",1028965,215,60,23,298
"28966",1028966,129,114,10,253
"28967",1028967,87,131,18,236
"28968",1028968,120,129,8,257
"28969",1028969,202,33,1,236
"28970",1028970,97,175,7,279
"28971",1028971,241,62,10,313
"28972",1028972,134,106,14,254
"28973",1028973,105,94,15,214
"28974",1028974,91,101,6,198
"28975",1028975,48,0,0,48
"28976",1028976,186,74,11,271
"28977",1028977,26,111,4,141
"28978",1028978,57,289,4,350
"28979",1028979,125,112,17,254
"28980",1028980,113,127,4,244
"28981",1028981,17,8,0,25
"28982",1028982,144,141,17,302
"28983",1028983,51,179,1,231
"28984",1028984,192,59,1,252
"28985",1028985,230,32,3,265
"28986",1028986,215,85,19,319
"28987",1028987,84,159,1,244
"28988",1028988,33,96,12,141
"28989",1028989,98,110,7,215
"28990",1028990,16,146,5,167
"28991",1028991,96,152,1,249
"28992",1028992,78,150,4,232
"28993",1028993,211,4,6,221
"28994",1028994,115,120,11,246
"28995",1028995,49,283,7,339
"28996",1028996,116,42,9,167
"28997",1028997,126,53,8,187
"28998",1028998,65,186,6,257
"28999",1028999,78,142,7,227
"29000",1029000,4,8,0,12
"29001",1029001,83,47,4,134
"29002",1029002,99,144,10,253
"29003",1029003,65,151,10,226
"29004",1029004,117,153,18,288
"29005",1029005,164,48,2,214
"29006",1029006,105,148,14,267
"29007",1029007,202,66,7,275
"29008",1029008,99,121,12,232
"29009",1029009,154,85,3,242
"29010",1029010,21,5,2,28
"29011",1029011,115,109,11,235
"29012",1029012,22,16,2,40
"29013",1029013,163,23,6,192
"29014",1029014,11,32,2,45
"29015",1029015,185,62,9,256
"29016",1029016,155,97,8,260
"29017",1029017,180,94,7,281
"29018",1029018,16,176,6,198
"29019",1029019,121,144,6,271
"29020",1029020,70,281,5,356
"29021",1029021,52,79,2,133
"29022",1029022,118,27,2,147
"29023",1029023,140,68,10,218
"29024",1029024,181,84,19,284
"29025",1029025,3,8,0,11
"29026",1029026,68,90,2,160
"29027",1029027,147,45,9,201
"29028",1029028,246,41,7,294
"29029",1029029,227,43,2,272
"29030",1029030,175,79,4,258
"29031",1029031,108,172,17,297
"29032",1029032,147,176,13,336
"29033",1029033,207,15,13,235
"29034",1029034,151,87,8,246
"29035",1029035,13,13,0,26
"29036",1029036,168,32,9,209
"29037",1029037,18,133,2,153
"29038",1029038,40,117,4,161
"29039",1029039,79,5,0,84
"29040",1029040,185,100,11,296
"29041",1029041,81,39,3,123
"29042",1029042,31,159,4,194
"29043",1029043,115,54,10,179
"29044",1029044,148,68,3,219
"29045",1029045,125,28,5,158
"29046",1029046,162,2,3,167
"29047",1029047,54,125,12,191
"29048",1029048,125,78,4,207
"29049",1029049,106,86,4,196
"29050",1029050,110,125,2,237
"29051",1029051,81,168,10,259
"29052",1029052,8,28,0,36
"29053",1029053,92,104,2,198
"29054",1029054,25,8,2,35
"29055",1029055,162,78,5,245
"29056",1029056,160,51,8,219
"29057",1029057,196,97,16,309
"29058",1029058,95,138,7,240
"29059",1029059,25,327,5,357
"29060",1029060,30,228,1,259
"29061",1029061,26,225,5,256
"29062",1029062,165,90,10,265
"29063",1029063,42,214,8,264
"29064",1029064,135,110,13,258
"29065",1029065,144,41,16,201
"29066",1029066,179,19,3,201
"29067",1029067,69,186,15,270
"29068",1029068,11,51,1,63
"29069",1029069,41,11,3,55
"29070",1029070,83,82,4,169
"29071",1029071,138,107,7,252
"29072",1029072,99,172,6,277
"29073",1029073,154,32,7,193
"29074",1029074,127,154,12,293
"29075",1029075,193,31,7,231
"29076",1029076,193,25,7,225
"29077",1029077,127,167,23,317
"29078",1029078,192,82,3,277
"29079",1029079,118,137,9,264
"29080",1029080,22,2,0,24
"29081",1029081,102,118,6,226
"29082",1029082,36,25,2,63
"29083",1029083,168,38,10,216
"29084",1029084,106,148,15,269
"29085",1029085,99,15,2,116
"29086",1029086,116,162,9,287
"29087",1029087,34,232,7,273
"29088",1029088,125,145,17,287
"29089",1029089,120,56,8,184
"29090",1029090,117,142,1,260
"29091",1029091,136,61,8,205
"29092",1029092,16,103,3,122
"29093",1029093,30,99,1,130
"29094",1029094,169,118,9,296
"29095",1029095,113,138,10,261
"29096",1029096,265,51,17,333
"29097",1029097,127,47,11,185
"29098",1029098,74,83,2,159
"29099",1029099,93,138,7,238
"29100",1029100,250,70,12,332
"29101",1029101,60,83,3,146
"29102",1029102,66,117,4,187
"29103",1029103,167,50,2,219
"29104",1029104,153,114,9,276
"29105",1029105,159,80,15,254
"29106",1029106,101,80,5,186
"29107",1029107,136,135,6,277
"29108",1029108,90,132,13,235
"29109",1029109,33,230,14,277
"29110",1029110,44,15,2,61
"29111",1029111,77,178,5,260
"29112",1029112,30,266,1,297
"29113",1029113,88,138,6,232
"29114",1029114,93,201,4,298
"29115",1029115,8,4,0,12
"29116",1029116,192,13,2,207
"29117",1029117,47,72,3,122
"29118",1029118,142,159,30,331
"29119",1029119,56,241,15,312
"29120",1029120,97,202,12,311
"29121",1029121,29,88,7,124
"29122",1029122,87,190,5,282
"29123",1029123,157,34,12,203
"29124",1029124,134,80,10,224
"29125",1029125,119,60,4,183
"29126",1029126,46,15,7,68
"29127",1029127,8,184,0,192
"29128",1029128,29,168,4,201
"29129",1029129,87,173,13,273
"29130",1029130,204,54,6,264
"29131",1029131,71,190,13,274
"29132",1029132,58,198,3,259
"29133",1029133,165,138,23,326
"29134",1029134,103,47,10,160
"29135",1029135,77,124,6,207
"29136",1029136,170,105,16,291
"29137",1029137,181,146,19,346
"29138",1029138,44,257,14,315
"29139",1029139,155,106,16,277
"29140",1029140,169,30,3,202
"29141",1029141,106,168,7,281
"29142",1029142,152,15,3,170
"29143",1029143,73,106,8,187
"29144",1029144,28,12,10,50
"29145",1029145,161,102,16,279
"29146",1029146,133,14,13,160
"29147",1029147,176,86,16,278
"29148",1029148,58,40,2,100
"29149",1029149,152,80,8,240
"29150",1029150,67,124,6,197
"29151",1029151,181,87,7,275
"29152",1029152,139,69,7,215
"29153",1029153,250,220,22,492
"29154",1029154,65,135,15,215
"29155",1029155,91,65,7,163
"29156",1029156,186,38,7,231
"29157",1029157,153,17,7,177
"29158",1029158,20,10,1,31
"29159",1029159,100,163,16,279
"29160",1029160,183,82,12,277
"29161",1029161,156,119,16,291
"29162",1029162,48,168,6,222
"29163",1029163,142,50,6,198
"29164",1029164,88,86,9,183
"29165",1029165,129,46,12,187
"29166",1029166,101,191,14,306
"29167",1029167,183,39,16,238
"29168",1029168,156,30,5,191
"29169",1029169,74,160,7,241
"29170",1029170,134,31,8,173
"29171",1029171,138,79,9,226
"29172",1029172,38,76,1,115
"29173",1029173,189,11,8,208
"29174",1029174,83,245,10,338
"29175",1029175,21,298,8,327
"29176",1029176,193,78,9,280
"29177",1029177,74,131,16,221
"29178",1029178,133,121,4,258
"29179",1029179,50,128,8,186
"29180",1029180,213,50,11,274
"29181",1029181,14,29,1,44
"29182",1029182,92,146,3,241
"29183",1029183,127,38,4,169
"29184",1029184,98,79,7,184
"29185",1029185,87,32,6,125
"29186",1029186,140,113,9,262
"29187",1029187,178,112,12,302
"29188",1029188,62,8,1,71
"29189",1029189,32,227,5,264
"29190",1029190,168,115,17,300
"29191",1029191,145,94,22,261
"29192",1029192,106,201,11,318
"29193",1029193,150,131,10,291
"29194",1029194,141,54,8,203
"29195",1029195,61,235,7,303
"29196",1029196,66,224,3,293
"29197",1029197,267,12,14,293
"29198",1029198,8,56,0,64
"29199",1029199,107,71,2,180
"29200",1029200,67,182,4,253
"29201",1029201,133,158,18,309
"29202",1029202,118,124,18,260
"29203",1029203,129,180,4,313
"29204",1029204,114,115,2,231
"29205",1029205,41,201,6,248
"29206",1029206,103,177,10,290
"29207",1029207,34,150,5,189
"29208",1029208,37,6,1,44
"29209",1029209,135,103,9,247
"29210",1029210,51,88,14,153
"29211",1029211,45,169,7,221
"29212",1029212,31,241,3,275
"29213",1029213,42,258,7,307
"29214",1029214,40,133,7,180
"29215",1029215,48,176,7,231
"29216",1029216,76,121,1,198
"29217",1029217,129,61,13,203
"29218",1029218,125,140,9,274
"29219",1029219,71,201,16,288
"29220",1029220,59,122,4,185
"29221",1029221,145,142,5,292
"29222",1029222,129,91,9,229
"29223",1029223,187,131,16,334
"29224",1029224,61,230,14,305
"29225",1029225,170,25,6,201
"29226",1029226,61,20,1,82
"29227",1029227,149,97,10,256
"29228",1029228,134,40,5,179
"29229",1029229,46,92,5,143
"29230",1029230,162,77,7,246
"29231",1029231,106,131,19,256
"29232",1029232,20,194,9,223
"29233",1029233,160,87,5,252
"29234",1029234,77,126,14,217
"29235",1029235,67,204,6,277
"29236",1029236,79,122,4,205
"29237",1029237,129,87,7,223
"29238",1029238,190,72,9,271
"29239",1029239,176,26,4,206
"29240",1029240,112,73,6,191
"29241",1029241,125,74,9,208
"29242",1029242,139,118,19,276
"29243",1029243,189,3,5,197
"29244",1029244,77,256,5,338
"29245",1029245,202,10,2,214
"29246",1029246,28,178,3,209
"29247",1029247,99,95,10,204
"29248",1029248,23,115,1,139
"29249",1029249,49,177,1,227
"29250",1029250,132,150,21,303
"29251",1029251,112,156,10,278
"29252",1029252,116,5,7,128
"29253",1029253,104,43,13,160
"29254",1029254,48,206,0,254
"29255",1029255,147,72,13,232
"29256",1029256,76,66,7,149
"29257",1029257,157,93,3,253
"29258",1029258,44,225,9,278
"29259",1029259,148,119,20,287
"29260",1029260,39,151,8,198
"29261",1029261,29,52,1,82
"29262",1029262,82,179,12,273
"29263",1029263,143,125,18,286
"29264",1029264,40,179,0,219
"29265",1029265,140,80,10,230
"29266",1029266,27,107,1,135
"29267",1029267,138,46,11,195
"29268",1029268,16,51,6,73
"29269",1029269,41,188,14,243
"29270",1029270,83,16,2,101
"29271",1029271,37,193,9,239
"29272",1029272,29,2,0,31
"29273",1029273,222,59,20,301
"29274",1029274,206,109,14,329
"29275",1029275,33,34,0,67
"29276",1029276,99,180,10,289
"29277",1029277,134,128,11,273
"29278",1029278,195,78,1,274
"29279",1029279,9,95,0,104
"29280",1029280,94,126,17,237
"29281",1029281,76,70,20,166
"29282",1029282,196,14,5,215
"29283",1029283,63,77,3,143
"29284",1029284,250,35,19,304
"29285",1029285,66,81,1,148
"29286",1029286,35,272,2,309
"29287",1029287,30,150,5,185
"29288",1029288,79,167,4,250
"29289",1029289,126,87,5,218
"29290",1029290,156,71,5,232
"29291",1029291,88,223,10,321
"29292",1029292,122,122,13,257
"29293",1029293,153,0,2,155
"29294",1029294,101,128,13,242
"29295",1029295,108,13,1,122
"29296",1029296,183,41,7,231
"29297",1029297,194,35,8,237
"29298",1029298,126,108,19,253
"29299",1029299,185,103,13,301
"29300",1029300,53,201,10,264
"29301",1029301,70,267,6,343
"29302",1029302,221,69,19,309
"29303",1029303,83,46,4,133
"29304",1029304,144,54,8,206
"29305",1029305,33,269,4,306
"29306",1029306,93,73,7,173
"29307",1029307,189,40,11,240
"29308",1029308,50,200,8,258
"29309",1029309,52,116,3,171
"29310",1029310,175,31,6,212
"29311",1029311,139,73,9,221
"29312",1029312,9,15,0,24
"29313",1029313,197,8,1,206
"29314",1029314,242,32,6,280
"29315",1029315,30,179,2,211
"29316",1029316,46,188,0,234
"29317",1029317,121,51,4,176
"29318",1029318,109,104,12,225
"29319",1029319,27,201,20,248
"29320",1029320,113,59,14,186
"29321",1029321,123,151,23,297
"29322",1029322,250,68,21,339
"29323",1029323,105,31,5,141
"29324",1029324,69,152,12,233
"29325",1029325,79,123,13,215
"29326",1029326,223,9,4,236
"29327",1029327,48,153,12,213
"29328",1029328,40,210,7,257
"29329",1029329,54,259,4,317
"29330",1029330,97,122,3,222
"29331",1029331,114,42,9,165
"29332",1029332,64,118,21,203
"29333",1029333,171,91,15,277
"29334",1029334,67,157,12,236
"29335",1029335,36,118,2,156
"29336",1029336,51,224,14,289
"29337",1029337,219,19,3,241
"29338",1029338,138,29,13,180
"29339",1029339,282,32,10,324
"29340",1029340,120,166,14,300
"29341",1029341,42,128,4,174
"29342",1029342,60,140,9,209
"29343",1029343,11,21,1,33
"29344",1029344,56,37,0,93
"29345",1029345,62,171,11,244
"29346",1029346,200,31,3,234
"29347",1029347,154,82,16,252
"29348",1029348,96,141,12,249
"29349",1029349,222,31,10,263
"29350",1029350,58,100,18,176
"29351",1029351,109,56,10,175
"29352",1029352,61,137,9,207
"29353",1029353,135,104,14,253
"29354",1029354,117,191,9,317
"29355",1029355,114,184,20,318
"29356",1029356,146,78,9,233
"29357",1029357,98,87,3,188
"29358",1029358,148,10,4,162
"29359",1029359,68,97,3,168
"29360",1029360,59,214,6,279
"29361",1029361,213,108,17,338
"29362",1029362,20,189,16,225
"29363",1029363,66,19,2,87
"29364",1029364,5,64,0,69
"29365",1029365,117,54,20,191
"29366",1029366,49,254,6,309
"29367",1029367,140,157,8,305
"29368",1029368,88,185,6,279
"29369",1029369,142,111,20,273
"29370",1029370,169,84,8,261
"29371",1029371,106,72,8,186
"29372",1029372,82,124,2,208
"29373",1029373,105,40,5,150
"29374",1029374,77,96,14,187
"29375",1029375,114,91,5,210
"29376",1029376,18,56,1,75
"29377",1029377,131,124,13,268
"29378",1029378,174,134,20,328
"29379",1029379,69,52,6,127
"29380",1029380,54,93,6,153
"29381",1029381,6,3,0,9
"29382",1029382,91,72,9,172
"29383",1029383,115,165,3,283
"29384",1029384,77,179,18,274
"29385",1029385,31,152,4,187
"29386",1029386,108,32,9,149
"29387",1029387,16,56,3,75
"29388",1029388,236,97,15,348
"29389",1029389,26,225,8,259
"29390",1029390,39,72,4,115
"29391",1029391,45,6,3,54
"29392",1029392,103,112,9,224
"29393",1029393,120,166,13,299
"29394",1029394,38,196,13,247
"29395",1029395,8,15,0,23
"29396",1029396,92,31,4,127
"29397",1029397,48,246,13,307
"29398",1029398,208,45,15,268
"29399",1029399,134,141,18,293
"29400",1029400,160,133,16,309
"29401",1029401,150,100,14,264
"29402",1029402,48,132,4,184
"29403",1029403,107,22,6,135
"29404",1029404,22,28,0,50
"29405",1029405,245,17,7,269
"29406",1029406,119,50,9,178
"29407",1029407,251,20,6,277
"29408",1029408,31,256,2,289
"29409",1029409,37,114,2,153
"29410",1029410,160,42,9,211
"29411",1029411,88,157,8,253
"29412",1029412,97,118,14,229
"29413",1029413,116,177,15,308
"29414",1029414,220,51,16,287
"29415",1029415,151,332,21,504
"29416",1029416,132,94,13,239
"29417",1029417,206,43,10,259
"29418",1029418,60,37,2,99
"29419",1029419,127,112,7,246
"29420",1029420,253,3,3,259
"29421",1029421,43,187,2,232
"29422",1029422,184,28,3,215
"29423",1029423,126,80,14,220
"29424",1029424,31,160,5,196
"29425",1029425,88,94,6,188
"29426",1029426,236,12,6,254
"29427",1029427,104,41,17,162
"29428",1029428,24,181,3,208
"29429",1029429,58,138,9,205
"29430",1029430,3,8,0,11
"29431",1029431,130,139,8,277
"29432",1029432,13,59,5,77
"29433",1029433,121,132,4,257
"29434",1029434,226,34,3,263
"29435",1029435,26,219,11,256
"29436",1029436,130,37,3,170
"29437",1029437,166,138,13,317
"29438",1029438,44,37,0,81
"29439",1029439,45,205,12,262
"29440",1029440,177,60,8,245
"29441",1029441,173,78,9,260
"29442",1029442,116,156,9,281
"29443",1029443,67,138,6,211
"29444",1029444,126,109,13,248
"29445",1029445,22,34,1,57
"29446",1029446,80,172,5,257
"29447",1029447,152,86,9,247
"29448",1029448,131,90,6,227
"29449",1029449,38,12,0,50
"29450",1029450,85,56,5,146
"29451",1029451,165,93,5,263
"29452",1029452,98,155,3,256
"29453",1029453,125,113,15,253
"29454",1029454,177,114,10,301
"29455",1029455,266,34,6,306
"29456",1029456,75,130,9,214
"29457",1029457,86,175,9,270
"29458",1029458,134,65,4,203
"29459",1029459,118,21,4,143
"29460",1029460,67,207,6,280
"29461",1029461,101,156,14,271
"29462",1029462,98,184,6,288
"29463",1029463,139,123,16,278
"29464",1029464,103,113,13,229
"29465",1029465,14,48,0,62
"29466",1029466,247,19,4,270
"29467",1029467,87,40,5,132
"29468",1029468,217,45,0,262
"29469",1029469,137,20,6,163
"29470",1029470,143,214,9,366
"29471",1029471,121,54,3,178
"29472",1029472,91,139,17,247
"29473",1029473,154,56,1,211
"29474",1029474,25,2,2,29
"29475",1029475,107,137,5,249
"29476",1029476,176,2,0,178
"29477",1029477,56,88,5,149
"29478",1029478,132,64,1,197
"29479",1029479,41,239,9,289
"29480",1029480,104,99,10,213
"29481",1029481,73,59,5,137
"29482",1029482,91,20,2,113
"29483",1029483,116,109,6,231
"29484",1029484,96,64,6,166
"29485",1029485,150,114,8,272
"29486",1029486,141,88,7,236
"29487",1029487,170,139,7,316
"29488",1029488,99,64,4,167
"29489",1029489,18,64,0,82
"29490",1029490,88,112,6,206
"29491",1029491,81,72,3,156
"29492",1029492,170,103,20,293
"29493",1029493,28,81,8,117
"29494",1029494,138,89,15,242
"29495",1029495,178,21,6,205
"29496",1029496,62,207,20,289
"29497",1029497,136,85,5,226
"29498",1029498,91,178,7,276
"29499",1029499,16,52,3,71
"29500",1029500,41,194,3,238
"29501",1029501,153,57,6,216
"29502",1029502,224,35,13,272
"29503",1029503,119,20,7,146
"29504",1029504,43,147,0,190
"29505",1029505,190,72,11,273
"29506",1029506,125,114,7,246
"29507",1029507,140,43,9,192
"29508",1029508,86,20,6,112
"29509",1029509,161,106,5,272
"29510",1029510,85,148,8,241
"29511",1029511,186,102,18,306
"29512",1029512,20,190,2,212
"29513",1029513,175,101,21,297
"29514",1029514,151,94,11,256
"29515",1029515,231,30,9,270
"29516",1029516,62,209,10,281
"29517",1029517,196,97,11,304
"29518",1029518,82,141,11,234
"29519",1029519,37,20,1,58
"29520",1029520,77,170,11,258
"29521",1029521,206,27,14,247
"29522",1029522,5,6,0,11
"29523",1029523,115,31,2,148
"29524",1029524,185,54,6,245
"29525",1029525,34,174,4,212
"29526",1029526,82,47,6,135
"29527",1029527,67,191,6,264
"29528",1029528,76,74,14,164
"29529",1029529,46,243,4,293
"29530",1029530,85,171,11,267
"29531",1029531,30,249,2,281
"29532",1029532,53,217,10,280
"29533",1029533,8,16,0,24
"29534",1029534,109,9,0,118
"29535",1029535,137,24,5,166
"29536",1029536,68,171,5,244
"29537",1029537,198,73,11,282
"29538",1029538,54,74,5,133
"29539",1029539,95,187,10,292
"29540",1029540,23,182,6,211
"29541",1029541,96,189,7,292
"29542",1029542,106,26,2,134
"29543",1029543,61,70,4,135
"29544",1029544,89,175,6,270
"29545",1029545,74,200,8,282
"29546",1029546,185,35,5,225
"29547",1029547,137,91,4,232
"29548",1029548,42,23,1,66
"29549",1029549,146,99,22,267
"29550",1029550,201,31,7,239
"29551",1029551,90,132,15,237
"29552",1029552,187,96,19,302
"29553",1029553,167,62,6,235
"29554",1029554,90,178,16,284
"29555",1029555,113,2,2,117
"29556",1029556,78,210,5,293
"29557",1029557,82,120,11,213
"29558",1029558,98,163,13,274
"29559",1029559,83,116,4,203
"29560",1029560,25,122,2,149
"29561",1029561,232,2,9,243
"29562",1029562,9,35,3,47
"29563",1029563,144,26,3,173
"29564",1029564,145,125,17,287
"29565",1029565,145,46,10,201
"29566",1029566,102,185,17,304
"29567",1029567,32,219,3,254
"29568",1029568,193,38,4,235
"29569",1029569,240,36,8,284
"29570",1029570,85,254,10,349
"29571",1029571,22,205,4,231
"29572",1029572,65,24,3,92
"29573",1029573,87,30,4,121
"29574",1029574,78,106,6,190
"29575",1029575,37,173,8,218
"29576",1029576,69,182,25,276
"29577",1029577,42,216,2,260
"29578",1029578,136,135,7,278
"29579",1029579,162,156,6,324
"29580",1029580,67,122,6,195
"29581",1029581,172,123,7,302
"29582",1029582,63,204,10,277
"29583",1029583,136,18,3,157
"29584",1029584,155,67,12,234
"29585",1029585,212,49,11,272
"29586",1029586,57,163,13,233
"29587",1029587,85,127,9,221
"29588",1029588,154,87,5,246
"29589",1029589,127,98,11,236
"29590",1029590,130,59,1,190
"29591",1029591,22,212,3,237
"29592",1029592,103,66,10,179
"29593",1029593,195,44,14,253
"29594",1029594,130,64,9,203
"29595",1029595,67,98,5,170
"29596",1029596,112,62,9,183
"29597",1029597,107,175,15,297
"29598",1029598,18,172,4,194
"29599",1029599,58,237,3,298
"29600",1029600,211,62,13,286
"29601",1029601,307,102,16,425
"29602",1029602,140,103,20,263
"29603",1029603,61,227,4,292
"29604",1029604,72,207,9,288
"29605",1029605,148,45,8,201
"29606",1029606,103,107,16,226
"29607",1029607,13,283,6,302
"29608",1029608,99,39,4,142
"29609",1029609,174,137,4,315
"29610",1029610,200,20,7,227
"29611",1029611,170,86,14,270
"29612",1029612,88,103,4,195
"29613",1029613,32,196,10,238
"29614",1029614,108,90,13,211
"29615",1029615,42,288,5,335
"29616",1029616,200,10,5,215
"29617",1029617,182,43,3,228
"29618",1029618,106,145,12,263
"29619",1029619,176,7,5,188
"29620",1029620,58,173,5,236
"29621",1029621,119,26,3,148
"29622",1029622,25,322,9,356
"29623",1029623,233,16,18,267
"29624",1029624,161,27,5,193
"29625",1029625,121,49,5,175
"29626",1029626,97,16,1,114
"29627",1029627,111,38,13,162
"29628",1029628,99,151,1,251
"29629",1029629,145,79,6,230
"29630",1029630,132,142,5,279
"29631",1029631,94,188,17,299
"29632",1029632,246,21,5,272
"29633",1029633,47,190,4,241
"29634",1029634,96,90,7,193
"29635",1029635,56,163,18,237
"29636",1029636,78,108,4,190
"29637",1029637,97,145,6,248
"29638",1029638,168,19,5,192
"29639",1029639,178,39,10,227
"29640",1029640,49,100,9,158
"29641",1029641,111,78,5,194
"29642",1029642,204,26,4,234
"29643",1029643,94,168,11,273
"29644",1029644,149,80,7,236
"29645",1029645,50,53,8,111
"29646",1029646,118,158,29,305
"29647",1029647,143,151,17,311
"29648",1029648,178,93,19,290
"29649",1029649,28,247,2,277
"29650",1029650,116,140,13,269
"29651",1029651,166,70,7,243
"29652",1029652,66,184,7,257
"29653",1029653,37,276,9,322
"29654",1029654,108,105,10,223
"29655",1029655,83,232,12,327
"29656",1029656,127,38,5,170
"29657",1029657,148,146,24,318
"29658",1029658,25,142,5,172
"29659",1029659,63,276,4,343
"29660",1029660,83,247,8,338
"29661",1029661,109,134,10,253
"29662",1029662,39,191,3,233
"29663",1029663,73,121,18,212
"29664",1029664,150,67,6,223
"29665",1029665,11,23,5,39
"29666",1029666,182,36,11,229
"29667",1029667,174,107,9,290
"29668",1029668,81,239,11,331
"29669",1029669,73,21,2,96
"29670",1029670,83,141,6,230
"29671",1029671,62,221,16,299
"29672",1029672,84,40,1,125
"29673",1029673,68,3,0,71
"29674",1029674,15,227,2,244
"29675",1029675,100,218,5,323
"29676",1029676,97,145,27,269
"29677",1029677,219,32,3,254
"29678",1029678,224,66,6,296
"29679",1029679,156,24,4,184
"29680",1029680,212,26,5,243
"29681",1029681,42,77,5,124
"29682",1029682,44,194,4,242
"29683",1029683,73,48,3,124
"29684",1029684,113,173,8,294
"29685",1029685,217,52,12,281
"29686",1029686,41,252,10,303
"29687",1029687,112,121,12,245
"29688",1029688,83,182,7,272
"29689",1029689,134,51,9,194
"29690",1029690,122,98,9,229
"29691",1029691,87,101,20,208
"29692",1029692,149,46,7,202
"29693",1029693,42,169,3,214
"29694",1029694,145,117,3,265
"29695",1029695,313,11,4,328
"29696",1029696,51,257,7,315
"29697",1029697,94,98,1,193
"29698",1029698,79,85,6,170
"29699",1029699,60,135,11,206
"29700",1029700,12,197,1,210
"29701",1029701,178,164,10,352
"29702",1029702,192,14,4,210
"29703",1029703,85,188,8,281
"29704",1029704,197,56,7,260
"29705",1029705,145,14,9,168
"29706",1029706,246,16,3,265
"29707",1029707,196,90,11,297
"29708",1029708,174,27,7,208
"29709",1029709,100,6,2,108
"29710",1029710,90,93,13,196
"29711",1029711,98,171,10,279
"29712",1029712,13,27,0,40
"29713",1029713,230,53,18,301
"29714",1029714,176,28,15,219
"29715",1029715,7,68,0,75
"29716",1029716,92,109,4,205
"29717",1029717,137,52,6,195
"29718",1029718,186,38,12,236
"29719",1029719,37,252,6,295
"29720",1029720,64,228,10,302
"29721",1029721,196,20,7,223
"29722",1029722,79,74,2,155
"29723",1029723,57,3,3,63
"29724",1029724,173,49,4,226
"29725",1029725,141,164,9,314
"29726",1029726,136,135,5,276
"29727",1029727,149,51,14,214
"29728",1029728,93,49,10,152
"29729",1029729,232,101,24,357
"29730",1029730,62,180,4,246
"29731",1029731,128,84,0,212
"29732",1029732,128,72,17,217
"29733",1029733,225,48,17,290
"29734",1029734,175,66,23,264
"29735",1029735,50,132,3,185
"29736",1029736,120,113,18,251
"29737",1029737,63,216,15,294
"29738",1029738,214,116,10,340
"29739",1029739,148,29,4,181
"29740",1029740,15,206,0,221
"29741",1029741,234,28,13,275
"29742",1029742,115,71,23,209
"29743",1029743,53,202,3,258
"29744",1029744,164,84,13,261
"29745",1029745,93,169,22,284
"29746",1029746,41,176,7,224
"29747",1029747,85,41,6,132
"29748",1029748,264,41,10,315
"29749",1029749,14,72,4,90
"29750",1029750,30,0,0,30
"29751",1029751,31,250,3,284
"29752",1029752,174,52,8,234
"29753",1029753,54,255,7,316
"29754",1029754,89,187,8,284
"29755",1029755,17,6,0,23
"29756",1029756,156,60,6,222
"29757",1029757,156,86,15,257
"29758",1029758,100,103,11,214
"29759",1029759,22,273,4,299
"29760",1029760,70,2,0,72
"29761",1029761,62,0,2,64
"29762",1029762,178,89,8,275
"29763",1029763,65,221,7,293
"29764",1029764,64,200,5,269
"29765",1029765,115,84,5,204
"29766",1029766,20,165,3,188
"29767",1029767,91,114,15,220
"29768",1029768,168,40,9,217
"29769",1029769,163,87,15,265
"29770",1029770,43,278,7,328
"29771",1029771,175,74,11,260
"29772",1029772,99,257,11,367
"29773",1029773,183,40,3,226
"29774",1029774,111,107,9,227
"29775",1029775,87,165,9,261
"29776",1029776,108,116,3,227
"29777",1029777,129,118,9,256
"29778",1029778,9,4,3,16
"29779",1029779,231,80,5,316
"29780",1029780,104,132,8,244
"29781",1029781,41,136,5,182
"29782",1029782,44,214,1,259
"29783",1029783,95,73,4,172
"29784",1029784,221,35,11,267
"29785",1029785,162,57,13,232
"29786",1029786,59,97,10,166
"29787",1029787,89,80,6,175
"29788",1029788,239,65,19,323
"29789",1029789,163,39,2,204
"29790",1029790,64,231,6,301
"29791",1029791,53,169,3,225
"29792",1029792,114,92,3,209
"29793",1029793,147,132,24,303
"29794",1029794,7,12,0,19
"29795",1029795,82,165,5,252
"29796",1029796,264,41,12,317
"29797",1029797,83,237,10,330
"29798",1029798,165,111,15,291
"29799",1029799,91,107,4,202
"29800",1029800,112,94,17,223
"29801",1029801,57,103,5,165
"29802",1029802,121,160,10,291
"29803",1029803,41,37,1,79
"29804",1029804,120,48,10,178
"29805",1029805,42,239,4,285
"29806",1029806,68,267,6,341
"29807",1029807,33,234,7,274
"29808",1029808,158,66,9,233
"29809",1029809,128,116,3,247
"29810",1029810,119,57,6,182
"29811",1029811,53,11,3,67
"29812",1029812,195,10,6,211
"29813",1029813,107,50,2,159
"29814",1029814,82,41,13,136
"29815",1029815,1,2,0,3
"29816",1029816,120,42,4,166
"29817",1029817,38,230,3,271
"29818",1029818,104,153,8,265
"29819",1029819,167,71,5,243
"29820",1029820,163,99,13,275
"29821",1029821,21,231,8,260
"29822",1029822,96,143,5,244
"29823",1029823,180,91,11,282
"29824",1029824,174,82,9,265
"29825",1029825,17,7,0,24
"29826",1029826,44,130,7,181
"29827",1029827,189,22,5,216
"29828",1029828,131,40,4,175
"29829",1029829,146,64,7,217
"29830",1029830,206,38,8,252
"29831",1029831,55,161,14,230
"29832",1029832,66,12,0,78
"29833",1029833,123,106,17,246
"29834",1029834,76,238,7,321
"29835",1029835,116,76,2,194
"29836",1029836,163,32,10,205
"29837",1029837,115,137,7,259
"29838",1029838,35,150,9,194
"29839",1029839,234,79,16,329
"29840",1029840,150,141,24,315
"29841",1029841,182,12,9,203
"29842",1029842,165,46,17,228
"29843",1029843,152,45,1,198
"29844",1029844,121,195,8,324
"29845",1029845,53,6,1,60
"29846",1029846,4,6,0,10
"29847",1029847,157,54,9,220
"29848",1029848,57,215,12,284
"29849",1029849,109,119,27,255
"29850",1029850,77,185,9,271
"29851",1029851,48,129,10,187
"29852",1029852,45,215,4,264
"29853",1029853,156,29,7,192
"29854",1029854,119,100,9,228
"29855",1029855,85,89,6,180
"29856",1029856,45,161,5,211
"29857",1029857,60,199,11,270
"29858",1029858,74,125,10,209
"29859",1029859,85,194,9,288
"29860",1029860,98,200,14,312
"29861",1029861,174,28,7,209
"29862",1029862,186,71,4,261
"29863",1029863,122,52,13,187
"29864",1029864,101,27,1,129
"29865",1029865,93,120,7,220
"29866",1029866,156,30,5,191
"29867",1029867,75,70,9,154
"29868",1029868,59,196,2,257
"29869",1029869,226,35,6,267
"29870",1029870,227,61,4,292
"29871",1029871,65,72,4,141
"29872",1029872,112,157,12,281
"29873",1029873,90,56,1,147
"29874",1029874,162,100,11,273
"29875",1029875,54,18,0,72
"29876",1029876,49,122,9,180
"29877",1029877,17,222,3,242
"29878",1029878,119,85,7,211
"29879",1029879,115,48,4,167
"29880",1029880,102,117,4,223
"29881",1029881,67,180,5,252
"29882",1029882,102,108,7,217
"29883",1029883,81,46,6,133
"29884",1029884,42,227,5,274
"29885",1029885,18,64,2,84
"29886",1029886,120,130,3,253
"29887",1029887,143,98,8,249
"29888",1029888,151,39,9,199
"29889",1029889,92,188,9,289
"29890",1029890,102,135,12,249
"29891",1029891,79,219,10,308
"29892",1029892,51,227,9,287
"29893",1029893,40,218,4,262
"29894",1029894,68,5,4,77
"29895",1029895,134,82,8,224
"29896",1029896,95,20,1,116
"29897",1029897,123,91,10,224
"29898",1029898,138,135,6,279
"29899",1029899,105,28,5,138
"29900",1029900,76,175,22,273
"29901",1029901,154,28,4,186
"29902",1029902,121,84,2,207
"29903",1029903,164,142,8,314
"29904",1029904,91,141,5,237
"29905",1029905,82,258,11,351
"29906",1029906,44,132,3,179
"29907",1029907,121,144,10,275
"29908",1029908,112,121,9,242
"29909",1029909,79,141,15,235
"29910",1029910,43,131,6,180
"29911",1029911,114,82,11,207
"29912",1029912,193,16,4,213
"29913",1029913,137,26,2,165
"29914",1029914,58,142,11,211
"29915",1029915,124,112,17,253
"29916",1029916,148,78,7,233
"29917",1029917,82,112,3,197
"29918",1029918,112,54,5,171
"29919",1029919,145,104,12,261
"29920",1029920,139,100,16,255
"29921",1029921,31,245,3,279
"29922",1029922,7,103,4,114
"29923",1029923,321,14,7,342
"29924",1029924,152,49,9,210
"29925",1029925,115,29,0,144
"29926",1029926,71,103,6,180
"29927",1029927,97,87,12,196
"29928",1029928,133,71,17,221
"29929",1029929,189,27,5,221
"29930",1029930,41,56,7,104
"29931",1029931,173,38,3,214
"29932",1029932,23,183,6,212
"29933",1029933,201,56,5,262
"29934",1029934,74,130,12,216
"29935",1029935,26,44,1,71
"29936",1029936,119,57,4,180
"29937",1029937,212,107,13,332
"29938",1029938,64,186,11,261
"29939",1029939,74,65,7,146
"29940",1029940,141,161,25,327
"29941",1029941,23,64,1,88
"29942",1029942,65,244,5,314
"29943",1029943,107,38,3,148
"29944",1029944,109,73,1,183
"29945",1029945,194,12,6,212
"29946",1029946,216,33,7,256
"29947",1029947,124,130,8,262
"29948",1029948,207,18,10,235
"29949",1029949,79,164,16,259
"29950",1029950,15,6,1,22
"29951",1029951,94,188,4,286
"29952",1029952,95,165,10,270
"29953",1029953,27,7,2,36
"29954",1029954,153,90,6,249
"29955",1029955,74,109,8,191
"29956",1029956,62,246,5,313
"29957",1029957,172,127,22,321
"29958",1029958,144,129,13,286
"29959",1029959,46,72,11,129
"29960",1029960,71,196,9,276
"29961",1029961,166,63,6,235
"29962",1029962,196,41,13,250
"29963",1029963,122,129,8,259
"29964",1029964,179,34,5,218
"29965",1029965,61,175,5,241
"29966",1029966,141,29,4,174
"29967",1029967,76,58,8,142
"29968",1029968,166,85,5,256
"29969",1029969,64,116,17,197
"29970",1029970,98,31,4,133
"29971",1029971,104,152,1,257
"29972",1029972,143,57,8,208
"29973",1029973,150,49,7,206
"29974",1029974,104,44,6,154
"29975",1029975,154,119,11,284
"29976",1029976,42,179,7,228
"29977",1029977,170,62,9,241
"29978",1029978,51,122,10,183
"29979",1029979,29,189,8,226
"29980",1029980,32,6,2,40
"29981",1029981,75,81,3,159
"29982",1029982,84,112,3,199
"29983",1029983,131,82,6,219
"29984",1029984,80,198,8,286
"29985",1029985,87,87,0,174
"29986",1029986,131,56,7,194
"29987",1029987,82,142,14,238
"29988",1029988,186,49,22,257
"29989",1029989,219,42,6,267
"29990",1029990,49,28,2,79
"29991",1029991,153,38,7,198
"29992",1029992,113,141,10,264
"29993",1029993,140,88,3,231
"29994",1029994,127,91,8,226
"29995",1029995,126,86,6,218
"29996",1029996,99,84,2,185
"29997",1029997,31,163,12,206
"29998",1029998,25,12,2,39
"29999",1029999,165,89,9,263
"30000",1030000,102,89,9,200
"30001",1030001,189,131,16,336
"30002",1030002,69,102,6,177
"30003",1030003,108,144,15,267
"30004",1030004,91,133,6,230
"30005",1030005,35,261,4,300
"30006",1030006,250,12,9,271
"30007",1030007,85,149,6,240
"30008",1030008,72,129,2,203
"30009",1030009,231,28,6,265
"30010",1030010,136,36,14,186
"30011",1030011,135,144,23,302
"30012",1030012,61,85,13,159
"30013",1030013,75,155,5,235
"30014",1030014,74,238,2,314
"30015",1030015,110,131,18,259
"30016",1030016,43,160,7,210
"30017",1030017,180,48,4,232
"30018",1030018,141,142,9,292
"30019",1030019,118,106,28,252
"30020",1030020,133,27,6,166
"30021",1030021,136,52,3,191
"30022",1030022,62,191,4,257
"30023",1030023,72,176,18,266
"30024",1030024,27,43,2,72
"30025",1030025,120,34,7,161
"30026",1030026,24,211,6,241
"30027",1030027,72,143,3,218
"30028",1030028,66,226,7,299
"30029",1030029,152,101,10,263
"30030",1030030,179,40,5,224
"30031",1030031,58,23,5,86
"30032",1030032,116,111,9,236
"30033",1030033,81,165,13,259
"30034",1030034,38,17,3,58
"30035",1030035,21,3,2,26
"30036",1030036,157,27,5,189
"30037",1030037,148,83,3,234
"30038",1030038,79,94,6,179
"30039",1030039,96,114,7,217
"30040",1030040,9,36,0,45
"30041",1030041,54,58,2,114
"30042",1030042,147,172,20,339
"30043",1030043,171,41,19,231
"30044",1030044,74,163,10,247
"30045",1030045,144,105,18,267
"30046",1030046,175,49,4,228
"30047",1030047,67,184,9,260
"30048",1030048,136,32,4,172
"30049",1030049,42,214,5,261
"30050",1030050,206,81,11,298
"30051",1030051,146,61,8,215
"30052",1030052,30,72,11,113
"30053",1030053,247,11,14,272
"30054",1030054,62,187,13,262
"30055",1030055,182,116,16,314
"30056",1030056,10,18,2,30
"30057",1030057,113,147,5,265
"30058",1030058,97,92,7,196
"30059",1030059,147,11,3,161
"30060",1030060,46,199,6,251
"30061",1030061,66,102,9,177
"30062",1030062,124,56,5,185
"30063",1030063,169,70,6,245
"30064",1030064,66,100,8,174
"30065",1030065,93,228,15,336
"30066",1030066,30,235,2,267
"30067",1030067,83,131,9,223
"30068",1030068,85,181,5,271
"30069",1030069,47,164,5,216
"30070",1030070,198,4,2,204
"30071",1030071,45,210,4,259
"30072",1030072,138,36,8,182
"30073",1030073,165,59,10,234
"30074",1030074,36,63,8,107
"30075",1030075,47,253,3,303
"30076",1030076,101,206,6,313
"30077",1030077,33,151,4,188
"30078",1030078,131,60,19,210
"30079",1030079,86,154,9,249
"30080",1030080,86,120,6,212
"30081",1030081,126,7,5,138
"30082",1030082,77,226,19,322
"30083",1030083,7,14,0,21
"30084",1030084,147,119,6,272
"30085",1030085,225,23,7,255
"30086",1030086,36,26,1,63
"30087",1030087,133,167,15,315
"30088",1030088,167,88,12,267
"30089",1030089,174,77,28,279
"30090",1030090,12,287,9,308
"30091",1030091,125,115,13,253
"30092",1030092,79,126,14,219
"30093",1030093,175,33,5,213
"30094",1030094,154,72,6,232
"30095",1030095,104,84,19,207
"30096",1030096,238,67,14,319
"30097",1030097,77,147,9,233
"30098",1030098,5,11,1,17
"30099",1030099,105,167,6,278
"30100",1030100,208,40,4,252
"30101",1030101,202,58,9,269
"30102",1030102,72,196,6,274
"30103",1030103,138,34,5,177
"30104",1030104,141,121,10,272
"30105",1030105,94,46,10,150
"30106",1030106,101,157,14,272
"30107",1030107,109,81,6,196
"30108",1030108,51,29,7,87
"30109",1030109,133,135,13,281
"30110",1030110,124,94,8,226
"30111",1030111,19,5,1,25
"30112",1030112,44,94,6,144
"30113",1030113,32,323,5,360
"30114",1030114,130,126,16,272
"30115",1030115,136,111,3,250
"30116",1030116,183,123,11,317
"30117",1030117,80,31,9,120
"30118",1030118,119,154,3,276
"30119",1030119,198,77,8,283
"30120",1030120,99,150,5,254
"30121",1030121,98,128,10,236
"30122",1030122,19,51,2,72
"30123",1030123,6,17,2,25
"30124",1030124,121,90,3,214
"30125",1030125,4,4,0,8
"30126",1030126,207,47,8,262
"30127",1030127,75,222,13,310
"30128",1030128,131,116,6,253
"30129",1030129,206,93,18,317
"30130",1030130,24,58,4,86
"30131",1030131,70,173,8,251
"30132",1030132,174,97,14,285
"30133",1030133,59,166,15,240
"30134",1030134,96,147,13,256
"30135",1030135,205,18,4,227
"30136",1030136,210,48,16,274
"30137",1030137,25,25,1,51
"30138",1030138,118,53,14,185
"30139",1030139,209,28,6,243
"30140",1030140,171,68,16,255
"30141",1030141,24,278,10,312
"30142",1030142,90,165,1,256
"30143",1030143,128,143,24,295
"30144",1030144,78,186,3,267
"30145",1030145,119,287,23,429
"30146",1030146,71,176,5,252
"30147",1030147,71,153,5,229
"30148",1030148,140,65,18,223
"30149",1030149,44,180,5,229
"30150",1030150,169,33,5,207
"30151",1030151,154,128,20,302
"30152",1030152,54,68,3,125
"30153",1030153,182,39,6,227
"30154",1030154,35,177,1,213
"30155",1030155,118,62,1,181
"30156",1030156,97,165,14,276
"30157",1030157,22,78,6,106
"30158",1030158,118,158,5,281
"30159",1030159,96,182,7,285
"30160",1030160,89,198,8,295
"30161",1030161,16,140,3,159
"30162",1030162,128,139,13,280
"30163",1030163,133,112,17,262
"30164",1030164,192,148,10,350
"30165",1030165,74,42,0,116
"30166",1030166,148,115,12,275
"30167",1030167,115,36,5,156
"30168",1030168,174,50,7,231
"30169",1030169,190,30,5,225
"30170",1030170,180,59,12,251
"30171",1030171,59,193,8,260
"30172",1030172,127,44,7,178
"30173",1030173,160,30,5,195
"30174",1030174,130,134,3,267
"30175",1030175,164,152,15,331
"30176",1030176,90,181,7,278
"30177",1030177,146,74,10,230
"30178",1030178,76,103,13,192
"30179",1030179,125,16,3,144
"30180",1030180,100,143,11,254
"30181",1030181,167,23,12,202
"30182",1030182,249,48,7,304
"30183",1030183,61,145,13,219
"30184",1030184,157,73,6,236
"30185",1030185,78,36,7,121
"30186",1030186,39,208,2,249
"30187",1030187,154,40,6,200
"30188",1030188,86,162,1,249
"30189",1030189,32,274,10,316
"30190",1030190,128,93,13,234
"30191",1030191,108,82,18,208
"30192",1030192,173,51,7,231
"30193",1030193,185,21,6,212
"30194",1030194,137,33,6,176
"30195",1030195,74,85,10,169
"30196",1030196,61,153,10,224
"30197",1030197,127,43,2,172
"30198",1030198,140,83,12,235
"30199",1030199,67,178,15,260
"30200",1030200,163,63,8,234
"30201",1030201,154,90,12,256
"30202",1030202,59,122,2,183
"30203",1030203,180,88,18,286
"30204",1030204,68,107,13,188
"30205",1030205,122,141,11,274
"30206",1030206,131,19,7,157
"30207",1030207,69,151,12,232
"30208",1030208,183,37,8,228
"30209",1030209,174,54,9,237
"30210",1030210,61,99,5,165
"30211",1030211,89,37,6,132
"30212",1030212,103,211,6,320
"30213",1030213,40,174,9,223
"30214",1030214,138,116,3,257
"30215",1030215,85,35,3,123
"30216",1030216,224,21,9,254
"30217",1030217,16,26,1,43
"30218",1030218,57,206,3,266
"30219",1030219,12,0,0,12
"30220",1030220,113,147,9,269
"30221",1030221,215,55,18,288
"30222",1030222,215,57,9,281
"30223",1030223,189,76,15,280
"30224",1030224,88,233,10,331
"30225",1030225,67,231,3,301
"30226",1030226,284,4,3,291
"30227",1030227,203,32,2,237
"30228",1030228,58,34,5,97
"30229",1030229,16,240,3,259
"30230",1030230,43,19,6,68
"30231",1030231,159,43,7,209
"30232",1030232,210,48,6,264
"30233",1030233,163,26,9,198
"30234",1030234,102,45,8,155
"30235",1030235,52,54,8,114
"30236",1030236,124,41,5,170
"30237",1030237,13,1,0,14
"30238",1030238,218,40,9,267
"30239",1030239,178,46,20,244
"30240",1030240,122,186,3,311
"30241",1030241,140,183,12,335
"30242",1030242,30,217,1,248
"30243",1030243,139,92,6,237
"30244",1030244,193,60,10,263
"30245",1030245,47,141,5,193
"30246",1030246,210,25,11,246
"30247",1030247,39,145,6,190
"30248",1030248,94,188,28,310
"30249",1030249,49,108,4,161
"30250",1030250,174,48,6,228
"30251",1030251,62,207,7,276
"30252",1030252,89,72,14,175
"30253",1030253,55,16,5,76
"30254",1030254,142,43,0,185
"30255",1030255,127,21,1,149
"30256",1030256,193,24,4,221
"30257",1030257,167,115,5,287
"30258",1030258,122,146,12,280
"30259",1030259,81,53,2,136
"30260",1030260,196,107,12,315
"30261",1030261,122,53,4,179
"30262",1030262,119,203,9,331
"30263",1030263,90,43,7,140
"30264",1030264,138,102,11,251
"30265",1030265,37,115,5,157
"30266",1030266,72,52,7,131
"30267",1030267,105,60,4,169
"30268",1030268,130,46,7,183
"30269",1030269,183,85,5,273
"30270",1030270,34,195,3,232
"30271",1030271,222,59,10,291
"30272",1030272,216,23,8,247
"30273",1030273,132,53,9,194
"30274",1030274,14,98,3,115
"30275",1030275,54,190,10,254
"30276",1030276,72,216,11,299
"30277",1030277,155,122,6,283
"30278",1030278,77,144,7,228
"30279",1030279,49,79,4,132
"30280",1030280,61,112,10,183
"30281",1030281,147,63,4,214
"30282",1030282,75,239,2,316
"30283",1030283,50,9,0,59
"30284",1030284,65,70,10,145
"30285",1030285,58,21,2,81
"30286",1030286,22,230,13,265
"30287",1030287,75,132,4,211
"30288",1030288,184,30,7,221
"30289",1030289,253,11,17,281
"30290",1030290,187,52,2,241
"30291",1030291,102,228,9,339
"30292",1030292,46,268,8,322
"30293",1030293,183,59,7,249
"30294",1030294,120,177,14,311
"30295",1030295,102,113,5,220
"30296",1030296,138,132,15,285
"30297",1030297,90,116,9,215
"30298",1030298,77,115,13,205
"30299",1030299,104,67,7,178
"30300",1030300,120,107,7,234
"30301",1030301,145,101,8,254
"30302",1030302,187,101,16,304
"30303",1030303,20,231,0,251
"30304",1030304,54,47,3,104
"30305",1030305,176,24,3,203
"30306",1030306,129,127,12,268
"30307",1030307,86,40,2,128
"30308",1030308,55,165,2,222
"30309",1030309,100,66,9,175
"30310",1030310,23,50,1,74
"30311",1030311,33,223,9,265
"30312",1030312,61,79,6,146
"30313",1030313,38,1,2,41
"30314",1030314,10,45,1,56
"30315",1030315,72,179,9,260
"30316",1030316,42,115,10,167
"30317",1030317,109,45,7,161
"30318",1030318,120,12,1,133
"30319",1030319,187,28,9,224
"30320",1030320,125,95,10,230
"30321",1030321,136,135,9,280
"30322",1030322,52,52,5,109
"30323",1030323,95,136,5,236
"30324",1030324,156,33,4,193
"30325",1030325,211,51,7,269
"30326",1030326,140,82,3,225
"30327",1030327,210,38,10,258
"30328",1030328,140,52,7,199
"30329",1030329,185,106,3,294
"30330",1030330,117,8,7,132
"30331",1030331,15,10,1,26
"30332",1030332,239,60,14,313
"30333",1030333,40,258,4,302
"30334",1030334,244,33,12,289
"30335",1030335,64,171,16,251
"30336",1030336,113,57,16,186
"30337",1030337,92,3,3,98
"30338",1030338,135,30,7,172
"30339",1030339,250,14,6,270
"30340",1030340,180,86,4,270
"30341",1030341,48,283,3,334
"30342",1030342,246,37,13,296
"30343",1030343,104,139,14,257
"30344",1030344,79,159,7,245
"30345",1030345,107,194,4,305
"30346",1030346,71,20,2,93
"30347",1030347,51,194,16,261
"30348",1030348,62,269,11,342
"30349",1030349,132,106,9,247
"30350",1030350,180,115,7,302
"30351",1030351,15,96,3,114
"30352",1030352,147,166,5,318
"30353",1030353,144,106,12,262
"30354",1030354,40,216,0,256
"30355",1030355,100,73,4,177
"30356",1030356,270,22,5,297
"30357",1030357,98,129,8,235
"30358",1030358,116,121,42,279
"30359",1030359,153,108,24,285
"30360",1030360,176,101,22,299
"30361",1030361,38,28,2,68
"30362",1030362,165,93,3,261
"30363",1030363,72,223,10,305
"30364",1030364,82,204,13,299
"30365",1030365,183,73,13,269
"30366",1030366,198,55,5,258
"30367",1030367,133,4,5,142
"30368",1030368,37,204,3,244
"30369",1030369,133,91,11,235
"30370",1030370,6,11,2,19
"30371",1030371,70,200,17,287
"30372",1030372,152,65,8,225
"30373",1030373,221,26,12,259
"30374",1030374,22,176,5,203
"30375",1030375,133,88,9,230
"30376",1030376,144,116,9,269
"30377",1030377,141,36,2,179
"30378",1030378,22,56,0,78
"30379",1030379,143,77,8,228
"30380",1030380,40,142,3,185
"30381",1030381,55,60,0,115
"30382",1030382,187,10,4,201
"30383",1030383,171,21,11,203
"30384",1030384,171,167,18,356
"30385",1030385,103,162,3,268
"30386",1030386,113,189,12,314
"30387",1030387,140,138,10,288
"30388",1030388,99,188,11,298
"30389",1030389,88,10,1,99
"30390",1030390,198,43,8,249
"30391",1030391,70,236,4,310
"30392",1030392,151,60,4,215
"30393",1030393,52,50,2,104
"30394",1030394,52,100,4,156
"30395",1030395,106,124,12,242
"30396",1030396,148,63,7,218
"30397",1030397,159,39,9,207
"30398",1030398,143,133,3,279
"30399",1030399,82,93,12,187
"30400",1030400,30,136,2,168
"30401",1030401,132,42,5,179
"30402",1030402,136,139,11,286
"30403",1030403,221,21,6,248
"30404",1030404,200,12,1,213
"30405",1030405,108,19,1,128
"30406",1030406,75,112,5,192
"30407",1030407,136,111,8,255
"30408",1030408,149,77,7,233
"30409",1030409,74,178,22,274
"30410",1030410,177,42,5,224
"30411",1030411,139,10,2,151
"30412",1030412,58,26,3,87
"30413",1030413,60,134,7,201
"30414",1030414,48,45,6,99
"30415",1030415,19,251,1,271
"30416",1030416,149,112,22,283
"30417",1030417,76,37,5,118
"30418",1030418,166,34,8,208
"30419",1030419,187,23,5,215
"30420",1030420,93,182,12,287
"30421",1030421,49,189,10,248
"30422",1030422,98,88,10,196
"30423",1030423,11,134,2,147
"30424",1030424,180,112,11,303
"30425",1030425,147,133,4,284
"30426",1030426,141,149,4,294
"30427",1030427,131,238,8,377
"30428",1030428,177,111,13,301
"30429",1030429,84,179,5,268
"30430",1030430,88,135,17,240
"30431",1030431,83,170,5,258
"30432",1030432,155,76,8,239
"30433",1030433,173,71,6,250
"30434",1030434,152,26,9,187
"30435",1030435,134,12,2,148
"30436",1030436,10,0,1,11
"30437",1030437,158,43,9,210
"30438",1030438,259,48,19,326
"30439",1030439,113,110,7,230
"30440",1030440,56,122,10,188
"30441",1030441,83,44,10,137
"30442",1030442,92,64,2,158
"30443",1030443,140,84,17,241
"30444",1030444,187,68,12,267
"30445",1030445,38,71,0,109
"30446",1030446,9,20,3,32
"30447",1030447,59,158,6,223
"30448",1030448,71,55,1,127
"30449",1030449,90,28,4,122
"30450",1030450,87,121,7,215
"30451",1030451,99,81,12,192
"30452",1030452,138,13,2,153
"30453",1030453,59,231,16,306
"30454",1030454,95,29,5,129
"30455",1030455,56,66,3,125
"30456",1030456,164,103,6,273
"30457",1030457,170,20,4,194
"30458",1030458,78,51,2,131
"30459",1030459,134,80,3,217
"30460",1030460,39,44,2,85
"30461",1030461,111,86,4,201
"30462",1030462,166,27,10,203
"30463",1030463,91,57,2,150
"30464",1030464,182,38,5,225
"30465",1030465,93,205,22,320
"30466",1030466,153,126,3,282
"30467",1030467,106,60,11,177
"30468",1030468,154,5,3,162
"30469",1030469,109,102,7,218
"30470",1030470,76,97,7,180
"30471",1030471,79,146,5,230
"30472",1030472,88,73,3,164
"30473",1030473,86,124,1,211
"30474",1030474,70,232,11,313
"30475",1030475,180,35,8,223
"30476",1030476,152,47,7,206
"30477",1030477,244,21,13,278
"30478",1030478,115,30,1,146
"30479",1030479,66,89,4,159
"30480",1030480,192,90,14,296
"30481",1030481,109,212,6,327
"30482",1030482,116,187,6,309
"30483",1030483,144,80,5,229
"30484",1030484,60,162,8,230
"30485",1030485,98,219,10,327
"30486",1030486,109,85,6,200
"30487",1030487,146,35,2,183
"30488",1030488,79,115,20,214
"30489",1030489,155,70,8,233
"30490",1030490,111,119,26,256
"30491",1030491,61,99,2,162
"30492",1030492,140,36,3,179
"30493",1030493,58,190,12,260
"30494",1030494,189,16,7,212
"30495",1030495,115,147,4,266
"30496",1030496,241,253,37,531
"30497",1030497,105,164,6,275
"30498",1030498,130,147,5,282
"30499",1030499,46,218,2,266
"30500",1030500,126,189,14,329
"30501",1030501,8,63,1,72
"30502",1030502,169,79,6,254
"30503",1030503,157,70,5,232
"30504",1030504,256,63,9,328
"30505",1030505,128,43,4,175
"30506",1030506,89,121,22,232
"30507",1030507,48,121,6,175
"30508",1030508,168,25,4,197
"30509",1030509,47,193,5,245
"30510",1030510,248,26,6,280
"30511",1030511,130,20,3,153
"30512",1030512,93,222,10,325
"30513",1030513,161,119,13,293
"30514",1030514,81,17,0,98
"30515",1030515,80,111,5,196
"30516",1030516,149,87,6,242
"30517",1030517,76,104,5,185
"30518",1030518,209,79,12,300
"30519",1030519,78,183,14,275
"30520",1030520,224,57,7,288
"30521",1030521,79,32,3,114
"30522",1030522,69,195,8,272
"30523",1030523,144,48,4,196
"30524",1030524,174,131,10,315
"30525",1030525,59,191,10,260
"30526",1030526,209,10,7,226
"30527",1030527,177,28,5,210
"30528",1030528,8,32,1,41
"30529",1030529,52,264,9,325
"30530",1030530,75,49,6,130
"30531",1030531,79,149,6,234
"30532",1030532,109,29,1,139
"30533",1030533,66,119,3,188
"30534",1030534,171,128,24,323
"30535",1030535,105,154,9,268
"30536",1030536,91,204,5,300
"30537",1030537,51,160,4,215
"30538",1030538,146,135,9,290
"30539",1030539,24,197,2,223
"30540",1030540,138,79,5,222
"30541",1030541,83,58,3,144
"30542",1030542,185,93,5,283
"30543",1030543,136,39,9,184
"30544",1030544,139,89,8,236
"30545",1030545,49,248,6,303
"30546",1030546,80,174,2,256
"30547",1030547,148,92,7,247
"30548",1030548,41,236,12,289
"30549",1030549,46,75,10,131
"30550",1030550,57,255,3,315
"30551",1030551,5,3,1,9
"30552",1030552,101,176,6,283
"30553",1030553,174,54,10,238
"30554",1030554,139,18,4,161
"30555",1030555,42,224,4,270
"30556",1030556,138,41,11,190
"30557",1030557,13,76,3,92
"30558",1030558,95,23,4,122
"30559",1030559,73,61,13,147
"30560",1030560,122,64,7,193
"30561",1030561,144,58,15,217
"30562",1030562,81,191,5,277
"30563",1030563,19,238,4,261
"30564",1030564,107,97,2,206
"30565",1030565,157,142,4,303
"30566",1030566,60,88,2,150
"30567",1030567,73,199,3,275
"30568",1030568,104,134,16,254
"30569",1030569,64,74,0,138
"30570",1030570,177,35,4,216
"30571",1030571,175,58,5,238
"30572",1030572,217,37,8,262
"30573",1030573,159,108,11,278
"30574",1030574,197,40,13,250
"30575",1030575,68,216,3,287
"30576",1030576,182,48,6,236
"30577",1030577,252,29,5,286
"30578",1030578,94,32,5,131
"30579",1030579,156,69,5,230
"30580",1030580,194,25,6,225
"30581",1030581,120,8,0,128
"30582",1030582,232,25,4,261
"30583",1030583,59,17,2,78
"30584",1030584,93,187,7,287
"30585",1030585,55,51,2,108
"30586",1030586,101,102,3,206
"30587",1030587,66,416,7,489
"30588",1030588,201,7,9,217
"30589",1030589,70,173,1,244
"30590",1030590,115,141,2,258
"30591",1030591,2,64,0,66
"30592",1030592,95,194,8,297
"30593",1030593,257,24,10,291
"30594",1030594,87,116,10,213
"30595",1030595,126,110,4,240
"30596",1030596,22,243,8,273
"30597",1030597,11,46,0,57
"30598",1030598,31,174,2,207
"30599",1030599,16,194,4,214
"30600",1030600,139,184,17,340
"30601",1030601,51,160,10,221
"30602",1030602,181,92,15,288
"30603",1030603,167,123,8,298
"30604",1030604,136,106,14,256
"30605",1030605,209,48,4,261
"30606",1030606,85,99,9,193
"30607",1030607,190,25,5,220
"30608",1030608,52,85,14,151
"30609",1030609,8,123,3,134
"30610",1030610,31,184,4,219
"30611",1030611,104,155,8,267
"30612",1030612,50,5,1,56
"30613",1030613,214,49,8,271
"30614",1030614,217,20,7,244
"30615",1030615,46,169,7,222
"30616",1030616,107,168,24,299
"30617",1030617,78,162,10,250
"30618",1030618,161,37,13,211
"30619",1030619,145,42,11,198
"30620",1030620,188,74,10,272
"30621",1030621,58,230,3,291
"30622",1030622,26,84,7,117
"30623",1030623,40,166,6,212
"30624",1030624,59,172,7,238
"30625",1030625,56,253,9,318
"30626",1030626,113,41,3,157
"30627",1030627,16,3,0,19
"30628",1030628,31,119,2,152
"30629",1030629,41,305,2,348
"30630",1030630,102,179,9,290
"30631",1030631,207,88,19,314
"30632",1030632,113,0,0,113
"30633",1030633,35,128,2,165
"30634",1030634,245,18,1,264
"30635",1030635,5,111,6,122
"30636",1030636,12,99,3,114
"30637",1030637,24,219,4,247
"30638",1030638,116,102,5,223
"30639",1030639,55,234,18,307
"30640",1030640,16,11,1,28
"30641",1030641,149,22,17,188
"30642",1030642,194,86,10,290
"30643",1030643,80,91,10,181
"30644",1030644,121,177,14,312
"30645",1030645,184,83,9,276
"30646",1030646,124,18,1,143
"30647",1030647,120,46,5,171
"30648",1030648,86,113,11,210
"30649",1030649,54,257,3,314
"30650",1030650,94,129,4,227
"30651",1030651,117,18,6,141
"30652",1030652,234,21,11,266
"30653",1030653,217,59,19,295
"30654",1030654,22,3,0,25
"30655",1030655,65,126,15,206
"30656",1030656,41,23,2,66
"30657",1030657,71,190,4,265
"30658",1030658,116,178,14,308
"30659",1030659,142,123,10,275
"30660",1030660,57,131,8,196
"30661",1030661,115,156,6,277
"30662",1030662,234,31,10,275
"30663",1030663,58,206,7,271
"30664",1030664,49,230,10,289
"30665",1030665,47,193,6,246
"30666",1030666,55,155,21,231
"30667",1030667,49,278,11,338
"30668",1030668,199,76,14,289
"30669",1030669,103,74,14,191
"30670",1030670,115,53,3,171
"30671",1030671,33,254,9,296
"30672",1030672,98,163,14,275
"30673",1030673,68,144,5,217
"30674",1030674,12,211,2,225
"30675",1030675,64,213,5,282
"30676",1030676,17,89,0,106
"30677",1030677,170,11,4,185
"30678",1030678,197,21,4,222
"30679",1030679,143,67,10,220
"30680",1030680,55,202,2,259
"30681",1030681,5,42,1,48
"30682",1030682,29,142,3,174
"30683",1030683,45,140,1,186
"30684",1030684,82,181,2,265
"30685",1030685,87,28,4,119
"30686",1030686,79,102,6,187
"30687",1030687,41,40,8,89
"30688",1030688,98,112,7,217
"30689",1030689,146,1,2,149
"30690",1030690,9,6,1,16
"30691",1030691,53,51,4,108
"30692",1030692,39,230,6,275
"30693",1030693,179,87,6,272
"30694",1030694,115,220,13,348
"30695",1030695,28,257,2,287
"30696",1030696,87,24,4,115
"30697",1030697,107,84,10,201
"30698",1030698,72,131,6,209
"30699",1030699,94,85,6,185
"30700",1030700,129,65,12,206
"30701",1030701,33,25,4,62
"30702",1030702,149,36,4,189
"30703",1030703,163,80,9,252
"30704",1030704,189,34,7,230
"30705",1030705,1,2,0,3
"30706",1030706,126,17,1,144
"30707",1030707,145,22,5,172
"30708",1030708,1,4,0,5
"30709",1030709,135,91,12,238
"30710",1030710,182,106,7,295
"30711",1030711,136,114,11,261
"30712",1030712,239,68,12,319
"30713",1030713,56,150,7,213
"30714",1030714,166,114,7,287
"30715",1030715,51,18,5,74
"30716",1030716,117,139,5,261
"30717",1030717,68,80,4,152
"30718",1030718,43,96,5,144
"30719",1030719,16,85,2,103
"30720",1030720,98,185,11,294
"30721",1030721,157,61,7,225
"30722",1030722,318,2,1,321
"30723",1030723,196,50,18,264
"30724",1030724,30,267,3,300
"30725",1030725,178,41,23,242
"30726",1030726,161,67,12,240
"30727",1030727,39,239,1,279
"30728",1030728,49,128,13,190
"30729",1030729,163,64,11,238
"30730",1030730,200,100,3,303
"30731",1030731,5,3,3,11
"30732",1030732,119,47,9,175
"30733",1030733,107,171,5,283
"30734",1030734,60,65,0,125
"30735",1030735,139,99,2,240
"30736",1030736,70,184,13,267
"30737",1030737,63,232,6,301
"30738",1030738,80,226,22,328
"30739",1030739,147,44,6,197
"30740",1030740,21,0,1,22
"30741",1030741,32,281,10,323
"30742",1030742,17,120,0,137
"30743",1030743,137,29,8,174
"30744",1030744,138,54,2,194
"30745",1030745,55,63,5,123
"30746",1030746,75,165,4,244
"30747",1030747,43,92,3,138
"30748",1030748,118,26,5,149
"30749",1030749,61,120,17,198
"30750",1030750,86,164,10,260
"30751",1030751,159,27,9,195
"30752",1030752,49,103,8,160
"30753",1030753,59,146,19,224
"30754",1030754,114,94,31,239
"30755",1030755,269,36,10,315
"30756",1030756,156,106,3,265
"30757",1030757,69,95,2,166
"30758",1030758,260,8,21,289
"30759",1030759,21,279,6,306
"30760",1030760,157,6,6,169
"30761",1030761,102,202,14,318
"30762",1030762,256,6,26,288
"30763",1030763,162,146,14,322
"30764",1030764,253,34,14,301
"30765",1030765,191,71,11,273
"30766",1030766,60,189,3,252
"30767",1030767,30,2,3,35
"30768",1030768,90,158,17,265
"30769",1030769,36,153,6,195
"30770",1030770,116,83,0,199
"30771",1030771,187,112,9,308
"30772",1030772,124,145,13,282
"30773",1030773,216,66,8,290
"30774",1030774,59,233,5,297
"30775",1030775,80,209,5,294
"30776",1030776,160,127,15,302
"30777",1030777,140,68,8,216
"30778",1030778,74,222,7,303
"30779",1030779,107,159,16,282
"30780",1030780,93,138,6,237
"30781",1030781,248,59,12,319
"30782",1030782,108,147,13,268
"30783",1030783,0,0,0,0
"30784",1030784,44,27,3,74
"30785",1030785,64,201,5,270
"30786",1030786,154,138,5,297
"30787",1030787,122,96,13,231
"30788",1030788,34,274,8,316
"30789",1030789,116,144,14,274
"30790",1030790,54,244,4,302
"30791",1030791,60,246,6,312
"30792",1030792,194,80,24,298
"30793",1030793,55,204,0,259
"30794",1030794,237,31,10,278
"30795",1030795,183,66,10,259
"30796",1030796,92,54,4,150
"30797",1030797,68,229,7,304
"30798",1030798,7,14,3,24
"30799",1030799,15,76,5,96
"30800",1030800,111,153,3,267
"30801",1030801,194,36,18,248
"30802",1030802,168,103,20,291
"30803",1030803,236,21,6,263
"30804",1030804,167,59,7,233
"30805",1030805,87,149,6,242
"30806",1030806,193,47,14,254
"30807",1030807,174,26,7,207
"30808",1030808,9,59,6,74
"30809",1030809,79,175,8,262
"30810",1030810,59,2,0,61
"30811",1030811,104,93,9,206
"30812",1030812,25,238,7,270
"30813",1030813,8,159,1,168
"30814",1030814,60,230,7,297
"30815",1030815,96,130,14,240
"30816",1030816,91,95,10,196
"30817",1030817,53,5,3,61
"30818",1030818,112,151,9,272
"30819",1030819,129,84,6,219
"30820",1030820,77,29,4,110
"30821",1030821,130,131,4,265
"30822",1030822,188,75,7,270
"30823",1030823,95,81,8,184
"30824",1030824,81,106,14,201
"30825",1030825,141,134,11,286
"30826",1030826,77,239,6,322
"30827",1030827,104,178,9,291
"30828",1030828,77,28,6,111
"30829",1030829,109,121,8,238
"30830",1030830,124,183,7,314
"30831",1030831,137,104,8,249
"30832",1030832,204,60,8,272
"30833",1030833,164,59,6,229
"30834",1030834,124,107,13,244
"30835",1030835,29,235,8,272
"30836",1030836,112,140,9,261
"30837",1030837,45,224,4,273
"30838",1030838,181,72,13,266
"30839",1030839,26,88,4,118
"30840",1030840,96,143,14,253
"30841",1030841,156,90,7,253
"30842",1030842,82,215,8,305
"30843",1030843,144,43,11,198
"30844",1030844,156,113,12,281
"30845",1030845,195,90,7,292
"30846",1030846,204,30,10,244
"30847",1030847,14,11,1,26
"30848",1030848,134,173,12,319
"30849",1030849,154,97,9,260
"30850",1030850,127,121,4,252
"30851",1030851,43,278,4,325
"30852",1030852,89,115,6,210
"30853",1030853,117,1,4,122
"30854",1030854,45,15,4,64
"30855",1030855,119,22,3,144
"30856",1030856,79,199,19,297
"30857",1030857,151,28,6,185
"30858",1030858,91,92,24,207
"30859",1030859,60,145,5,210
"30860",1030860,80,54,6,140
"30861",1030861,122,46,6,174
"30862",1030862,213,32,10,255
"30863",1030863,0,0,0,0
"30864",1030864,122,202,4,328
"30865",1030865,162,87,12,261
"30866",1030866,146,66,7,219
"30867",1030867,171,97,7,275
"30868",1030868,10,11,0,21
"30869",1030869,162,71,19,252
"30870",1030870,58,239,6,303
"30871",1030871,138,70,9,217
"30872",1030872,146,140,16,302
"30873",1030873,4,17,1,22
"30874",1030874,138,48,6,192
"30875",1030875,11,58,1,70
"30876",1030876,122,102,7,231
"30877",1030877,91,122,11,224
"30878",1030878,93,52,4,149
"30879",1030879,80,168,5,253
"30880",1030880,153,141,10,304
"30881",1030881,68,31,6,105
"30882",1030882,227,45,8,280
"30883",1030883,72,136,2,210
"30884",1030884,173,75,17,265
"30885",1030885,86,80,7,173
"30886",1030886,173,72,10,255
"30887",1030887,91,142,8,241
"30888",1030888,71,81,11,163
"30889",1030889,83,57,4,144
"30890",1030890,179,14,6,199
"30891",1030891,119,225,11,355
"30892",1030892,172,41,10,223
"30893",1030893,80,128,22,230
"30894",1030894,8,32,1,41
"30895",1030895,71,240,8,319
"30896",1030896,140,19,11,170
"30897",1030897,163,46,4,213
"30898",1030898,133,107,3,243
"30899",1030899,115,108,14,237
"30900",1030900,166,98,1,265
"30901",1030901,41,122,6,169
"30902",1030902,90,165,12,267
"30903",1030903,97,141,4,242
"30904",1030904,174,71,6,251
"30905",1030905,124,102,17,243
"30906",1030906,197,21,3,221
"30907",1030907,45,4,2,51
"30908",1030908,138,64,7,209
"30909",1030909,38,148,14,200
"30910",1030910,72,124,17,213
"30911",1030911,127,35,5,167
"30912",1030912,146,112,18,276
"30913",1030913,20,336,3,359
"30914",1030914,108,143,9,260
"30915",1030915,73,188,10,271
"30916",1030916,192,70,2,264
"30917",1030917,95,39,2,136
"30918",1030918,173,54,8,235
"30919",1030919,146,84,13,243
"30920",1030920,52,254,7,313
"30921",1030921,50,256,1,307
"30922",1030922,23,225,2,250
"30923",1030923,66,186,16,268
"30924",1030924,178,23,5,206
"30925",1030925,78,152,1,231
"30926",1030926,161,108,17,286
"30927",1030927,133,130,6,269
"30928",1030928,157,74,7,238
"30929",1030929,102,80,9,191
"30930",1030930,135,34,8,177
"30931",1030931,106,153,6,265
"30932",1030932,124,28,12,164
"30933",1030933,45,201,18,264
"30934",1030934,75,210,10,295
"30935",1030935,208,47,9,264
"30936",1030936,71,179,6,256
"30937",1030937,60,259,3,322
"30938",1030938,27,108,3,138
"30939",1030939,67,162,8,237
"30940",1030940,83,45,8,136
"30941",1030941,200,35,8,243
"30942",1030942,25,255,3,283
"30943",1030943,94,206,6,306
"30944",1030944,60,8,1,69
"30945",1030945,158,77,4,239
"30946",1030946,144,105,13,262
"30947",1030947,216,32,10,258
"30948",1030948,182,46,16,244
"30949",1030949,85,83,4,172
"30950",1030950,31,85,1,117
"30951",1030951,177,83,15,275
"30952",1030952,34,190,11,235
"30953",1030953,188,17,2,207
"30954",1030954,164,102,7,273
"30955",1030955,170,51,9,230
"30956",1030956,91,98,14,203
"30957",1030957,79,213,2,294
"30958",1030958,56,162,17,235
"30959",1030959,50,151,7,208
"30960",1030960,118,165,10,293
"30961",1030961,100,219,9,328
"30962",1030962,71,106,12,189
"30963",1030963,104,148,6,258
"30964",1030964,122,45,8,175
"30965",1030965,142,33,7,182
"30966",1030966,111,35,11,157
"30967",1030967,33,196,5,234
"30968",1030968,178,33,10,221
"30969",1030969,102,75,6,183
"30970",1030970,129,96,12,237
"30971",1030971,24,12,0,36
"30972",1030972,43,222,5,270
"30973",1030973,38,114,1,153
"30974",1030974,65,4,1,70
"30975",1030975,78,163,14,255
"30976",1030976,123,77,4,204
"30977",1030977,37,239,2,278
"30978",1030978,34,217,7,258
"30979",1030979,28,50,1,79
"30980",1030980,176,86,9,271
"30981",1030981,52,123,6,181
"30982",1030982,83,123,8,214
"30983",1030983,165,35,4,204
"30984",1030984,282,99,32,413
"30985",1030985,104,59,5,168
"30986",1030986,132,167,0,299
"30987",1030987,95,107,1,203
"30988",1030988,245,86,11,342
"30989",1030989,81,103,2,186
"30990",1030990,44,214,3,261
"30991",1030991,101,106,9,216
"30992",1030992,59,74,5,138
"30993",1030993,43,255,10,308
"30994",1030994,163,98,18,279
"30995",1030995,111,43,10,164
"30996",1030996,228,87,5,320
"30997",1030997,151,30,3,184
"30998",1030998,116,181,14,311
"30999",1030999,95,38,12,145
"31000",1031000,133,141,14,288
"31001",1031001,51,184,6,241
"31002",1031002,32,215,5,252
"31003",1031003,116,187,19,322
"31004",1031004,161,69,4,234
"31005",1031005,99,46,8,153
"31006",1031006,178,68,4,250
"31007",1031007,225,51,8,284
"31008",1031008,184,46,18,248
"31009",1031009,63,33,3,99
"31010",1031010,47,243,3,293
"31011",1031011,160,11,5,176
"31012",1031012,154,21,4,179
"31013",1031013,214,23,13,250
"31014",1031014,84,161,5,250
"31015",1031015,43,169,5,217
"31016",1031016,56,255,13,324
"31017",1031017,253,50,12,315
"31018",1031018,141,83,5,229
"31019",1031019,96,17,2,115
"31020",1031020,34,197,11,242
"31021",1031021,92,71,3,166
"31022",1031022,114,92,6,212
"31023",1031023,218,8,2,228
"31024",1031024,147,14,3,164
"31025",1031025,106,132,8,246
"31026",1031026,54,34,4,92
"31027",1031027,26,19,0,45
"31028",1031028,157,41,3,201
"31029",1031029,26,109,0,135
"31030",1031030,112,95,12,219
"31031",1031031,194,69,3,266
"31032",1031032,57,166,11,234
"31033",1031033,198,53,4,255
"31034",1031034,133,78,16,227
"31035",1031035,130,62,6,198
"31036",1031036,78,158,7,243
"31037",1031037,98,59,6,163
"31038",1031038,155,69,12,236
"31039",1031039,57,18,11,86
"31040",1031040,53,158,8,219
"31041",1031041,63,20,3,86
"31042",1031042,108,54,5,167
"31043",1031043,65,104,2,171
"31044",1031044,53,265,6,324
"31045",1031045,109,24,11,144
"31046",1031046,107,34,7,148
"31047",1031047,191,68,16,275
"31048",1031048,69,190,2,261
"31049",1031049,75,151,3,229
"31050",1031050,89,200,9,298
"31051",1031051,95,57,7,159
"31052",1031052,51,212,18,281
"31053",1031053,228,64,22,314
"31054",1031054,99,19,5,123
"31055",1031055,142,22,3,167
"31056",1031056,180,136,5,321
"31057",1031057,44,163,2,209
"31058",1031058,117,47,4,168
"31059",1031059,95,90,3,188
"31060",1031060,112,187,18,317
"31061",1031061,109,142,4,255
"31062",1031062,101,143,3,247
"31063",1031063,133,100,7,240
"31064",1031064,127,154,18,299
"31065",1031065,73,206,19,298
"31066",1031066,129,157,14,300
"31067",1031067,253,3,5,261
"31068",1031068,74,208,8,290
"31069",1031069,97,72,5,174
"31070",1031070,180,52,6,238
"31071",1031071,41,251,2,294
"31072",1031072,177,55,2,234
"31073",1031073,115,49,1,165
"31074",1031074,151,105,4,260
"31075",1031075,73,49,7,129
"31076",1031076,94,165,12,271
"31077",1031077,46,48,7,101
"31078",1031078,173,23,1,197
"31079",1031079,255,39,7,301
"31080",1031080,57,185,5,247
"31081",1031081,70,237,4,311
"31082",1031082,94,80,4,178
"31083",1031083,127,148,16,291
"31084",1031084,151,38,4,193
"31085",1031085,59,185,4,248
"31086",1031086,254,43,12,309
"31087",1031087,58,142,4,204
"31088",1031088,136,328,27,491
"31089",1031089,123,10,7,140
"31090",1031090,208,78,11,297
"31091",1031091,114,104,7,225
"31092",1031092,65,168,7,240
"31093",1031093,127,68,1,196
"31094",1031094,113,133,11,257
"31095",1031095,61,159,13,233
"31096",1031096,150,96,1,247
"31097",1031097,94,38,5,137
"31098",1031098,151,8,3,162
"31099",1031099,110,74,7,191
"31100",1031100,83,88,7,178
"31101",1031101,58,232,8,298
"31102",1031102,194,37,7,238
"31103",1031103,99,13,5,117
"31104",1031104,60,165,1,226
"31105",1031105,183,88,12,283
"31106",1031106,148,65,9,222
"31107",1031107,109,66,6,181
"31108",1031108,149,33,6,188
"31109",1031109,189,108,11,308
"31110",1031110,136,33,1,170
"31111",1031111,83,160,13,256
"31112",1031112,25,93,4,122
"31113",1031113,168,7,6,181
"31114",1031114,93,48,10,151
"31115",1031115,76,92,7,175
"31116",1031116,113,91,19,223
"31117",1031117,111,99,5,215
"31118",1031118,42,70,0,112
"31119",1031119,2,1,0,3
"31120",1031120,74,70,12,156
"31121",1031121,201,42,5,248
"31122",1031122,36,142,2,180
"31123",1031123,93,106,9,208
"31124",1031124,75,149,5,229
"31125",1031125,43,19,1,63
"31126",1031126,136,65,17,218
"31127",1031127,149,94,7,250
"31128",1031128,70,74,6,150
"31129",1031129,107,155,20,282
"31130",1031130,71,186,12,269
"31131",1031131,143,107,10,260
"31132",1031132,80,86,3,169
"31133",1031133,205,48,4,257
"31134",1031134,137,100,1,238
"31135",1031135,98,36,7,141
"31136",1031136,199,118,7,324
"31137",1031137,33,127,0,160
"31138",1031138,32,170,2,204
"31139",1031139,176,105,13,294
"31140",1031140,11,5,3,19
"31141",1031141,92,137,5,234
"31142",1031142,159,89,6,254
"31143",1031143,116,80,4,200
"31144",1031144,136,95,6,237
"31145",1031145,128,41,2,171
"31146",1031146,146,109,15,270
"31147",1031147,51,195,3,249
"31148",1031148,170,125,9,304
"31149",1031149,187,91,5,283
"31150",1031150,133,7,1,141
"31151",1031151,55,153,16,224
"31152",1031152,59,198,7,264
"31153",1031153,145,69,3,217
"31154",1031154,192,52,3,247
"31155",1031155,110,35,7,152
"31156",1031156,74,13,1,88
"31157",1031157,155,40,11,206
"31158",1031158,118,151,12,281
"31159",1031159,141,6,3,150
"31160",1031160,59,253,4,316
"31161",1031161,99,27,11,137
"31162",1031162,25,232,7,264
"31163",1031163,34,53,5,92
"31164",1031164,192,64,7,263
"31165",1031165,153,123,15,291
"31166",1031166,31,172,7,210
"31167",1031167,82,151,11,244
"31168",1031168,125,144,23,292
"31169",1031169,51,238,6,295
"31170",1031170,50,168,8,226
"31171",1031171,105,93,10,208
"31172",1031172,59,177,8,244
"31173",1031173,188,9,3,200
"31174",1031174,30,226,10,266
"31175",1031175,144,131,7,282
"31176",1031176,135,31,3,169
"31177",1031177,60,77,2,139
"31178",1031178,207,38,6,251
"31179",1031179,63,207,12,282
"31180",1031180,99,71,12,182
"31181",1031181,30,148,3,181
"31182",1031182,178,62,24,264
"31183",1031183,110,124,12,246
"31184",1031184,51,171,5,227
"31185",1031185,144,104,15,263
"31186",1031186,36,267,6,309
"31187",1031187,139,69,7,215
"31188",1031188,71,113,4,188
"31189",1031189,184,66,9,259
"31190",1031190,125,45,7,177
"31191",1031191,47,32,3,82
"31192",1031192,199,55,8,262
"31193",1031193,162,27,6,195
"31194",1031194,95,121,11,227
"31195",1031195,139,74,7,220
"31196",1031196,219,52,12,283
"31197",1031197,59,179,0,238
"31198",1031198,112,69,11,192
"31199",1031199,154,87,3,244
"31200",1031200,100,67,9,176
"31201",1031201,212,73,15,300
"31202",1031202,55,185,13,253
"31203",1031203,48,81,5,134
"31204",1031204,74,128,12,214
"31205",1031205,25,214,7,246
"31206",1031206,47,159,4,210
"31207",1031207,142,54,6,202
"31208",1031208,36,258,9,303
"31209",1031209,116,47,5,168
"31210",1031210,39,36,2,77
"31211",1031211,117,49,7,173
"31212",1031212,73,182,16,271
"31213",1031213,106,120,7,233
"31214",1031214,107,105,12,224
"31215",1031215,135,112,12,259
"31216",1031216,88,173,11,272
"31217",1031217,137,153,6,296
"31218",1031218,200,61,12,273
"31219",1031219,148,66,8,222
"31220",1031220,113,92,13,218
"31221",1031221,182,65,4,251
"31222",1031222,116,45,15,176
"31223",1031223,169,101,4,274
"31224",1031224,46,17,6,69
"31225",1031225,85,63,4,152
"31226",1031226,55,37,2,94
"31227",1031227,2,3,0,5
"31228",1031228,161,64,11,236
"31229",1031229,138,88,2,228
"31230",1031230,164,93,9,266
"31231",1031231,171,139,19,329
"31232",1031232,3,21,0,24
"31233",1031233,85,188,8,281
"31234",1031234,75,155,7,237
"31235",1031235,42,43,5,90
"31236",1031236,257,36,7,300
"31237",1031237,54,49,3,106
"31238",1031238,83,177,4,264
"31239",1031239,38,270,9,317
"31240",1031240,8,87,3,98
"31241",1031241,221,50,8,279
"31242",1031242,48,0,0,48
"31243",1031243,18,196,9,223
"31244",1031244,24,236,9,269
"31245",1031245,101,150,17,268
"31246",1031246,73,164,3,240
"31247",1031247,86,160,2,248
"31248",1031248,10,6,1,17
"31249",1031249,100,49,4,153
"31250",1031250,237,29,10,276
"31251",1031251,80,115,2,197
"31252",1031252,176,33,10,219
"31253",1031253,137,45,4,186
"31254",1031254,99,150,2,251
"31255",1031255,166,111,15,292
"31256",1031256,73,247,5,325
"31257",1031257,114,14,5,133
"31258",1031258,114,41,5,160
"31259",1031259,3,6,0,9
"31260",1031260,166,50,2,218
"31261",1031261,195,46,19,260
"31262",1031262,69,287,3,359
"31263",1031263,93,170,6,269
"31264",1031264,128,60,2,190
"31265",1031265,94,262,10,366
"31266",1031266,113,56,1,170
"31267",1031267,35,194,1,230
"31268",1031268,80,114,8,202
"31269",1031269,69,188,13,270
"31270",1031270,63,177,10,250
"31271",1031271,46,250,11,307
"31272",1031272,178,41,2,221
"31273",1031273,43,106,11,160
"31274",1031274,72,192,1,265
"31275",1031275,8,9,1,18
"31276",1031276,98,138,5,241
"31277",1031277,159,41,4,204
"31278",1031278,112,108,7,227
"31279",1031279,124,47,5,176
"31280",1031280,32,12,19,63
"31281",1031281,23,0,0,23
"31282",1031282,78,102,10,190
"31283",1031283,29,212,1,242
"31284",1031284,125,30,4,159
"31285",1031285,120,126,11,257
"31286",1031286,127,134,16,277
"31287",1031287,141,74,12,227
"31288",1031288,166,37,7,210
"31289",1031289,70,108,4,182
"31290",1031290,152,1,0,153
"31291",1031291,114,106,4,224
"31292",1031292,173,35,6,214
"31293",1031293,148,111,5,264
"31294",1031294,92,204,12,308
"31295",1031295,118,103,6,227
"31296",1031296,40,2,0,42
"31297",1031297,178,321,40,539
"31298",1031298,131,35,14,180
"31299",1031299,237,44,9,290
"31300",1031300,112,66,8,186
"31301",1031301,238,6,5,249
"31302",1031302,26,12,2,40
"31303",1031303,72,177,5,254
"31304",1031304,68,151,2,221
"31305",1031305,119,175,21,315
"31306",1031306,158,6,3,167
"31307",1031307,94,101,12,207
"31308",1031308,126,33,5,164
"31309",1031309,36,229,5,270
"31310",1031310,177,64,5,246
"31311",1031311,52,163,5,220
"31312",1031312,127,58,6,191
"31313",1031313,85,9,2,96
"31314",1031314,117,83,9,209
"31315",1031315,56,88,3,147
"31316",1031316,104,93,6,203
"31317",1031317,41,243,3,287
"31318",1031318,113,0,2,115
"31319",1031319,63,178,5,246
"31320",1031320,63,19,0,82
"31321",1031321,158,154,19,331
"31322",1031322,22,8,1,31
"31323",1031323,36,116,3,155
"31324",1031324,42,4,3,49
"31325",1031325,194,17,5,216
"31326",1031326,129,66,3,198
"31327",1031327,60,81,2,143
"31328",1031328,135,147,10,292
"31329",1031329,10,29,1,40
"31330",1031330,94,184,5,283
"31331",1031331,177,13,2,192
"31332",1031332,9,5,0,14
"31333",1031333,27,55,5,87
"31334",1031334,54,119,20,193
"31335",1031335,131,116,2,249
"31336",1031336,21,230,2,253
"31337",1031337,80,186,7,273
"31338",1031338,37,206,3,246
"31339",1031339,67,44,5,116
"31340",1031340,5,13,2,20
"31341",1031341,184,28,4,216
"31342",1031342,186,62,5,253
"31343",1031343,54,169,3,226
"31344",1031344,122,43,8,173
"31345",1031345,15,15,3,33
"31346",1031346,106,123,12,241
"31347",1031347,81,185,10,276
"31348",1031348,134,154,7,295
"31349",1031349,119,13,5,137
"31350",1031350,197,94,15,306
"31351",1031351,91,95,12,198
"31352",1031352,137,135,12,284
"31353",1031353,130,97,12,239
"31354",1031354,173,75,5,253
"31355",1031355,114,30,1,145
"31356",1031356,78,202,6,286
"31357",1031357,97,129,3,229
"31358",1031358,18,261,6,285
"31359",1031359,98,72,8,178
"31360",1031360,123,88,6,217
"31361",1031361,156,64,16,236
"31362",1031362,79,191,11,281
"31363",1031363,93,179,5,277
"31364",1031364,82,179,6,267
"31365",1031365,45,251,2,298
"31366",1031366,34,224,4,262
"31367",1031367,253,2,8,263
"31368",1031368,87,184,20,291
"31369",1031369,160,158,13,331
"31370",1031370,79,121,2,202
"31371",1031371,184,30,11,225
"31372",1031372,234,22,5,261
"31373",1031373,126,157,3,286
"31374",1031374,129,19,6,154
"31375",1031375,212,23,4,239
"31376",1031376,57,128,1,186
"31377",1031377,188,17,1,206
"31378",1031378,261,37,7,305
"31379",1031379,93,123,7,223
"31380",1031380,25,168,1,194
"31381",1031381,63,124,13,200
"31382",1031382,33,226,2,261
"31383",1031383,25,147,5,177
"31384",1031384,32,10,1,43
"31385",1031385,177,33,5,215
"31386",1031386,165,35,6,206
"31387",1031387,123,57,6,186
"31388",1031388,148,103,12,263
"31389",1031389,27,117,6,150
"31390",1031390,8,1,0,9
"31391",1031391,209,42,12,263
"31392",1031392,91,68,2,161
"31393",1031393,1,6,0,7
"31394",1031394,183,47,12,242
"31395",1031395,72,149,1,222
"31396",1031396,84,48,19,151
"31397",1031397,66,195,2,263
"31398",1031398,166,1,1,168
"31399",1031399,62,286,4,352
"31400",1031400,37,141,4,182
"31401",1031401,66,178,4,248
"31402",1031402,99,93,3,195
"31403",1031403,116,16,8,140
"31404",1031404,188,18,4,210
"31405",1031405,45,192,7,244
"31406",1031406,99,83,7,189
"31407",1031407,58,113,7,178
"31408",1031408,5,97,3,105
"31409",1031409,72,125,3,200
"31410",1031410,63,174,7,244
"31411",1031411,163,109,9,281
"31412",1031412,203,62,10,275
"31413",1031413,205,40,2,247
"31414",1031414,206,84,7,297
"31415",1031415,88,90,10,188
"31416",1031416,125,155,11,291
"31417",1031417,31,195,1,227
"31418",1031418,13,13,2,28
"31419",1031419,94,52,6,152
"31420",1031420,142,35,8,185
"31421",1031421,64,106,3,173
"31422",1031422,24,92,3,119
"31423",1031423,180,107,10,297
"31424",1031424,159,51,2,212
"31425",1031425,256,17,12,285
"31426",1031426,181,71,12,264
"31427",1031427,65,201,12,278
"31428",1031428,52,35,6,93
"31429",1031429,8,96,3,107
"31430",1031430,81,89,1,171
"31431",1031431,139,92,9,240
"31432",1031432,50,163,4,217
"31433",1031433,93,190,5,288
"31434",1031434,70,29,3,102
"31435",1031435,64,91,7,162
"31436",1031436,149,109,16,274
"31437",1031437,49,67,5,121
"31438",1031438,49,180,15,244
"31439",1031439,123,138,12,273
"31440",1031440,10,26,1,37
"31441",1031441,79,224,17,320
"31442",1031442,98,168,14,280
"31443",1031443,152,0,1,153
"31444",1031444,196,28,9,233
"31445",1031445,117,68,4,189
"31446",1031446,58,27,2,87
"31447",1031447,103,71,7,181
"31448",1031448,160,88,17,265
"31449",1031449,103,135,6,244
"31450",1031450,126,46,3,175
"31451",1031451,63,178,7,248
"31452",1031452,35,45,0,80
"31453",1031453,69,176,6,251
"31454",1031454,57,123,9,189
"31455",1031455,159,92,5,256
"31456",1031456,103,29,5,137
"31457",1031457,176,58,9,243
"31458",1031458,48,16,1,65
"31459",1031459,45,174,4,223
"31460",1031460,212,64,7,283
"31461",1031461,172,135,4,311
"31462",1031462,59,120,11,190
"31463",1031463,117,28,14,159
"31464",1031464,31,213,4,248
"31465",1031465,156,51,6,213
"31466",1031466,65,5,1,71
"31467",1031467,21,221,9,251
"31468",1031468,209,97,24,330
"31469",1031469,74,75,5,154
"31470",1031470,193,75,14,282
"31471",1031471,91,37,4,132
"31472",1031472,170,64,7,241
"31473",1031473,54,279,12,345
"31474",1031474,108,250,22,380
"31475",1031475,69,180,17,266
"31476",1031476,14,4,0,18
"31477",1031477,34,214,3,251
"31478",1031478,183,93,10,286
"31479",1031479,225,29,12,266
"31480",1031480,187,81,18,286
"31481",1031481,71,163,7,241
"31482",1031482,84,134,4,222
"31483",1031483,86,223,6,315
"31484",1031484,90,101,14,205
"31485",1031485,151,67,4,222
"31486",1031486,95,136,5,236
"31487",1031487,114,77,14,205
"31488",1031488,40,33,1,74
"31489",1031489,153,123,21,297
"31490",1031490,43,186,6,235
"31491",1031491,112,110,6,228
"31492",1031492,46,191,23,260
"31493",1031493,66,88,7,161
"31494",1031494,132,105,6,243
"31495",1031495,4,22,1,27
"31496",1031496,254,25,2,281
"31497",1031497,164,45,5,214
"31498",1031498,163,61,7,231
"31499",1031499,55,227,6,288
"31500",1031500,135,97,13,245
"31501",1031501,144,20,1,165
"31502",1031502,119,129,11,259
"31503",1031503,127,190,10,327
"31504",1031504,108,155,11,274
"31505",1031505,170,72,16,258
"31506",1031506,170,131,15,316
"31507",1031507,48,10,1,59
"31508",1031508,165,38,11,214
"31509",1031509,181,107,6,294
"31510",1031510,135,101,26,262
"31511",1031511,244,51,11,306
"31512",1031512,84,195,5,284
"31513",1031513,11,41,1,53
"31514",1031514,33,205,2,240
"31515",1031515,172,85,15,272
"31516",1031516,221,15,9,245
"31517",1031517,91,204,7,302
"31518",1031518,64,118,1,183
"31519",1031519,135,99,6,240
"31520",1031520,39,161,4,204
"31521",1031521,250,13,4,267
"31522",1031522,87,115,5,207
"31523",1031523,155,91,10,256
"31524",1031524,110,162,16,288
"31525",1031525,154,26,4,184
"31526",1031526,86,199,16,301
"31527",1031527,49,95,6,150
"31528",1031528,39,139,3,181
"31529",1031529,151,14,7,172
"31530",1031530,33,287,4,324
"31531",1031531,21,300,7,328
"31532",1031532,158,23,7,188
"31533",1031533,224,71,9,304
"31534",1031534,65,162,9,236
"31535",1031535,89,103,14,206
"31536",1031536,134,53,7,194
"31537",1031537,155,119,17,291
"31538",1031538,158,111,7,276
"31539",1031539,125,38,5,168
"31540",1031540,42,273,11,326
"31541",1031541,133,114,5,252
"31542",1031542,105,68,6,179
"31543",1031543,81,32,6,119
"31544",1031544,33,71,4,108
"31545",1031545,99,189,1,289
"31546",1031546,90,185,16,291
"31547",1031547,40,5,0,45
"31548",1031548,84,130,8,222
"31549",1031549,76,218,10,304
"31550",1031550,63,21,7,91
"31551",1031551,21,40,1,62
"31552",1031552,71,120,8,199
"31553",1031553,151,88,16,255
"31554",1031554,58,116,4,178
"31555",1031555,134,49,2,185
"31556",1031556,148,105,8,261
"31557",1031557,89,109,2,200
"31558",1031558,21,30,1,52
"31559",1031559,12,161,1,174
"31560",1031560,112,193,5,310
"31561",1031561,18,140,9,167
"31562",1031562,88,122,17,227
"31563",1031563,158,30,2,190
"31564",1031564,244,31,12,287
"31565",1031565,224,75,9,308
"31566",1031566,91,155,9,255
"31567",1031567,161,60,20,241
"31568",1031568,125,58,6,189
"31569",1031569,73,182,18,273
"31570",1031570,236,17,3,256
"31571",1031571,93,107,24,224
"31572",1031572,168,62,5,235
"31573",1031573,108,92,5,205
"31574",1031574,96,209,15,320
"31575",1031575,154,116,10,280
"31576",1031576,47,129,7,183
"31577",1031577,154,46,2,202
"31578",1031578,53,250,3,306
"31579",1031579,24,5,3,32
"31580",1031580,95,197,20,312
"31581",1031581,84,141,16,241
"31582",1031582,126,98,10,234
"31583",1031583,133,175,4,312
"31584",1031584,163,43,8,214
"31585",1031585,218,55,15,288
"31586",1031586,100,177,15,292
"31587",1031587,191,46,11,248
"31588",1031588,160,100,9,269
"31589",1031589,206,95,9,310
"31590",1031590,78,186,12,276
"31591",1031591,93,58,8,159
"31592",1031592,271,47,9,327
"31593",1031593,115,172,15,302
"31594",1031594,39,64,3,106
"31595",1031595,33,26,0,59
"31596",1031596,82,158,4,244
"31597",1031597,30,33,1,64
"31598",1031598,55,212,11,278
"31599",1031599,85,177,7,269
"31600",1031600,57,242,8,307
"31601",1031601,136,41,8,185
"31602",1031602,52,21,3,76
"31603",1031603,155,35,2,192
"31604",1031604,85,202,12,299
"31605",1031605,107,156,13,276
"31606",1031606,8,1,1,10
"31607",1031607,54,153,1,208
"31608",1031608,44,33,10,87
"31609",1031609,117,130,16,263
"31610",1031610,288,1,1,290
"31611",1031611,122,31,6,159
"31612",1031612,288,9,5,302
"31613",1031613,51,173,4,228
"31614",1031614,29,253,3,285
"31615",1031615,103,162,13,278
"31616",1031616,93,48,3,144
"31617",1031617,212,34,10,256
"31618",1031618,172,63,1,236
"31619",1031619,61,62,2,125
"31620",1031620,23,201,6,230
"31621",1031621,140,127,26,293
"31622",1031622,21,177,2,200
"31623",1031623,155,49,9,213
"31624",1031624,109,109,10,228
"31625",1031625,203,27,1,231
"31626",1031626,100,97,4,201
"31627",1031627,184,39,17,240
"31628",1031628,116,127,8,251
"31629",1031629,139,150,14,303
"31630",1031630,143,90,4,237
"31631",1031631,171,57,4,232
"31632",1031632,157,165,7,329
"31633",1031633,189,64,10,263
"31634",1031634,56,143,8,207
"31635",1031635,121,58,2,181
"31636",1031636,97,183,10,290
"31637",1031637,180,36,2,218
"31638",1031638,15,131,5,151
"31639",1031639,105,65,15,185
"31640",1031640,44,71,3,118
"31641",1031641,47,316,1,364
"31642",1031642,145,20,4,169
"31643",1031643,127,98,12,237
"31644",1031644,2,53,0,55
"31645",1031645,102,30,0,132
"31646",1031646,51,228,2,281
"31647",1031647,178,51,8,237
"31648",1031648,186,100,11,297
"31649",1031649,64,34,2,100
"31650",1031650,64,39,4,107
"31651",1031651,143,33,18,194
"31652",1031652,189,25,2,216
"31653",1031653,127,72,2,201
"31654",1031654,80,110,20,210
"31655",1031655,133,15,1,149
"31656",1031656,25,98,5,128
"31657",1031657,114,129,12,255
"31658",1031658,25,194,1,220
"31659",1031659,93,86,1,180
"31660",1031660,30,33,1,64
"31661",1031661,85,103,3,191
"31662",1031662,243,17,11,271
"31663",1031663,111,86,4,201
"31664",1031664,230,25,6,261
"31665",1031665,189,84,8,281
"31666",1031666,115,151,8,274
"31667",1031667,67,251,3,321
"31668",1031668,31,115,7,153
"31669",1031669,43,93,0,136
"31670",1031670,110,77,13,200
"31671",1031671,52,222,13,287
"31672",1031672,78,219,10,307
"31673",1031673,99,95,12,206
"31674",1031674,151,73,9,233
"31675",1031675,147,29,1,177
"31676",1031676,159,49,6,214
"31677",1031677,141,102,10,253
"31678",1031678,178,81,19,278
"31679",1031679,84,52,7,143
"31680",1031680,185,22,10,217
"31681",1031681,101,130,7,238
"31682",1031682,87,144,12,243
"31683",1031683,217,61,8,286
"31684",1031684,189,96,25,310
"31685",1031685,134,146,30,310
"31686",1031686,78,196,6,280
"31687",1031687,83,186,9,278
"31688",1031688,223,15,6,244
"31689",1031689,56,168,14,238
"31690",1031690,150,20,8,178
"31691",1031691,100,60,3,163
"31692",1031692,124,81,9,214
"31693",1031693,43,128,5,176
"31694",1031694,74,153,17,244
"31695",1031695,2,0,0,2
"31696",1031696,101,73,5,179
"31697",1031697,90,120,1,211
"31698",1031698,51,224,6,281
"31699",1031699,102,21,2,125
"31700",1031700,93,138,11,242
"31701",1031701,114,108,11,233
"31702",1031702,42,237,4,283
"31703",1031703,141,98,15,254
"31704",1031704,157,45,8,210
"31705",1031705,104,185,15,304
"31706",1031706,181,36,8,225
"31707",1031707,132,16,6,154
"31708",1031708,47,60,7,114
"31709",1031709,228,38,8,274
"31710",1031710,133,34,3,170
"31711",1031711,193,41,3,237
"31712",1031712,36,134,2,172
"31713",1031713,134,78,6,218
"31714",1031714,26,21,0,47
"31715",1031715,55,187,3,245
"31716",1031716,211,31,3,245
"31717",1031717,123,165,12,300
"31718",1031718,217,30,8,255
"31719",1031719,140,145,17,302
"31720",1031720,35,212,13,260
"31721",1031721,44,42,3,89
"31722",1031722,140,4,1,145
"31723",1031723,149,129,11,289
"31724",1031724,108,168,23,299
"31725",1031725,99,217,5,321
"31726",1031726,19,280,6,305
"31727",1031727,176,34,12,222
"31728",1031728,199,104,21,324
"31729",1031729,102,99,11,212
"31730",1031730,115,65,12,192
"31731",1031731,69,48,9,126
"31732",1031732,173,60,9,242
"31733",1031733,114,172,10,296
"31734",1031734,31,218,4,253
"31735",1031735,19,5,1,25
"31736",1031736,184,36,7,227
"31737",1031737,37,250,3,290
"31738",1031738,79,44,7,130
"31739",1031739,34,156,4,194
"31740",1031740,87,211,14,312
"31741",1031741,110,90,1,201
"31742",1031742,25,251,4,280
"31743",1031743,247,21,3,271
"31744",1031744,63,157,0,220
"31745",1031745,78,64,5,147
"31746",1031746,229,78,21,328
"31747",1031747,184,21,5,210
"31748",1031748,71,239,2,312
"31749",1031749,134,87,3,224
"31750",1031750,15,343,6,364
"31751",1031751,12,29,1,42
"31752",1031752,14,16,1,31
"31753",1031753,58,175,13,246
"31754",1031754,31,62,1,94
"31755",1031755,131,156,20,307
"31756",1031756,208,40,16,264
"31757",1031757,179,86,4,269
"31758",1031758,112,35,2,149
"31759",1031759,168,13,2,183
"31760",1031760,21,38,0,59
"31761",1031761,52,11,3,66
"31762",1031762,49,144,7,200
"31763",1031763,204,23,6,233
"31764",1031764,47,149,11,207
"31765",1031765,42,81,10,133
"31766",1031766,97,112,4,213
"31767",1031767,55,213,2,270
"31768",1031768,148,96,1,245
"31769",1031769,141,41,14,196
"31770",1031770,239,30,11,280
"31771",1031771,5,13,0,18
"31772",1031772,231,10,1,242
"31773",1031773,80,78,6,164
"31774",1031774,163,65,11,239
"31775",1031775,85,176,5,266
"31776",1031776,182,100,17,299
"31777",1031777,148,142,16,306
"31778",1031778,318,27,11,356
"31779",1031779,51,43,10,104
"31780",1031780,86,27,4,117
"31781",1031781,70,150,10,230
"31782",1031782,61,245,4,310
"31783",1031783,191,90,18,299
"31784",1031784,88,177,11,276
"31785",1031785,48,234,11,293
"31786",1031786,103,147,8,258
"31787",1031787,34,88,5,127
"31788",1031788,143,128,8,279
"31789",1031789,183,89,15,287
"31790",1031790,226,15,4,245
"31791",1031791,213,30,4,247
"31792",1031792,78,153,4,235
"31793",1031793,99,14,5,118
"31794",1031794,159,12,6,177
"31795",1031795,98,129,8,235
"31796",1031796,182,91,8,281
"31797",1031797,110,173,2,285
"31798",1031798,143,39,6,188
"31799",1031799,146,90,7,243
"31800",1031800,148,64,7,219
"31801",1031801,164,87,7,258
"31802",1031802,68,163,16,247
"31803",1031803,119,88,12,219
"31804",1031804,112,84,9,205
"31805",1031805,116,47,2,165
"31806",1031806,133,69,4,206
"31807",1031807,226,74,16,316
"31808",1031808,42,42,2,86
"31809",1031809,118,48,7,173
"31810",1031810,46,250,14,310
"31811",1031811,69,113,7,189
"31812",1031812,78,81,8,167
"31813",1031813,98,18,5,121
"31814",1031814,73,177,21,271
"31815",1031815,90,124,15,229
"31816",1031816,141,102,20,263
"31817",1031817,54,213,9,276
"31818",1031818,46,50,1,97
"31819",1031819,3,104,1,108
"31820",1031820,222,46,5,273
"31821",1031821,174,49,12,235
"31822",1031822,44,151,5,200
"31823",1031823,51,209,14,274
"31824",1031824,96,190,14,300
"31825",1031825,62,58,5,125
"31826",1031826,109,189,11,309
"31827",1031827,133,38,17,188
"31828",1031828,56,130,1,187
"31829",1031829,174,43,4,221
"31830",1031830,106,99,16,221
"31831",1031831,46,14,2,62
"31832",1031832,69,187,15,271
"31833",1031833,57,113,3,173
"31834",1031834,133,86,12,231
"31835",1031835,190,48,8,246
"31836",1031836,148,152,11,311
"31837",1031837,186,39,22,247
"31838",1031838,93,57,5,155
"31839",1031839,21,36,5,62
"31840",1031840,128,172,20,320
"31841",1031841,66,154,20,240
"31842",1031842,66,171,8,245
"31843",1031843,68,191,9,268
"31844",1031844,113,59,6,178
"31845",1031845,60,121,2,183
"31846",1031846,54,108,15,177
"31847",1031847,90,196,5,291
"31848",1031848,215,28,4,247
"31849",1031849,122,8,4,134
"31850",1031850,99,143,2,244
"31851",1031851,98,103,9,210
"31852",1031852,35,238,6,279
"31853",1031853,136,60,3,199
"31854",1031854,24,187,8,219
"31855",1031855,131,118,6,255
"31856",1031856,177,74,4,255
"31857",1031857,10,14,2,26
"31858",1031858,81,249,6,336
"31859",1031859,17,21,1,39
"31860",1031860,41,144,7,192
"31861",1031861,148,94,7,249
"31862",1031862,106,54,4,164
"31863",1031863,78,196,14,288
"31864",1031864,134,126,12,272
"31865",1031865,139,159,5,303
"31866",1031866,59,139,6,204
"31867",1031867,107,123,12,242
"31868",1031868,77,102,12,191
"31869",1031869,53,268,8,329
"31870",1031870,201,49,6,256
"31871",1031871,86,216,2,304
"31872",1031872,77,63,8,148
"31873",1031873,9,18,2,29
"31874",1031874,37,252,2,291
"31875",1031875,172,49,20,241
"31876",1031876,167,110,13,290
"31877",1031877,153,68,3,224
"31878",1031878,107,34,9,150
"31879",1031879,129,205,11,345
"31880",1031880,128,197,6,331
"31881",1031881,179,29,6,214
"31882",1031882,66,163,3,232
"31883",1031883,42,239,12,293
"31884",1031884,150,103,14,267
"31885",1031885,125,146,12,283
"31886",1031886,135,78,8,221
"31887",1031887,157,161,10,328
"31888",1031888,44,120,7,171
"31889",1031889,252,33,7,292
"31890",1031890,164,73,0,237
"31891",1031891,73,195,28,296
"31892",1031892,30,53,4,87
"31893",1031893,121,104,4,229
"31894",1031894,27,192,3,222
"31895",1031895,55,156,8,219
"31896",1031896,101,176,14,291
"31897",1031897,31,207,6,244
"31898",1031898,33,215,9,257
"31899",1031899,81,124,3,208
"31900",1031900,62,150,25,237
"31901",1031901,49,62,2,113
"31902",1031902,181,72,7,260
"31903",1031903,191,32,8,231
"31904",1031904,198,49,7,254
"31905",1031905,199,85,16,300
"31906",1031906,79,198,10,287
"31907",1031907,12,15,0,27
"31908",1031908,35,214,1,250
"31909",1031909,205,76,5,286
"31910",1031910,201,72,14,287
"31911",1031911,160,78,3,241
"31912",1031912,46,101,1,148
"31913",1031913,79,177,4,260
"31914",1031914,73,56,8,137
"31915",1031915,91,124,4,219
"31916",1031916,74,129,10,213
"31917",1031917,163,115,14,292
"31918",1031918,57,113,5,175
"31919",1031919,6,11,1,18
"31920",1031920,29,98,7,134
"31921",1031921,45,280,11,336
"31922",1031922,90,23,4,117
"31923",1031923,108,49,4,161
"31924",1031924,83,219,2,304
"31925",1031925,124,137,12,273
"31926",1031926,278,16,21,315
"31927",1031927,167,114,9,290
"31928",1031928,198,49,6,253
"31929",1031929,198,132,16,346
"31930",1031930,136,24,8,168
"31931",1031931,236,48,5,289
"31932",1031932,59,112,21,192
"31933",1031933,152,132,6,290
"31934",1031934,121,111,9,241
"31935",1031935,222,31,9,262
"31936",1031936,76,201,11,288
"31937",1031937,84,152,22,258
"31938",1031938,60,241,6,307
"31939",1031939,263,41,7,311
"31940",1031940,120,69,16,205
"31941",1031941,204,83,4,291
"31942",1031942,164,80,14,258
"31943",1031943,5,8,0,13
"31944",1031944,46,25,5,76
"31945",1031945,119,77,12,208
"31946",1031946,144,121,13,278
"31947",1031947,192,120,9,321
"31948",1031948,174,104,21,299
"31949",1031949,160,41,7,208
"31950",1031950,90,151,7,248
"31951",1031951,67,189,23,279
"31952",1031952,58,68,10,136
"31953",1031953,94,169,17,280
"31954",1031954,137,44,4,185
"31955",1031955,85,28,2,115
"31956",1031956,95,19,5,119
"31957",1031957,134,83,12,229
"31958",1031958,85,209,14,308
"31959",1031959,59,89,4,152
"31960",1031960,61,187,12,260
"31961",1031961,20,165,2,187
"31962",1031962,117,57,10,184
"31963",1031963,138,57,10,205
"31964",1031964,41,178,3,222
"31965",1031965,41,243,10,294
"31966",1031966,72,186,15,273
"31967",1031967,15,32,1,48
"31968",1031968,91,175,22,288
"31969",1031969,66,13,7,86
"31970",1031970,63,228,7,298
"31971",1031971,25,27,1,53
"31972",1031972,227,83,3,313
"31973",1031973,158,156,13,327
"31974",1031974,64,146,6,216
"31975",1031975,118,52,8,178
"31976",1031976,118,86,0,204
"31977",1031977,171,93,7,271
"31978",1031978,73,63,2,138
"31979",1031979,71,77,4,152
"31980",1031980,78,158,13,249
"31981",1031981,136,52,8,196
"31982",1031982,201,50,13,264
"31983",1031983,68,217,12,297
"31984",1031984,118,72,3,193
"31985",1031985,48,210,7,265
"31986",1031986,106,111,4,221
"31987",1031987,109,66,9,184
"31988",1031988,55,149,4,208
"31989",1031989,42,28,5,75
"31990",1031990,123,147,6,276
"31991",1031991,124,69,8,201
"31992",1031992,128,117,11,256
"31993",1031993,185,15,7,207
"31994",1031994,47,115,9,171
"31995",1031995,167,94,10,271
"31996",1031996,59,17,1,77
"31997",1031997,81,113,14,208
"31998",1031998,43,166,12,221
"31999",1031999,91,117,1,209
"32000",1032000,94,175,13,282
"32001",1032001,178,19,13,210
"32002",1032002,134,74,8,216
"32003",1032003,96,186,8,290
"32004",1032004,47,215,0,262
"32005",1032005,166,93,7,266
"32006",1032006,51,5,2,58
"32007",1032007,40,193,3,236
"32008",1032008,18,2,2,22
"32009",1032009,214,12,0,226
"32010",1032010,155,64,4,223
"32011",1032011,71,197,7,275
"32012",1032012,98,27,4,129
"32013",1032013,132,166,15,313
"32014",1032014,106,94,1,201
"32015",1032015,225,33,12,270
"32016",1032016,46,162,2,210
"32017",1032017,67,167,17,251
"32018",1032018,96,138,11,245
"32019",1032019,12,33,1,46
"32020",1032020,40,111,12,163
"32021",1032021,8,56,2,66
"32022",1032022,84,34,5,123
"32023",1032023,169,82,9,260
"32024",1032024,59,121,14,194
"32025",1032025,56,155,3,214
"32026",1032026,153,71,5,229
"32027",1032027,245,76,16,337
"32028",1032028,97,114,16,227
"32029",1032029,152,99,13,264
"32030",1032030,91,153,13,257
"32031",1032031,124,111,10,245
"32032",1032032,176,36,2,214
"32033",1032033,171,23,2,196
"32034",1032034,238,22,11,271
"32035",1032035,106,94,17,217
"32036",1032036,234,61,4,299
"32037",1032037,136,33,9,178
"32038",1032038,30,232,14,276
"32039",1032039,24,18,0,42
"32040",1032040,61,237,8,306
"32041",1032041,97,200,8,305
"32042",1032042,27,141,3,171
"32043",1032043,141,89,7,237
"32044",1032044,234,15,3,252
"32045",1032045,41,8,2,51
"32046",1032046,164,89,19,272
"32047",1032047,102,75,10,187
"32048",1032048,163,85,10,258
"32049",1032049,18,77,2,97
"32050",1032050,36,115,2,153
"32051",1032051,153,61,16,230
"32052",1032052,100,70,8,178
"32053",1032053,136,60,7,203
"32054",1032054,76,141,3,220
"32055",1032055,84,46,6,136
"32056",1032056,177,21,11,209
"32057",1032057,217,21,1,239
"32058",1032058,41,194,10,245
"32059",1032059,143,87,10,240
"32060",1032060,107,77,6,190
"32061",1032061,146,47,1,194
"32062",1032062,163,64,9,236
"32063",1032063,66,84,2,152
"32064",1032064,8,2,0,10
"32065",1032065,31,96,3,130
"32066",1032066,50,31,2,83
"32067",1032067,143,57,18,218
"32068",1032068,158,48,7,213
"32069",1032069,32,173,1,206
"32070",1032070,76,91,9,176
"32071",1032071,144,53,10,207
"32072",1032072,1,7,1,9
"32073",1032073,144,130,11,285
"32074",1032074,115,28,9,152
"32075",1032075,150,61,1,212
"32076",1032076,154,99,11,264
"32077",1032077,125,34,11,170
"32078",1032078,82,65,12,159
"32079",1032079,25,70,3,98
"32080",1032080,42,178,4,224
"32081",1032081,147,16,3,166
"32082",1032082,203,81,4,288
"32083",1032083,168,46,5,219
"32084",1032084,224,25,8,257
"32085",1032085,268,25,5,298
"32086",1032086,35,91,10,136
"32087",1032087,42,282,2,326
"32088",1032088,211,73,10,294
"32089",1032089,133,62,6,201
"32090",1032090,114,121,4,239
"32091",1032091,125,58,5,188
"32092",1032092,98,1,0,99
"32093",1032093,122,187,3,312
"32094",1032094,92,103,24,219
"32095",1032095,100,25,4,129
"32096",1032096,162,50,9,221
"32097",1032097,75,186,16,277
"32098",1032098,200,78,11,289
"32099",1032099,71,191,13,275
"32100",1032100,254,49,10,313
"32101",1032101,55,142,15,212
"32102",1032102,97,120,4,221
"32103",1032103,77,255,16,348
"32104",1032104,118,120,4,242
"32105",1032105,136,102,6,244
"32106",1032106,87,154,10,251
"32107",1032107,230,14,8,252
"32108",1032108,183,106,13,302
"32109",1032109,215,73,7,295
"32110",1032110,63,0,0,63
"32111",1032111,81,157,6,244
"32112",1032112,147,64,8,219
"32113",1032113,57,217,7,281
"32114",1032114,236,154,17,407
"32115",1032115,131,36,3,170
"32116",1032116,122,102,2,226
"32117",1032117,176,50,16,242
"32118",1032118,42,173,8,223
"32119",1032119,105,42,8,155
"32120",1032120,28,33,5,66
"32121",1032121,43,23,2,68
"32122",1032122,37,111,14,162
"32123",1032123,154,68,8,230
"32124",1032124,188,134,10,332
"32125",1032125,108,155,7,270
"32126",1032126,116,75,4,195
"32127",1032127,227,20,6,253
"32128",1032128,167,61,4,232
"32129",1032129,121,55,10,186
"32130",1032130,156,133,8,297
"32131",1032131,100,127,8,235
"32132",1032132,58,207,10,275
"32133",1032133,67,9,2,78
"32134",1032134,94,245,4,343
"32135",1032135,197,40,5,242
"32136",1032136,118,20,1,139
"32137",1032137,174,54,3,231
"32138",1032138,19,1,1,21
"32139",1032139,103,74,3,180
"32140",1032140,150,99,12,261
"32141",1032141,120,84,13,217
"32142",1032142,177,11,3,191
"32143",1032143,177,95,12,284
"32144",1032144,24,122,5,151
"32145",1032145,66,65,5,136
"32146",1032146,249,26,8,283
"32147",1032147,37,208,0,245
"32148",1032148,206,58,17,281
"32149",1032149,140,8,4,152
"32150",1032150,96,46,7,149
"32151",1032151,194,45,6,245
"32152",1032152,57,235,5,297
"32153",1032153,69,196,16,281
"32154",1032154,31,221,3,255
"32155",1032155,103,124,14,241
"32156",1032156,212,118,20,350
"32157",1032157,68,223,10,301
"32158",1032158,85,197,2,284
"32159",1032159,254,106,25,385
"32160",1032160,101,197,16,314
"32161",1032161,42,129,6,177
"32162",1032162,23,179,0,202
"32163",1032163,123,59,3,185
"32164",1032164,47,213,4,264
"32165",1032165,90,136,13,239
"32166",1032166,63,159,11,233
"32167",1032167,128,184,7,319
"32168",1032168,93,11,3,107
"32169",1032169,198,38,24,260
"32170",1032170,124,0,1,125
"32171",1032171,190,65,5,260
"32172",1032172,122,202,10,334
"32173",1032173,248,42,9,299
"32174",1032174,122,99,8,229
"32175",1032175,124,82,6,212
"32176",1032176,39,40,3,82
"32177",1032177,116,71,3,190
"32178",1032178,49,16,3,68
"32179",1032179,110,78,8,196
"32180",1032180,201,68,13,282
"32181",1032181,191,57,7,255
"32182",1032182,88,140,15,243
"32183",1032183,52,27,1,80
"32184",1032184,87,204,15,306
"32185",1032185,38,22,1,61
"32186",1032186,105,157,23,285
"32187",1032187,232,54,4,290
"32188",1032188,154,73,12,239
"32189",1032189,95,142,28,265
"32190",1032190,169,75,5,249
"32191",1032191,212,80,18,310
"32192",1032192,88,147,4,239
"32193",1032193,26,201,3,230
"32194",1032194,110,93,6,209
"32195",1032195,35,90,12,137
"32196",1032196,67,157,7,231
"32197",1032197,38,295,10,343
"32198",1032198,50,223,6,279
"32199",1032199,112,71,10,193
"32200",1032200,64,126,5,195
"32201",1032201,78,219,7,304
"32202",1032202,152,115,11,278
"32203",1032203,18,223,3,244
"32204",1032204,108,57,12,177
"32205",1032205,32,97,5,134
"32206",1032206,50,242,2,294
"32207",1032207,69,22,5,96
"32208",1032208,47,252,10,309
"32209",1032209,145,125,19,289
"32210",1032210,182,22,6,210
"32211",1032211,173,114,9,296
"32212",1032212,180,43,8,231
"32213",1032213,171,47,3,221
"32214",1032214,173,81,7,261
"32215",1032215,48,273,5,326
"32216",1032216,92,191,6,289
"32217",1032217,162,20,5,187
"32218",1032218,36,52,2,90
"32219",1032219,131,5,3,139
"32220",1032220,64,167,5,236
"32221",1032221,242,45,10,297
"32222",1032222,43,262,4,309
"32223",1032223,141,54,13,208
"32224",1032224,148,83,6,237
"32225",1032225,142,38,6,186
"32226",1032226,193,39,9,241
"32227",1032227,113,148,19,280
"32228",1032228,111,121,2,234
"32229",1032229,214,44,12,270
"32230",1032230,188,75,17,280
"32231",1032231,55,164,9,228
"32232",1032232,196,28,10,234
"32233",1032233,63,119,10,192
"32234",1032234,184,24,7,215
"32235",1032235,109,168,13,290
"32236",1032236,114,62,15,191
"32237",1032237,112,137,11,260
"32238",1032238,13,9,0,22
"32239",1032239,101,12,1,114
"32240",1032240,86,78,3,167
"32241",1032241,100,147,11,258
"32242",1032242,48,288,13,349
"32243",1032243,110,127,9,246
"32244",1032244,27,155,13,195
"32245",1032245,115,111,7,233
"32246",1032246,34,16,1,51
"32247",1032247,111,77,3,191
"32248",1032248,122,38,7,167
"32249",1032249,34,4,0,38
"32250",1032250,86,73,3,162
"32251",1032251,236,41,10,287
"32252",1032252,71,217,4,292
"32253",1032253,142,7,2,151
"32254",1032254,120,102,10,232
"32255",1032255,32,165,10,207
"32256",1032256,77,221,4,302
"32257",1032257,51,241,11,303
"32258",1032258,166,124,25,315
"32259",1032259,67,109,11,187
"32260",1032260,85,45,11,141
"32261",1032261,50,222,6,278
"32262",1032262,73,172,11,256
"32263",1032263,188,40,11,239
"32264",1032264,24,128,3,155
"32265",1032265,206,103,11,320
"32266",1032266,124,82,9,215
"32267",1032267,31,239,3,273
"32268",1032268,143,133,8,284
"32269",1032269,101,8,2,111
"32270",1032270,237,31,7,275
"32271",1032271,112,206,12,330
"32272",1032272,200,23,1,224
"32273",1032273,144,51,6,201
"32274",1032274,95,158,3,256
"32275",1032275,144,132,17,293
"32276",1032276,92,118,6,216
"32277",1032277,229,44,10,283
"32278",1032278,78,199,17,294
"32279",1032279,140,18,7,165
"32280",1032280,171,108,14,293
"32281",1032281,201,63,22,286
"32282",1032282,28,194,9,231
"32283",1032283,168,24,4,196
"32284",1032284,93,190,19,302
"32285",1032285,92,181,6,279
"32286",1032286,167,29,4,200
"32287",1032287,168,20,8,196
"32288",1032288,129,189,14,332
"32289",1032289,230,29,2,261
"32290",1032290,119,147,9,275
"32291",1032291,141,113,10,264
"32292",1032292,81,185,11,277
"32293",1032293,79,167,11,257
"32294",1032294,62,274,4,340
"32295",1032295,164,94,10,268
"32296",1032296,165,97,18,280
"32297",1032297,4,5,1,10
"32298",1032298,161,42,2,205
"32299",1032299,80,76,21,177
"32300",1032300,78,148,15,241
"32301",1032301,90,67,8,165
"32302",1032302,200,95,11,306
"32303",1032303,45,13,2,60
"32304",1032304,43,212,11,266
"32305",1032305,136,95,9,240
"32306",1032306,36,35,1,72
"32307",1032307,164,46,10,220
"32308",1032308,28,276,11,315
"32309",1032309,46,270,4,320
"32310",1032310,149,96,12,257
"32311",1032311,5,35,2,42
"32312",1032312,32,9,0,41
"32313",1032313,50,79,4,133
"32314",1032314,86,148,15,249
"32315",1032315,151,80,8,239
"32316",1032316,42,233,4,279
"32317",1032317,103,32,2,137
"32318",1032318,81,180,4,265
"32319",1032319,44,0,1,45
"32320",1032320,103,115,13,231
"32321",1032321,129,5,4,138
"32322",1032322,50,105,0,155
"32323",1032323,69,174,14,257
"32324",1032324,96,45,5,146
"32325",1032325,85,61,6,152
"32326",1032326,142,117,22,281
"32327",1032327,239,45,8,292
"32328",1032328,57,83,8,148
"32329",1032329,35,18,1,54
"32330",1032330,144,1,0,145
"32331",1032331,150,55,8,213
"32332",1032332,1,0,1,2
"32333",1032333,328,62,8,398
"32334",1032334,207,10,4,221
"32335",1032335,56,117,9,182
"32336",1032336,78,230,10,318
"32337",1032337,104,153,8,265
"32338",1032338,64,190,3,257
"32339",1032339,39,231,3,273
"32340",1032340,56,152,4,212
"32341",1032341,109,20,0,129
"32342",1032342,177,71,11,259
"32343",1032343,3,26,2,31
"32344",1032344,62,280,9,351
"32345",1032345,179,39,5,223
"32346",1032346,158,42,7,207
"32347",1032347,13,7,2,22
"32348",1032348,171,13,4,188
"32349",1032349,57,187,11,255
"32350",1032350,23,187,3,213
"32351",1032351,66,142,7,215
"32352",1032352,61,185,2,248
"32353",1032353,76,65,9,150
"32354",1032354,120,79,8,207
"32355",1032355,190,44,7,241
"32356",1032356,76,185,10,271
"32357",1032357,231,74,13,318
"32358",1032358,61,166,2,229
"32359",1032359,109,71,6,186
"32360",1032360,42,21,12,75
"32361",1032361,131,138,3,272
"32362",1032362,82,208,13,303
"32363",1032363,118,26,3,147
"32364",1032364,89,79,7,175
"32365",1032365,183,65,5,253
"32366",1032366,160,12,5,177
"32367",1032367,55,50,6,111
"32368",1032368,8,3,1,12
"32369",1032369,110,197,23,330
"32370",1032370,144,113,5,262
"32371",1032371,121,61,7,189
"32372",1032372,127,75,4,206
"32373",1032373,95,107,3,205
"32374",1032374,55,74,8,137
"32375",1032375,22,27,2,51
"32376",1032376,101,73,20,194
"32377",1032377,8,57,0,65
"32378",1032378,62,142,1,205
"32379",1032379,231,157,4,392
"32380",1032380,32,139,3,174
"32381",1032381,0,9,0,9
"32382",1032382,52,248,7,307
"32383",1032383,155,60,16,231
"32384",1032384,95,214,23,332
"32385",1032385,236,6,2,244
"32386",1032386,209,36,9,254
"32387",1032387,40,45,2,87
"32388",1032388,107,259,5,371
"32389",1032389,227,42,4,273
"32390",1032390,70,197,20,287
"32391",1032391,37,24,3,64
"32392",1032392,46,196,8,250
"32393",1032393,46,15,3,64
"32394",1032394,151,30,4,185
"32395",1032395,41,227,5,273
"32396",1032396,206,24,3,233
"32397",1032397,100,13,4,117
"32398",1032398,40,52,8,100
"32399",1032399,89,105,10,204
"32400",1032400,51,36,3,90
"32401",1032401,15,137,6,158
"32402",1032402,176,104,7,287
"32403",1032403,1,29,3,33
"32404",1032404,68,142,4,214
"32405",1032405,163,77,4,244
"32406",1032406,194,35,4,233
"32407",1032407,35,231,5,271
"32408",1032408,49,37,2,88
"32409",1032409,128,138,28,294
"32410",1032410,149,13,5,167
"32411",1032411,76,26,6,108
"32412",1032412,118,113,3,234
"32413",1032413,98,122,15,235
"32414",1032414,117,118,11,246
"32415",1032415,65,31,4,100
"32416",1032416,156,89,3,248
"32417",1032417,219,157,7,383
"32418",1032418,89,174,18,281
"32419",1032419,102,55,7,164
"32420",1032420,126,59,3,188
"32421",1032421,58,177,4,239
"32422",1032422,253,36,8,297
"32423",1032423,171,129,15,315
"32424",1032424,32,142,19,193
"32425",1032425,123,73,7,203
"32426",1032426,147,64,5,216
"32427",1032427,116,100,26,242
"32428",1032428,24,295,2,321
"32429",1032429,71,89,2,162
"32430",1032430,154,56,17,227
"32431",1032431,127,181,9,317
"32432",1032432,8,132,4,144
"32433",1032433,160,130,16,306
"32434",1032434,75,65,7,147
"32435",1032435,94,208,4,306
"32436",1032436,17,4,1,22
"32437",1032437,171,35,4,210
"32438",1032438,97,175,12,284
"32439",1032439,156,63,6,225
"32440",1032440,164,23,8,195
"32441",1032441,28,230,4,262
"32442",1032442,118,136,13,267
"32443",1032443,125,104,4,233
"32444",1032444,95,38,2,135
"32445",1032445,15,39,1,55
"32446",1032446,59,270,13,342
"32447",1032447,7,22,0,29
"32448",1032448,179,20,6,205
"32449",1032449,206,14,10,230
"32450",1032450,149,19,0,168
"32451",1032451,26,74,1,101
"32452",1032452,124,100,9,233
"32453",1032453,155,19,7,181
"32454",1032454,3,62,2,67
"32455",1032455,197,47,5,249
"32456",1032456,96,53,3,152
"32457",1032457,124,98,7,229
"32458",1032458,35,187,11,233
"32459",1032459,142,139,1,282
"32460",1032460,172,51,10,233
"32461",1032461,221,37,12,270
"32462",1032462,77,46,4,127
"32463",1032463,191,88,20,299
"32464",1032464,71,118,8,197
"32465",1032465,120,149,3,272
"32466",1032466,48,177,5,230
"32467",1032467,193,110,11,314
"32468",1032468,29,136,7,172
"32469",1032469,181,47,10,238
"32470",1032470,63,110,7,180
"32471",1032471,131,99,3,233
"32472",1032472,65,118,11,194
"32473",1032473,100,128,9,237
"32474",1032474,176,5,1,182
"32475",1032475,52,77,16,145
"32476",1032476,38,255,3,296
"32477",1032477,45,248,5,298
"32478",1032478,52,54,0,106
"32479",1032479,117,128,9,254
"32480",1032480,99,21,7,127
"32481",1032481,45,137,7,189
"32482",1032482,11,5,0,16
"32483",1032483,66,157,10,233
"32484",1032484,31,171,5,207
"32485",1032485,174,46,6,226
"32486",1032486,61,81,11,153
"32487",1032487,116,66,7,189
"32488",1032488,15,20,1,36
"32489",1032489,183,17,9,209
"32490",1032490,142,77,7,226
"32491",1032491,174,26,2,202
"32492",1032492,160,50,4,214
"32493",1032493,25,95,6,126
"32494",1032494,99,25,1,125
"32495",1032495,146,82,13,241
"32496",1032496,187,102,19,308
"32497",1032497,150,44,15,209
"32498",1032498,60,147,2,209
"32499",1032499,53,132,5,190
"32500",1032500,3,9,1,13
"32501",1032501,45,75,2,122
"32502",1032502,107,145,6,258
"32503",1032503,109,146,13,268
"32504",1032504,23,52,2,77
"32505",1032505,93,108,7,208
"32506",1032506,97,53,10,160
"32507",1032507,63,171,18,252
"32508",1032508,37,135,2,174
"32509",1032509,131,169,7,307
"32510",1032510,28,258,11,297
"32511",1032511,43,41,9,93
"32512",1032512,95,126,9,230
"32513",1032513,121,148,12,281
"32514",1032514,182,94,11,287
"32515",1032515,155,134,27,316
"32516",1032516,102,149,20,271
"32517",1032517,100,181,11,292
"32518",1032518,155,129,16,300
"32519",1032519,111,30,8,149
"32520",1032520,19,214,1,234
"32521",1032521,184,44,10,238
"32522",1032522,49,61,3,113
"32523",1032523,135,98,10,243
"32524",1032524,154,89,18,261
"32525",1032525,76,123,9,208
"32526",1032526,99,87,9,195
"32527",1032527,104,53,8,165
"32528",1032528,106,169,8,283
"32529",1032529,177,7,1,185
"32530",1032530,55,184,8,247
"32531",1032531,51,180,13,244
"32532",1032532,142,97,8,247
"32533",1032533,175,109,15,299
"32534",1032534,74,41,1,116
"32535",1032535,124,103,5,232
"32536",1032536,161,12,5,178
"32537",1032537,147,132,2,281
"32538",1032538,172,105,19,296
"32539",1032539,84,101,20,205
"32540",1032540,31,115,7,153
"32541",1032541,77,237,4,318
"32542",1032542,146,152,9,307
"32543",1032543,15,144,3,162
"32544",1032544,112,46,2,160
"32545",1032545,86,137,13,236
"32546",1032546,29,31,3,63
"32547",1032547,71,31,13,115
"32548",1032548,116,121,20,257
"32549",1032549,139,101,14,254
"32550",1032550,87,175,7,269
"32551",1032551,35,251,14,300
"32552",1032552,58,217,6,281
"32553",1032553,45,138,10,193
"32554",1032554,143,47,4,194
"32555",1032555,25,130,1,156
"32556",1032556,110,79,1,190
"32557",1032557,172,67,4,243
"32558",1032558,109,199,5,313
"32559",1032559,14,110,3,127
"32560",1032560,79,162,7,248
"32561",1032561,167,57,6,230
"32562",1032562,148,69,5,222
"32563",1032563,173,46,6,225
"32564",1032564,135,66,3,204
"32565",1032565,124,42,10,176
"32566",1032566,203,87,10,300
"32567",1032567,47,34,5,86
"32568",1032568,51,211,11,273
"32569",1032569,137,74,7,218
"32570",1032570,62,215,6,283
"32571",1032571,72,110,6,188
"32572",1032572,132,97,10,239
"32573",1032573,122,148,10,280
"32574",1032574,130,22,8,160
"32575",1032575,45,22,4,71
"32576",1032576,58,68,3,129
"32577",1032577,24,3,2,29
"32578",1032578,85,56,6,147
"32579",1032579,63,89,2,154
"32580",1032580,63,114,3,180
"32581",1032581,106,185,10,301
"32582",1032582,90,130,7,227
"32583",1032583,70,84,5,159
"32584",1032584,140,49,18,207
"32585",1032585,39,19,3,61
"32586",1032586,75,183,4,262
"32587",1032587,21,115,4,140
"32588",1032588,225,9,5,239
"32589",1032589,47,103,3,153
"32590",1032590,58,141,11,210
"32591",1032591,133,45,11,189
"32592",1032592,157,66,10,233
"32593",1032593,96,38,4,138
"32594",1032594,169,108,11,288
"32595",1032595,127,105,14,246
"32596",1032596,148,21,7,176
"32597",1032597,77,167,6,250
"32598",1032598,173,63,7,243
"32599",1032599,20,206,1,227
"32600",1032600,96,143,5,244
"32601",1032601,66,196,12,274
"32602",1032602,164,66,6,236
"32603",1032603,145,83,9,237
"32604",1032604,102,65,5,172
"32605",1032605,171,53,16,240
"32606",1032606,116,90,6,212
"32607",1032607,149,76,3,228
"32608",1032608,176,44,17,237
"32609",1032609,40,149,8,197
"32610",1032610,38,191,5,234
"32611",1032611,4,17,1,22
"32612",1032612,62,183,2,247
"32613",1032613,43,264,10,317
"32614",1032614,203,26,6,235
"32615",1032615,96,110,3,209
"32616",1032616,30,210,3,243
"32617",1032617,94,61,7,162
"32618",1032618,117,104,6,227
"32619",1032619,103,189,2,294
"32620",1032620,190,51,9,250
"32621",1032621,40,98,2,140
"32622",1032622,132,133,9,274
"32623",1032623,94,73,9,176
"32624",1032624,109,54,11,174
"32625",1032625,36,40,1,77
"32626",1032626,132,132,8,272
"32627",1032627,29,235,5,269
"32628",1032628,171,80,4,255
"32629",1032629,190,37,10,237
"32630",1032630,50,135,4,189
"32631",1032631,74,128,4,206
"32632",1032632,106,154,6,266
"32633",1032633,72,132,9,213
"32634",1032634,67,188,14,269
"32635",1032635,74,161,4,239
"32636",1032636,161,44,6,211
"32637",1032637,103,54,4,161
"32638",1032638,53,205,6,264
"32639",1032639,114,81,17,212
"32640",1032640,27,169,20,216
"32641",1032641,213,97,15,325
"32642",1032642,12,38,4,54
"32643",1032643,180,90,2,272
"32644",1032644,151,96,15,262
"32645",1032645,53,149,7,209
"32646",1032646,81,190,22,293
"32647",1032647,58,203,0,261
"32648",1032648,17,98,5,120
"32649",1032649,91,130,11,232
"32650",1032650,190,59,19,268
"32651",1032651,48,96,13,157
"32652",1032652,53,158,2,213
"32653",1032653,31,176,7,214
"32654",1032654,71,150,10,231
"32655",1032655,128,39,1,168
"32656",1032656,18,31,1,50
"32657",1032657,6,1,1,8
"32658",1032658,165,80,16,261
"32659",1032659,24,148,4,176
"32660",1032660,63,25,3,91
"32661",1032661,138,25,4,167
"32662",1032662,8,9,1,18
"32663",1032663,162,52,16,230
"32664",1032664,104,209,11,324
"32665",1032665,75,271,0,346
"32666",1032666,73,152,10,235
"32667",1032667,87,15,4,106
"32668",1032668,154,75,6,235
"32669",1032669,33,27,7,67
"32670",1032670,196,33,6,235
"32671",1032671,219,49,6,274
"32672",1032672,36,150,3,189
"32673",1032673,77,74,2,153
"32674",1032674,87,243,0,330
"32675",1032675,95,25,6,126
"32676",1032676,128,102,18,248
"32677",1032677,223,39,8,270
"32678",1032678,139,35,6,180
"32679",1032679,139,22,7,168
"32680",1032680,129,140,11,280
"32681",1032681,167,152,32,351
"32682",1032682,88,182,16,286
"32683",1032683,235,34,10,279
"32684",1032684,18,172,5,195
"32685",1032685,113,31,9,153
"32686",1032686,86,89,6,181
"32687",1032687,47,182,6,235
"32688",1032688,43,69,6,118
"32689",1032689,12,5,1,18
"32690",1032690,59,217,11,287
"32691",1032691,49,31,2,82
"32692",1032692,14,47,4,65
"32693",1032693,173,102,5,280
"32694",1032694,125,148,3,276
"32695",1032695,53,2,2,57
"32696",1032696,172,38,7,217
"32697",1032697,198,62,12,272
"32698",1032698,44,237,9,290
"32699",1032699,77,160,6,243
"32700",1032700,211,56,8,275
"32701",1032701,185,52,7,244
"32702",1032702,273,0,6,279
"32703",1032703,152,102,15,269
"32704",1032704,80,154,10,244
"32705",1032705,100,165,6,271
"32706",1032706,43,26,1,70
"32707",1032707,5,144,2,151
"32708",1032708,197,53,6,256
"32709",1032709,193,51,2,246
"32710",1032710,59,167,10,236
"32711",1032711,162,35,5,202
"32712",1032712,148,43,8,199
"32713",1032713,82,67,8,157
"32714",1032714,92,192,7,291
"32715",1032715,137,71,2,210
"32716",1032716,112,110,7,229
"32717",1032717,73,178,3,254
"32718",1032718,107,96,14,217
"32719",1032719,88,83,8,179
"32720",1032720,176,95,13,284
"32721",1032721,218,14,6,238
"32722",1032722,199,51,11,261
"32723",1032723,227,51,11,289
"32724",1032724,133,27,5,165
"32725",1032725,178,63,13,254
"32726",1032726,55,210,7,272
"32727",1032727,84,131,9,224
"32728",1032728,213,63,2,278
"32729",1032729,90,82,6,178
"32730",1032730,37,183,6,226
"32731",1032731,40,174,8,222
"32732",1032732,98,183,12,293
"32733",1032733,74,159,1,234
"32734",1032734,39,169,14,222
"32735",1032735,102,223,19,344
"32736",1032736,20,24,1,45
"32737",1032737,231,28,11,270
"32738",1032738,114,130,6,250
"32739",1032739,159,40,14,213
"32740",1032740,56,241,9,306
"32741",1032741,152,130,18,300
"32742",1032742,195,66,7,268
"32743",1032743,100,264,9,373
"32744",1032744,56,53,4,113
"32745",1032745,41,231,7,279
"32746",1032746,136,82,6,224
"32747",1032747,61,84,5,150
"32748",1032748,22,152,13,187
"32749",1032749,134,104,11,249
"32750",1032750,68,188,8,264
"32751",1032751,191,25,5,221
"32752",1032752,148,51,13,212
"32753",1032753,17,13,0,30
"32754",1032754,107,100,1,208
"32755",1032755,137,115,2,254
"32756",1032756,101,183,14,298
"32757",1032757,80,173,7,260
"32758",1032758,92,126,12,230
"32759",1032759,79,155,11,245
"32760",1032760,159,92,5,256
"32761",1032761,84,111,2,197
"32762",1032762,167,110,18,295
"32763",1032763,40,21,4,65
"32764",1032764,162,28,8,198
"32765",1032765,203,62,4,269
"32766",1032766,176,79,5,260
"32767",1032767,182,62,9,253
"32768",1032768,199,36,8,243
"32769",1032769,296,21,23,340
"32770",1032770,68,151,5,224
"32771",1032771,153,43,5,201
"32772",1032772,100,177,4,281
"32773",1032773,132,117,10,259
"32774",1032774,15,250,8,273
"32775",1032775,169,25,12,206
"32776",1032776,60,215,13,288
"32777",1032777,67,258,8,333
"32778",1032778,125,132,6,263
"32779",1032779,48,176,3,227
"32780",1032780,120,66,9,195
"32781",1032781,145,10,5,160
"32782",1032782,75,35,1,111
"32783",1032783,95,103,5,203
"32784",1032784,195,16,5,216
"32785",1032785,135,93,17,245
"32786",1032786,133,173,8,314
"32787",1032787,334,7,4,345
"32788",1032788,95,204,21,320
"32789",1032789,44,192,3,239
"32790",1032790,108,189,20,317
"32791",1032791,2,4,1,7
"32792",1032792,59,201,10,270
"32793",1032793,67,35,3,105
"32794",1032794,67,221,5,293
"32795",1032795,103,144,7,254
"32796",1032796,158,104,7,269
"32797",1032797,164,109,5,278
"32798",1032798,205,63,5,273
"32799",1032799,241,14,5,260
"32800",1032800,220,50,12,282
"32801",1032801,140,87,5,232
"32802",1032802,95,37,4,136
"32803",1032803,74,103,10,187
"32804",1032804,179,131,14,324
"32805",1032805,59,136,9,204
"32806",1032806,188,60,9,257
"32807",1032807,31,157,12,200
"32808",1032808,52,192,5,249
"32809",1032809,185,38,7,230
"32810",1032810,19,255,3,277
"32811",1032811,47,229,13,289
"32812",1032812,203,71,7,281
"32813",1032813,51,214,9,274
"32814",1032814,180,13,8,201
"32815",1032815,30,188,3,221
"32816",1032816,128,143,7,278
"32817",1032817,167,43,7,217
"32818",1032818,3,9,1,13
"32819",1032819,37,29,1,67
"32820",1032820,111,150,17,278
"32821",1032821,47,74,1,122
"32822",1032822,198,95,7,300
"32823",1032823,164,68,6,238
"32824",1032824,63,48,0,111
"32825",1032825,178,57,12,247
"32826",1032826,115,148,9,272
"32827",1032827,100,153,7,260
"32828",1032828,138,63,18,219
"32829",1032829,57,259,4,320
"32830",1032830,121,162,9,292
"32831",1032831,86,21,0,107
"32832",1032832,126,94,15,235
"32833",1032833,110,184,7,301
"32834",1032834,195,77,15,287
"32835",1032835,130,80,7,217
"32836",1032836,29,274,13,316
"32837",1032837,71,225,9,305
"32838",1032838,41,185,2,228
"32839",1032839,16,20,1,37
"32840",1032840,42,128,12,182
"32841",1032841,223,32,11,266
"32842",1032842,208,21,5,234
"32843",1032843,36,168,7,211
"32844",1032844,111,137,2,250
"32845",1032845,168,102,5,275
"32846",1032846,72,203,13,288
"32847",1032847,104,84,11,199
"32848",1032848,103,130,21,254
"32849",1032849,127,100,17,244
"32850",1032850,105,90,18,213
"32851",1032851,74,180,13,267
"32852",1032852,167,101,10,278
"32853",1032853,111,150,9,270
"32854",1032854,54,114,4,172
"32855",1032855,112,145,10,267
"32856",1032856,215,51,9,275
"32857",1032857,221,27,4,252
"32858",1032858,71,86,7,164
"32859",1032859,43,256,5,304
"32860",1032860,114,148,10,272
"32861",1032861,184,38,9,231
"32862",1032862,29,36,4,69
"32863",1032863,89,136,8,233
"32864",1032864,84,156,11,251
"32865",1032865,115,104,12,231
"32866",1032866,65,229,2,296
"32867",1032867,162,123,20,305
"32868",1032868,100,79,12,191
"32869",1032869,170,69,17,256
"32870",1032870,146,81,5,232
"32871",1032871,201,77,16,294
"32872",1032872,55,230,6,291
"32873",1032873,34,76,6,116
"32874",1032874,195,96,11,302
"32875",1032875,148,56,15,219
"32876",1032876,85,46,11,142
"32877",1032877,223,33,9,265
"32878",1032878,57,79,2,138
"32879",1032879,127,156,7,290
"32880",1032880,55,69,7,131
"32881",1032881,53,101,6,160
"32882",1032882,195,60,5,260
"32883",1032883,191,95,10,296
"32884",1032884,191,33,6,230
"32885",1032885,34,234,7,275
"32886",1032886,129,64,12,205
"32887",1032887,5,13,0,18
"32888",1032888,234,26,2,262
"32889",1032889,154,40,14,208
"32890",1032890,163,104,16,283
"32891",1032891,160,59,4,223
"32892",1032892,132,58,18,208
"32893",1032893,82,138,3,223
"32894",1032894,177,33,16,226
"32895",1032895,32,93,3,128
"32896",1032896,124,164,10,298
"32897",1032897,112,125,6,243
"32898",1032898,196,59,6,261
"32899",1032899,142,94,8,244
"32900",1032900,64,123,0,187
"32901",1032901,60,7,1,68
"32902",1032902,191,86,6,283
"32903",1032903,136,55,8,199
"32904",1032904,74,152,5,231
"32905",1032905,141,60,8,209
"32906",1032906,107,109,4,220
"32907",1032907,71,97,6,174
"32908",1032908,94,134,6,234
"32909",1032909,40,153,1,194
"32910",1032910,143,21,4,168
"32911",1032911,107,62,14,183
"32912",1032912,129,78,2,209
"32913",1032913,192,88,13,293
"32914",1032914,68,153,3,224
"32915",1032915,56,41,6,103
"32916",1032916,101,101,12,214
"32917",1032917,86,23,1,110
"32918",1032918,142,116,4,262
"32919",1032919,152,15,4,171
"32920",1032920,44,222,4,270
"32921",1032921,68,161,7,236
"32922",1032922,86,109,5,200
"32923",1032923,104,67,2,173
"32924",1032924,151,113,3,267
"32925",1032925,40,65,5,110
"32926",1032926,112,125,7,244
"32927",1032927,203,6,1,210
"32928",1032928,12,4,1,17
"32929",1032929,143,48,2,193
"32930",1032930,246,5,8,259
"32931",1032931,123,86,11,220
"32932",1032932,158,86,7,251
"32933",1032933,167,56,3,226
"32934",1032934,206,56,9,271
"32935",1032935,174,100,2,276
"32936",1032936,53,257,15,325
"32937",1032937,283,87,9,379
"32938",1032938,33,244,5,282
"32939",1032939,119,155,12,286
"32940",1032940,174,61,2,237
"32941",1032941,122,59,8,189
"32942",1032942,177,42,8,227
"32943",1032943,163,121,8,292
"32944",1032944,89,100,10,199
"32945",1032945,219,58,22,299
"32946",1032946,126,137,31,294
"32947",1032947,193,43,16,252
"32948",1032948,129,86,6,221
"32949",1032949,121,15,9,145
"32950",1032950,69,117,12,198
"32951",1032951,42,274,5,321
"32952",1032952,14,45,2,61
"32953",1032953,71,116,4,191
"32954",1032954,136,149,17,302
"32955",1032955,145,92,2,239
"32956",1032956,60,281,7,348
"32957",1032957,224,23,4,251
"32958",1032958,41,223,20,284
"32959",1032959,128,81,5,214
"32960",1032960,123,115,4,242
"32961",1032961,50,270,13,333
"32962",1032962,79,157,20,256
"32963",1032963,56,139,1,196
"32964",1032964,73,60,5,138
"32965",1032965,210,49,1,260
"32966",1032966,81,2,2,85
"32967",1032967,190,241,11,442
"32968",1032968,70,149,9,228
"32969",1032969,85,107,13,205
"32970",1032970,44,167,1,212
"32971",1032971,36,10,1,47
"32972",1032972,73,89,6,168
"32973",1032973,198,83,11,292
"32974",1032974,80,97,12,189
"32975",1032975,136,157,2,295
"32976",1032976,47,227,3,277
"32977",1032977,4,11,0,15
"32978",1032978,78,141,18,237
"32979",1032979,158,66,10,234
"32980",1032980,157,48,4,209
"32981",1032981,56,235,2,293
"32982",1032982,104,126,7,237
"32983",1032983,171,121,6,298
"32984",1032984,55,211,12,278
"32985",1032985,39,101,16,156
"32986",1032986,133,109,14,256
"32987",1032987,151,25,3,179
"32988",1032988,66,29,1,96
"32989",1032989,114,169,12,295
"32990",1032990,109,54,8,171
"32991",1032991,66,164,5,235
"32992",1032992,102,160,13,275
"32993",1032993,75,217,12,304
"32994",1032994,46,219,10,275
"32995",1032995,116,15,3,134
"32996",1032996,69,19,1,89
"32997",1032997,216,23,3,242
"32998",1032998,21,262,2,285
"32999",1032999,122,191,12,325
"33000",1033000,74,203,8,285
"33001",1033001,15,3,1,19
"33002",1033002,203,65,6,274
"33003",1033003,345,102,33,480
"33004",1033004,59,226,8,293
"33005",1033005,40,152,2,194
"33006",1033006,142,93,12,247
"33007",1033007,125,54,6,185
"33008",1033008,57,30,1,88
"33009",1033009,139,118,10,267
"33010",1033010,93,92,8,193
"33011",1033011,192,48,10,250
"33012",1033012,3,39,1,43
"33013",1033013,58,234,13,305
"33014",1033014,33,252,8,293
"33015",1033015,194,25,1,220
"33016",1033016,167,32,8,207
"33017",1033017,231,70,15,316
"33018",1033018,66,239,7,312
"33019",1033019,104,8,1,113
"33020",1033020,89,100,8,197
"33021",1033021,180,70,3,253
"33022",1033022,120,31,2,153
"33023",1033023,124,108,11,243
"33024",1033024,21,188,10,219
"33025",1033025,68,199,8,275
"33026",1033026,100,137,18,255
"33027",1033027,212,24,10,246
"33028",1033028,184,47,12,243
"33029",1033029,54,155,4,213
"33030",1033030,121,48,10,179
"33031",1033031,17,264,5,286
"33032",1033032,77,127,9,213
"33033",1033033,80,177,13,270
"33034",1033034,127,118,15,260
"33035",1033035,13,152,2,167
"33036",1033036,61,76,2,139
"33037",1033037,125,100,17,242
"33038",1033038,137,56,5,198
"33039",1033039,154,105,3,262
"33040",1033040,207,19,14,240
"33041",1033041,84,102,3,189
"33042",1033042,122,109,6,237
"33043",1033043,43,25,1,69
"33044",1033044,25,97,3,125
"33045",1033045,87,237,11,335
"33046",1033046,72,130,8,210
"33047",1033047,84,98,5,187
"33048",1033048,74,139,6,219
"33049",1033049,81,123,8,212
"33050",1033050,197,78,12,287
"33051",1033051,83,32,4,119
"33052",1033052,26,225,1,252
"33053",1033053,97,57,9,163
"33054",1033054,146,99,18,263
"33055",1033055,114,179,5,298
"33056",1033056,31,252,5,288
"33057",1033057,32,268,6,306
"33058",1033058,29,130,3,162
"33059",1033059,8,5,3,16
"33060",1033060,132,173,14,319
"33061",1033061,56,126,5,187
"33062",1033062,47,102,4,153
"33063",1033063,13,326,10,349
"33064",1033064,67,121,4,192
"33065",1033065,42,117,14,173
"33066",1033066,170,104,25,299
"33067",1033067,104,145,7,256
"33068",1033068,82,65,1,148
"33069",1033069,123,61,2,186
"33070",1033070,113,105,8,226
"33071",1033071,75,16,6,97
"33072",1033072,98,126,21,245
"33073",1033073,49,119,8,176
"33074",1033074,161,61,15,237
"33075",1033075,197,61,10,268
"33076",1033076,250,15,5,270
"33077",1033077,133,66,5,204
"33078",1033078,165,46,12,223
"33079",1033079,11,13,3,27
"33080",1033080,155,118,12,285
"33081",1033081,31,281,1,313
"33082",1033082,60,177,8,245
"33083",1033083,197,292,13,502
"33084",1033084,195,76,15,286
"33085",1033085,143,53,2,198
"33086",1033086,48,206,1,255
"33087",1033087,102,17,4,123
"33088",1033088,91,132,7,230
"33089",1033089,59,18,2,79
"33090",1033090,124,166,12,302
"33091",1033091,210,45,12,267
"33092",1033092,200,49,11,260
"33093",1033093,146,116,7,269
"33094",1033094,46,60,6,112
"33095",1033095,159,42,24,225
"33096",1033096,52,162,1,215
"33097",1033097,59,112,10,181
"33098",1033098,17,96,8,121
"33099",1033099,225,44,14,283
"33100",1033100,54,74,0,128
"33101",1033101,143,56,10,209
"33102",1033102,13,185,2,200
"33103",1033103,117,93,10,220
"33104",1033104,122,26,6,154
"33105",1033105,149,45,7,201
"33106",1033106,106,35,2,143
"33107",1033107,30,12,5,47
"33108",1033108,94,5,1,100
"33109",1033109,120,103,15,238
"33110",1033110,185,66,7,258
"33111",1033111,160,34,9,203
"33112",1033112,57,143,10,210
"33113",1033113,185,22,7,214
"33114",1033114,155,90,5,250
"33115",1033115,39,103,1,143
"33116",1033116,82,70,5,157
"33117",1033117,161,19,7,187
"33118",1033118,161,25,1,187
"33119",1033119,211,136,11,358
"33120",1033120,180,26,2,208
"33121",1033121,135,14,3,152
"33122",1033122,184,17,4,205
"33123",1033123,286,16,5,307
"33124",1033124,16,199,5,220
"33125",1033125,30,148,3,181
"33126",1033126,103,134,5,242
"33127",1033127,138,53,5,196
"33128",1033128,297,4,10,311
"33129",1033129,55,129,10,194
"33130",1033130,151,15,1,167
"33131",1033131,172,21,4,197
"33132",1033132,60,145,7,212
"33133",1033133,262,16,9,287
"33134",1033134,164,68,5,237
"33135",1033135,103,128,3,234
"33136",1033136,99,58,2,159
"33137",1033137,71,181,6,258
"33138",1033138,155,78,14,247
"33139",1033139,184,31,6,221
"33140",1033140,227,36,4,267
"33141",1033141,132,67,11,210
"33142",1033142,117,166,8,291
"33143",1033143,113,135,6,254
"33144",1033144,89,147,16,252
"33145",1033145,63,195,4,262
"33146",1033146,222,21,5,248
"33147",1033147,196,3,14,213
"33148",1033148,208,20,7,235
"33149",1033149,21,36,4,61
"33150",1033150,161,14,2,177
"33151",1033151,196,59,13,268
"33152",1033152,147,104,4,255
"33153",1033153,106,11,3,120
"33154",1033154,49,101,6,156
"33155",1033155,99,64,3,166
"33156",1033156,156,31,12,199
"33157",1033157,161,126,13,300
"33158",1033158,188,64,7,259
"33159",1033159,95,179,9,283
"33160",1033160,37,2,1,40
"33161",1033161,105,0,0,105
"33162",1033162,197,98,3,298
"33163",1033163,131,67,13,211
"33164",1033164,202,113,9,324
"33165",1033165,138,102,10,250
"33166",1033166,183,85,15,283
"33167",1033167,201,34,14,249
"33168",1033168,175,116,8,299
"33169",1033169,142,69,12,223
"33170",1033170,139,70,6,215
"33171",1033171,100,84,2,186
"33172",1033172,11,12,2,25
"33173",1033173,183,42,5,230
"33174",1033174,76,206,6,288
"33175",1033175,45,146,4,195
"33176",1033176,89,106,3,198
"33177",1033177,188,27,11,226
"33178",1033178,32,65,2,99
"33179",1033179,132,63,6,201
"33180",1033180,193,76,9,278
"33181",1033181,254,22,5,281
"33182",1033182,141,148,14,303
"33183",1033183,111,62,8,181
"33184",1033184,75,173,8,256
"33185",1033185,53,184,12,249
"33186",1033186,16,117,1,134
"33187",1033187,68,229,2,299
"33188",1033188,109,44,11,164
"33189",1033189,158,144,14,316
"33190",1033190,150,98,3,251
"33191",1033191,107,17,1,125
"33192",1033192,129,68,12,209
"33193",1033193,158,67,17,242
"33194",1033194,158,70,6,234
"33195",1033195,62,64,7,133
"33196",1033196,75,146,3,224
"33197",1033197,137,63,13,213
"33198",1033198,226,78,9,313
"33199",1033199,81,127,4,212
"33200",1033200,129,88,4,221
"33201",1033201,125,151,12,288
"33202",1033202,183,123,7,313
"33203",1033203,161,120,16,297
"33204",1033204,123,82,16,221
"33205",1033205,169,32,4,205
"33206",1033206,147,82,7,236
"33207",1033207,238,30,6,274
"33208",1033208,189,92,3,284
"33209",1033209,53,73,11,137
"33210",1033210,162,105,8,275
"33211",1033211,199,68,18,285
"33212",1033212,78,174,3,255
"33213",1033213,41,39,3,83
"33214",1033214,34,161,3,198
"33215",1033215,122,79,6,207
"33216",1033216,34,81,1,116
"33217",1033217,129,82,12,223
"33218",1033218,107,104,21,232
"33219",1033219,98,124,6,228
"33220",1033220,28,240,8,276
"33221",1033221,50,123,1,174
"33222",1033222,54,58,2,114
"33223",1033223,172,49,7,228
"33224",1033224,17,12,1,30
"33225",1033225,38,220,4,262
"33226",1033226,154,31,7,192
"33227",1033227,185,89,9,283
"33228",1033228,103,58,3,164
"33229",1033229,125,61,3,189
"33230",1033230,166,30,13,209
"33231",1033231,209,71,12,292
"33232",1033232,58,201,10,269
"33233",1033233,63,212,19,294
"33234",1033234,144,42,4,190
"33235",1033235,198,42,5,245
"33236",1033236,170,17,9,196
"33237",1033237,104,191,6,301
"33238",1033238,71,164,17,252
"33239",1033239,68,180,6,254
"33240",1033240,8,38,4,50
"33241",1033241,38,270,15,323
"33242",1033242,158,108,22,288
"33243",1033243,11,31,2,44
"33244",1033244,58,205,13,276
"33245",1033245,176,66,14,256
"33246",1033246,77,147,10,234
"33247",1033247,125,144,13,282
"33248",1033248,161,81,11,253
"33249",1033249,229,104,19,352
"33250",1033250,116,64,8,188
"33251",1033251,85,205,10,300
"33252",1033252,70,238,4,312
"33253",1033253,74,91,11,176
"33254",1033254,109,141,12,262
"33255",1033255,118,0,1,119
"33256",1033256,92,130,10,232
"33257",1033257,123,98,13,234
"33258",1033258,186,61,5,252
"33259",1033259,118,40,10,168
"33260",1033260,47,62,4,113
"33261",1033261,112,135,14,261
"33262",1033262,124,164,5,293
"33263",1033263,78,205,12,295
"33264",1033264,7,36,0,43
"33265",1033265,150,33,4,187
"33266",1033266,84,42,4,130
"33267",1033267,37,125,8,170
"33268",1033268,43,148,0,191
"33269",1033269,32,30,2,64
"33270",1033270,80,194,4,278
"33271",1033271,84,192,7,283
"33272",1033272,127,50,4,181
"33273",1033273,195,58,7,260
"33274",1033274,136,90,9,235
"33275",1033275,118,146,6,270
"33276",1033276,46,19,4,69
"33277",1033277,167,53,4,224
"33278",1033278,167,50,6,223
"33279",1033279,205,89,15,309
"33280",1033280,55,148,3,206
"33281",1033281,120,47,2,169
"33282",1033282,126,45,1,172
"33283",1033283,155,134,13,302
"33284",1033284,64,213,6,283
"33285",1033285,183,72,10,265
"33286",1033286,200,38,8,246
"33287",1033287,160,135,19,314
"33288",1033288,53,225,4,282
"33289",1033289,91,30,5,126
"33290",1033290,109,107,10,226
"33291",1033291,9,5,0,14
"33292",1033292,89,77,5,171
"33293",1033293,94,127,16,237
"33294",1033294,106,102,7,215
"33295",1033295,73,163,2,238
"33296",1033296,14,117,4,135
"33297",1033297,176,26,5,207
"33298",1033298,120,151,15,286
"33299",1033299,51,254,8,313
"33300",1033300,76,52,2,130
"33301",1033301,108,140,6,254
"33302",1033302,121,41,4,166
"33303",1033303,52,83,5,140
"33304",1033304,128,86,1,215
"33305",1033305,220,17,7,244
"33306",1033306,75,230,4,309
"33307",1033307,60,198,10,268
"33308",1033308,99,107,3,209
"33309",1033309,116,62,16,194
"33310",1033310,162,28,7,197
"33311",1033311,149,110,12,271
"33312",1033312,184,105,12,301
"33313",1033313,157,52,7,216
"33314",1033314,175,31,11,217
"33315",1033315,188,80,26,294
"33316",1033316,72,113,14,199
"33317",1033317,202,52,10,264
"33318",1033318,68,130,2,200
"33319",1033319,12,21,1,34
"33320",1033320,170,38,12,220
"33321",1033321,183,12,3,198
"33322",1033322,188,56,8,252
"33323",1033323,88,179,6,273
"33324",1033324,33,227,6,266
"33325",1033325,150,30,16,196
"33326",1033326,13,24,0,37
"33327",1033327,181,119,8,308
"33328",1033328,42,9,1,52
"33329",1033329,127,58,1,186
"33330",1033330,128,12,0,140
"33331",1033331,37,136,6,179
"33332",1033332,20,16,1,37
"33333",1033333,101,78,7,186
"33334",1033334,12,43,2,57
"33335",1033335,177,89,17,283
"33336",1033336,22,215,5,242
"33337",1033337,127,110,24,261
"33338",1033338,163,95,7,265
"33339",1033339,89,8,4,101
"33340",1033340,98,170,2,270
"33341",1033341,98,84,5,187
"33342",1033342,147,86,9,242
"33343",1033343,0,6,0,6
"33344",1033344,56,21,8,85
"33345",1033345,171,79,9,259
"33346",1033346,216,46,7,269
"33347",1033347,93,30,7,130
"33348",1033348,147,107,7,261
"33349",1033349,142,43,6,191
"33350",1033350,177,106,12,295
"33351",1033351,72,146,5,223
"33352",1033352,115,90,0,205
"33353",1033353,139,83,8,230
"33354",1033354,63,186,3,252
"33355",1033355,227,73,11,311
"33356",1033356,141,29,5,175
"33357",1033357,168,23,7,198
"33358",1033358,136,101,20,257
"33359",1033359,128,132,5,265
"33360",1033360,20,83,1,104
"33361",1033361,82,188,13,283
"33362",1033362,133,44,6,183
"33363",1033363,24,74,2,100
"33364",1033364,78,14,3,95
"33365",1033365,107,33,8,148
"33366",1033366,16,335,3,354
"33367",1033367,23,41,1,65
"33368",1033368,49,135,16,200
"33369",1033369,222,19,17,258
"33370",1033370,91,103,5,199
"33371",1033371,108,188,5,301
"33372",1033372,90,186,3,279
"33373",1033373,224,91,8,323
"33374",1033374,43,208,0,251
"33375",1033375,38,130,4,172
"33376",1033376,84,160,13,257
"33377",1033377,40,43,2,85
"33378",1033378,77,190,6,273
"33379",1033379,96,71,3,170
"33380",1033380,71,171,17,259
"33381",1033381,15,114,1,130
"33382",1033382,219,32,2,253
"33383",1033383,111,28,4,143
"33384",1033384,191,145,11,347
"33385",1033385,46,163,4,213
"33386",1033386,157,75,5,237
"33387",1033387,77,77,1,155
"33388",1033388,142,90,12,244
"33389",1033389,109,82,3,194
"33390",1033390,119,45,13,177
"33391",1033391,134,75,5,214
"33392",1033392,172,51,9,232
"33393",1033393,61,204,17,282
"33394",1033394,155,100,6,261
"33395",1033395,197,91,21,309
"33396",1033396,137,177,15,329
"33397",1033397,43,2,2,47
"33398",1033398,47,208,5,260
"33399",1033399,162,112,12,286
"33400",1033400,168,40,3,211
"33401",1033401,85,203,14,302
"33402",1033402,172,63,4,239
"33403",1033403,79,176,1,256
"33404",1033404,123,167,18,308
"33405",1033405,44,146,9,199
"33406",1033406,54,26,8,88
"33407",1033407,148,182,3,333
"33408",1033408,147,83,4,234
"33409",1033409,37,233,6,276
"33410",1033410,172,38,9,219
"33411",1033411,21,10,1,32
"33412",1033412,72,191,5,268
"33413",1033413,157,167,7,331
"33414",1033414,74,106,6,186
"33415",1033415,121,104,14,239
"33416",1033416,105,175,9,289
"33417",1033417,168,83,8,259
"33418",1033418,151,32,8,191
"33419",1033419,131,69,5,205
"33420",1033420,168,48,10,226
"33421",1033421,153,119,15,287
"33422",1033422,118,63,9,190
"33423",1033423,18,294,2,314
"33424",1033424,22,243,3,268
"33425",1033425,83,1,0,84
"33426",1033426,117,144,11,272
"33427",1033427,104,164,3,271
"33428",1033428,79,90,3,172
"33429",1033429,51,177,13,241
"33430",1033430,253,21,13,287
"33431",1033431,87,42,6,135
"33432",1033432,144,34,5,183
"33433",1033433,149,21,5,175
"33434",1033434,188,91,8,287
"33435",1033435,39,33,6,78
"33436",1033436,72,219,5,296
"33437",1033437,186,22,7,215
"33438",1033438,112,144,3,259
"33439",1033439,155,76,5,236
"33440",1033440,108,16,3,127
"33441",1033441,96,131,9,236
"33442",1033442,95,119,3,217
"33443",1033443,87,23,6,116
"33444",1033444,176,86,12,274
"33445",1033445,50,186,19,255
"33446",1033446,219,53,6,278
"33447",1033447,128,131,24,283
"33448",1033448,68,21,4,93
"33449",1033449,46,74,3,123
"33450",1033450,207,34,9,250
"33451",1033451,84,208,13,305
"33452",1033452,150,7,4,161
"33453",1033453,137,48,4,189
"33454",1033454,169,73,13,255
"33455",1033455,139,57,6,202
"33456",1033456,176,15,7,198
"33457",1033457,179,23,2,204
"33458",1033458,81,160,13,254
"33459",1033459,49,272,9,330
"33460",1033460,182,63,10,255
"33461",1033461,141,59,7,207
"33462",1033462,209,69,6,284
"33463",1033463,98,75,1,174
"33464",1033464,245,50,11,306
"33465",1033465,144,25,5,174
"33466",1033466,67,210,7,284
"33467",1033467,20,3,2,25
"33468",1033468,163,115,12,290
"33469",1033469,151,123,8,282
"33470",1033470,18,17,3,38
"33471",1033471,38,24,1,63
"33472",1033472,93,140,10,243
"33473",1033473,71,35,3,109
"33474",1033474,180,72,10,262
"33475",1033475,158,87,8,253
"33476",1033476,72,15,3,90
"33477",1033477,203,92,11,306
"33478",1033478,38,164,8,210
"33479",1033479,96,145,15,256
"33480",1033480,68,258,6,332
"33481",1033481,112,46,8,166
"33482",1033482,203,35,7,245
"33483",1033483,51,31,4,86
"33484",1033484,99,60,3,162
"33485",1033485,110,136,15,261
"33486",1033486,180,36,6,222
"33487",1033487,79,167,5,251
"33488",1033488,125,85,13,223
"33489",1033489,13,11,1,25
"33490",1033490,176,45,7,228
"33491",1033491,24,280,7,311
"33492",1033492,156,121,8,285
"33493",1033493,46,30,4,80
"33494",1033494,154,72,6,232
"33495",1033495,249,85,13,347
"33496",1033496,97,76,8,181
"33497",1033497,59,73,7,139
"33498",1033498,11,15,0,26
"33499",1033499,23,24,1,48
"33500",1033500,101,48,2,151
"33501",1033501,215,29,8,252
"33502",1033502,65,45,11,121
"33503",1033503,116,157,8,281
"33504",1033504,134,63,12,209
"33505",1033505,113,125,6,244
"33506",1033506,19,259,8,286
"33507",1033507,91,46,7,144
"33508",1033508,115,121,11,247
"33509",1033509,82,185,10,277
"33510",1033510,178,62,10,250
"33511",1033511,153,10,3,166
"33512",1033512,89,83,11,183
"33513",1033513,36,50,6,92
"33514",1033514,52,76,5,133
"33515",1033515,69,142,3,214
"33516",1033516,183,90,3,276
"33517",1033517,87,157,3,247
"33518",1033518,118,109,8,235
"33519",1033519,127,94,6,227
"33520",1033520,95,61,1,157
"33521",1033521,133,48,4,185
"33522",1033522,151,35,4,190
"33523",1033523,52,189,5,246
"33524",1033524,153,43,2,198
"33525",1033525,129,111,13,253
"33526",1033526,76,161,15,252
"33527",1033527,100,129,20,249
"33528",1033528,149,172,9,330
"33529",1033529,133,124,5,262
"33530",1033530,30,255,7,292
"33531",1033531,153,45,11,209
"33532",1033532,138,43,3,184
"33533",1033533,190,56,12,258
"33534",1033534,8,61,2,71
"33535",1033535,34,110,10,154
"33536",1033536,120,165,14,299
"33537",1033537,130,24,1,155
"33538",1033538,46,115,11,172
"33539",1033539,111,214,14,339
"33540",1033540,100,153,11,264
"33541",1033541,46,226,3,275
"33542",1033542,170,30,6,206
"33543",1033543,144,96,3,243
"33544",1033544,163,75,10,248
"33545",1033545,162,26,3,191
"33546",1033546,122,232,11,365
"33547",1033547,143,58,11,212
"33548",1033548,149,21,0,170
"33549",1033549,52,220,9,281
"33550",1033550,94,110,7,211
"33551",1033551,146,137,12,295
"33552",1033552,158,103,9,270
"33553",1033553,118,148,19,285
"33554",1033554,4,17,2,23
"33555",1033555,22,155,2,179
"33556",1033556,113,161,6,280
"33557",1033557,90,62,8,160
"33558",1033558,107,104,11,222
"33559",1033559,184,40,6,230
"33560",1033560,211,94,17,322
"33561",1033561,136,53,4,193
"33562",1033562,68,283,6,357
"33563",1033563,123,134,3,260
"33564",1033564,82,136,5,223
"33565",1033565,140,133,12,285
"33566",1033566,79,212,2,293
"33567",1033567,68,202,7,277
"33568",1033568,126,173,6,305
"33569",1033569,24,18,1,43
"33570",1033570,44,236,6,286
"33571",1033571,75,182,13,270
"33572",1033572,32,168,10,210
"33573",1033573,59,249,5,313
"33574",1033574,63,142,9,214
"33575",1033575,104,164,4,272
"33576",1033576,26,65,5,96
"33577",1033577,18,150,3,171
"33578",1033578,236,41,6,283
"33579",1033579,47,250,3,300
"33580",1033580,194,63,10,267
"33581",1033581,99,114,7,220
"33582",1033582,210,52,4,266
"33583",1033583,2,18,0,20
"33584",1033584,292,10,12,314
"33585",1033585,48,25,8,81
"33586",1033586,238,119,14,371
"33587",1033587,161,128,10,299
"33588",1033588,155,72,8,235
"33589",1033589,80,124,11,215
"33590",1033590,94,108,14,216
"33591",1033591,130,76,5,211
"33592",1033592,11,1,0,12
"33593",1033593,170,82,11,263
"33594",1033594,256,71,5,332
"33595",1033595,146,124,7,277
"33596",1033596,56,242,1,299
"33597",1033597,49,200,5,254
"33598",1033598,195,64,4,263
"33599",1033599,232,81,8,321
"33600",1033600,64,88,5,157
"33601",1033601,78,99,0,177
"33602",1033602,120,122,10,252
"33603",1033603,245,24,2,271
"33604",1033604,110,83,10,203
"33605",1033605,72,87,9,168
"33606",1033606,153,119,20,292
"33607",1033607,105,39,12,156
"33608",1033608,87,144,11,242
"33609",1033609,135,58,9,202
"33610",1033610,86,184,3,273
"33611",1033611,173,104,12,289
"33612",1033612,133,64,8,205
"33613",1033613,96,162,3,261
"33614",1033614,92,215,16,323
"33615",1033615,111,28,2,141
"33616",1033616,109,164,14,287
"33617",1033617,27,252,0,279
"33618",1033618,37,197,4,238
"33619",1033619,53,176,8,237
"33620",1033620,81,207,11,299
"33621",1033621,113,60,3,176
"33622",1033622,153,46,4,203
"33623",1033623,64,199,4,267
"33624",1033624,52,3,6,61
"33625",1033625,152,57,6,215
"33626",1033626,79,243,4,326
"33627",1033627,188,54,5,247
"33628",1033628,70,224,9,303
"33629",1033629,82,149,8,239
"33630",1033630,129,117,11,257
"33631",1033631,144,68,5,217
"33632",1033632,73,65,5,143
"33633",1033633,40,241,6,287
"33634",1033634,236,2,2,240
"33635",1033635,26,5,2,33
"33636",1033636,222,37,4,263
"33637",1033637,135,101,6,242
"33638",1033638,162,70,23,255
"33639",1033639,166,53,2,221
"33640",1033640,211,43,12,266
"33641",1033641,199,119,26,344
"33642",1033642,69,218,4,291
"33643",1033643,78,107,10,195
"33644",1033644,112,97,5,214
"33645",1033645,199,64,12,275
"33646",1033646,103,115,12,230
"33647",1033647,44,16,1,61
"33648",1033648,189,21,7,217
"33649",1033649,27,228,1,256
"33650",1033650,68,72,7,147
"33651",1033651,201,195,7,403
"33652",1033652,246,18,4,268
"33653",1033653,158,41,3,202
"33654",1033654,85,64,3,152
"33655",1033655,43,119,9,171
"33656",1033656,41,279,6,326
"33657",1033657,46,220,3,269
"33658",1033658,173,62,18,253
"33659",1033659,24,28,0,52
"33660",1033660,155,39,5,199
"33661",1033661,205,28,6,239
"33662",1033662,39,214,3,256
"33663",1033663,31,66,0,97
"33664",1033664,76,194,10,280
"33665",1033665,108,100,13,221
"33666",1033666,143,92,8,243
"33667",1033667,35,79,1,115
"33668",1033668,119,184,16,319
"33669",1033669,102,136,2,240
"33670",1033670,182,24,8,214
"33671",1033671,68,194,7,269
"33672",1033672,49,127,11,187
"33673",1033673,32,107,5,144
"33674",1033674,157,30,2,189
"33675",1033675,54,42,13,109
"33676",1033676,38,241,3,282
"33677",1033677,179,49,6,234
"33678",1033678,89,120,8,217
"33679",1033679,214,91,6,311
"33680",1033680,112,94,3,209
"33681",1033681,33,177,5,215
"33682",1033682,22,33,1,56
"33683",1033683,204,56,10,270
"33684",1033684,157,31,10,198
"33685",1033685,209,30,10,249
"33686",1033686,108,27,12,147
"33687",1033687,162,36,7,205
"33688",1033688,117,52,7,176
"33689",1033689,98,175,19,292
"33690",1033690,68,142,8,218
"33691",1033691,148,48,2,198
"33692",1033692,48,181,5,234
"33693",1033693,44,224,7,275
"33694",1033694,153,29,8,190
"33695",1033695,25,163,3,191
"33696",1033696,168,28,4,200
"33697",1033697,7,49,3,59
"33698",1033698,33,174,1,208
"33699",1033699,240,19,7,266
"33700",1033700,99,148,5,252
"33701",1033701,100,109,7,216
"33702",1033702,199,18,5,222
"33703",1033703,81,43,2,126
"33704",1033704,107,29,3,139
"33705",1033705,113,50,6,169
"33706",1033706,58,130,2,190
"33707",1033707,106,55,5,166
"33708",1033708,61,102,2,165
"33709",1033709,136,177,12,325
"33710",1033710,130,143,15,288
"33711",1033711,49,161,8,218
"33712",1033712,84,31,0,115
"33713",1033713,5,85,0,90
"33714",1033714,27,243,7,277
"33715",1033715,74,185,2,261
"33716",1033716,101,188,24,313
"33717",1033717,99,102,3,204
"33718",1033718,76,133,2,211
"33719",1033719,46,229,10,285
"33720",1033720,196,21,9,226
"33721",1033721,182,41,2,225
"33722",1033722,205,12,5,222
"33723",1033723,156,54,6,216
"33724",1033724,88,181,7,276
"33725",1033725,171,61,10,242
"33726",1033726,120,59,8,187
"33727",1033727,36,165,4,205
"33728",1033728,82,153,4,239
"33729",1033729,18,2,3,23
"33730",1033730,125,121,8,254
"33731",1033731,208,8,3,219
"33732",1033732,26,1,2,29
"33733",1033733,212,63,11,286
"33734",1033734,76,87,4,167
"33735",1033735,29,232,2,263
"33736",1033736,69,96,12,177
"33737",1033737,135,91,4,230
"33738",1033738,43,109,7,159
"33739",1033739,240,68,8,316
"33740",1033740,30,68,0,98
"33741",1033741,156,56,5,217
"33742",1033742,218,30,8,256
"33743",1033743,209,13,3,225
"33744",1033744,195,67,12,274
"33745",1033745,69,181,4,254
"33746",1033746,48,231,4,283
"33747",1033747,60,180,17,257
"33748",1033748,49,19,7,75
"33749",1033749,63,41,4,108
"33750",1033750,51,170,12,233
"33751",1033751,133,73,5,211
"33752",1033752,110,0,0,110
"33753",1033753,72,159,11,242
"33754",1033754,68,28,8,104
"33755",1033755,159,22,7,188
"33756",1033756,188,16,11,215
"33757",1033757,98,91,11,200
"33758",1033758,143,69,18,230
"33759",1033759,102,52,3,157
"33760",1033760,60,103,5,168
"33761",1033761,113,38,5,156
"33762",1033762,135,43,10,188
"33763",1033763,84,173,6,263
"33764",1033764,113,93,1,207
"33765",1033765,172,38,7,217
"33766",1033766,88,13,0,101
"33767",1033767,81,105,21,207
"33768",1033768,142,63,4,209
"33769",1033769,106,28,9,143
"33770",1033770,106,36,5,147
"33771",1033771,159,59,0,218
"33772",1033772,62,180,8,250
"33773",1033773,209,84,15,308
"33774",1033774,80,193,18,291
"33775",1033775,18,40,8,66
"33776",1033776,99,68,11,178
"33777",1033777,236,24,5,265
"33778",1033778,29,236,1,266
"33779",1033779,84,162,10,256
"33780",1033780,98,174,8,280
"33781",1033781,78,127,20,225
"33782",1033782,87,187,8,282
"33783",1033783,83,196,4,283
"33784",1033784,24,50,1,75
"33785",1033785,8,132,1,141
"33786",1033786,116,24,7,147
"33787",1033787,77,55,7,139
"33788",1033788,49,78,1,128
"33789",1033789,26,83,7,116
"33790",1033790,159,28,9,196
"33791",1033791,190,77,14,281
"33792",1033792,184,51,9,244
"33793",1033793,3,13,1,17
"33794",1033794,46,156,17,219
"33795",1033795,165,123,7,295
"33796",1033796,43,105,10,158
"33797",1033797,127,46,6,179
"33798",1033798,89,121,12,222
"33799",1033799,138,68,10,216
"33800",1033800,144,111,7,262
"33801",1033801,219,50,11,280
"33802",1033802,254,10,4,268
"33803",1033803,211,29,8,248
"33804",1033804,81,209,6,296
"33805",1033805,25,209,8,242
"33806",1033806,118,61,7,186
"33807",1033807,241,24,5,270
"33808",1033808,32,277,8,317
"33809",1033809,122,141,14,277
"33810",1033810,86,187,11,284
"33811",1033811,210,25,4,239
"33812",1033812,19,9,0,28
"33813",1033813,105,168,2,275
"33814",1033814,132,103,6,241
"33815",1033815,28,194,4,226
"33816",1033816,62,190,19,271
"33817",1033817,104,54,6,164
"33818",1033818,36,267,0,303
"33819",1033819,16,178,1,195
"33820",1033820,121,114,3,238
"33821",1033821,70,114,2,186
"33822",1033822,77,87,6,170
"33823",1033823,200,23,3,226
"33824",1033824,73,143,2,218
"33825",1033825,90,63,6,159
"33826",1033826,69,175,21,265
"33827",1033827,155,116,4,275
"33828",1033828,104,56,7,167
"33829",1033829,66,88,1,155
"33830",1033830,69,202,19,290
"33831",1033831,58,216,5,279
"33832",1033832,95,126,6,227
"33833",1033833,54,251,2,307
"33834",1033834,119,178,17,314
"33835",1033835,91,123,6,220
"33836",1033836,173,42,11,226
"33837",1033837,81,179,10,270
"33838",1033838,117,99,5,221
"33839",1033839,206,363,34,603
"33840",1033840,158,158,17,333
"33841",1033841,18,6,1,25
"33842",1033842,175,33,4,212
"33843",1033843,261,15,14,290
"33844",1033844,226,71,11,308
"33845",1033845,4,4,1,9
"33846",1033846,126,16,2,144
"33847",1033847,24,154,3,181
"33848",1033848,9,7,1,17
"33849",1033849,72,76,1,149
"33850",1033850,62,181,6,249
"33851",1033851,90,96,2,188
"33852",1033852,128,78,7,213
"33853",1033853,107,22,1,130
"33854",1033854,90,104,6,200
"33855",1033855,156,22,5,183
"33856",1033856,120,85,10,215
"33857",1033857,103,49,4,156
"33858",1033858,154,64,9,227
"33859",1033859,80,142,9,231
"33860",1033860,123,103,7,233
"33861",1033861,244,117,12,373
"33862",1033862,139,135,8,282
"33863",1033863,181,56,7,244
"33864",1033864,179,50,19,248
"33865",1033865,92,161,11,264
"33866",1033866,161,111,3,275
"33867",1033867,56,36,9,101
"33868",1033868,148,75,13,236
"33869",1033869,33,251,10,294
"33870",1033870,92,127,8,227
"33871",1033871,193,63,5,261
"33872",1033872,89,168,4,261
"33873",1033873,249,27,8,284
"33874",1033874,158,137,25,320
"33875",1033875,60,190,14,264
"33876",1033876,63,236,6,305
"33877",1033877,76,213,18,307
"33878",1033878,88,191,8,287
"33879",1033879,70,64,5,139
"33880",1033880,98,56,2,156
"33881",1033881,176,70,3,249
"33882",1033882,68,60,7,135
"33883",1033883,73,166,3,242
"33884",1033884,97,82,1,180
"33885",1033885,226,37,5,268
"33886",1033886,95,76,12,183
"33887",1033887,261,211,28,500
"33888",1033888,194,129,9,332
"33889",1033889,75,152,20,247
"33890",1033890,118,148,5,271
"33891",1033891,58,150,10,218
"33892",1033892,95,150,7,252
"33893",1033893,176,82,8,266
"33894",1033894,13,52,1,66
"33895",1033895,220,66,9,295
"33896",1033896,85,162,15,262
"33897",1033897,136,58,21,215
"33898",1033898,181,61,6,248
"33899",1033899,76,44,0,120
"33900",1033900,85,154,22,261
"33901",1033901,106,64,11,181
"33902",1033902,44,40,2,86
"33903",1033903,101,88,3,192
"33904",1033904,161,83,12,256
"33905",1033905,66,141,23,230
"33906",1033906,70,215,2,287
"33907",1033907,160,5,4,169
"33908",1033908,204,36,10,250
"33909",1033909,169,106,11,286
"33910",1033910,127,144,6,277
"33911",1033911,41,144,10,195
"33912",1033912,11,42,0,53
"33913",1033913,78,88,7,173
"33914",1033914,166,70,8,244
"33915",1033915,31,223,4,258
"33916",1033916,173,141,8,322
"33917",1033917,33,202,1,236
"33918",1033918,14,27,0,41
"33919",1033919,143,140,12,295
"33920",1033920,80,168,14,262
"33921",1033921,46,53,3,102
"33922",1033922,83,227,1,311
"33923",1033923,238,55,10,303
"33924",1033924,181,62,14,257
"33925",1033925,165,39,6,210
"33926",1033926,151,112,5,268
"33927",1033927,38,159,6,203
"33928",1033928,77,243,7,327
"33929",1033929,154,29,4,187
"33930",1033930,169,79,4,252
"33931",1033931,117,50,20,187
"33932",1033932,27,286,8,321
"33933",1033933,127,19,3,149
"33934",1033934,41,35,0,76
"33935",1033935,133,156,4,293
"33936",1033936,8,2,0,10
"33937",1033937,98,80,18,196
"33938",1033938,43,32,4,79
"33939",1033939,187,81,1,269
"33940",1033940,161,136,22,319
"33941",1033941,30,8,2,40
"33942",1033942,94,203,12,309
"33943",1033943,180,52,4,236
"33944",1033944,188,20,5,213
"33945",1033945,192,69,17,278
"33946",1033946,80,196,11,287
"33947",1033947,91,168,13,272
"33948",1033948,119,94,12,225
"33949",1033949,86,162,13,261
"33950",1033950,89,86,11,186
"33951",1033951,28,292,6,326
"33952",1033952,99,105,7,211
"33953",1033953,101,86,9,196
"33954",1033954,23,170,8,201
"33955",1033955,130,14,2,146
"33956",1033956,139,94,9,242
"33957",1033957,60,145,11,216
"33958",1033958,115,139,19,273
"33959",1033959,160,59,3,222
"33960",1033960,64,92,11,167
"33961",1033961,12,30,2,44
"33962",1033962,247,10,5,262
"33963",1033963,92,55,7,154
"33964",1033964,153,70,5,228
"33965",1033965,91,129,5,225
"33966",1033966,92,180,7,279
"33967",1033967,124,92,13,229
"33968",1033968,29,191,4,224
"33969",1033969,27,75,2,104
"33970",1033970,194,64,9,267
"33971",1033971,41,243,8,292
"33972",1033972,24,250,4,278
"33973",1033973,182,96,6,284
"33974",1033974,232,44,16,292
"33975",1033975,36,26,2,64
"33976",1033976,175,120,10,305
"33977",1033977,217,42,4,263
"33978",1033978,176,16,3,195
"33979",1033979,60,3,0,63
"33980",1033980,79,113,6,198
"33981",1033981,26,185,7,218
"33982",1033982,128,85,10,223
"33983",1033983,14,245,5,264
"33984",1033984,154,45,8,207
"33985",1033985,123,50,4,177
"33986",1033986,32,1,1,34
"33987",1033987,72,157,7,236
"33988",1033988,139,21,5,165
"33989",1033989,99,107,10,216
"33990",1033990,175,15,8,198
"33991",1033991,205,54,4,263
"33992",1033992,193,79,6,278
"33993",1033993,190,42,9,241
"33994",1033994,169,116,17,302
"33995",1033995,91,144,27,262
"33996",1033996,225,49,6,280
"33997",1033997,72,119,7,198
"33998",1033998,158,122,2,282
"33999",1033999,158,0,6,164
"34000",1034000,107,4,0,111
"34001",1034001,41,258,1,300
"34002",1034002,110,94,9,213
"34003",1034003,59,212,8,279
"34004",1034004,125,89,13,227
"34005",1034005,138,91,5,234
"34006",1034006,147,82,21,250
"34007",1034007,29,216,1,246
"34008",1034008,177,41,7,225
"34009",1034009,127,98,13,238
"34010",1034010,150,48,7,205
"34011",1034011,88,151,6,245
"34012",1034012,40,93,4,137
"34013",1034013,216,14,6,236
"34014",1034014,184,37,4,225
"34015",1034015,126,126,14,266
"34016",1034016,136,29,4,169
"34017",1034017,262,6,10,278
"34018",1034018,236,135,17,388
"34019",1034019,159,151,15,325
"34020",1034020,24,158,2,184
"34021",1034021,137,117,9,263
"34022",1034022,124,134,16,274
"34023",1034023,114,99,12,225
"34024",1034024,99,60,9,168
"34025",1034025,62,201,6,269
"34026",1034026,198,111,11,320
"34027",1034027,131,86,9,226
"34028",1034028,190,38,8,236
"34029",1034029,181,86,14,281
"34030",1034030,176,69,8,253
"34031",1034031,142,115,14,271
"34032",1034032,124,156,6,286
"34033",1034033,80,107,2,189
"34034",1034034,118,118,18,254
"34035",1034035,214,61,13,288
"34036",1034036,62,163,13,238
"34037",1034037,144,120,8,272
"34038",1034038,80,163,7,250
"34039",1034039,89,162,7,258
"34040",1034040,238,25,4,267
"34041",1034041,158,121,7,286
"34042",1034042,137,87,8,232
"34043",1034043,97,113,18,228
"34044",1034044,80,58,12,150
"34045",1034045,170,3,4,177
"34046",1034046,67,267,16,350
"34047",1034047,187,79,12,278
"34048",1034048,144,82,8,234
"34049",1034049,163,102,22,287
"34050",1034050,146,52,20,218
"34051",1034051,135,111,6,252
"34052",1034052,116,21,10,147
"34053",1034053,71,31,9,111
"34054",1034054,160,82,7,249
"34055",1034055,126,72,10,208
"34056",1034056,105,139,15,259
"34057",1034057,107,166,4,277
"34058",1034058,143,18,5,166
"34059",1034059,24,210,4,238
"34060",1034060,20,7,0,27
"34061",1034061,121,152,22,295
"34062",1034062,185,22,1,208
"34063",1034063,131,140,17,288
"34064",1034064,146,31,12,189
"34065",1034065,62,170,12,244
"34066",1034066,100,44,7,151
"34067",1034067,63,87,8,158
"34068",1034068,179,19,8,206
"34069",1034069,82,161,7,250
"34070",1034070,185,19,7,211
"34071",1034071,155,23,3,181
"34072",1034072,97,115,18,230
"34073",1034073,81,145,14,240
"34074",1034074,214,26,7,247
"34075",1034075,49,158,8,215
"34076",1034076,41,115,10,166
"34077",1034077,150,33,8,191
"34078",1034078,106,97,5,208
"34079",1034079,178,132,14,324
"34080",1034080,147,129,12,288
"34081",1034081,89,81,3,173
"34082",1034082,128,76,9,213
"34083",1034083,199,87,10,296
"34084",1034084,39,194,5,238
"34085",1034085,107,81,5,193
"34086",1034086,123,123,9,255
"34087",1034087,126,131,6,263
"34088",1034088,54,174,14,242
"34089",1034089,101,142,7,250
"34090",1034090,116,58,5,179
"34091",1034091,60,108,4,172
"34092",1034092,18,15,2,35
"34093",1034093,98,128,6,232
"34094",1034094,58,236,7,301
"34095",1034095,63,210,8,281
"34096",1034096,117,37,13,167
"34097",1034097,212,39,17,268
"34098",1034098,138,42,4,184
"34099",1034099,59,195,8,262
"34100",1034100,197,43,10,250
"34101",1034101,91,133,10,234
"34102",1034102,86,45,14,145
"34103",1034103,210,44,14,268
"34104",1034104,117,32,6,155
"34105",1034105,119,48,11,178
"34106",1034106,120,176,13,309
"34107",1034107,239,70,6,315
"34108",1034108,88,242,4,334
"34109",1034109,26,4,0,30
"34110",1034110,81,34,10,125
"34111",1034111,90,123,3,216
"34112",1034112,197,18,11,226
"34113",1034113,90,32,7,129
"34114",1034114,148,15,25,188
"34115",1034115,58,47,1,106
"34116",1034116,68,114,4,186
"34117",1034117,204,1,1,206
"34118",1034118,223,56,11,290
"34119",1034119,49,234,11,294
"34120",1034120,94,157,21,272
"34121",1034121,206,82,9,297
"34122",1034122,80,174,14,268
"34123",1034123,46,37,0,83
"34124",1034124,150,179,10,339
"34125",1034125,94,50,7,151
"34126",1034126,118,3,3,124
"34127",1034127,132,37,3,172
"34128",1034128,144,124,7,275
"34129",1034129,187,31,4,222
"34130",1034130,191,61,10,262
"34131",1034131,158,50,9,217
"34132",1034132,195,83,13,291
"34133",1034133,127,57,7,191
"34134",1034134,245,62,12,319
"34135",1034135,49,47,1,97
"34136",1034136,75,79,4,158
"34137",1034137,111,91,10,212
"34138",1034138,15,147,1,163
"34139",1034139,137,71,18,226
"34140",1034140,39,38,1,78
"34141",1034141,33,140,11,184
"34142",1034142,197,8,10,215
"34143",1034143,196,35,5,236
"34144",1034144,198,62,6,266
"34145",1034145,43,187,8,238
"34146",1034146,121,44,5,170
"34147",1034147,166,131,13,310
"34148",1034148,89,114,8,211
"34149",1034149,71,87,2,160
"34150",1034150,194,102,20,316
"34151",1034151,198,45,11,254
"34152",1034152,197,65,10,272
"34153",1034153,182,35,4,221
"34154",1034154,175,33,9,217
"34155",1034155,203,61,12,276
"34156",1034156,32,191,1,224
"34157",1034157,159,92,4,255
"34158",1034158,75,157,5,237
"34159",1034159,163,89,7,259
"34160",1034160,235,29,12,276
"34161",1034161,116,62,12,190
"34162",1034162,156,74,12,242
"34163",1034163,82,28,7,117
"34164",1034164,131,64,11,206
"34165",1034165,157,60,7,224
"34166",1034166,34,197,2,233
"34167",1034167,105,159,11,275
"34168",1034168,159,115,10,284
"34169",1034169,63,207,4,274
"34170",1034170,123,112,17,252
"34171",1034171,201,12,2,215
"34172",1034172,40,148,5,193
"34173",1034173,138,72,13,223
"34174",1034174,72,185,10,267
"34175",1034175,30,138,2,170
"34176",1034176,52,203,5,260
"34177",1034177,16,32,5,53
"34178",1034178,192,7,7,206
"34179",1034179,154,11,2,167
"34180",1034180,140,120,8,268
"34181",1034181,56,47,0,103
"34182",1034182,106,83,12,201
"34183",1034183,57,103,5,165
"34184",1034184,121,51,6,178
"34185",1034185,207,21,5,233
"34186",1034186,133,63,3,199
"34187",1034187,167,14,4,185
"34188",1034188,164,69,7,240
"34189",1034189,11,3,0,14
"34190",1034190,134,101,5,240
"34191",1034191,94,43,14,151
"34192",1034192,53,128,4,185
"34193",1034193,248,63,8,319
"34194",1034194,79,142,11,232
"34195",1034195,1,5,1,7
"34196",1034196,160,28,3,191
"34197",1034197,70,4,2,76
"34198",1034198,147,59,9,215
"34199",1034199,166,40,5,211
"34200",1034200,133,53,4,190
"34201",1034201,22,173,3,198
"34202",1034202,72,14,1,87
"34203",1034203,84,73,4,161
"34204",1034204,149,83,6,238
"34205",1034205,56,135,3,194
"34206",1034206,109,158,7,274
"34207",1034207,5,71,0,76
"34208",1034208,8,245,5,258
"34209",1034209,167,102,12,281
"34210",1034210,79,136,16,231
"34211",1034211,107,209,11,327
"34212",1034212,42,41,3,86
"34213",1034213,23,1,1,25
"34214",1034214,80,181,11,272
"34215",1034215,66,12,1,79
"34216",1034216,112,161,9,282
"34217",1034217,133,65,11,209
"34218",1034218,85,87,9,181
"34219",1034219,188,57,22,267
"34220",1034220,34,167,5,206
"34221",1034221,224,35,4,263
"34222",1034222,132,91,15,238
"34223",1034223,48,58,2,108
"34224",1034224,169,74,15,258
"34225",1034225,131,110,10,251
"34226",1034226,160,91,8,259
"34227",1034227,6,144,3,153
"34228",1034228,89,44,7,140
"34229",1034229,134,76,8,218
"34230",1034230,77,71,4,152
"34231",1034231,161,40,11,212
"34232",1034232,103,3,2,108
"34233",1034233,133,151,7,291
"34234",1034234,146,128,12,286
"34235",1034235,21,212,0,233
"34236",1034236,159,148,15,322
"34237",1034237,53,131,1,185
"34238",1034238,1,0,0,1
"34239",1034239,185,24,4,213
"34240",1034240,107,181,8,296
"34241",1034241,154,107,10,271
"34242",1034242,133,30,7,170
"34243",1034243,175,85,16,276
"34244",1034244,140,32,3,175
"34245",1034245,50,187,11,248
"34246",1034246,27,224,7,258
"34247",1034247,177,66,7,250
"34248",1034248,128,26,4,158
"34249",1034249,163,100,10,273
"34250",1034250,126,156,8,290
"34251",1034251,29,288,7,324
"34252",1034252,57,246,9,312
"34253",1034253,184,40,8,232
"34254",1034254,186,35,10,231
"34255",1034255,116,173,17,306
"34256",1034256,114,55,4,173
"34257",1034257,75,149,3,227
"34258",1034258,187,27,7,221
"34259",1034259,196,25,3,224
"34260",1034260,55,211,11,277
"34261",1034261,7,0,0,7
"34262",1034262,140,90,8,238
"34263",1034263,30,152,8,190
"34264",1034264,135,139,5,279
"34265",1034265,89,189,3,281
"34266",1034266,157,73,8,238
"34267",1034267,193,41,4,238
"34268",1034268,178,9,6,193
"34269",1034269,168,86,2,256
"34270",1034270,87,40,1,128
"34271",1034271,176,56,3,235
"34272",1034272,87,180,14,281
"34273",1034273,87,171,8,266
"34274",1034274,55,110,3,168
"34275",1034275,174,63,12,249
"34276",1034276,172,57,3,232
"34277",1034277,172,52,11,235
"34278",1034278,58,218,5,281
"34279",1034279,146,42,20,208
"34280",1034280,65,240,10,315
"34281",1034281,166,101,5,272
"34282",1034282,145,9,9,163
"34283",1034283,128,86,16,230
"34284",1034284,142,49,9,200
"34285",1034285,87,25,6,118
"34286",1034286,71,137,4,212
"34287",1034287,43,98,3,144
"34288",1034288,160,35,10,205
"34289",1034289,12,208,1,221
"34290",1034290,28,265,2,295
"34291",1034291,70,176,5,251
"34292",1034292,22,147,3,172
"34293",1034293,126,104,9,239
"34294",1034294,122,184,13,319
"34295",1034295,29,200,4,233
"34296",1034296,79,156,20,255
"34297",1034297,96,99,14,209
"34298",1034298,159,23,3,185
"34299",1034299,86,53,6,145
"34300",1034300,149,21,4,174
"34301",1034301,149,20,3,172
"34302",1034302,87,215,9,311
"34303",1034303,84,94,0,178
"34304",1034304,101,184,18,303
"34305",1034305,249,19,5,273
"34306",1034306,31,270,7,308
"34307",1034307,6,66,5,77
"34308",1034308,162,50,3,215
"34309",1034309,148,24,6,178
"34310",1034310,133,178,7,318
"34311",1034311,40,198,8,246
"34312",1034312,144,88,5,237
"34313",1034313,263,25,4,292
"34314",1034314,152,60,10,222
"34315",1034315,128,97,7,232
"34316",1034316,98,133,4,235
"34317",1034317,102,206,3,311
"34318",1034318,153,130,30,313
"34319",1034319,105,119,9,233
"34320",1034320,90,92,7,189
"34321",1034321,86,164,5,255
"34322",1034322,109,179,8,296
"34323",1034323,11,85,3,99
"34324",1034324,102,172,9,283
"34325",1034325,14,203,4,221
"34326",1034326,122,48,7,177
"34327",1034327,202,88,14,304
"34328",1034328,45,240,8,293
"34329",1034329,176,37,4,217
"34330",1034330,183,55,5,243
"34331",1034331,77,92,2,171
"34332",1034332,70,246,6,322
"34333",1034333,70,103,8,181
"34334",1034334,107,190,8,305
"34335",1034335,76,207,13,296
"34336",1034336,55,241,7,303
"34337",1034337,31,189,2,222
"34338",1034338,200,90,18,308
"34339",1034339,24,108,2,134
"34340",1034340,26,12,1,39
"34341",1034341,48,190,5,243
"34342",1034342,89,171,7,267
"34343",1034343,55,138,7,200
"34344",1034344,136,116,11,263
"34345",1034345,199,70,8,277
"34346",1034346,30,17,3,50
"34347",1034347,83,120,8,211
"34348",1034348,43,118,9,170
"34349",1034349,129,57,5,191
"34350",1034350,80,112,9,201
"34351",1034351,80,195,12,287
"34352",1034352,236,14,4,254
"34353",1034353,141,33,2,176
"34354",1034354,4,7,2,13
"34355",1034355,168,43,4,215
"34356",1034356,26,195,4,225
"34357",1034357,38,128,13,179
"34358",1034358,46,216,3,265
"34359",1034359,94,5,5,104
"34360",1034360,84,250,5,339
"34361",1034361,2,12,0,14
"34362",1034362,139,66,15,220
"34363",1034363,50,143,2,195
"34364",1034364,158,50,18,226
"34365",1034365,2,13,1,16
"34366",1034366,88,121,11,220
"34367",1034367,15,54,5,74
"34368",1034368,88,204,4,296
"34369",1034369,77,163,14,254
"34370",1034370,170,60,2,232
"34371",1034371,21,155,3,179
"34372",1034372,116,38,7,161
"34373",1034373,153,80,5,238
"34374",1034374,155,96,13,264
"34375",1034375,12,125,1,138
"34376",1034376,17,5,0,22
"34377",1034377,113,146,19,278
"34378",1034378,224,43,8,275
"34379",1034379,107,43,13,163
"34380",1034380,160,59,9,228
"34381",1034381,42,187,3,232
"34382",1034382,71,188,8,267
"34383",1034383,184,62,9,255
"34384",1034384,183,76,10,269
"34385",1034385,135,49,11,195
"34386",1034386,73,256,13,342
"34387",1034387,83,90,9,182
"34388",1034388,130,127,6,263
"34389",1034389,213,63,12,288
"34390",1034390,133,119,4,256
"34391",1034391,24,266,1,291
"34392",1034392,108,52,9,169
"34393",1034393,185,88,21,294
"34394",1034394,65,228,7,300
"34395",1034395,80,261,9,350
"34396",1034396,85,189,11,285
"34397",1034397,56,31,8,95
"34398",1034398,119,90,11,220
"34399",1034399,30,191,3,224
"34400",1034400,79,248,1,328
"34401",1034401,198,56,15,269
"34402",1034402,62,210,9,281
"34403",1034403,45,251,11,307
"34404",1034404,72,15,8,95
"34405",1034405,52,89,4,145
"34406",1034406,98,105,5,208
"34407",1034407,57,124,12,193
"34408",1034408,111,159,36,306
"34409",1034409,125,160,11,296
"34410",1034410,69,115,9,193
"34411",1034411,107,30,1,138
"34412",1034412,44,25,2,71
"34413",1034413,183,23,8,214
"34414",1034414,53,252,7,312
"34415",1034415,70,121,16,207
"34416",1034416,192,1,7,200
"34417",1034417,77,58,3,138
"34418",1034418,155,57,7,219
"34419",1034419,22,166,2,190
"34420",1034420,11,3,0,14
"34421",1034421,148,114,2,264
"34422",1034422,138,29,9,176
"34423",1034423,62,140,1,203
"34424",1034424,148,102,8,258
"34425",1034425,99,100,9,208
"34426",1034426,143,108,3,254
"34427",1034427,147,72,15,234
"34428",1034428,18,144,0,162
"34429",1034429,175,41,3,219
"34430",1034430,59,126,4,189
"34431",1034431,171,61,5,237
"34432",1034432,199,65,4,268
"34433",1034433,53,216,7,276
"34434",1034434,142,52,3,197
"34435",1034435,10,18,1,29
"34436",1034436,253,41,13,307
"34437",1034437,28,14,3,45
"34438",1034438,137,104,4,245
"34439",1034439,80,103,5,188
"34440",1034440,56,188,11,255
"34441",1034441,110,125,2,237
"34442",1034442,98,58,20,176
"34443",1034443,133,158,16,307
"34444",1034444,192,56,11,259
"34445",1034445,131,94,14,239
"34446",1034446,105,12,4,121
"34447",1034447,180,49,7,236
"34448",1034448,38,174,7,219
"34449",1034449,92,148,19,259
"34450",1034450,122,87,22,231
"34451",1034451,148,101,18,267
"34452",1034452,196,70,7,273
"34453",1034453,89,238,13,340
"34454",1034454,76,144,5,225
"34455",1034455,120,131,0,251
"34456",1034456,100,91,5,196
"34457",1034457,142,33,4,179
"34458",1034458,41,265,5,311
"34459",1034459,156,77,5,238
"34460",1034460,71,229,7,307
"34461",1034461,92,80,6,178
"34462",1034462,120,159,8,287
"34463",1034463,2,4,0,6
"34464",1034464,40,12,3,55
"34465",1034465,78,29,4,111
"34466",1034466,65,130,16,211
"34467",1034467,195,1,0,196
"34468",1034468,125,300,7,432
"34469",1034469,71,233,13,317
"34470",1034470,89,69,13,171
"34471",1034471,173,103,15,291
"34472",1034472,172,28,10,210
"34473",1034473,41,16,1,58
"34474",1034474,81,126,7,214
"34475",1034475,42,133,7,182
"34476",1034476,19,1,0,20
"34477",1034477,89,46,12,147
"34478",1034478,7,54,3,64
"34479",1034479,49,265,12,326
"34480",1034480,126,154,7,287
"34481",1034481,110,12,4,126
"34482",1034482,72,25,10,107
"34483",1034483,103,37,5,145
"34484",1034484,174,36,12,222
"34485",1034485,55,223,11,289
"34486",1034486,110,155,11,276
"34487",1034487,20,23,0,43
"34488",1034488,151,82,11,244
"34489",1034489,121,123,11,255
"34490",1034490,76,104,13,193
"34491",1034491,70,69,5,144
"34492",1034492,120,132,12,264
"34493",1034493,146,71,7,224
"34494",1034494,30,260,7,297
"34495",1034495,213,24,17,254
"34496",1034496,25,36,1,62
"34497",1034497,18,189,1,208
"34498",1034498,311,10,5,326
"34499",1034499,99,196,11,306
"34500",1034500,198,79,4,281
"34501",1034501,76,102,5,183
"34502",1034502,61,201,7,269
"34503",1034503,10,0,0,10
"34504",1034504,88,190,11,289
"34505",1034505,51,108,1,160
"34506",1034506,31,48,3,82
"34507",1034507,66,42,4,112
"34508",1034508,34,32,4,70
"34509",1034509,147,81,10,238
"34510",1034510,113,151,10,274
"34511",1034511,130,79,10,219
"34512",1034512,142,70,4,216
"34513",1034513,62,119,7,188
"34514",1034514,75,158,8,241
"34515",1034515,67,168,3,238
"34516",1034516,153,132,6,291
"34517",1034517,171,86,7,264
"34518",1034518,173,103,19,295
"34519",1034519,25,6,1,32
"34520",1034520,153,50,4,207
"34521",1034521,25,170,2,197
"34522",1034522,50,4,2,56
"34523",1034523,131,127,6,264
"34524",1034524,50,44,2,96
"34525",1034525,22,186,3,211
"34526",1034526,244,31,9,284
"34527",1034527,74,93,7,174
"34528",1034528,120,240,24,384
"34529",1034529,63,146,10,219
"34530",1034530,89,182,30,301
"34531",1034531,120,140,15,275
"34532",1034532,18,32,1,51
"34533",1034533,175,1,0,176
"34534",1034534,106,178,16,300
"34535",1034535,14,83,3,100
"34536",1034536,93,142,9,244
"34537",1034537,151,15,0,166
"34538",1034538,192,30,7,229
"34539",1034539,165,98,5,268
"34540",1034540,19,18,1,38
"34541",1034541,30,211,3,244
"34542",1034542,82,172,14,268
"34543",1034543,57,191,2,250
"34544",1034544,146,93,14,253
"34545",1034545,103,37,8,148
"34546",1034546,130,196,16,342
"34547",1034547,199,98,15,312
"34548",1034548,55,161,13,229
"34549",1034549,147,94,13,254
"34550",1034550,54,70,3,127
"34551",1034551,131,70,3,204
"34552",1034552,141,41,2,184
"34553",1034553,81,32,10,123
"34554",1034554,31,204,29,264
"34555",1034555,168,42,2,212
"34556",1034556,1,79,0,80
"34557",1034557,108,195,20,323
"34558",1034558,20,147,3,170
"34559",1034559,129,80,8,217
"34560",1034560,144,73,6,223
"34561",1034561,46,130,3,179
"34562",1034562,70,67,3,140
"34563",1034563,89,62,5,156
"34564",1034564,120,147,16,283
"34565",1034565,109,117,10,236
"34566",1034566,224,39,6,269
"34567",1034567,178,39,6,223
"34568",1034568,132,137,12,281
"34569",1034569,156,53,9,218
"34570",1034570,90,82,1,173
"34571",1034571,115,115,7,237
"34572",1034572,157,90,3,250
"34573",1034573,38,205,8,251
"34574",1034574,66,70,1,137
"34575",1034575,153,103,12,268
"34576",1034576,248,58,22,328
"34577",1034577,293,1,5,299
"34578",1034578,200,91,15,306
"34579",1034579,138,265,7,410
"34580",1034580,107,157,15,279
"34581",1034581,106,8,4,118
"34582",1034582,77,117,13,207
"34583",1034583,10,145,1,156
"34584",1034584,25,60,1,86
"34585",1034585,78,283,9,370
"34586",1034586,51,280,18,349
"34587",1034587,110,89,11,210
"34588",1034588,167,122,13,302
"34589",1034589,128,0,0,128
"34590",1034590,170,143,5,318
"34591",1034591,132,54,11,197
"34592",1034592,118,67,6,191
"34593",1034593,210,21,5,236
"34594",1034594,112,174,15,301
"34595",1034595,178,98,6,282
"34596",1034596,143,26,5,174
"34597",1034597,124,144,3,271
"34598",1034598,121,67,8,196
"34599",1034599,51,5,1,57
"34600",1034600,207,33,6,246
"34601",1034601,91,69,5,165
"34602",1034602,150,12,3,165
"34603",1034603,124,103,29,256
"34604",1034604,19,16,0,35
"34605",1034605,48,162,8,218
"34606",1034606,107,101,14,222
"34607",1034607,27,154,3,184
"34608",1034608,35,165,6,206
"34609",1034609,194,41,3,238
"34610",1034610,110,136,6,252
"34611",1034611,89,113,6,208
"34612",1034612,131,137,6,274
"34613",1034613,131,38,6,175
"34614",1034614,146,42,5,193
"34615",1034615,82,175,10,267
"34616",1034616,87,116,7,210
"34617",1034617,193,79,23,295
"34618",1034618,209,62,9,280
"34619",1034619,69,150,8,227
"34620",1034620,241,77,19,337
"34621",1034621,197,55,9,261
"34622",1034622,91,110,4,205
"34623",1034623,15,46,0,61
"34624",1034624,185,46,13,244
"34625",1034625,174,62,15,251
"34626",1034626,44,47,3,94
"34627",1034627,107,145,8,260
"34628",1034628,119,116,7,242
"34629",1034629,207,32,10,249
"34630",1034630,70,82,4,156
"34631",1034631,148,87,9,244
"34632",1034632,149,40,4,193
"34633",1034633,65,126,9,200
"34634",1034634,227,72,21,320
"34635",1034635,168,33,8,209
"34636",1034636,8,1,1,10
"34637",1034637,54,193,2,249
"34638",1034638,149,33,6,188
"34639",1034639,145,18,5,168
"34640",1034640,96,51,2,149
"34641",1034641,79,107,8,194
"34642",1034642,226,25,5,256
"34643",1034643,142,156,17,315
"34644",1034644,70,159,4,233
"34645",1034645,193,39,8,240
"34646",1034646,57,149,6,212
"34647",1034647,151,125,9,285
"34648",1034648,70,84,14,168
"34649",1034649,163,71,8,242
"34650",1034650,102,43,5,150
"34651",1034651,196,6,4,206
"34652",1034652,159,71,6,236
"34653",1034653,201,58,12,271
"34654",1034654,86,196,5,287
"34655",1034655,223,28,8,259
"34656",1034656,95,108,4,207
"34657",1034657,189,47,4,240
"34658",1034658,61,197,9,267
"34659",1034659,63,136,6,205
"34660",1034660,85,52,2,139
"34661",1034661,68,190,11,269
"34662",1034662,50,0,0,50
"34663",1034663,86,48,4,138
"34664",1034664,81,158,8,247
"34665",1034665,222,33,14,269
"34666",1034666,196,59,11,266
"34667",1034667,62,50,5,117
"34668",1034668,126,174,6,306
"34669",1034669,48,112,1,161
"34670",1034670,42,33,5,80
"34671",1034671,54,249,1,304
"34672",1034672,103,69,8,180
"34673",1034673,176,41,11,228
"34674",1034674,53,285,5,343
"34675",1034675,140,106,6,252
"34676",1034676,11,75,2,88
"34677",1034677,226,37,14,277
"34678",1034678,109,108,11,228
"34679",1034679,96,35,1,132
"34680",1034680,49,241,5,295
"34681",1034681,190,71,11,272
"34682",1034682,2,5,1,8
"34683",1034683,123,49,3,175
"34684",1034684,102,10,4,116
"34685",1034685,123,111,3,237
"34686",1034686,209,102,16,327
"34687",1034687,44,98,6,148
"34688",1034688,154,108,21,283
"34689",1034689,3,4,1,8
"34690",1034690,68,100,9,177
"34691",1034691,96,50,12,158
"34692",1034692,165,148,3,316
"34693",1034693,128,22,3,153
"34694",1034694,130,103,14,247
"34695",1034695,102,138,10,250
"34696",1034696,97,41,7,145
"34697",1034697,29,202,11,242
"34698",1034698,119,172,19,310
"34699",1034699,142,54,6,202
"34700",1034700,17,169,1,187
"34701",1034701,216,33,8,257
"34702",1034702,70,179,25,274
"34703",1034703,151,88,19,258
"34704",1034704,26,280,14,320
"34705",1034705,234,13,27,274
"34706",1034706,185,49,12,246
"34707",1034707,88,26,3,117
"34708",1034708,107,102,10,219
"34709",1034709,35,149,8,192
"34710",1034710,99,177,3,279
"34711",1034711,77,81,17,175
"34712",1034712,34,124,4,162
"34713",1034713,137,27,7,171
"34714",1034714,58,249,10,317
"34715",1034715,152,82,4,238
"34716",1034716,130,90,12,232
"34717",1034717,155,51,8,214
"34718",1034718,192,90,25,307
"34719",1034719,70,234,12,316
"34720",1034720,156,80,9,245
"34721",1034721,100,0,0,100
"34722",1034722,185,36,9,230
"34723",1034723,91,22,7,120
"34724",1034724,90,66,13,169
"34725",1034725,70,160,17,247
"34726",1034726,174,54,11,239
"34727",1034727,62,255,17,334
"34728",1034728,22,36,2,60
"34729",1034729,80,122,5,207
"34730",1034730,83,173,3,259
"34731",1034731,47,173,8,228
"34732",1034732,132,2,1,135
"34733",1034733,48,204,1,253
"34734",1034734,164,48,10,222
"34735",1034735,86,214,9,309
"34736",1034736,47,188,18,253
"34737",1034737,46,231,0,277
"34738",1034738,29,193,2,224
"34739",1034739,65,167,9,241
"34740",1034740,191,56,17,264
"34741",1034741,128,110,9,247
"34742",1034742,23,8,0,31
"34743",1034743,109,141,18,268
"34744",1034744,135,43,3,181
"34745",1034745,52,210,9,271
"34746",1034746,101,31,2,134
"34747",1034747,60,232,6,298
"34748",1034748,23,233,2,258
"34749",1034749,171,66,6,243
"34750",1034750,91,162,4,257
"34751",1034751,94,115,22,231
"34752",1034752,47,197,11,255
"34753",1034753,157,130,5,292
"34754",1034754,120,130,10,260
"34755",1034755,82,150,5,237
"34756",1034756,200,43,7,250
"34757",1034757,25,248,2,275
"34758",1034758,41,271,8,320
"34759",1034759,98,111,8,217
"34760",1034760,224,83,13,320
"34761",1034761,101,227,10,338
"34762",1034762,67,234,13,314
"34763",1034763,189,65,6,260
"34764",1034764,171,118,14,303
"34765",1034765,19,154,3,176
"34766",1034766,140,131,14,285
"34767",1034767,112,201,9,322
"34768",1034768,121,48,12,181
"34769",1034769,148,38,2,188
"34770",1034770,189,31,16,236
"34771",1034771,20,327,4,351
"34772",1034772,191,25,6,222
"34773",1034773,73,247,11,331
"34774",1034774,108,79,9,196
"34775",1034775,224,17,12,253
"34776",1034776,50,266,6,322
"34777",1034777,71,229,17,317
"34778",1034778,48,158,2,208
"34779",1034779,302,3,2,307
"34780",1034780,146,83,9,238
"34781",1034781,158,88,6,252
"34782",1034782,145,69,2,216
"34783",1034783,223,75,11,309
"34784",1034784,184,59,12,255
"34785",1034785,59,170,4,233
"34786",1034786,113,81,7,201
"34787",1034787,10,21,0,31
"34788",1034788,174,95,7,276
"34789",1034789,78,147,9,234
"34790",1034790,6,92,2,100
"34791",1034791,92,144,3,239
"34792",1034792,134,129,9,272
"34793",1034793,24,287,7,318
"34794",1034794,84,19,3,106
"34795",1034795,47,213,14,274
"34796",1034796,134,56,12,202
"34797",1034797,125,156,7,288
"34798",1034798,128,83,6,217
"34799",1034799,38,240,10,288
"34800",1034800,59,249,11,319
"34801",1034801,111,88,9,208
"34802",1034802,174,60,8,242
"34803",1034803,30,254,1,285
"34804",1034804,90,188,11,289
"34805",1034805,4,8,1,13
"34806",1034806,144,74,2,220
"34807",1034807,179,11,4,194
"34808",1034808,97,109,6,212
"34809",1034809,154,117,9,280
"34810",1034810,44,132,2,178
"34811",1034811,126,51,4,181
"34812",1034812,139,100,6,245
"34813",1034813,78,250,8,336
"34814",1034814,29,25,7,61
"34815",1034815,206,56,2,264
"34816",1034816,92,60,7,159
"34817",1034817,208,73,15,296
"34818",1034818,36,21,6,63
"34819",1034819,59,165,7,231
"34820",1034820,134,68,10,212
"34821",1034821,135,38,8,181
"34822",1034822,105,152,9,266
"34823",1034823,89,101,16,206
"34824",1034824,15,6,2,23
"34825",1034825,194,73,4,271
"34826",1034826,97,91,7,195
"34827",1034827,44,115,14,173
"34828",1034828,29,180,2,211
"34829",1034829,40,201,8,249
"34830",1034830,66,20,1,87
"34831",1034831,148,27,2,177
"34832",1034832,69,82,1,152
"34833",1034833,192,39,6,237
"34834",1034834,67,160,10,237
"34835",1034835,133,104,4,241
"34836",1034836,35,2,1,38
"34837",1034837,75,214,17,306
"34838",1034838,78,184,7,269
"34839",1034839,67,211,5,283
"34840",1034840,171,126,14,311
"34841",1034841,202,24,4,230
"34842",1034842,135,125,25,285
"34843",1034843,68,163,4,235
"34844",1034844,73,172,13,258
"34845",1034845,128,137,16,281
"34846",1034846,157,37,2,196
"34847",1034847,132,87,9,228
"34848",1034848,87,27,2,116
"34849",1034849,111,164,10,285
"34850",1034850,199,103,21,323
"34851",1034851,84,217,8,309
"34852",1034852,150,43,6,199
"34853",1034853,121,94,2,217
"34854",1034854,139,133,11,283
"34855",1034855,84,84,9,177
"34856",1034856,73,196,25,294
"34857",1034857,47,42,6,95
"34858",1034858,99,64,0,163
"34859",1034859,78,55,7,140
"34860",1034860,23,9,2,34
"34861",1034861,242,74,19,335
"34862",1034862,91,94,12,197
"34863",1034863,26,199,2,227
"34864",1034864,46,145,4,195
"34865",1034865,227,26,9,262
"34866",1034866,19,98,1,118
"34867",1034867,132,13,7,152
"34868",1034868,29,190,4,223
"34869",1034869,77,62,5,144
"34870",1034870,104,19,6,129
"34871",1034871,89,51,6,146
"34872",1034872,186,78,5,269
"34873",1034873,173,42,16,231
"34874",1034874,179,96,6,281
"34875",1034875,148,82,10,240
"34876",1034876,150,141,14,305
"34877",1034877,48,293,6,347
"34878",1034878,171,66,15,252
"34879",1034879,88,26,6,120
"34880",1034880,87,186,12,285
"34881",1034881,83,131,3,217
"34882",1034882,16,12,0,28
"34883",1034883,152,121,13,286
"34884",1034884,32,221,4,257
"34885",1034885,246,19,4,269
"34886",1034886,91,133,9,233
"34887",1034887,91,172,15,278
"34888",1034888,72,111,5,188
"34889",1034889,22,283,7,312
"34890",1034890,131,36,9,176
"34891",1034891,124,193,9,326
"34892",1034892,70,4,3,77
"34893",1034893,198,64,15,277
"34894",1034894,160,88,16,264
"34895",1034895,80,180,18,278
"34896",1034896,72,143,7,222
"34897",1034897,188,51,6,245
"34898",1034898,126,158,12,296
"34899",1034899,126,18,2,146
"34900",1034900,256,43,19,318
"34901",1034901,44,24,3,71
"34902",1034902,83,180,30,293
"34903",1034903,49,166,6,221
"34904",1034904,155,93,13,261
"34905",1034905,136,152,17,305
"34906",1034906,114,88,10,212
"34907",1034907,139,28,7,174
"34908",1034908,39,84,5,128
"34909",1034909,30,112,3,145
"34910",1034910,230,20,7,257
"34911",1034911,201,69,8,278
"34912",1034912,195,87,13,295
"34913",1034913,27,201,5,233
"34914",1034914,102,74,4,180
"34915",1034915,47,244,7,298
"34916",1034916,58,150,4,212
"34917",1034917,134,108,16,258
"34918",1034918,115,127,8,250
"34919",1034919,31,243,3,277
"34920",1034920,85,166,8,259
"34921",1034921,254,51,12,317
"34922",1034922,73,140,9,222
"34923",1034923,27,277,3,307
"34924",1034924,167,97,10,274
"34925",1034925,15,17,3,35
"34926",1034926,79,28,9,116
"34927",1034927,129,142,1,272
"34928",1034928,21,25,2,48
"34929",1034929,87,84,1,172
"34930",1034930,137,83,12,232
"34931",1034931,4,7,0,11
"34932",1034932,115,132,10,257
"34933",1034933,38,257,2,297
"34934",1034934,47,224,7,278
"34935",1034935,124,67,19,210
"34936",1034936,178,133,12,323
"34937",1034937,152,107,40,299
"34938",1034938,66,68,0,134
"34939",1034939,75,153,11,239
"34940",1034940,86,142,8,236
"34941",1034941,224,105,13,342
"34942",1034942,87,34,9,130
"34943",1034943,28,212,7,247
"34944",1034944,131,79,7,217
"34945",1034945,74,150,4,228
"34946",1034946,67,196,9,272
"34947",1034947,225,25,2,252
"34948",1034948,105,114,7,226
"34949",1034949,45,195,4,244
"34950",1034950,127,134,4,265
"34951",1034951,52,155,6,213
"34952",1034952,54,252,7,313
"34953",1034953,101,158,11,270
"34954",1034954,46,170,7,223
"34955",1034955,143,57,10,210
"34956",1034956,106,27,2,135
"34957",1034957,32,242,1,275
"34958",1034958,135,23,10,168
"34959",1034959,186,91,12,289
"34960",1034960,162,68,8,238
"34961",1034961,191,123,14,328
"34962",1034962,45,31,1,77
"34963",1034963,4,8,2,14
"34964",1034964,115,141,15,271
"34965",1034965,107,47,3,157
"34966",1034966,24,178,11,213
"34967",1034967,124,78,12,214
"34968",1034968,76,234,20,330
"34969",1034969,146,146,3,295
"34970",1034970,46,59,6,111
"34971",1034971,155,86,6,247
"34972",1034972,17,3,4,24
"34973",1034973,195,40,5,240
"34974",1034974,97,13,0,110
"34975",1034975,106,40,27,173
"34976",1034976,189,78,3,270
"34977",1034977,154,42,9,205
"34978",1034978,206,36,8,250
"34979",1034979,87,268,6,361
"34980",1034980,141,14,1,156
"34981",1034981,139,96,16,251
"34982",1034982,38,9,1,48
"34983",1034983,25,157,5,187
"34984",1034984,226,63,3,292
"34985",1034985,161,80,6,247
"34986",1034986,93,119,17,229
"34987",1034987,188,65,15,268
"34988",1034988,161,73,8,242
"34989",1034989,26,254,2,282
"34990",1034990,47,190,8,245
"34991",1034991,255,6,9,270
"34992",1034992,53,55,10,118
"34993",1034993,103,60,9,172
"34994",1034994,151,20,5,176
"34995",1034995,45,10,4,59
"34996",1034996,57,199,12,268
"34997",1034997,9,7,2,18
"34998",1034998,113,147,8,268
"34999",1034999,211,21,5,237
"35000",1035000,161,101,12,274
"35001",1035001,86,170,17,273
"35002",1035002,93,23,0,116
"35003",1035003,35,231,9,275
"35004",1035004,66,188,2,256
"35005",1035005,88,225,7,320
"35006",1035006,15,221,4,240
"35007",1035007,169,48,9,226
"35008",1035008,150,17,8,175
"35009",1035009,193,22,3,218
"35010",1035010,49,242,4,295
"35011",1035011,103,48,10,161
"35012",1035012,47,163,5,215
"35013",1035013,155,78,13,246
"35014",1035014,207,86,7,300
"35015",1035015,108,134,12,254
"35016",1035016,154,61,7,222
"35017",1035017,124,77,3,204
"35018",1035018,173,101,5,279
"35019",1035019,29,220,5,254
"35020",1035020,108,31,3,142
"35021",1035021,167,97,10,274
"35022",1035022,90,83,9,182
"35023",1035023,71,179,11,261
"35024",1035024,243,13,2,258
"35025",1035025,29,230,3,262
"35026",1035026,70,171,11,252
"35027",1035027,8,4,1,13
"35028",1035028,136,61,5,202
"35029",1035029,64,210,8,282
"35030",1035030,15,67,2,84
"35031",1035031,163,120,18,301
"35032",1035032,134,76,6,216
"35033",1035033,92,153,7,252
"35034",1035034,190,11,4,205
"35035",1035035,66,131,13,210
"35036",1035036,152,140,14,306
"35037",1035037,200,73,0,273
"35038",1035038,6,1,0,7
"35039",1035039,113,107,15,235
"35040",1035040,25,27,4,56
"35041",1035041,109,29,3,141
"35042",1035042,185,54,5,244
"35043",1035043,143,21,2,166
"35044",1035044,72,69,5,146
"35045",1035045,139,31,6,176
"35046",1035046,58,196,14,268
"35047",1035047,27,166,8,201
"35048",1035048,158,146,7,311
"35049",1035049,57,262,14,333
"35050",1035050,67,68,14,149
"35051",1035051,122,54,5,181
"35052",1035052,131,86,6,223
"35053",1035053,160,102,8,270
"35054",1035054,47,44,4,95
"35055",1035055,83,86,7,176
"35056",1035056,134,67,9,210
"35057",1035057,145,80,9,234
"35058",1035058,23,246,0,269
"35059",1035059,116,128,10,254
"35060",1035060,122,117,18,257
"35061",1035061,67,163,16,246
"35062",1035062,151,68,17,236
"35063",1035063,44,81,11,136
"35064",1035064,70,202,5,277
"35065",1035065,177,61,15,253
"35066",1035066,143,49,10,202
"35067",1035067,56,121,11,188
"35068",1035068,120,115,10,245
"35069",1035069,19,212,7,238
"35070",1035070,135,156,24,315
"35071",1035071,200,30,11,241
"35072",1035072,212,39,5,256
"35073",1035073,82,223,15,320
"35074",1035074,6,2,1,9
"35075",1035075,155,15,8,178
"35076",1035076,63,149,11,223
"35077",1035077,87,73,13,173
"35078",1035078,120,146,12,278
"35079",1035079,152,87,7,246
"35080",1035080,127,129,15,271
"35081",1035081,21,129,4,154
"35082",1035082,82,118,10,210
"35083",1035083,32,23,0,55
"35084",1035084,51,197,8,256
"35085",1035085,139,18,3,160
"35086",1035086,79,146,19,244
"35087",1035087,39,188,15,242
"35088",1035088,41,260,6,307
"35089",1035089,122,185,9,316
"35090",1035090,147,112,12,271
"35091",1035091,138,109,11,258
"35092",1035092,140,118,6,264
"35093",1035093,60,46,1,107
"35094",1035094,67,108,8,183
"35095",1035095,145,60,2,207
"35096",1035096,73,354,7,434
"35097",1035097,138,17,5,160
"35098",1035098,24,268,1,293
"35099",1035099,25,322,7,354
"35100",1035100,124,11,4,139
"35101",1035101,89,90,14,193
"35102",1035102,239,9,5,253
"35103",1035103,73,41,14,128
"35104",1035104,117,99,3,219
"35105",1035105,166,121,13,300
"35106",1035106,25,210,2,237
"35107",1035107,38,193,3,234
"35108",1035108,195,52,4,251
"35109",1035109,353,62,12,427
"35110",1035110,43,177,5,225
"35111",1035111,205,76,23,304
"35112",1035112,41,143,6,190
"35113",1035113,13,272,2,287
"35114",1035114,98,62,2,162
"35115",1035115,38,176,1,215
"35116",1035116,186,37,8,231
"35117",1035117,182,28,9,219
"35118",1035118,85,129,3,217
"35119",1035119,73,184,7,264
"35120",1035120,203,59,1,263
"35121",1035121,71,24,3,98
"35122",1035122,70,44,2,116
"35123",1035123,107,113,8,228
"35124",1035124,44,188,4,236
"35125",1035125,43,135,10,188
"35126",1035126,109,146,16,271
"35127",1035127,104,161,16,281
"35128",1035128,119,17,3,139
"35129",1035129,199,71,12,282
"35130",1035130,94,169,13,276
"35131",1035131,101,52,8,161
"35132",1035132,152,5,6,163
"35133",1035133,259,22,7,288
"35134",1035134,101,46,11,158
"35135",1035135,133,13,2,148
"35136",1035136,98,130,1,229
"35137",1035137,129,76,9,214
"35138",1035138,210,43,12,265
"35139",1035139,163,86,4,253
"35140",1035140,49,27,1,77
"35141",1035141,104,111,11,226
"35142",1035142,38,300,2,340
"35143",1035143,122,177,7,306
"35144",1035144,88,143,7,238
"35145",1035145,163,42,4,209
"35146",1035146,135,51,8,194
"35147",1035147,227,27,4,258
"35148",1035148,72,165,4,241
"35149",1035149,218,28,1,247
"35150",1035150,91,146,15,252
"35151",1035151,84,14,0,98
"35152",1035152,95,131,14,240
"35153",1035153,157,115,7,279
"35154",1035154,177,59,4,240
"35155",1035155,118,100,9,227
"35156",1035156,111,71,8,190
"35157",1035157,78,153,14,245
"35158",1035158,80,15,2,97
"35159",1035159,34,207,2,243
"35160",1035160,194,96,15,305
"35161",1035161,49,189,10,248
"35162",1035162,130,135,5,270
"35163",1035163,9,46,0,55
"35164",1035164,161,11,0,172
"35165",1035165,174,110,9,293
"35166",1035166,97,14,5,116
"35167",1035167,68,176,3,247
"35168",1035168,56,167,2,225
"35169",1035169,71,184,4,259
"35170",1035170,86,177,16,279
"35171",1035171,98,68,5,171
"35172",1035172,180,102,8,290
"35173",1035173,111,26,8,145
"35174",1035174,63,73,2,138
"35175",1035175,43,200,2,245
"35176",1035176,128,98,8,234
"35177",1035177,122,50,7,179
"35178",1035178,176,85,10,271
"35179",1035179,104,110,11,225
"35180",1035180,109,5,2,116
"35181",1035181,114,172,11,297
"35182",1035182,133,22,6,161
"35183",1035183,133,134,14,281
"35184",1035184,173,83,14,270
"35185",1035185,67,183,8,258
"35186",1035186,160,60,10,230
"35187",1035187,183,41,19,243
"35188",1035188,164,60,3,227
"35189",1035189,37,236,12,285
"35190",1035190,174,63,13,250
"35191",1035191,110,204,5,319
"35192",1035192,41,46,8,95
"35193",1035193,146,98,11,255
"35194",1035194,129,79,0,208
"35195",1035195,22,105,5,132
"35196",1035196,138,114,5,257
"35197",1035197,54,225,0,279
"35198",1035198,250,34,18,302
"35199",1035199,23,236,6,265
"35200",1035200,154,48,11,213
"35201",1035201,193,85,16,294
"35202",1035202,57,108,3,168
"35203",1035203,31,51,0,82
"35204",1035204,156,172,12,340
"35205",1035205,235,12,8,255
"35206",1035206,92,36,3,131
"35207",1035207,86,14,3,103
"35208",1035208,37,202,8,247
"35209",1035209,209,28,7,244
"35210",1035210,157,131,17,305
"35211",1035211,78,186,1,265
"35212",1035212,113,89,10,212
"35213",1035213,125,94,9,228
"35214",1035214,209,37,10,256
"35215",1035215,247,13,6,266
"35216",1035216,178,136,14,328
"35217",1035217,213,93,16,322
"35218",1035218,158,99,1,258
"35219",1035219,75,142,4,221
"35220",1035220,209,29,3,241
"35221",1035221,168,37,11,216
"35222",1035222,66,183,12,261
"35223",1035223,78,199,10,287
"35224",1035224,146,109,6,261
"35225",1035225,165,59,10,234
"35226",1035226,59,92,3,154
"35227",1035227,172,154,15,341
"35228",1035228,79,206,5,290
"35229",1035229,234,55,11,300
"35230",1035230,63,193,16,272
"35231",1035231,182,93,10,285
"35232",1035232,233,20,6,259
"35233",1035233,11,4,2,17
"35234",1035234,143,165,18,326
"35235",1035235,146,61,23,230
"35236",1035236,43,219,9,271
"35237",1035237,64,126,12,202
"35238",1035238,17,54,1,72
"35239",1035239,46,70,7,123
"35240",1035240,135,135,8,278
"35241",1035241,98,62,4,164
"35242",1035242,206,43,5,254
"35243",1035243,138,51,7,196
"35244",1035244,168,90,16,274
"35245",1035245,106,140,12,258
"35246",1035246,8,23,1,32
"35247",1035247,169,61,14,244
"35248",1035248,116,125,4,245
"35249",1035249,104,75,10,189
"35250",1035250,82,160,9,251
"35251",1035251,127,65,6,198
"35252",1035252,165,52,11,228
"35253",1035253,26,227,5,258
"35254",1035254,231,41,7,279
"35255",1035255,114,148,4,266
"35256",1035256,71,220,6,297
"35257",1035257,60,36,3,99
"35258",1035258,220,30,4,254
"35259",1035259,89,152,11,252
"35260",1035260,183,112,10,305
"35261",1035261,197,26,5,228
"35262",1035262,229,40,10,279
"35263",1035263,137,104,7,248
"35264",1035264,35,249,3,287
"35265",1035265,159,21,3,183
"35266",1035266,30,170,5,205
"35267",1035267,140,1,1,142
"35268",1035268,56,219,9,284
"35269",1035269,153,92,8,253
"35270",1035270,65,161,10,236
"35271",1035271,83,246,1,330
"35272",1035272,64,3,1,68
"35273",1035273,150,72,14,236
"35274",1035274,199,15,5,219
"35275",1035275,217,35,7,259
"35276",1035276,340,84,27,451
"35277",1035277,86,181,11,278
"35278",1035278,34,69,2,105
"35279",1035279,171,67,17,255
"35280",1035280,40,140,8,188
"35281",1035281,95,98,9,202
"35282",1035282,29,8,1,38
"35283",1035283,272,6,11,289
"35284",1035284,147,65,4,216
"35285",1035285,97,62,2,161
"35286",1035286,66,182,12,260
"35287",1035287,177,124,14,315
"35288",1035288,13,21,2,36
"35289",1035289,124,145,5,274
"35290",1035290,19,83,2,104
"35291",1035291,90,52,6,148
"35292",1035292,242,48,15,305
"35293",1035293,72,37,9,118
"35294",1035294,168,27,8,203
"35295",1035295,63,18,1,82
"35296",1035296,40,30,1,71
"35297",1035297,85,82,7,174
"35298",1035298,76,160,6,242
"35299",1035299,47,165,0,212
"35300",1035300,54,203,6,263
"35301",1035301,6,6,1,13
"35302",1035302,156,60,11,227
"35303",1035303,13,69,2,84
"35304",1035304,61,103,10,174
"35305",1035305,64,159,1,224
"35306",1035306,108,85,10,203
"35307",1035307,242,222,65,529
"35308",1035308,109,106,12,227
"35309",1035309,117,25,4,146
"35310",1035310,143,82,6,231
"35311",1035311,92,348,6,446
"35312",1035312,29,169,1,199
"35313",1035313,198,76,10,284
"35314",1035314,133,49,9,191
"35315",1035315,127,188,12,327
"35316",1035316,76,82,6,164
"35317",1035317,127,63,1,191
"35318",1035318,51,151,7,209
"35319",1035319,57,187,5,249
"35320",1035320,120,45,4,169
"35321",1035321,72,7,2,81
"35322",1035322,110,171,10,291
"35323",1035323,50,31,1,82
"35324",1035324,148,173,6,327
"35325",1035325,91,60,5,156
"35326",1035326,67,208,16,291
"35327",1035327,124,18,6,148
"35328",1035328,3,1,0,4
"35329",1035329,106,396,14,516
"35330",1035330,12,36,1,49
"35331",1035331,112,73,6,191
"35332",1035332,227,18,10,255
"35333",1035333,103,90,23,216
"35334",1035334,165,25,11,201
"35335",1035335,50,128,4,182
"35336",1035336,2,15,5,22
"35337",1035337,99,201,14,314
"35338",1035338,147,42,5,194
"35339",1035339,12,4,0,16
"35340",1035340,227,66,5,298
"35341",1035341,245,28,5,278
"35342",1035342,200,53,9,262
"35343",1035343,48,253,2,303
"35344",1035344,127,181,7,315
"35345",1035345,68,23,4,95
"35346",1035346,212,154,9,375
"35347",1035347,101,145,2,248
"35348",1035348,99,140,26,265
"35349",1035349,140,26,7,173
"35350",1035350,22,221,6,249
"35351",1035351,216,70,14,300
"35352",1035352,93,158,16,267
"35353",1035353,100,57,6,163
"35354",1035354,35,279,5,319
"35355",1035355,65,84,18,167
"35356",1035356,123,155,27,305
"35357",1035357,181,114,11,306
"35358",1035358,85,56,6,147
"35359",1035359,132,80,8,220
"35360",1035360,37,169,2,208
"35361",1035361,44,24,4,72
"35362",1035362,7,36,4,47
"35363",1035363,50,166,8,224
"35364",1035364,148,142,16,306
"35365",1035365,158,33,11,202
"35366",1035366,182,43,7,232
"35367",1035367,76,183,24,283
"35368",1035368,102,124,13,239
"35369",1035369,149,131,10,290
"35370",1035370,5,10,2,17
"35371",1035371,147,78,11,236
"35372",1035372,57,194,4,255
"35373",1035373,92,197,11,300
"35374",1035374,15,23,2,40
"35375",1035375,225,18,5,248
"35376",1035376,37,78,2,117
"35377",1035377,178,63,9,250
"35378",1035378,68,106,10,184
"35379",1035379,334,87,40,461
"35380",1035380,136,63,4,203
"35381",1035381,177,15,6,198
"35382",1035382,29,140,2,171
"35383",1035383,168,31,1,200
"35384",1035384,128,52,10,190
"35385",1035385,5,44,0,49
"35386",1035386,180,45,7,232
"35387",1035387,174,44,1,219
"35388",1035388,63,26,5,94
"35389",1035389,142,76,3,221
"35390",1035390,115,50,6,171
"35391",1035391,173,34,12,219
"35392",1035392,144,107,8,259
"35393",1035393,68,273,10,351
"35394",1035394,123,14,2,139
"35395",1035395,70,193,10,273
"35396",1035396,72,112,21,205
"35397",1035397,40,180,1,221
"35398",1035398,121,2,0,123
"35399",1035399,181,54,17,252
"35400",1035400,32,14,0,46
"35401",1035401,217,12,6,235
"35402",1035402,165,36,4,205
"35403",1035403,125,60,15,200
"35404",1035404,48,106,21,175
"35405",1035405,121,143,16,280
"35406",1035406,21,213,23,257
"35407",1035407,166,97,7,270
"35408",1035408,95,52,4,151
"35409",1035409,22,10,2,34
"35410",1035410,77,144,14,235
"35411",1035411,14,19,0,33
"35412",1035412,217,96,20,333
"35413",1035413,196,83,9,288
"35414",1035414,139,98,9,246
"35415",1035415,146,25,2,173
"35416",1035416,100,69,8,177
"35417",1035417,146,42,2,190
"35418",1035418,157,119,18,294
"35419",1035419,200,90,15,305
"35420",1035420,122,98,8,228
"35421",1035421,128,154,5,287
"35422",1035422,121,301,24,446
"35423",1035423,57,237,7,301
"35424",1035424,120,184,10,314
"35425",1035425,36,190,3,229
"35426",1035426,148,22,6,176
"35427",1035427,106,35,2,143
"35428",1035428,135,85,8,228
"35429",1035429,153,47,6,206
"35430",1035430,22,90,2,114
"35431",1035431,114,66,3,183
"35432",1035432,21,284,4,309
"35433",1035433,127,87,8,222
"35434",1035434,64,176,15,255
"35435",1035435,23,62,3,88
"35436",1035436,15,153,3,171
"35437",1035437,173,66,2,241
"35438",1035438,77,151,9,237
"35439",1035439,92,45,9,146
"35440",1035440,184,52,7,243
"35441",1035441,123,87,5,215
"35442",1035442,25,9,1,35
"35443",1035443,171,118,5,294
"35444",1035444,48,185,18,251
"35445",1035445,77,228,4,309
"35446",1035446,20,138,7,165
"35447",1035447,175,79,14,268
"35448",1035448,212,40,6,258
"35449",1035449,100,131,15,246
"35450",1035450,16,6,0,22
"35451",1035451,146,11,7,164
"35452",1035452,168,35,5,208
"35453",1035453,101,23,5,129
"35454",1035454,176,45,11,232
"35455",1035455,130,47,13,190
"35456",1035456,39,36,2,77
"35457",1035457,47,165,17,229
"35458",1035458,116,194,9,319
"35459",1035459,165,74,15,254
"35460",1035460,167,65,11,243
"35461",1035461,140,71,5,216
"35462",1035462,30,181,5,216
"35463",1035463,32,266,5,303
"35464",1035464,111,113,20,244
"35465",1035465,255,40,6,301
"35466",1035466,159,1,0,160
"35467",1035467,64,151,9,224
"35468",1035468,91,180,8,279
"35469",1035469,57,80,7,144
"35470",1035470,55,157,3,215
"35471",1035471,139,81,7,227
"35472",1035472,47,94,4,145
"35473",1035473,69,200,3,272
"35474",1035474,133,64,4,201
"35475",1035475,118,165,25,308
"35476",1035476,194,1,0,195
"35477",1035477,165,55,1,221
"35478",1035478,111,28,6,145
"35479",1035479,54,136,8,198
"35480",1035480,51,166,8,225
"35481",1035481,113,23,2,138
"35482",1035482,128,74,7,209
"35483",1035483,69,38,16,123
"35484",1035484,5,2,1,8
"35485",1035485,185,108,16,309
"35486",1035486,3,10,0,13
"35487",1035487,71,152,2,225
"35488",1035488,79,129,27,235
"35489",1035489,141,73,16,230
"35490",1035490,11,47,3,61
"35491",1035491,191,69,10,270
"35492",1035492,176,112,10,298
"35493",1035493,128,98,7,233
"35494",1035494,87,102,18,207
"35495",1035495,53,205,12,270
"35496",1035496,164,114,13,291
"35497",1035497,177,42,11,230
"35498",1035498,178,70,7,255
"35499",1035499,32,89,11,132
"35500",1035500,111,68,11,190
"35501",1035501,111,43,4,158
"35502",1035502,196,106,13,315
"35503",1035503,20,239,9,268
"35504",1035504,160,50,6,216
"35505",1035505,84,241,18,343
"35506",1035506,168,51,5,224
"35507",1035507,116,81,3,200
"35508",1035508,102,39,4,145
"35509",1035509,95,107,7,209
"35510",1035510,188,70,0,258
"35511",1035511,188,63,12,263
"35512",1035512,195,74,8,277
"35513",1035513,91,196,17,304
"35514",1035514,148,68,14,230
"35515",1035515,103,53,4,160
"35516",1035516,52,216,5,273
"35517",1035517,154,67,10,231
"35518",1035518,161,10,2,173
"35519",1035519,159,110,7,276
"35520",1035520,128,88,9,225
"35521",1035521,187,55,8,250
"35522",1035522,45,39,6,90
"35523",1035523,176,95,3,274
"35524",1035524,99,156,11,266
"35525",1035525,70,130,7,207
"35526",1035526,62,283,8,353
"35527",1035527,132,29,2,163
"35528",1035528,105,30,4,139
"35529",1035529,177,68,7,252
"35530",1035530,4,87,1,92
"35531",1035531,60,29,5,94
"35532",1035532,51,89,7,147
"35533",1035533,146,96,13,255
"35534",1035534,221,16,8,245
"35535",1035535,108,44,8,160
"35536",1035536,34,262,1,297
"35537",1035537,143,45,9,197
"35538",1035538,161,35,5,201
"35539",1035539,164,32,6,202
"35540",1035540,58,192,7,257
"35541",1035541,184,53,6,243
"35542",1035542,201,51,10,262
"35543",1035543,40,207,6,253
"35544",1035544,47,221,8,276
"35545",1035545,111,220,11,342
"35546",1035546,209,99,5,313
"35547",1035547,240,64,5,309
"35548",1035548,54,50,2,106
"35549",1035549,14,5,0,19
"35550",1035550,82,208,13,303
"35551",1035551,63,50,5,118
"35552",1035552,3,0,1,4
"35553",1035553,114,101,12,227
"35554",1035554,104,196,3,303
"35555",1035555,17,93,2,112
"35556",1035556,195,44,9,248
"35557",1035557,13,46,4,63
"35558",1035558,171,8,21,200
"35559",1035559,147,35,6,188
"35560",1035560,66,66,5,137
"35561",1035561,122,136,13,271
"35562",1035562,143,4,3,150
"35563",1035563,147,22,7,176
"35564",1035564,100,162,11,273
"35565",1035565,24,102,3,129
"35566",1035566,209,26,4,239
"35567",1035567,53,189,11,253
"35568",1035568,52,238,3,293
"35569",1035569,171,34,7,212
"35570",1035570,61,204,13,278
"35571",1035571,87,36,13,136
"35572",1035572,107,29,4,140
"35573",1035573,58,388,7,453
"35574",1035574,36,4,2,42
"35575",1035575,84,166,3,253
"35576",1035576,249,0,0,249
"35577",1035577,221,25,4,250
"35578",1035578,60,207,1,268
"35579",1035579,184,96,10,290
"35580",1035580,61,25,2,88
"35581",1035581,75,44,9,128
"35582",1035582,110,167,11,288
"35583",1035583,142,90,7,239
"35584",1035584,91,208,4,303
"35585",1035585,44,158,3,205
"35586",1035586,58,245,8,311
"35587",1035587,70,177,9,256
"35588",1035588,106,3,2,111
"35589",1035589,11,222,2,235
"35590",1035590,131,112,14,257
"35591",1035591,162,43,14,219
"35592",1035592,60,92,10,162
"35593",1035593,152,123,15,290
"35594",1035594,123,52,2,177
"35595",1035595,127,49,4,180
"35596",1035596,147,106,2,255
"35597",1035597,58,56,6,120
"35598",1035598,61,234,4,299
"35599",1035599,87,46,15,148
"35600",1035600,140,138,11,289
"35601",1035601,59,122,5,186
"35602",1035602,33,7,1,41
"35603",1035603,1,6,0,7
"35604",1035604,157,62,9,228
"35605",1035605,162,86,2,250
"35606",1035606,150,50,5,205
"35607",1035607,91,133,12,236
"35608",1035608,85,120,2,207
"35609",1035609,115,73,17,205
"35610",1035610,123,17,6,146
"35611",1035611,82,38,6,126
"35612",1035612,32,165,9,206
"35613",1035613,114,109,5,228
"35614",1035614,79,197,19,295
"35615",1035615,81,82,5,168
"35616",1035616,138,93,4,235
"35617",1035617,24,36,4,64
"35618",1035618,226,42,11,279
"35619",1035619,151,41,4,196
"35620",1035620,59,174,6,239
"35621",1035621,156,81,14,251
"35622",1035622,20,49,1,70
"35623",1035623,119,161,7,287
"35624",1035624,215,92,17,324
"35625",1035625,198,0,0,198
"35626",1035626,99,133,5,237
"35627",1035627,102,104,6,212
"35628",1035628,198,139,4,341
"35629",1035629,139,71,15,225
"35630",1035630,105,100,4,209
"35631",1035631,175,122,10,307
"35632",1035632,134,110,19,263
"35633",1035633,203,30,11,244
"35634",1035634,50,190,5,245
"35635",1035635,5,37,0,42
"35636",1035636,237,48,6,291
"35637",1035637,101,123,5,229
"35638",1035638,104,151,19,274
"35639",1035639,49,190,7,246
"35640",1035640,141,58,2,201
"35641",1035641,210,65,10,285
"35642",1035642,235,17,2,254
"35643",1035643,112,139,11,262
"35644",1035644,186,71,2,259
"35645",1035645,16,36,1,53
"35646",1035646,198,15,11,224
"35647",1035647,113,108,11,232
"35648",1035648,141,66,8,215
"35649",1035649,65,142,12,219
"35650",1035650,75,102,7,184
"35651",1035651,88,235,4,327
"35652",1035652,120,2,7,129
"35653",1035653,242,58,9,309
"35654",1035654,65,108,14,187
"35655",1035655,33,101,7,141
"35656",1035656,37,227,11,275
"35657",1035657,131,95,7,233
"35658",1035658,136,111,9,256
"35659",1035659,74,79,5,158
"35660",1035660,30,223,9,262
"35661",1035661,129,37,5,171
"35662",1035662,175,36,11,222
"35663",1035663,162,74,14,250
"35664",1035664,194,109,14,317
"35665",1035665,222,85,19,326
"35666",1035666,100,192,10,302
"35667",1035667,39,175,5,219
"35668",1035668,104,138,9,251
"35669",1035669,108,30,5,143
"35670",1035670,23,72,3,98
"35671",1035671,80,72,12,164
"35672",1035672,22,61,1,84
"35673",1035673,85,65,9,159
"35674",1035674,61,196,11,268
"35675",1035675,81,155,6,242
"35676",1035676,140,112,14,266
"35677",1035677,104,90,11,205
"35678",1035678,115,43,8,166
"35679",1035679,116,61,3,180
"35680",1035680,101,71,5,177
"35681",1035681,170,96,4,270
"35682",1035682,165,55,4,224
"35683",1035683,120,134,10,264
"35684",1035684,243,20,8,271
"35685",1035685,151,121,19,291
"35686",1035686,63,22,3,88
"35687",1035687,152,123,17,292
"35688",1035688,5,30,0,35
"35689",1035689,55,271,8,334
"35690",1035690,220,22,5,247
"35691",1035691,176,46,10,232
"35692",1035692,161,54,6,221
"35693",1035693,196,35,12,243
"35694",1035694,27,139,6,172
"35695",1035695,199,102,20,321
"35696",1035696,69,6,2,77
"35697",1035697,208,88,12,308
"35698",1035698,174,102,11,287
"35699",1035699,146,59,12,217
"35700",1035700,54,188,1,243
"35701",1035701,54,202,7,263
"35702",1035702,197,35,8,240
"35703",1035703,206,76,28,310
"35704",1035704,99,91,7,197
"35705",1035705,279,10,4,293
"35706",1035706,79,170,7,256
"35707",1035707,86,188,8,282
"35708",1035708,108,79,15,202
"35709",1035709,16,81,0,97
"35710",1035710,137,57,14,208
"35711",1035711,30,134,0,164
"35712",1035712,226,51,20,297
"35713",1035713,45,171,8,224
"35714",1035714,38,232,6,276
"35715",1035715,112,131,4,247
"35716",1035716,281,7,9,297
"35717",1035717,182,109,28,319
"35718",1035718,40,119,15,174
"35719",1035719,158,68,6,232
"35720",1035720,138,41,3,182
"35721",1035721,172,51,13,236
"35722",1035722,170,18,7,195
"35723",1035723,60,170,11,241
"35724",1035724,65,16,5,86
"35725",1035725,106,168,15,289
"35726",1035726,211,78,15,304
"35727",1035727,19,3,2,24
"35728",1035728,145,35,12,192
"35729",1035729,56,237,13,306
"35730",1035730,125,110,6,241
"35731",1035731,193,39,7,239
"35732",1035732,267,15,7,289
"35733",1035733,29,133,7,169
"35734",1035734,41,84,6,131
"35735",1035735,162,115,17,294
"35736",1035736,47,136,10,193
"35737",1035737,149,79,6,234
"35738",1035738,202,110,12,324
"35739",1035739,99,55,5,159
"35740",1035740,70,81,7,158
"35741",1035741,95,61,10,166
"35742",1035742,111,143,19,273
"35743",1035743,244,62,8,314
"35744",1035744,106,30,1,137
"35745",1035745,143,21,3,167
"35746",1035746,24,66,1,91
"35747",1035747,33,107,3,143
"35748",1035748,9,137,1,147
"35749",1035749,166,66,11,243
"35750",1035750,160,99,26,285
"35751",1035751,238,34,15,287
"35752",1035752,8,24,4,36
"35753",1035753,78,146,7,231
"35754",1035754,224,73,10,307
"35755",1035755,50,248,9,307
"35756",1035756,211,88,10,309
"35757",1035757,17,11,2,30
"35758",1035758,228,13,2,243
"35759",1035759,84,19,2,105
"35760",1035760,156,68,7,231
"35761",1035761,151,96,6,253
"35762",1035762,135,60,8,203
"35763",1035763,159,94,11,264
"35764",1035764,102,67,9,178
"35765",1035765,47,234,5,286
"35766",1035766,89,140,25,254
"35767",1035767,72,221,6,299
"35768",1035768,85,145,4,234
"35769",1035769,101,63,5,169
"35770",1035770,142,77,11,230
"35771",1035771,139,58,5,202
"35772",1035772,112,154,10,276
"35773",1035773,90,141,10,241
"35774",1035774,54,152,3,209
"35775",1035775,44,271,16,331
"35776",1035776,88,88,12,188
"35777",1035777,144,31,9,184
"35778",1035778,96,153,8,257
"35779",1035779,84,154,7,245
"35780",1035780,143,77,1,221
"35781",1035781,155,59,7,221
"35782",1035782,146,134,12,292
"35783",1035783,60,32,2,94
"35784",1035784,116,95,8,219
"35785",1035785,82,76,12,170
"35786",1035786,91,193,4,288
"35787",1035787,30,72,7,109
"35788",1035788,84,69,10,163
"35789",1035789,47,258,5,310
"35790",1035790,19,206,2,227
"35791",1035791,148,135,16,299
"35792",1035792,19,136,5,160
"35793",1035793,84,88,21,193
"35794",1035794,119,25,11,155
"35795",1035795,78,79,12,169
"35796",1035796,122,31,5,158
"35797",1035797,34,268,5,307
"35798",1035798,110,178,3,291
"35799",1035799,160,65,3,228
"35800",1035800,136,135,1,272
"35801",1035801,65,169,18,252
"35802",1035802,61,131,4,196
"35803",1035803,121,106,15,242
"35804",1035804,184,28,4,216
"35805",1035805,156,83,8,247
"35806",1035806,164,84,18,266
"35807",1035807,103,84,10,197
"35808",1035808,178,47,11,236
"35809",1035809,127,13,2,142
"35810",1035810,59,19,1,79
"35811",1035811,228,61,22,311
"35812",1035812,133,164,20,317
"35813",1035813,40,68,4,112
"35814",1035814,94,86,12,192
"35815",1035815,31,157,5,193
"35816",1035816,96,181,6,283
"35817",1035817,55,180,6,241
"35818",1035818,189,67,11,267
"35819",1035819,10,312,1,323
"35820",1035820,134,150,32,316
"35821",1035821,233,47,4,284
"35822",1035822,175,31,21,227
"35823",1035823,208,88,6,302
"35824",1035824,88,223,15,326
"35825",1035825,166,79,16,261
"35826",1035826,63,176,3,242
"35827",1035827,7,8,1,16
"35828",1035828,88,164,7,259
"35829",1035829,82,191,14,287
"35830",1035830,89,168,5,262
"35831",1035831,125,13,9,147
"35832",1035832,10,21,2,33
"35833",1035833,48,73,5,126
"35834",1035834,194,100,12,306
"35835",1035835,5,45,2,52
"35836",1035836,33,243,1,277
"35837",1035837,161,69,1,231
"35838",1035838,8,5,1,14
"35839",1035839,112,59,6,177
"35840",1035840,113,33,3,149
"35841",1035841,157,18,2,177
"35842",1035842,130,158,18,306
"35843",1035843,98,10,0,108
"35844",1035844,199,114,5,318
"35845",1035845,178,127,12,317
"35846",1035846,221,44,9,274
"35847",1035847,91,195,20,306
"35848",1035848,27,128,1,156
"35849",1035849,44,45,2,91
"35850",1035850,124,134,6,264
"35851",1035851,7,11,0,18
"35852",1035852,258,21,22,301
"35853",1035853,138,112,8,258
"35854",1035854,260,29,1,290
"35855",1035855,169,64,12,245
"35856",1035856,155,98,13,266
"35857",1035857,126,38,5,169
"35858",1035858,154,157,14,325
"35859",1035859,83,148,11,242
"35860",1035860,226,53,15,294
"35861",1035861,24,24,3,51
"35862",1035862,178,98,12,288
"35863",1035863,47,32,2,81
"35864",1035864,121,20,29,170
"35865",1035865,178,31,4,213
"35866",1035866,251,55,12,318
"35867",1035867,79,142,5,226
"35868",1035868,72,167,6,245
"35869",1035869,3,18,1,22
"35870",1035870,65,216,2,283
"35871",1035871,34,180,5,219
"35872",1035872,154,59,9,222
"35873",1035873,192,67,13,272
"35874",1035874,56,214,12,282
"35875",1035875,28,193,4,225
"35876",1035876,76,219,9,304
"35877",1035877,213,21,8,242
"35878",1035878,129,39,2,170
"35879",1035879,25,168,2,195
"35880",1035880,208,41,10,259
"35881",1035881,169,58,14,241
"35882",1035882,45,218,4,267
"35883",1035883,191,33,11,235
"35884",1035884,69,9,0,78
"35885",1035885,188,24,0,212
"35886",1035886,7,71,0,78
"35887",1035887,180,118,4,302
"35888",1035888,138,13,5,156
"35889",1035889,88,196,6,290
"35890",1035890,108,138,1,247
"35891",1035891,24,15,0,39
"35892",1035892,200,13,5,218
"35893",1035893,38,240,8,286
"35894",1035894,77,104,16,197
"35895",1035895,141,74,6,221
"35896",1035896,17,10,0,27
"35897",1035897,57,130,11,198
"35898",1035898,195,2,1,198
"35899",1035899,56,154,6,216
"35900",1035900,194,30,10,234
"35901",1035901,164,60,4,228
"35902",1035902,35,239,3,277
"35903",1035903,60,135,17,212
"35904",1035904,71,29,2,102
"35905",1035905,178,41,3,222
"35906",1035906,39,312,5,356
"35907",1035907,182,134,9,325
"35908",1035908,93,141,4,238
"35909",1035909,116,51,12,179
"35910",1035910,166,48,14,228
"35911",1035911,140,14,6,160
"35912",1035912,187,66,7,260
"35913",1035913,11,163,7,181
"35914",1035914,153,20,4,177
"35915",1035915,155,51,4,210
"35916",1035916,127,78,13,218
"35917",1035917,23,139,4,166
"35918",1035918,221,41,8,270
"35919",1035919,113,110,12,235
"35920",1035920,45,85,5,135
"35921",1035921,42,155,5,202
"35922",1035922,160,68,6,234
"35923",1035923,40,223,2,265
"35924",1035924,132,34,8,174
"35925",1035925,145,92,14,251
"35926",1035926,197,56,10,263
"35927",1035927,135,177,13,325
"35928",1035928,171,139,12,322
"35929",1035929,48,100,4,152
"35930",1035930,99,37,5,141
"35931",1035931,205,84,21,310
"35932",1035932,160,71,5,236
"35933",1035933,24,25,5,54
"35934",1035934,190,17,7,214
"35935",1035935,74,88,7,169
"35936",1035936,50,111,3,164
"35937",1035937,40,32,5,77
"35938",1035938,130,117,2,249
"35939",1035939,48,41,6,95
"35940",1035940,83,158,11,252
"35941",1035941,130,144,14,288
"35942",1035942,105,20,6,131
"35943",1035943,149,118,11,278
"35944",1035944,28,21,3,52
"35945",1035945,88,182,11,281
"35946",1035946,45,237,8,290
"35947",1035947,234,90,18,342
"35948",1035948,87,220,9,316
"35949",1035949,45,238,8,291
"35950",1035950,202,73,7,282
"35951",1035951,29,18,0,47
"35952",1035952,38,225,5,268
"35953",1035953,15,25,3,43
"35954",1035954,112,91,10,213
"35955",1035955,89,142,5,236
"35956",1035956,27,200,4,231
"35957",1035957,154,74,6,234
"35958",1035958,179,81,5,265
"35959",1035959,81,221,10,312
"35960",1035960,202,72,14,288
"35961",1035961,184,90,8,282
"35962",1035962,158,71,9,238
"35963",1035963,58,120,7,185
"35964",1035964,71,58,5,134
"35965",1035965,84,126,1,211
"35966",1035966,100,81,16,197
"35967",1035967,113,78,12,203
"35968",1035968,73,43,14,130
"35969",1035969,30,104,8,142
"35970",1035970,214,64,12,290
"35971",1035971,185,55,21,261
"35972",1035972,162,77,8,247
"35973",1035973,34,160,1,195
"35974",1035974,63,39,0,102
"35975",1035975,99,138,11,248
"35976",1035976,214,4,0,218
"35977",1035977,13,59,1,73
"35978",1035978,13,63,0,76
"35979",1035979,207,42,4,253
"35980",1035980,42,35,5,82
"35981",1035981,178,63,7,248
"35982",1035982,144,95,7,246
"35983",1035983,104,116,6,226
"35984",1035984,162,97,4,263
"35985",1035985,134,97,19,250
"35986",1035986,194,62,5,261
"35987",1035987,193,31,16,240
"35988",1035988,27,42,3,72
"35989",1035989,174,82,1,257
"35990",1035990,129,74,13,216
"35991",1035991,54,188,11,253
"35992",1035992,151,111,11,273
"35993",1035993,15,222,2,239
"35994",1035994,116,97,2,215
"35995",1035995,75,87,17,179
"35996",1035996,88,227,7,322
"35997",1035997,0,6,0,6
"35998",1035998,87,18,3,108
"35999",1035999,53,48,2,103
"36000",1036000,21,202,3,226
"36001",1036001,126,46,8,180
"36002",1036002,147,45,4,196
"36003",1036003,94,183,11,288
"36004",1036004,49,198,8,255
"36005",1036005,135,44,2,181
"36006",1036006,72,190,7,269
"36007",1036007,127,136,7,270
"36008",1036008,22,9,0,31
"36009",1036009,71,89,5,165
"36010",1036010,162,51,5,218
"36011",1036011,86,112,19,217
"36012",1036012,119,51,14,184
"36013",1036013,19,160,3,182
"36014",1036014,107,51,2,160
"36015",1036015,23,265,10,298
"36016",1036016,73,121,8,202
"36017",1036017,153,51,10,214
"36018",1036018,166,85,8,259
"36019",1036019,135,81,13,229
"36020",1036020,186,82,10,278
"36021",1036021,168,69,12,249
"36022",1036022,97,176,23,296
"36023",1036023,188,57,10,255
"36024",1036024,84,121,10,215
"36025",1036025,114,198,13,325
"36026",1036026,193,40,4,237
"36027",1036027,158,59,1,218
"36028",1036028,68,33,2,103
"36029",1036029,184,8,3,195
"36030",1036030,219,30,6,255
"36031",1036031,65,64,3,132
"36032",1036032,193,28,5,226
"36033",1036033,135,196,7,338
"36034",1036034,61,220,12,293
"36035",1036035,116,148,6,270
"36036",1036036,255,35,6,296
"36037",1036037,48,239,6,293
"36038",1036038,98,146,25,269
"36039",1036039,69,162,14,245
"36040",1036040,154,114,15,283
"36041",1036041,162,87,10,259
"36042",1036042,67,167,12,246
"36043",1036043,61,30,1,92
"36044",1036044,91,171,1,263
"36045",1036045,67,72,7,146
"36046",1036046,95,116,7,218
"36047",1036047,89,160,4,253
"36048",1036048,142,63,5,210
"36049",1036049,107,119,17,243
"36050",1036050,28,1,0,29
"36051",1036051,117,111,11,239
"36052",1036052,201,97,21,319
"36053",1036053,124,121,5,250
"36054",1036054,2,22,2,26
"36055",1036055,53,49,4,106
"36056",1036056,197,62,13,272
"36057",1036057,87,148,9,244
"36058",1036058,55,9,1,65
"36059",1036059,160,46,2,208
"36060",1036060,128,64,4,196
"36061",1036061,91,49,3,143
"36062",1036062,139,88,10,237
"36063",1036063,28,188,11,227
"36064",1036064,186,45,14,245
"36065",1036065,98,169,5,272
"36066",1036066,208,70,21,299
"36067",1036067,153,27,4,184
"36068",1036068,142,77,11,230
"36069",1036069,127,107,10,244
"36070",1036070,228,82,6,316
"36071",1036071,174,95,28,297
"36072",1036072,120,62,6,188
"36073",1036073,107,83,5,195
"36074",1036074,229,50,6,285
"36075",1036075,139,77,13,229
"36076",1036076,66,15,4,85
"36077",1036077,119,125,25,269
"36078",1036078,135,30,5,170
"36079",1036079,84,53,3,140
"36080",1036080,110,128,14,252
"36081",1036081,154,32,12,198
"36082",1036082,111,123,8,242
"36083",1036083,92,62,10,164
"36084",1036084,41,236,8,285
"36085",1036085,274,37,14,325
"36086",1036086,98,178,18,294
"36087",1036087,193,15,14,222
"36088",1036088,108,38,15,161
"36089",1036089,157,59,10,226
"36090",1036090,107,29,4,140
"36091",1036091,134,105,7,246
"36092",1036092,147,80,8,235
"36093",1036093,147,48,9,204
"36094",1036094,130,96,13,239
"36095",1036095,160,149,24,333
"36096",1036096,114,84,10,208
"36097",1036097,117,33,6,156
"36098",1036098,29,50,1,80
"36099",1036099,161,23,4,188
"36100",1036100,177,149,8,334
"36101",1036101,155,83,1,239
"36102",1036102,205,43,9,257
"36103",1036103,134,200,13,347
"36104",1036104,4,57,3,64
"36105",1036105,6,98,0,104
"36106",1036106,188,25,7,220
"36107",1036107,32,0,1,33
"36108",1036108,94,65,11,170
"36109",1036109,172,88,27,287
"36110",1036110,80,2,1,83
"36111",1036111,73,183,8,264
"36112",1036112,167,100,24,291
"36113",1036113,166,33,10,209
"36114",1036114,73,181,9,263
"36115",1036115,124,144,13,281
"36116",1036116,142,39,9,190
"36117",1036117,64,103,11,178
"36118",1036118,46,100,5,151
"36119",1036119,28,192,5,225
"36120",1036120,179,58,6,243
"36121",1036121,86,45,8,139
"36122",1036122,111,44,5,160
"36123",1036123,106,119,8,233
"36124",1036124,82,26,1,109
"36125",1036125,175,110,9,294
"36126",1036126,214,71,10,295
"36127",1036127,189,31,8,228
"36128",1036128,42,10,5,57
"36129",1036129,65,165,6,236
"36130",1036130,113,143,8,264
"36131",1036131,109,242,10,361
"36132",1036132,66,85,4,155
"36133",1036133,190,40,7,237
"36134",1036134,33,158,14,205
"36135",1036135,18,19,1,38
"36136",1036136,138,83,1,222
"36137",1036137,153,168,24,345
"36138",1036138,56,188,23,267
"36139",1036139,49,35,2,86
"36140",1036140,79,139,3,221
"36141",1036141,46,221,17,284
"36142",1036142,94,71,11,176
"36143",1036143,84,7,0,91
"36144",1036144,193,40,1,234
"36145",1036145,241,44,3,288
"36146",1036146,171,45,8,224
"36147",1036147,49,160,8,217
"36148",1036148,80,212,13,305
"36149",1036149,106,107,3,216
"36150",1036150,45,271,4,320
"36151",1036151,191,23,8,222
"36152",1036152,65,115,9,189
"36153",1036153,67,165,5,237
"36154",1036154,88,91,12,191
"36155",1036155,144,102,6,252
"36156",1036156,199,40,1,240
"36157",1036157,95,25,2,122
"36158",1036158,67,159,7,233
"36159",1036159,48,172,10,230
"36160",1036160,89,142,14,245
"36161",1036161,53,111,1,165
"36162",1036162,49,188,4,241
"36163",1036163,165,48,12,225
"36164",1036164,119,123,14,256
"36165",1036165,102,80,10,192
"36166",1036166,69,178,10,257
"36167",1036167,58,63,8,129
"36168",1036168,80,189,7,276
"36169",1036169,52,25,4,81
"36170",1036170,108,133,10,251
"36171",1036171,75,147,4,226
"36172",1036172,54,38,3,95
"36173",1036173,137,71,8,216
"36174",1036174,155,66,3,224
"36175",1036175,26,190,1,217
"36176",1036176,27,156,5,188
"36177",1036177,94,15,3,112
"36178",1036178,73,190,13,276
"36179",1036179,23,213,7,243
"36180",1036180,103,168,9,280
"36181",1036181,170,54,5,229
"36182",1036182,77,176,10,263
"36183",1036183,72,143,11,226
"36184",1036184,131,74,4,209
"36185",1036185,127,63,4,194
"36186",1036186,55,24,1,80
"36187",1036187,28,188,3,219
"36188",1036188,131,45,4,180
"36189",1036189,238,35,4,277
"36190",1036190,19,178,7,204
"36191",1036191,31,17,2,50
"36192",1036192,83,80,6,169
"36193",1036193,62,234,5,301
"36194",1036194,106,74,7,187
"36195",1036195,135,104,12,251
"36196",1036196,129,164,6,299
"36197",1036197,114,140,7,261
"36198",1036198,232,11,3,246
"36199",1036199,10,84,2,96
"36200",1036200,93,57,17,167
"36201",1036201,112,64,7,183
"36202",1036202,139,61,10,210
"36203",1036203,209,24,4,237
"36204",1036204,40,12,1,53
"36205",1036205,105,16,3,124
"36206",1036206,93,84,6,183
"36207",1036207,115,126,3,244
"36208",1036208,104,169,14,287
"36209",1036209,85,230,3,318
"36210",1036210,94,161,8,263
"36211",1036211,86,183,12,281
"36212",1036212,176,89,16,281
"36213",1036213,106,24,5,135
"36214",1036214,21,7,1,29
"36215",1036215,211,41,13,265
"36216",1036216,13,0,0,13
"36217",1036217,84,138,3,225
"36218",1036218,90,33,4,127
"36219",1036219,170,62,5,237
"36220",1036220,124,112,4,240
"36221",1036221,57,138,12,207
"36222",1036222,79,238,11,328
"36223",1036223,26,259,6,291
"36224",1036224,45,222,2,269
"36225",1036225,61,210,10,281
"36226",1036226,10,9,4,23
"36227",1036227,43,21,1,65
"36228",1036228,50,177,13,240
"36229",1036229,209,90,18,317
"36230",1036230,181,20,8,209
"36231",1036231,137,38,5,180
"36232",1036232,251,44,12,307
"36233",1036233,264,1,6,271
"36234",1036234,86,116,17,219
"36235",1036235,166,48,9,223
"36236",1036236,110,71,6,187
"36237",1036237,205,15,7,227
"36238",1036238,134,123,9,266
"36239",1036239,99,156,9,264
"36240",1036240,187,62,8,257
"36241",1036241,224,69,11,304
"36242",1036242,132,34,5,171
"36243",1036243,44,146,8,198
"36244",1036244,226,53,14,293
"36245",1036245,116,138,14,268
"36246",1036246,85,191,8,284
"36247",1036247,6,4,0,10
"36248",1036248,135,81,11,227
"36249",1036249,100,121,1,222
"36250",1036250,19,78,7,104
"36251",1036251,30,204,1,235
"36252",1036252,163,44,3,210
"36253",1036253,21,20,6,47
"36254",1036254,114,82,7,203
"36255",1036255,86,189,6,281
"36256",1036256,77,11,2,90
"36257",1036257,73,198,4,275
"36258",1036258,43,262,12,317
"36259",1036259,143,51,6,200
"36260",1036260,100,120,2,222
"36261",1036261,191,66,11,268
"36262",1036262,73,148,10,231
"36263",1036263,105,113,6,224
"36264",1036264,130,25,12,167
"36265",1036265,178,28,8,214
"36266",1036266,164,23,5,192
"36267",1036267,97,109,9,215
"36268",1036268,20,244,5,269
"36269",1036269,11,28,0,39
"36270",1036270,50,105,2,157
"36271",1036271,66,82,2,150
"36272",1036272,182,64,6,252
"36273",1036273,142,115,10,267
"36274",1036274,114,170,24,308
"36275",1036275,141,81,15,237
"36276",1036276,133,65,7,205
"36277",1036277,53,110,18,181
"36278",1036278,143,83,14,240
"36279",1036279,164,27,2,193
"36280",1036280,26,211,2,239
"36281",1036281,194,12,8,214
"36282",1036282,160,112,9,281
"36283",1036283,133,36,6,175
"36284",1036284,82,174,14,270
"36285",1036285,73,91,5,169
"36286",1036286,97,122,10,229
"36287",1036287,179,41,4,224
"36288",1036288,28,57,1,86
"36289",1036289,122,127,6,255
"36290",1036290,141,60,4,205
"36291",1036291,20,70,0,90
"36292",1036292,81,112,6,199
"36293",1036293,139,160,9,308
"36294",1036294,28,196,5,229
"36295",1036295,153,108,8,269
"36296",1036296,91,145,14,250
"36297",1036297,19,70,7,96
"36298",1036298,112,70,11,193
"36299",1036299,57,19,4,80
"36300",1036300,43,267,10,320
"36301",1036301,165,39,7,211
"36302",1036302,52,123,13,188
"36303",1036303,8,2,3,13
"36304",1036304,28,215,2,245
"36305",1036305,112,16,2,130
"36306",1036306,170,28,5,203
"36307",1036307,35,245,3,283
"36308",1036308,94,153,10,257
"36309",1036309,77,117,9,203
"36310",1036310,73,141,6,220
"36311",1036311,46,69,3,118
"36312",1036312,171,47,3,221
"36313",1036313,110,121,13,244
"36314",1036314,105,188,12,305
"36315",1036315,176,48,12,236
"36316",1036316,75,136,1,212
"36317",1036317,98,11,6,115
"36318",1036318,149,15,2,166
"36319",1036319,128,98,6,232
"36320",1036320,34,200,9,243
"36321",1036321,69,172,4,245
"36322",1036322,155,15,8,178
"36323",1036323,88,171,7,266
"36324",1036324,57,285,2,344
"36325",1036325,98,115,4,217
"36326",1036326,160,85,8,253
"36327",1036327,2,9,0,11
"36328",1036328,233,28,6,267
"36329",1036329,185,88,10,283
"36330",1036330,39,252,8,299
"36331",1036331,146,67,9,222
"36332",1036332,198,36,9,243
"36333",1036333,48,86,5,139
"36334",1036334,139,121,18,278
"36335",1036335,94,101,3,198
"36336",1036336,138,105,14,257
"36337",1036337,81,133,16,230
"36338",1036338,20,213,3,236
"36339",1036339,109,135,3,247
"36340",1036340,187,74,7,268
"36341",1036341,119,70,7,196
"36342",1036342,87,192,9,288
"36343",1036343,53,123,2,178
"36344",1036344,87,179,8,274
"36345",1036345,78,95,5,178
"36346",1036346,222,47,17,286
"36347",1036347,162,88,5,255
"36348",1036348,59,124,7,190
"36349",1036349,133,81,2,216
"36350",1036350,52,187,2,241
"36351",1036351,92,161,16,269
"36352",1036352,194,49,7,250
"36353",1036353,19,223,4,246
"36354",1036354,119,176,5,300
"36355",1036355,56,54,4,114
"36356",1036356,179,16,3,198
"36357",1036357,119,132,4,255
"36358",1036358,70,241,7,318
"36359",1036359,124,48,4,176
"36360",1036360,68,147,4,219
"36361",1036361,198,87,4,289
"36362",1036362,221,38,9,268
"36363",1036363,135,58,4,197
"36364",1036364,40,5,3,48
"36365",1036365,58,94,10,162
"36366",1036366,221,93,7,321
"36367",1036367,153,78,14,245
"36368",1036368,197,55,7,259
"36369",1036369,129,142,22,293
"36370",1036370,52,214,10,276
"36371",1036371,134,39,3,176
"36372",1036372,56,241,12,309
"36373",1036373,72,77,18,167
"36374",1036374,86,120,3,209
"36375",1036375,242,11,8,261
"36376",1036376,129,160,9,298
"36377",1036377,236,19,2,257
"36378",1036378,172,110,11,293
"36379",1036379,131,21,3,155
"36380",1036380,154,21,4,179
"36381",1036381,123,61,13,197
"36382",1036382,183,11,1,195
"36383",1036383,141,66,11,218
"36384",1036384,229,20,7,256
"36385",1036385,82,3,1,86
"36386",1036386,23,139,3,165
"36387",1036387,102,116,5,223
"36388",1036388,195,99,13,307
"36389",1036389,65,105,12,182
"36390",1036390,40,53,8,101
"36391",1036391,185,82,8,275
"36392",1036392,113,146,15,274
"36393",1036393,99,213,13,325
"36394",1036394,143,47,10,200
"36395",1036395,152,34,10,196
"36396",1036396,209,43,10,262
"36397",1036397,119,118,1,238
"36398",1036398,160,37,7,204
"36399",1036399,177,62,12,251
"36400",1036400,9,4,0,13
"36401",1036401,137,95,4,236
"36402",1036402,202,64,3,269
"36403",1036403,123,58,10,191
"36404",1036404,164,22,7,193
"36405",1036405,37,123,3,163
"36406",1036406,129,80,10,219
"36407",1036407,80,137,12,229
"36408",1036408,104,68,4,176
"36409",1036409,29,14,0,43
"36410",1036410,180,38,3,221
"36411",1036411,56,140,11,207
"36412",1036412,35,260,13,308
"36413",1036413,177,197,9,383
"36414",1036414,55,207,14,276
"36415",1036415,48,164,14,226
"36416",1036416,98,117,9,224
"36417",1036417,36,245,10,291
"36418",1036418,31,61,6,98
"36419",1036419,147,108,10,265
"36420",1036420,196,70,8,274
"36421",1036421,103,82,7,192
"36422",1036422,34,114,14,162
"36423",1036423,116,37,6,159
"36424",1036424,154,32,14,200
"36425",1036425,85,0,0,85
"36426",1036426,99,115,4,218
"36427",1036427,126,109,7,242
"36428",1036428,62,116,11,189
"36429",1036429,67,220,6,293
"36430",1036430,80,258,5,343
"36431",1036431,213,19,5,237
"36432",1036432,104,178,24,306
"36433",1036433,191,64,11,266
"36434",1036434,21,51,2,74
"36435",1036435,120,61,7,188
"36436",1036436,164,106,5,275
"36437",1036437,147,45,8,200
"36438",1036438,77,109,4,190
"36439",1036439,67,207,11,285
"36440",1036440,41,72,6,119
"36441",1036441,133,75,1,209
"36442",1036442,135,103,4,242
"36443",1036443,39,238,7,284
"36444",1036444,180,41,18,239
"36445",1036445,162,38,16,216
"36446",1036446,68,197,7,272
"36447",1036447,148,59,9,216
"36448",1036448,109,103,10,222
"36449",1036449,48,155,1,204
"36450",1036450,86,19,1,106
"36451",1036451,66,203,22,291
"36452",1036452,90,193,13,296
"36453",1036453,99,140,5,244
"36454",1036454,45,253,10,308
"36455",1036455,75,130,7,212
"36456",1036456,179,17,8,204
"36457",1036457,192,28,5,225
"36458",1036458,90,70,4,164
"36459",1036459,50,194,6,250
"36460",1036460,224,36,8,268
"36461",1036461,138,52,10,200
"36462",1036462,203,41,9,253
"36463",1036463,96,165,5,266
"36464",1036464,121,26,1,148
"36465",1036465,237,26,9,272
"36466",1036466,252,3,4,259
"36467",1036467,165,44,5,214
"36468",1036468,94,68,6,168
"36469",1036469,64,182,15,261
"36470",1036470,15,110,0,125
"36471",1036471,86,175,15,276
"36472",1036472,103,177,9,289
"36473",1036473,116,136,2,254
"36474",1036474,232,61,13,306
"36475",1036475,157,114,14,285
"36476",1036476,210,41,5,256
"36477",1036477,27,12,1,40
"36478",1036478,243,16,3,262
"36479",1036479,63,271,1,335
"36480",1036480,10,1,1,12
"36481",1036481,23,275,8,306
"36482",1036482,66,262,16,344
"36483",1036483,116,77,19,212
"36484",1036484,52,235,14,301
"36485",1036485,134,65,12,211
"36486",1036486,168,119,10,297
"36487",1036487,134,18,4,156
"36488",1036488,146,60,13,219
"36489",1036489,68,74,15,157
"36490",1036490,40,275,5,320
"36491",1036491,19,230,7,256
"36492",1036492,204,33,9,246
"36493",1036493,72,25,2,99
"36494",1036494,131,63,2,196
"36495",1036495,26,218,10,254
"36496",1036496,159,27,8,194
"36497",1036497,29,244,2,275
"36498",1036498,145,15,7,167
"36499",1036499,176,22,6,204
"36500",1036500,129,22,5,156
"36501",1036501,14,113,3,130
"36502",1036502,86,53,8,147
"36503",1036503,44,130,1,175
"36504",1036504,87,184,10,281
"36505",1036505,76,103,7,186
"36506",1036506,31,112,9,152
"36507",1036507,94,185,10,289
"36508",1036508,138,67,16,221
"36509",1036509,154,75,9,238
"36510",1036510,88,138,5,231
"36511",1036511,64,177,6,247
"36512",1036512,70,137,6,213
"36513",1036513,123,88,13,224
"36514",1036514,180,53,5,238
"36515",1036515,168,87,12,267
"36516",1036516,116,141,13,270
"36517",1036517,71,102,12,185
"36518",1036518,91,89,10,190
"36519",1036519,59,95,5,159
"36520",1036520,39,254,5,298
"36521",1036521,128,23,3,154
"36522",1036522,82,134,4,220
"36523",1036523,60,142,10,212
"36524",1036524,268,26,12,306
"36525",1036525,116,143,6,265
"36526",1036526,198,67,22,287
"36527",1036527,106,99,7,212
"36528",1036528,187,67,16,270
"36529",1036529,160,100,12,272
"36530",1036530,174,95,1,270
"36531",1036531,91,132,7,230
"36532",1036532,126,61,17,204
"36533",1036533,144,92,9,245
"36534",1036534,104,16,3,123
"36535",1036535,137,69,13,219
"36536",1036536,66,35,7,108
"36537",1036537,98,161,15,274
"36538",1036538,172,37,9,218
"36539",1036539,232,71,27,330
"36540",1036540,6,6,0,12
"36541",1036541,129,9,2,140
"36542",1036542,165,72,6,243
"36543",1036543,141,132,22,295
"36544",1036544,174,66,7,247
"36545",1036545,94,106,7,207
"36546",1036546,103,50,2,155
"36547",1036547,12,31,2,45
"36548",1036548,80,25,4,109
"36549",1036549,144,52,17,213
"36550",1036550,24,153,4,181
"36551",1036551,36,20,2,58
"36552",1036552,130,70,14,214
"36553",1036553,55,171,8,234
"36554",1036554,39,275,3,317
"36555",1036555,124,107,8,239
"36556",1036556,53,224,6,283
"36557",1036557,127,97,9,233
"36558",1036558,8,161,1,170
"36559",1036559,104,204,13,321
"36560",1036560,100,226,15,341
"36561",1036561,145,104,10,259
"36562",1036562,136,49,5,190
"36563",1036563,74,13,1,88
"36564",1036564,83,72,6,161
"36565",1036565,134,3,3,140
"36566",1036566,201,64,6,271
"36567",1036567,119,122,12,253
"36568",1036568,96,82,8,186
"36569",1036569,99,20,4,123
"36570",1036570,211,83,16,310
"36571",1036571,41,185,14,240
"36572",1036572,149,22,4,175
"36573",1036573,89,149,3,241
"36574",1036574,111,197,8,316
"36575",1036575,16,179,1,196
"36576",1036576,157,118,14,289
"36577",1036577,66,81,4,151
"36578",1036578,77,85,13,175
"36579",1036579,77,145,22,244
"36580",1036580,93,148,13,254
"36581",1036581,127,26,7,160
"36582",1036582,115,49,7,171
"36583",1036583,157,56,2,215
"36584",1036584,117,94,26,237
"36585",1036585,197,62,10,269
"36586",1036586,98,172,13,283
"36587",1036587,90,208,18,316
"36588",1036588,224,64,8,296
"36589",1036589,160,71,7,238
"36590",1036590,47,205,4,256
"36591",1036591,54,59,1,114
"36592",1036592,84,55,6,145
"36593",1036593,51,234,17,302
"36594",1036594,155,135,3,293
"36595",1036595,157,29,3,189
"36596",1036596,56,124,17,197
"36597",1036597,195,13,4,212
"36598",1036598,154,88,6,248
"36599",1036599,125,248,11,384
"36600",1036600,33,118,7,158
"36601",1036601,17,1,0,18
"36602",1036602,155,78,5,238
"36603",1036603,142,73,13,228
"36604",1036604,66,246,7,319
"36605",1036605,49,15,1,65
"36606",1036606,119,98,15,232
"36607",1036607,31,3,0,34
"36608",1036608,189,74,5,268
"36609",1036609,97,168,6,271
"36610",1036610,117,159,13,289
"36611",1036611,58,208,1,267
"36612",1036612,101,36,6,143
"36613",1036613,41,63,6,110
"36614",1036614,3,102,3,108
"36615",1036615,61,104,1,166
"36616",1036616,80,4,5,89
"36617",1036617,131,59,7,197
"36618",1036618,35,89,2,126
"36619",1036619,60,158,1,219
"36620",1036620,82,243,3,328
"36621",1036621,96,182,3,281
"36622",1036622,84,212,9,305
"36623",1036623,179,58,13,250
"36624",1036624,44,192,6,242
"36625",1036625,181,36,14,231
"36626",1036626,205,67,8,280
"36627",1036627,132,100,7,239
"36628",1036628,156,98,8,262
"36629",1036629,197,36,10,243
"36630",1036630,165,107,9,281
"36631",1036631,130,70,16,216
"36632",1036632,218,54,9,281
"36633",1036633,76,260,3,339
"36634",1036634,108,181,9,298
"36635",1036635,93,153,6,252
"36636",1036636,73,145,8,226
"36637",1036637,76,183,24,283
"36638",1036638,66,177,23,266
"36639",1036639,22,203,2,227
"36640",1036640,134,100,18,252
"36641",1036641,168,126,17,311
"36642",1036642,105,82,2,189
"36643",1036643,132,97,5,234
"36644",1036644,53,137,12,202
"36645",1036645,137,71,10,218
"36646",1036646,173,71,11,255
"36647",1036647,19,55,1,75
"36648",1036648,26,34,4,64
"36649",1036649,88,171,24,283
"36650",1036650,127,10,2,139
"36651",1036651,89,110,10,209
"36652",1036652,147,114,5,266
"36653",1036653,21,20,3,44
"36654",1036654,160,46,6,212
"36655",1036655,109,20,3,132
"36656",1036656,104,81,7,192
"36657",1036657,107,153,8,268
"36658",1036658,78,175,17,270
"36659",1036659,33,268,6,307
"36660",1036660,91,179,5,275
"36661",1036661,157,76,5,238
"36662",1036662,209,12,5,226
"36663",1036663,102,145,8,255
"36664",1036664,212,31,6,249
"36665",1036665,74,81,6,161
"36666",1036666,123,119,9,251
"36667",1036667,246,13,10,269
"36668",1036668,68,126,10,204
"36669",1036669,89,140,10,239
"36670",1036670,117,144,9,270
"36671",1036671,183,26,3,212
"36672",1036672,78,182,10,270
"36673",1036673,57,210,10,277
"36674",1036674,244,89,20,353
"36675",1036675,96,134,7,237
"36676",1036676,272,11,2,285
"36677",1036677,133,58,5,196
"36678",1036678,199,115,11,325
"36679",1036679,76,192,13,281
"36680",1036680,76,182,1,259
"36681",1036681,55,171,5,231
"36682",1036682,191,21,7,219
"36683",1036683,152,41,5,198
"36684",1036684,231,65,11,307
"36685",1036685,46,33,2,81
"36686",1036686,164,55,6,225
"36687",1036687,41,278,9,328
"36688",1036688,83,156,1,240
"36689",1036689,9,0,0,9
"36690",1036690,221,33,12,266
"36691",1036691,59,140,14,213
"36692",1036692,128,114,10,252
"36693",1036693,56,157,5,218
"36694",1036694,176,91,9,276
"36695",1036695,199,89,16,304
"36696",1036696,209,11,8,228
"36697",1036697,75,77,13,165
"36698",1036698,68,239,4,311
"36699",1036699,39,274,2,315
"36700",1036700,109,77,5,191
"36701",1036701,134,38,4,176
"36702",1036702,192,55,10,257
"36703",1036703,26,262,3,291
"36704",1036704,69,157,7,233
"36705",1036705,137,167,18,322
"36706",1036706,56,202,7,265
"36707",1036707,60,116,19,195
"36708",1036708,162,34,6,202
"36709",1036709,252,26,8,286
"36710",1036710,106,84,11,201
"36711",1036711,76,107,8,191
"36712",1036712,107,133,1,241
"36713",1036713,68,195,15,278
"36714",1036714,223,57,11,291
"36715",1036715,63,110,7,180
"36716",1036716,93,67,5,165
"36717",1036717,62,208,15,285
"36718",1036718,51,191,11,253
"36719",1036719,41,51,0,92
"36720",1036720,191,58,7,256
"36721",1036721,204,55,5,264
"36722",1036722,103,190,5,298
"36723",1036723,149,127,19,295
"36724",1036724,5,3,1,9
"36725",1036725,53,127,15,195
"36726",1036726,177,89,6,272
"36727",1036727,90,70,4,164
"36728",1036728,203,60,8,271
"36729",1036729,113,156,6,275
"36730",1036730,145,46,2,193
"36731",1036731,39,150,6,195
"36732",1036732,61,77,8,146
"36733",1036733,241,15,17,273
"36734",1036734,24,108,7,139
"36735",1036735,111,177,6,294
"36736",1036736,156,77,7,240
"36737",1036737,154,15,3,172
"36738",1036738,118,22,4,144
"36739",1036739,64,187,5,256
"36740",1036740,44,152,4,200
"36741",1036741,24,138,2,164
"36742",1036742,116,93,9,218
"36743",1036743,87,106,5,198
"36744",1036744,38,68,5,111
"36745",1036745,120,21,4,145
"36746",1036746,147,103,7,257
"36747",1036747,65,117,7,189
"36748",1036748,189,37,15,241
"36749",1036749,167,92,11,270
"36750",1036750,166,103,4,273
"36751",1036751,204,86,7,297
"36752",1036752,73,141,12,226
"36753",1036753,93,235,24,352
"36754",1036754,86,119,5,210
"36755",1036755,36,161,5,202
"36756",1036756,29,101,1,131
"36757",1036757,124,38,1,163
"36758",1036758,15,217,2,234
"36759",1036759,178,35,9,222
"36760",1036760,161,60,5,226
"36761",1036761,31,147,3,181
"36762",1036762,188,40,1,229
"36763",1036763,23,29,2,54
"36764",1036764,119,104,10,233
"36765",1036765,132,85,2,219
"36766",1036766,131,53,9,193
"36767",1036767,111,160,16,287
"36768",1036768,23,153,6,182
"36769",1036769,191,47,8,246
"36770",1036770,230,108,18,356
"36771",1036771,59,217,8,284
"36772",1036772,133,156,9,298
"36773",1036773,165,74,11,250
"36774",1036774,158,16,6,180
"36775",1036775,46,257,8,311
"36776",1036776,87,112,3,202
"36777",1036777,49,229,5,283
"36778",1036778,193,89,16,298
"36779",1036779,10,269,1,280
"36780",1036780,227,77,2,306
"36781",1036781,78,127,11,216
"36782",1036782,100,56,7,163
"36783",1036783,79,99,8,186
"36784",1036784,143,157,19,319
"36785",1036785,114,31,3,148
"36786",1036786,153,67,8,228
"36787",1036787,124,91,13,228
"36788",1036788,158,53,9,220
"36789",1036789,76,123,4,203
"36790",1036790,142,48,9,199
"36791",1036791,48,85,2,135
"36792",1036792,79,108,7,194
"36793",1036793,48,223,11,282
"36794",1036794,148,53,5,206
"36795",1036795,181,64,11,256
"36796",1036796,130,198,12,340
"36797",1036797,35,9,0,44
"36798",1036798,100,70,4,174
"36799",1036799,95,99,4,198
"36800",1036800,44,187,3,234
"36801",1036801,34,270,8,312
"36802",1036802,119,94,15,228
"36803",1036803,107,115,9,231
"36804",1036804,174,84,6,264
"36805",1036805,66,199,15,280
"36806",1036806,48,224,29,301
"36807",1036807,200,42,6,248
"36808",1036808,157,41,3,201
"36809",1036809,107,2,1,110
"36810",1036810,280,13,11,304
"36811",1036811,63,62,7,132
"36812",1036812,22,221,4,247
"36813",1036813,17,146,3,166
"36814",1036814,45,89,7,141
"36815",1036815,168,125,6,299
"36816",1036816,341,6,7,354
"36817",1036817,268,59,5,332
"36818",1036818,90,101,3,194
"36819",1036819,153,27,2,182
"36820",1036820,166,71,5,242
"36821",1036821,32,254,0,286
"36822",1036822,276,41,15,332
"36823",1036823,147,191,16,354
"36824",1036824,130,130,6,266
"36825",1036825,70,188,7,265
"36826",1036826,183,49,6,238
"36827",1036827,40,177,8,225
"36828",1036828,43,256,12,311
"36829",1036829,175,87,10,272
"36830",1036830,63,121,2,186
"36831",1036831,78,157,6,241
"36832",1036832,40,87,2,129
"36833",1036833,133,79,7,219
"36834",1036834,90,187,7,284
"36835",1036835,70,130,7,207
"36836",1036836,17,206,6,229
"36837",1036837,232,19,2,253
"36838",1036838,207,35,4,246
"36839",1036839,185,63,9,257
"36840",1036840,33,215,12,260
"36841",1036841,114,128,14,256
"36842",1036842,124,155,9,288
"36843",1036843,46,101,7,154
"36844",1036844,65,111,7,183
"36845",1036845,153,136,9,298
"36846",1036846,67,139,4,210
"36847",1036847,90,12,2,104
"36848",1036848,151,51,4,206
"36849",1036849,180,95,11,286
"36850",1036850,75,29,2,106
"36851",1036851,70,116,5,191
"36852",1036852,145,125,6,276
"36853",1036853,103,17,4,124
"36854",1036854,10,1,1,12
"36855",1036855,6,67,1,74
"36856",1036856,58,11,7,76
"36857",1036857,75,226,6,307
"36858",1036858,124,32,10,166
"36859",1036859,193,77,13,283
"36860",1036860,152,11,7,170
"36861",1036861,79,156,15,250
"36862",1036862,38,160,10,208
"36863",1036863,38,357,6,401
"36864",1036864,195,15,4,214
"36865",1036865,87,89,9,185
"36866",1036866,25,158,7,190
"36867",1036867,81,148,18,247
"36868",1036868,132,0,0,132
"36869",1036869,16,102,7,125
"36870",1036870,122,118,18,258
"36871",1036871,158,78,2,238
"36872",1036872,84,199,13,296
"36873",1036873,56,148,3,207
"36874",1036874,136,105,14,255
"36875",1036875,273,16,5,294
"36876",1036876,81,29,5,115
"36877",1036877,14,0,2,16
"36878",1036878,145,106,14,265
"36879",1036879,95,162,7,264
"36880",1036880,107,43,14,164
"36881",1036881,197,41,3,241
"36882",1036882,87,195,11,293
"36883",1036883,69,25,7,101
"36884",1036884,197,152,12,361
"36885",1036885,22,14,3,39
"36886",1036886,5,3,0,8
"36887",1036887,216,30,5,251
"36888",1036888,135,77,10,222
"36889",1036889,50,255,13,318
"36890",1036890,189,104,21,314
"36891",1036891,55,237,8,300
"36892",1036892,104,162,8,274
"36893",1036893,67,228,7,302
"36894",1036894,122,85,20,227
"36895",1036895,135,47,4,186
"36896",1036896,91,197,10,298
"36897",1036897,103,98,14,215
"36898",1036898,70,136,10,216
"36899",1036899,179,39,5,223
"36900",1036900,194,28,5,227
"36901",1036901,128,26,5,159
"36902",1036902,257,10,7,274
"36903",1036903,90,181,5,276
"36904",1036904,115,80,6,201
"36905",1036905,85,29,3,117
"36906",1036906,19,39,0,58
"36907",1036907,127,148,5,280
"36908",1036908,7,15,1,23
"36909",1036909,1,133,0,134
"36910",1036910,52,149,2,203
"36911",1036911,163,73,10,246
"36912",1036912,81,50,9,140
"36913",1036913,163,55,10,228
"36914",1036914,83,83,5,171
"36915",1036915,87,165,9,261
"36916",1036916,55,51,5,111
"36917",1036917,139,18,6,163
"36918",1036918,43,15,6,64
"36919",1036919,149,119,4,272
"36920",1036920,186,51,11,248
"36921",1036921,14,56,2,72
"36922",1036922,94,53,7,154
"36923",1036923,157,90,5,252
"36924",1036924,75,206,4,285
"36925",1036925,82,73,10,165
"36926",1036926,37,179,0,216
"36927",1036927,138,114,10,262
"36928",1036928,114,44,7,165
"36929",1036929,124,18,9,151
"36930",1036930,75,156,16,247
"36931",1036931,152,56,11,219
"36932",1036932,119,24,7,150
"36933",1036933,75,192,15,282
"36934",1036934,201,62,8,271
"36935",1036935,87,92,11,190
"36936",1036936,63,193,21,277
"36937",1036937,214,27,8,249
"36938",1036938,131,23,2,156
"36939",1036939,121,129,6,256
"36940",1036940,111,64,3,178
"36941",1036941,117,188,13,318
"36942",1036942,102,136,8,246
"36943",1036943,197,110,18,325
"36944",1036944,152,112,11,275
"36945",1036945,52,202,5,259
"36946",1036946,85,7,5,97
"36947",1036947,175,29,3,207
"36948",1036948,168,38,10,216
"36949",1036949,110,93,9,212
"36950",1036950,148,74,15,237
"36951",1036951,133,109,7,249
"36952",1036952,84,15,4,103
"36953",1036953,212,28,4,244
"36954",1036954,131,46,5,182
"36955",1036955,98,171,15,284
"36956",1036956,6,11,0,17
"36957",1036957,130,109,17,256
"36958",1036958,40,126,7,173
"36959",1036959,17,18,0,35
"36960",1036960,127,86,18,231
"36961",1036961,187,61,12,260
"36962",1036962,33,133,4,170
"36963",1036963,132,58,10,200
"36964",1036964,50,105,6,161
"36965",1036965,37,41,1,79
"36966",1036966,177,76,18,271
"36967",1036967,90,97,5,192
"36968",1036968,140,61,11,212
"36969",1036969,19,150,3,172
"36970",1036970,186,35,9,230
"36971",1036971,172,19,7,198
"36972",1036972,131,128,4,263
"36973",1036973,105,178,9,292
"36974",1036974,211,24,10,245
"36975",1036975,40,24,2,66
"36976",1036976,27,163,2,192
"36977",1036977,150,54,2,206
"36978",1036978,181,34,9,224
"36979",1036979,87,143,11,241
"36980",1036980,173,53,5,231
"36981",1036981,129,17,3,149
"36982",1036982,57,232,4,293
"36983",1036983,151,84,8,243
"36984",1036984,22,214,3,239
"36985",1036985,46,162,7,215
"36986",1036986,48,145,15,208
"36987",1036987,143,156,11,310
"36988",1036988,156,53,4,213
"36989",1036989,94,76,2,172
"36990",1036990,202,52,2,256
"36991",1036991,12,131,1,144
"36992",1036992,171,112,12,295
"36993",1036993,202,101,3,306
"36994",1036994,31,237,4,272
"36995",1036995,73,54,4,131
"36996",1036996,76,89,1,166
"36997",1036997,108,162,24,294
"36998",1036998,36,89,8,133
"36999",1036999,40,219,3,262
"37000",1037000,14,10,0,24
"37001",1037001,137,15,11,163
"37002",1037002,103,117,0,220
"37003",1037003,236,231,26,493
"37004",1037004,94,74,5,173
"37005",1037005,146,144,16,306
"37006",1037006,157,28,4,189
"37007",1037007,114,18,6,138
"37008",1037008,123,134,6,263
"37009",1037009,222,42,5,269
"37010",1037010,74,39,6,119
"37011",1037011,212,34,10,256
"37012",1037012,104,13,0,117
"37013",1037013,3,26,1,30
"37014",1037014,86,24,1,111
"37015",1037015,77,57,9,143
"37016",1037016,120,131,10,261
"37017",1037017,87,90,10,187
"37018",1037018,141,94,16,251
"37019",1037019,132,171,10,313
"37020",1037020,116,106,1,223
"37021",1037021,216,73,13,302
"37022",1037022,42,24,3,69
"37023",1037023,68,90,4,162
"37024",1037024,143,99,8,250
"37025",1037025,156,43,16,215
"37026",1037026,108,151,12,271
"37027",1037027,158,46,5,209
"37028",1037028,217,56,18,291
"37029",1037029,211,45,9,265
"37030",1037030,117,76,16,209
"37031",1037031,43,88,1,132
"37032",1037032,9,41,1,51
"37033",1037033,111,52,14,177
"37034",1037034,54,161,13,228
"37035",1037035,187,90,10,287
"37036",1037036,95,92,19,206
"37037",1037037,114,125,10,249
"37038",1037038,68,138,4,210
"37039",1037039,90,115,3,208
"37040",1037040,100,6,2,108
"37041",1037041,132,90,4,226
"37042",1037042,76,79,3,158
"37043",1037043,10,14,1,25
"37044",1037044,133,44,7,184
"37045",1037045,161,13,8,182
"37046",1037046,54,170,25,249
"37047",1037047,83,34,3,120
"37048",1037048,121,209,7,337
"37049",1037049,176,32,3,211
"37050",1037050,133,135,10,278
"37051",1037051,99,167,6,272
"37052",1037052,52,209,5,266
"37053",1037053,108,146,11,265
"37054",1037054,19,274,3,296
"37055",1037055,187,61,1,249
"37056",1037056,127,75,7,209
"37057",1037057,64,188,2,254
"37058",1037058,118,90,15,223
"37059",1037059,23,114,4,141
"37060",1037060,156,74,8,238
"37061",1037061,181,120,19,320
"37062",1037062,40,46,2,88
"37063",1037063,39,179,15,233
"37064",1037064,172,23,6,201
"37065",1037065,159,104,2,265
"37066",1037066,117,10,4,131
"37067",1037067,36,43,3,82
"37068",1037068,33,14,3,50
"37069",1037069,34,137,3,174
"37070",1037070,131,75,5,211
"37071",1037071,65,262,7,334
"37072",1037072,110,192,10,312
"37073",1037073,40,191,14,245
"37074",1037074,0,0,0,0
"37075",1037075,153,89,12,254
"37076",1037076,64,127,6,197
"37077",1037077,269,15,3,287
"37078",1037078,10,152,10,172
"37079",1037079,154,183,12,349
"37080",1037080,46,277,1,324
"37081",1037081,225,61,9,295
"37082",1037082,172,33,12,217
"37083",1037083,192,74,4,270
"37084",1037084,90,82,13,185
"37085",1037085,148,99,8,255
"37086",1037086,26,6,0,32
"37087",1037087,81,185,8,274
"37088",1037088,181,29,5,215
"37089",1037089,197,75,4,276
"37090",1037090,131,160,5,296
"37091",1037091,80,130,5,215
"37092",1037092,95,131,1,227
"37093",1037093,33,256,10,299
"37094",1037094,7,259,1,267
"37095",1037095,121,70,8,199
"37096",1037096,32,51,3,86
"37097",1037097,149,62,9,220
"37098",1037098,123,25,5,153
"37099",1037099,191,21,5,217
"37100",1037100,144,140,8,292
"37101",1037101,162,31,7,200
"37102",1037102,260,33,9,302
"37103",1037103,134,156,13,303
"37104",1037104,207,69,16,292
"37105",1037105,48,53,0,101
"37106",1037106,60,95,3,158
"37107",1037107,84,107,2,193
"37108",1037108,96,33,2,131
"37109",1037109,54,120,2,176
"37110",1037110,168,108,20,296
"37111",1037111,93,94,1,188
"37112",1037112,143,70,5,218
"37113",1037113,102,76,6,184
"37114",1037114,163,90,10,263
"37115",1037115,97,122,9,228
"37116",1037116,47,163,12,222
"37117",1037117,73,222,1,296
"37118",1037118,242,24,7,273
"37119",1037119,45,56,2,103
"37120",1037120,91,50,6,147
"37121",1037121,182,64,10,256
"37122",1037122,172,54,15,241
"37123",1037123,146,113,3,262
"37124",1037124,22,10,3,35
"37125",1037125,96,124,11,231
"37126",1037126,77,174,11,262
"37127",1037127,62,59,7,128
"37128",1037128,106,64,3,173
"37129",1037129,138,53,7,198
"37130",1037130,45,72,13,130
"37131",1037131,27,152,0,179
"37132",1037132,61,72,4,137
"37133",1037133,41,91,7,139
"37134",1037134,100,141,11,252
"37135",1037135,134,47,6,187
"37136",1037136,97,148,14,259
"37137",1037137,192,73,10,275
"37138",1037138,35,135,4,174
"37139",1037139,129,163,22,314
"37140",1037140,174,58,9,241
"37141",1037141,172,94,17,283
"37142",1037142,110,99,6,215
"37143",1037143,159,51,11,221
"37144",1037144,178,76,10,264
"37145",1037145,71,181,8,260
"37146",1037146,120,40,3,163
"37147",1037147,170,105,5,280
"37148",1037148,7,25,2,34
"37149",1037149,133,95,12,240
"37150",1037150,50,32,4,86
"37151",1037151,37,6,2,45
"37152",1037152,104,159,7,270
"37153",1037153,46,86,4,136
"37154",1037154,50,155,3,208
"37155",1037155,152,85,3,240
"37156",1037156,178,44,4,226
"37157",1037157,101,187,9,297
"37158",1037158,106,109,13,228
"37159",1037159,188,72,3,263
"37160",1037160,68,250,6,324
"37161",1037161,77,192,7,276
"37162",1037162,63,245,5,313
"37163",1037163,78,174,16,268
"37164",1037164,97,109,18,224
"37165",1037165,75,168,15,258
"37166",1037166,35,229,8,272
"37167",1037167,142,166,18,326
"37168",1037168,105,61,1,167
"37169",1037169,166,112,11,289
"37170",1037170,43,43,1,87
"37171",1037171,59,162,10,231
"37172",1037172,129,39,17,185
"37173",1037173,211,37,6,254
"37174",1037174,74,18,3,95
"37175",1037175,71,234,14,319
"37176",1037176,56,152,6,214
"37177",1037177,43,220,5,268
"37178",1037178,29,181,1,211
"37179",1037179,55,4,2,61
"37180",1037180,43,14,0,57
"37181",1037181,99,75,3,177
"37182",1037182,50,27,0,77
"37183",1037183,121,10,11,142
"37184",1037184,148,118,5,271
"37185",1037185,109,132,10,251
"37186",1037186,63,202,10,275
"37187",1037187,75,136,5,216
"37188",1037188,55,257,4,316
"37189",1037189,53,74,0,127
"37190",1037190,189,26,9,224
"37191",1037191,48,208,16,272
"37192",1037192,124,18,7,149
"37193",1037193,117,51,9,177
"37194",1037194,147,162,4,313
"37195",1037195,52,155,3,210
"37196",1037196,78,84,4,166
"37197",1037197,67,1,0,68
"37198",1037198,154,104,23,281
"37199",1037199,142,66,9,217
"37200",1037200,53,167,1,221
"37201",1037201,146,70,5,221
"37202",1037202,19,6,0,25
"37203",1037203,153,52,0,205
"37204",1037204,34,231,2,267
"37205",1037205,161,80,3,244
"37206",1037206,153,60,1,214
"37207",1037207,56,86,2,144
"37208",1037208,84,192,12,288
"37209",1037209,112,17,5,134
"37210",1037210,145,24,9,178
"37211",1037211,52,160,10,222
"37212",1037212,61,150,3,214
"37213",1037213,122,81,20,223
"37214",1037214,200,50,6,256
"37215",1037215,68,172,19,259
"37216",1037216,49,153,1,203
"37217",1037217,113,64,3,180
"37218",1037218,117,18,6,141
"37219",1037219,58,173,7,238
"37220",1037220,109,126,7,242
"37221",1037221,204,56,12,272
"37222",1037222,118,151,12,281
"37223",1037223,186,84,14,284
"37224",1037224,179,54,11,244
"37225",1037225,136,51,8,195
"37226",1037226,147,106,13,266
"37227",1037227,140,82,5,227
"37228",1037228,92,105,6,203
"37229",1037229,85,179,8,272
"37230",1037230,69,84,1,154
"37231",1037231,76,89,1,166
"37232",1037232,141,107,16,264
"37233",1037233,152,90,12,254
"37234",1037234,48,191,10,249
"37235",1037235,229,56,15,300
"37236",1037236,168,22,5,195
"37237",1037237,276,39,5,320
"37238",1037238,161,152,16,329
"37239",1037239,133,110,12,255
"37240",1037240,52,87,4,143
"37241",1037241,148,44,15,207
"37242",1037242,114,126,9,249
"37243",1037243,197,65,6,268
"37244",1037244,62,199,14,275
"37245",1037245,140,47,3,190
"37246",1037246,103,89,6,198
"37247",1037247,144,154,6,304
"37248",1037248,59,210,10,279
"37249",1037249,263,64,8,335
"37250",1037250,97,184,12,293
"37251",1037251,125,37,2,164
"37252",1037252,119,53,6,178
"37253",1037253,46,235,4,285
"37254",1037254,93,120,10,223
"37255",1037255,151,122,21,294
"37256",1037256,66,196,7,269
"37257",1037257,160,72,4,236
"37258",1037258,96,181,13,290
"37259",1037259,200,48,10,258
"37260",1037260,61,193,5,259
"37261",1037261,163,133,20,316
"37262",1037262,39,164,5,208
"37263",1037263,82,81,7,170
"37264",1037264,49,273,4,326
"37265",1037265,207,31,15,253
"37266",1037266,166,76,13,255
"37267",1037267,90,146,2,238
"37268",1037268,22,289,5,316
"37269",1037269,95,201,10,306
"37270",1037270,116,105,3,224
"37271",1037271,217,26,6,249
"37272",1037272,50,84,12,146
"37273",1037273,32,79,1,112
"37274",1037274,40,152,7,199
"37275",1037275,76,48,6,130
"37276",1037276,57,18,4,79
"37277",1037277,159,68,13,240
"37278",1037278,225,33,5,263
"37279",1037279,168,82,4,254
"37280",1037280,105,165,6,276
"37281",1037281,245,39,13,297
"37282",1037282,107,7,0,114
"37283",1037283,100,70,7,177
"37284",1037284,64,122,33,219
"37285",1037285,72,217,14,303
"37286",1037286,166,66,7,239
"37287",1037287,80,126,15,221
"37288",1037288,86,89,15,190
"37289",1037289,67,119,5,191
"37290",1037290,44,190,3,237
"37291",1037291,48,190,1,239
"37292",1037292,114,87,15,216
"37293",1037293,60,194,11,265
"37294",1037294,163,31,18,212
"37295",1037295,199,25,7,231
"37296",1037296,116,136,5,257
"37297",1037297,190,42,12,244
"37298",1037298,31,111,10,152
"37299",1037299,58,108,2,168
"37300",1037300,28,76,5,109
"37301",1037301,35,226,2,263
"37302",1037302,62,147,0,209
"37303",1037303,95,161,13,269
"37304",1037304,31,231,2,264
"37305",1037305,120,121,14,255
"37306",1037306,147,44,8,199
"37307",1037307,251,53,10,314
"37308",1037308,189,52,5,246
"37309",1037309,25,7,5,37
"37310",1037310,89,33,10,132
"37311",1037311,115,198,28,341
"37312",1037312,110,65,6,181
"37313",1037313,144,24,5,173
"37314",1037314,54,164,5,223
"37315",1037315,154,41,14,209
"37316",1037316,37,140,5,182
"37317",1037317,93,86,11,190
"37318",1037318,177,65,13,255
"37319",1037319,49,166,8,223
"37320",1037320,84,17,4,105
"37321",1037321,29,268,10,307
"37322",1037322,25,164,4,193
"37323",1037323,121,59,5,185
"37324",1037324,156,46,9,211
"37325",1037325,134,147,18,299
"37326",1037326,28,153,10,191
"37327",1037327,154,53,12,219
"37328",1037328,72,219,18,309
"37329",1037329,203,56,8,267
"37330",1037330,28,158,5,191
"37331",1037331,79,192,18,289
"37332",1037332,237,60,14,311
"37333",1037333,230,5,4,239
"37334",1037334,155,67,7,229
"37335",1037335,164,122,10,296
"37336",1037336,121,47,7,175
"37337",1037337,137,26,3,166
"37338",1037338,77,112,4,193
"37339",1037339,217,90,5,312
"37340",1037340,2,138,0,140
"37341",1037341,124,119,9,252
"37342",1037342,39,125,23,187
"37343",1037343,65,188,14,267
"37344",1037344,98,83,12,193
"37345",1037345,6,2,0,8
"37346",1037346,64,105,4,173
"37347",1037347,35,225,6,266
"37348",1037348,154,75,7,236
"37349",1037349,40,154,6,200
"37350",1037350,250,51,8,309
"37351",1037351,185,11,5,201
"37352",1037352,189,62,3,254
"37353",1037353,50,160,3,213
"37354",1037354,118,85,19,222
"37355",1037355,266,48,10,324
"37356",1037356,160,84,16,260
"37357",1037357,112,168,15,295
"37358",1037358,94,163,8,265
"37359",1037359,60,6,2,68
"37360",1037360,33,270,2,305
"37361",1037361,101,76,0,177
"37362",1037362,128,69,12,209
"37363",1037363,153,119,15,287
"37364",1037364,122,162,19,303
"37365",1037365,156,1,3,160
"37366",1037366,83,138,6,227
"37367",1037367,229,24,14,267
"37368",1037368,305,4,9,318
"37369",1037369,149,69,4,222
"37370",1037370,148,144,10,302
"37371",1037371,40,237,13,290
"37372",1037372,199,18,5,222
"37373",1037373,108,198,7,313
"37374",1037374,185,43,4,232
"37375",1037375,24,4,0,28
"37376",1037376,65,148,5,218
"37377",1037377,197,74,5,276
"37378",1037378,106,132,12,250
"37379",1037379,93,163,2,258
"37380",1037380,134,41,9,184
"37381",1037381,119,164,9,292
"37382",1037382,195,84,24,303
"37383",1037383,5,19,0,24
"37384",1037384,38,261,2,301
"37385",1037385,128,153,7,288
"37386",1037386,90,63,20,173
"37387",1037387,7,75,2,84
"37388",1037388,163,61,12,236
"37389",1037389,105,109,16,230
"37390",1037390,60,109,8,177
"37391",1037391,222,66,12,300
"37392",1037392,43,216,6,265
"37393",1037393,57,207,11,275
"37394",1037394,55,189,21,265
"37395",1037395,170,85,9,264
"37396",1037396,59,18,2,79
"37397",1037397,135,75,8,218
"37398",1037398,32,226,6,264
"37399",1037399,166,72,8,246
"37400",1037400,134,89,10,233
"37401",1037401,3,132,1,136
"37402",1037402,68,215,8,291
"37403",1037403,52,138,4,194
"37404",1037404,126,25,8,159
"37405",1037405,90,62,10,162
"37406",1037406,57,159,11,227
"37407",1037407,87,197,11,295
"37408",1037408,107,49,0,156
"37409",1037409,219,16,11,246
"37410",1037410,139,16,0,155
"37411",1037411,184,39,5,228
"37412",1037412,89,149,15,253
"37413",1037413,171,83,15,269
"37414",1037414,19,253,3,275
"37415",1037415,106,117,6,229
"37416",1037416,76,27,9,112
"37417",1037417,4,264,4,272
"37418",1037418,52,100,11,163
"37419",1037419,134,82,6,222
"37420",1037420,137,114,10,261
"37421",1037421,208,93,16,317
"37422",1037422,140,180,10,330
"37423",1037423,86,41,1,128
"37424",1037424,194,21,9,224
"37425",1037425,100,123,17,240
"37426",1037426,109,78,16,203
"37427",1037427,222,64,25,311
"37428",1037428,229,41,9,279
"37429",1037429,66,56,10,132
"37430",1037430,77,187,7,271
"37431",1037431,26,107,6,139
"37432",1037432,142,31,5,178
"37433",1037433,108,140,2,250
"37434",1037434,90,35,4,129
"37435",1037435,85,227,8,320
"37436",1037436,137,58,9,204
"37437",1037437,132,108,8,248
"37438",1037438,137,58,7,202
"37439",1037439,168,61,5,234
"37440",1037440,68,169,11,248
"37441",1037441,47,108,3,158
"37442",1037442,153,57,9,219
"37443",1037443,76,199,8,283
"37444",1037444,235,46,14,295
"37445",1037445,31,11,2,44
"37446",1037446,56,233,7,296
"37447",1037447,109,111,10,230
"37448",1037448,38,148,8,194
"37449",1037449,122,25,4,151
"37450",1037450,72,2,1,75
"37451",1037451,203,67,14,284
"37452",1037452,212,20,7,239
"37453",1037453,61,80,3,144
"37454",1037454,68,94,13,175
"37455",1037455,185,70,7,262
"37456",1037456,108,117,4,229
"37457",1037457,221,68,17,306
"37458",1037458,86,103,2,191
"37459",1037459,56,197,14,267
"37460",1037460,45,270,17,332
"37461",1037461,211,33,4,248
"37462",1037462,15,253,4,272
"37463",1037463,82,150,8,240
"37464",1037464,196,96,10,302
"37465",1037465,102,54,11,167
"37466",1037466,88,106,6,200
"37467",1037467,170,67,7,244
"37468",1037468,117,172,5,294
"37469",1037469,77,175,7,259
"37470",1037470,120,111,4,235
"37471",1037471,60,149,7,216
"37472",1037472,73,33,5,111
"37473",1037473,285,4,3,292
"37474",1037474,172,45,4,221
"37475",1037475,242,34,14,290
"37476",1037476,56,111,9,176
"37477",1037477,176,47,9,232
"37478",1037478,40,235,4,279
"37479",1037479,128,76,6,210
"37480",1037480,82,32,5,119
"37481",1037481,70,225,2,297
"37482",1037482,73,194,26,293
"37483",1037483,162,42,13,217
"37484",1037484,140,59,12,211
"37485",1037485,157,73,22,252
"37486",1037486,75,7,0,82
"37487",1037487,212,93,17,322
"37488",1037488,107,140,5,252
"37489",1037489,266,29,11,306
"37490",1037490,119,126,14,259
"37491",1037491,87,236,16,339
"37492",1037492,77,164,12,253
"37493",1037493,59,2,0,61
"37494",1037494,148,107,11,266
"37495",1037495,69,115,19,203
"37496",1037496,147,46,5,198
"37497",1037497,140,102,6,248
"37498",1037498,34,136,10,180
"37499",1037499,28,29,3,60
"37500",1037500,149,101,5,255
"37501",1037501,86,114,10,210
"37502",1037502,168,44,15,227
"37503",1037503,43,35,4,82
"37504",1037504,90,90,4,184
"37505",1037505,56,206,9,271
"37506",1037506,31,0,0,31
"37507",1037507,180,17,5,202
"37508",1037508,51,152,9,212
"37509",1037509,94,96,13,203
"37510",1037510,166,3,1,170
"37511",1037511,73,72,9,154
"37512",1037512,104,232,4,340
"37513",1037513,45,139,7,191
"37514",1037514,36,66,4,106
"37515",1037515,112,174,8,294
"37516",1037516,114,43,6,163
"37517",1037517,84,81,11,176
"37518",1037518,132,109,10,251
"37519",1037519,75,75,5,155
"37520",1037520,83,167,3,253
"37521",1037521,17,96,4,117
"37522",1037522,92,191,13,296
"37523",1037523,94,13,5,112
"37524",1037524,71,176,4,251
"37525",1037525,65,166,1,232
"37526",1037526,122,104,11,237
"37527",1037527,48,77,4,129
"37528",1037528,43,22,0,65
"37529",1037529,170,16,6,192
"37530",1037530,133,7,3,143
"37531",1037531,232,74,6,312
"37532",1037532,143,22,1,166
"37533",1037533,82,106,9,197
"37534",1037534,151,114,16,281
"37535",1037535,139,82,11,232
"37536",1037536,54,78,4,136
"37537",1037537,196,20,4,220
"37538",1037538,139,138,14,291
"37539",1037539,88,77,6,171
"37540",1037540,168,140,4,312
"37541",1037541,107,124,8,239
"37542",1037542,151,35,6,192
"37543",1037543,41,215,5,261
"37544",1037544,218,36,13,267
"37545",1037545,23,3,0,26
"37546",1037546,110,128,16,254
"37547",1037547,56,114,5,175
"37548",1037548,163,24,3,190
"37549",1037549,203,69,8,280
"37550",1037550,49,27,1,77
"37551",1037551,7,14,0,21
"37552",1037552,198,84,20,302
"37553",1037553,208,50,6,264
"37554",1037554,45,212,7,264
"37555",1037555,80,195,7,282
"37556",1037556,143,134,10,287
"37557",1037557,159,29,5,193
"37558",1037558,113,71,7,191
"37559",1037559,151,56,8,215
"37560",1037560,12,4,0,16
"37561",1037561,7,21,0,28
"37562",1037562,179,50,7,236
"37563",1037563,35,321,6,362
"37564",1037564,139,59,10,208
"37565",1037565,235,19,12,266
"37566",1037566,53,209,7,269
"37567",1037567,240,30,5,275
"37568",1037568,102,138,10,250
"37569",1037569,116,139,15,270
"37570",1037570,66,41,3,110
"37571",1037571,209,47,8,264
"37572",1037572,58,159,3,220
"37573",1037573,103,67,4,174
"37574",1037574,125,98,16,239
"37575",1037575,24,16,0,40
"37576",1037576,134,35,5,174
"37577",1037577,24,80,4,108
"37578",1037578,91,82,6,179
"37579",1037579,191,84,2,277
"37580",1037580,103,172,14,289
"37581",1037581,194,90,12,296
"37582",1037582,83,149,11,243
"37583",1037583,34,236,7,277
"37584",1037584,54,5,2,61
"37585",1037585,75,218,3,296
"37586",1037586,157,44,7,208
"37587",1037587,82,151,8,241
"37588",1037588,56,177,9,242
"37589",1037589,123,123,6,252
"37590",1037590,10,151,2,163
"37591",1037591,203,42,7,252
"37592",1037592,185,92,16,293
"37593",1037593,123,142,11,276
"37594",1037594,193,126,7,326
"37595",1037595,129,91,5,225
"37596",1037596,96,160,9,265
"37597",1037597,5,2,0,7
"37598",1037598,41,129,11,181
"37599",1037599,122,99,10,231
"37600",1037600,297,36,24,357
"37601",1037601,24,107,1,132
"37602",1037602,141,90,3,234
"37603",1037603,233,47,8,288
"37604",1037604,191,7,4,202
"37605",1037605,67,166,8,241
"37606",1037606,162,145,23,330
"37607",1037607,209,55,7,271
"37608",1037608,171,47,11,229
"37609",1037609,105,180,3,288
"37610",1037610,49,119,7,175
"37611",1037611,17,3,0,20
"37612",1037612,36,127,8,171
"37613",1037613,175,75,6,256
"37614",1037614,28,211,4,243
"37615",1037615,143,36,9,188
"37616",1037616,32,253,2,287
"37617",1037617,99,172,4,275
"37618",1037618,36,151,3,190
"37619",1037619,176,105,3,284
"37620",1037620,131,67,14,212
"37621",1037621,99,156,4,259
"37622",1037622,160,4,4,168
"37623",1037623,208,43,10,261
"37624",1037624,153,97,20,270
"37625",1037625,85,128,12,225
"37626",1037626,36,243,4,283
"37627",1037627,100,134,13,247
"37628",1037628,35,192,3,230
"37629",1037629,210,95,10,315
"37630",1037630,27,134,0,161
"37631",1037631,77,155,26,258
"37632",1037632,132,75,6,213
"37633",1037633,87,194,1,282
"37634",1037634,70,147,3,220
"37635",1037635,195,107,21,323
"37636",1037636,25,154,10,189
"37637",1037637,32,233,3,268
"37638",1037638,74,217,6,297
"37639",1037639,106,44,1,151
"37640",1037640,86,170,4,260
"37641",1037641,130,43,8,181
"37642",1037642,36,256,3,295
"37643",1037643,48,235,18,301
"37644",1037644,105,57,15,177
"37645",1037645,82,110,2,194
"37646",1037646,25,12,0,37
"37647",1037647,98,131,11,240
"37648",1037648,11,7,0,18
"37649",1037649,180,51,9,240
"37650",1037650,158,90,16,264
"37651",1037651,48,236,10,294
"37652",1037652,155,41,5,201
"37653",1037653,119,120,11,250
"37654",1037654,191,25,4,220
"37655",1037655,91,149,10,250
"37656",1037656,59,102,9,170
"37657",1037657,103,156,17,276
"37658",1037658,71,169,10,250
"37659",1037659,105,123,19,247
"37660",1037660,172,26,2,200
"37661",1037661,67,28,3,98
"37662",1037662,153,27,7,187
"37663",1037663,52,16,3,71
"37664",1037664,132,15,11,158
"37665",1037665,235,6,6,247
"37666",1037666,59,184,13,256
"37667",1037667,72,77,6,155
"37668",1037668,61,98,27,186
"37669",1037669,119,56,12,187
"37670",1037670,7,1,1,9
"37671",1037671,182,63,8,253
"37672",1037672,159,136,8,303
"37673",1037673,77,96,7,180
"37674",1037674,71,61,3,135
"37675",1037675,186,25,9,220
"37676",1037676,105,101,16,222
"37677",1037677,65,242,7,314
"37678",1037678,89,80,16,185
"37679",1037679,168,158,7,333
"37680",1037680,36,238,4,278
"37681",1037681,57,283,4,344
"37682",1037682,178,38,11,227
"37683",1037683,94,14,3,111
"37684",1037684,94,150,7,251
"37685",1037685,200,34,7,241
"37686",1037686,110,53,6,169
"37687",1037687,131,86,10,227
"37688",1037688,32,10,2,44
"37689",1037689,145,31,8,184
"37690",1037690,267,13,11,291
"37691",1037691,178,118,5,301
"37692",1037692,62,197,6,265
"37693",1037693,84,97,20,201
"37694",1037694,76,35,1,112
"37695",1037695,223,21,10,254
"37696",1037696,136,101,7,244
"37697",1037697,194,65,9,268
"37698",1037698,115,65,6,186
"37699",1037699,38,180,9,227
"37700",1037700,21,221,1,243
"37701",1037701,110,171,16,297
"37702",1037702,45,142,9,196
"37703",1037703,113,54,4,171
"37704",1037704,136,154,14,304
"37705",1037705,25,15,1,41
"37706",1037706,162,46,1,209
"37707",1037707,73,261,0,334
"37708",1037708,56,208,6,270
"37709",1037709,61,35,2,98
"37710",1037710,105,142,2,249
"37711",1037711,86,82,6,174
"37712",1037712,92,172,11,275
"37713",1037713,84,86,7,177
"37714",1037714,116,143,8,267
"37715",1037715,62,41,9,112
"37716",1037716,87,80,8,175
"37717",1037717,39,61,4,104
"37718",1037718,95,189,2,286
"37719",1037719,129,83,1,213
"37720",1037720,178,23,6,207
"37721",1037721,56,37,1,94
"37722",1037722,63,55,5,123
"37723",1037723,117,56,7,180
"37724",1037724,203,44,7,254
"37725",1037725,165,71,7,243
"37726",1037726,55,214,8,277
"37727",1037727,44,75,7,126
"37728",1037728,29,43,3,75
"37729",1037729,25,218,2,245
"37730",1037730,97,31,5,133
"37731",1037731,116,26,1,143
"37732",1037732,75,121,5,201
"37733",1037733,64,221,13,298
"37734",1037734,215,70,10,295
"37735",1037735,108,121,16,245
"37736",1037736,43,254,2,299
"37737",1037737,85,191,7,283
"37738",1037738,47,152,3,202
"37739",1037739,149,82,13,244
"37740",1037740,108,97,10,215
"37741",1037741,91,84,15,190
"37742",1037742,121,92,7,220
"37743",1037743,95,149,16,260
"37744",1037744,120,101,0,221
"37745",1037745,85,101,9,195
"37746",1037746,119,88,6,213
"37747",1037747,49,196,8,253
"37748",1037748,133,54,7,194
"37749",1037749,24,268,6,298
"37750",1037750,47,31,0,78
"37751",1037751,102,58,4,164
"37752",1037752,83,56,1,140
"37753",1037753,73,99,10,182
"37754",1037754,118,73,4,195
"37755",1037755,169,42,19,230
"37756",1037756,20,16,3,39
"37757",1037757,21,190,2,213
"37758",1037758,238,67,15,320
"37759",1037759,112,62,3,177
"37760",1037760,176,58,11,245
"37761",1037761,167,46,4,217
"37762",1037762,78,129,13,220
"37763",1037763,20,239,1,260
"37764",1037764,207,39,12,258
"37765",1037765,73,153,12,238
"37766",1037766,37,238,6,281
"37767",1037767,44,160,1,205
"37768",1037768,0,5,0,5
"37769",1037769,35,205,3,243
"37770",1037770,188,23,3,214
"37771",1037771,19,89,3,111
"37772",1037772,185,41,13,239
"37773",1037773,128,89,9,226
"37774",1037774,103,178,17,298
"37775",1037775,167,48,13,228
"37776",1037776,119,112,5,236
"37777",1037777,89,206,5,300
"37778",1037778,61,155,8,224
"37779",1037779,152,81,8,241
"37780",1037780,125,172,15,312
"37781",1037781,44,185,7,236
"37782",1037782,207,25,2,234
"37783",1037783,144,121,15,280
"37784",1037784,19,191,2,212
"37785",1037785,44,173,5,222
"37786",1037786,60,217,7,284
"37787",1037787,111,111,10,232
"37788",1037788,2,3,2,7
"37789",1037789,57,186,2,245
"37790",1037790,94,182,12,288
"37791",1037791,72,122,5,199
"37792",1037792,64,198,10,272
"37793",1037793,40,94,2,136
"37794",1037794,181,29,14,224
"37795",1037795,61,87,7,155
"37796",1037796,54,0,0,54
"37797",1037797,157,111,7,275
"37798",1037798,34,197,5,236
"37799",1037799,261,13,6,280
"37800",1037800,89,192,8,289
"37801",1037801,172,98,7,277
"37802",1037802,12,7,2,21
"37803",1037803,62,123,1,186
"37804",1037804,199,35,6,240
"37805",1037805,89,108,9,206
"37806",1037806,5,5,0,10
"37807",1037807,90,67,8,165
"37808",1037808,190,66,2,258
"37809",1037809,5,13,3,21
"37810",1037810,83,153,6,242
"37811",1037811,57,102,4,163
"37812",1037812,42,1,1,44
"37813",1037813,133,113,13,259
"37814",1037814,28,196,1,225
"37815",1037815,184,96,8,288
"37816",1037816,130,94,8,232
"37817",1037817,140,72,11,223
"37818",1037818,168,86,6,260
"37819",1037819,116,17,1,134
"37820",1037820,111,197,8,316
"37821",1037821,120,183,22,325
"37822",1037822,150,78,4,232
"37823",1037823,178,59,4,241
"37824",1037824,6,3,1,10
"37825",1037825,37,214,5,256
"37826",1037826,217,14,5,236
"37827",1037827,199,40,6,245
"37828",1037828,172,57,5,234
"37829",1037829,263,47,7,317
"37830",1037830,58,85,2,145
"37831",1037831,19,274,3,296
"37832",1037832,147,60,2,209
"37833",1037833,146,71,4,221
"37834",1037834,48,252,4,304
"37835",1037835,156,59,16,231
"37836",1037836,266,36,11,313
"37837",1037837,62,45,13,120
"37838",1037838,196,39,15,250
"37839",1037839,172,94,13,279
"37840",1037840,61,146,10,217
"37841",1037841,99,177,4,280
"37842",1037842,174,81,14,269
"37843",1037843,100,84,13,197
"37844",1037844,190,66,5,261
"37845",1037845,119,147,12,278
"37846",1037846,18,72,1,91
"37847",1037847,168,77,5,250
"37848",1037848,251,34,10,295
"37849",1037849,135,97,1,233
"37850",1037850,155,53,12,220
"37851",1037851,161,45,5,211
"37852",1037852,5,5,0,10
"37853",1037853,109,99,6,214
"37854",1037854,201,42,12,255
"37855",1037855,50,12,6,68
"37856",1037856,93,42,7,142
"37857",1037857,53,172,5,230
"37858",1037858,46,73,5,124
"37859",1037859,189,78,9,276
"37860",1037860,48,153,13,214
"37861",1037861,99,55,11,165
"37862",1037862,127,50,4,181
"37863",1037863,174,25,12,211
"37864",1037864,164,27,5,196
"37865",1037865,96,149,8,253
"37866",1037866,48,265,3,316
"37867",1037867,132,164,7,303
"37868",1037868,28,95,4,127
"37869",1037869,31,19,0,50
"37870",1037870,63,63,4,130
"37871",1037871,129,49,6,184
"37872",1037872,163,52,7,222
"37873",1037873,188,32,5,225
"37874",1037874,130,116,5,251
"37875",1037875,23,105,4,132
"37876",1037876,191,11,5,207
"37877",1037877,145,116,10,271
"37878",1037878,47,249,7,303
"37879",1037879,107,103,6,216
"37880",1037880,94,248,7,349
"37881",1037881,73,70,3,146
"37882",1037882,106,176,8,290
"37883",1037883,12,195,1,208
"37884",1037884,42,30,0,72
"37885",1037885,46,63,2,111
"37886",1037886,53,26,6,85
"37887",1037887,81,140,19,240
"37888",1037888,75,180,10,265
"37889",1037889,92,135,11,238
"37890",1037890,162,86,3,251
"37891",1037891,37,42,4,83
"37892",1037892,224,20,8,252
"37893",1037893,49,265,2,316
"37894",1037894,151,75,7,233
"37895",1037895,41,237,4,282
"37896",1037896,135,160,8,303
"37897",1037897,143,116,8,267
"37898",1037898,174,36,5,215
"37899",1037899,221,32,0,253
"37900",1037900,183,78,10,271
"37901",1037901,161,65,7,233
"37902",1037902,230,29,9,268
"37903",1037903,151,53,7,211
"37904",1037904,22,223,0,245
"37905",1037905,39,63,2,104
"37906",1037906,241,53,13,307
"37907",1037907,200,59,7,266
"37908",1037908,251,6,3,260
"37909",1037909,53,200,4,257
"37910",1037910,104,139,6,249
"37911",1037911,54,192,8,254
"37912",1037912,238,5,3,246
"37913",1037913,1,6,1,8
"37914",1037914,160,89,3,252
"37915",1037915,63,248,2,313
"37916",1037916,117,49,5,171
"37917",1037917,54,2,1,57
"37918",1037918,70,4,1,75
"37919",1037919,159,21,6,186
"37920",1037920,142,107,9,258
"37921",1037921,19,203,2,224
"37922",1037922,61,124,4,189
"37923",1037923,111,80,8,199
"37924",1037924,135,151,14,300
"37925",1037925,51,240,4,295
"37926",1037926,78,172,24,274
"37927",1037927,69,33,2,104
"37928",1037928,47,251,5,303
"37929",1037929,16,5,1,22
"37930",1037930,147,74,4,225
"37931",1037931,45,171,2,218
"37932",1037932,61,30,6,97
"37933",1037933,105,196,7,308
"37934",1037934,37,73,9,119
"37935",1037935,191,134,8,333
"37936",1037936,75,122,12,209
"37937",1037937,28,209,4,241
"37938",1037938,63,105,4,172
"37939",1037939,52,162,5,219
"37940",1037940,191,86,12,289
"37941",1037941,169,29,7,205
"37942",1037942,97,132,4,233
"37943",1037943,113,118,10,241
"37944",1037944,9,27,2,38
"37945",1037945,148,58,7,213
"37946",1037946,165,14,3,182
"37947",1037947,40,195,10,245
"37948",1037948,66,193,3,262
"37949",1037949,89,72,11,172
"37950",1037950,67,84,6,157
"37951",1037951,145,27,2,174
"37952",1037952,56,166,11,233
"37953",1037953,111,188,5,304
"37954",1037954,88,158,3,249
"37955",1037955,128,58,2,188
"37956",1037956,15,42,6,63
"37957",1037957,155,57,3,215
"37958",1037958,175,21,8,204
"37959",1037959,87,212,8,307
"37960",1037960,70,130,10,210
"37961",1037961,72,26,6,104
"37962",1037962,213,20,1,234
"37963",1037963,148,17,1,166
"37964",1037964,80,174,22,276
"37965",1037965,191,50,6,247
"37966",1037966,37,183,1,221
"37967",1037967,140,96,10,246
"37968",1037968,172,121,12,305
"37969",1037969,151,73,14,238
"37970",1037970,41,296,7,344
"37971",1037971,43,256,7,306
"37972",1037972,182,89,18,289
"37973",1037973,148,62,3,213
"37974",1037974,143,48,9,200
"37975",1037975,172,28,8,208
"37976",1037976,103,24,3,130
"37977",1037977,104,133,7,244
"37978",1037978,178,121,8,307
"37979",1037979,109,231,6,346
"37980",1037980,157,76,4,237
"37981",1037981,76,176,14,266
"37982",1037982,113,137,3,253
"37983",1037983,50,103,5,158
"37984",1037984,93,200,5,298
"37985",1037985,82,165,8,255
"37986",1037986,86,52,7,145
"37987",1037987,12,10,0,22
"37988",1037988,23,7,0,30
"37989",1037989,37,156,5,198
"37990",1037990,156,127,18,301
"37991",1037991,91,120,14,225
"37992",1037992,111,17,3,131
"37993",1037993,152,16,6,174
"37994",1037994,145,12,10,167
"37995",1037995,181,130,11,322
"37996",1037996,105,112,5,222
"37997",1037997,5,0,1,6
"37998",1037998,43,204,8,255
"37999",1037999,181,21,6,208
"38000",1038000,156,103,8,267
"38001",1038001,113,78,6,197
"38002",1038002,56,114,2,172
"38003",1038003,177,45,3,225
"38004",1038004,119,111,12,242
"38005",1038005,22,70,2,94
"38006",1038006,22,47,1,70
"38007",1038007,213,25,6,244
"38008",1038008,116,83,15,214
"38009",1038009,92,164,6,262
"38010",1038010,166,114,5,285
"38011",1038011,192,105,10,307
"38012",1038012,91,203,4,298
"38013",1038013,198,104,4,306
"38014",1038014,3,6,0,9
"38015",1038015,62,146,4,212
"38016",1038016,169,27,5,201
"38017",1038017,157,125,16,298
"38018",1038018,37,62,3,102
"38019",1038019,134,41,11,186
"38020",1038020,64,150,6,220
"38021",1038021,181,132,10,323
"38022",1038022,166,87,9,262
"38023",1038023,135,39,3,177
"38024",1038024,57,40,1,98
"38025",1038025,183,42,8,233
"38026",1038026,56,49,1,106
"38027",1038027,112,51,4,167
"38028",1038028,96,43,8,147
"38029",1038029,26,30,3,59
"38030",1038030,200,109,7,316
"38031",1038031,57,55,3,115
"38032",1038032,148,22,6,176
"38033",1038033,134,111,21,266
"38034",1038034,187,91,15,293
"38035",1038035,62,67,5,134
"38036",1038036,35,232,5,272
"38037",1038037,111,154,20,285
"38038",1038038,88,253,6,347
"38039",1038039,149,96,14,259
"38040",1038040,75,113,9,197
"38041",1038041,67,190,3,260
"38042",1038042,162,96,10,268
"38043",1038043,114,154,6,274
"38044",1038044,105,89,16,210
"38045",1038045,39,24,6,69
"38046",1038046,139,85,12,236
"38047",1038047,153,119,31,303
"38048",1038048,179,62,16,257
"38049",1038049,82,215,8,305
"38050",1038050,158,112,7,277
"38051",1038051,15,61,2,78
"38052",1038052,153,90,19,262
"38053",1038053,177,130,7,314
"38054",1038054,49,236,3,288
"38055",1038055,177,54,13,244
"38056",1038056,157,69,2,228
"38057",1038057,157,124,15,296
"38058",1038058,109,61,5,175
"38059",1038059,39,183,0,222
"38060",1038060,79,251,14,344
"38061",1038061,54,267,10,331
"38062",1038062,61,204,9,274
"38063",1038063,174,125,15,314
"38064",1038064,87,85,12,184
"38065",1038065,101,200,12,313
"38066",1038066,58,198,18,274
"38067",1038067,131,185,11,327
"38068",1038068,75,173,26,274
"38069",1038069,82,110,3,195
"38070",1038070,175,7,0,182
"38071",1038071,118,57,10,185
"38072",1038072,116,72,6,194
"38073",1038073,151,81,11,243
"38074",1038074,102,247,12,361
"38075",1038075,121,88,12,221
"38076",1038076,152,76,5,233
"38077",1038077,212,34,5,251
"38078",1038078,135,63,15,213
"38079",1038079,61,187,7,255
"38080",1038080,85,125,5,215
"38081",1038081,122,51,11,184
"38082",1038082,200,27,4,231
"38083",1038083,208,35,8,251
"38084",1038084,196,106,17,319
"38085",1038085,124,96,10,230
"38086",1038086,54,218,8,280
"38087",1038087,120,87,18,225
"38088",1038088,174,78,18,270
"38089",1038089,54,207,23,284
"38090",1038090,42,3,2,47
"38091",1038091,45,27,2,74
"38092",1038092,44,212,2,258
"38093",1038093,182,51,17,250
"38094",1038094,197,57,19,273
"38095",1038095,22,18,0,40
"38096",1038096,33,75,1,109
"38097",1038097,134,9,4,147
"38098",1038098,52,4,0,56
"38099",1038099,39,28,4,71
"38100",1038100,59,151,11,221
"38101",1038101,230,24,7,261
"38102",1038102,42,3,2,47
"38103",1038103,168,103,17,288
"38104",1038104,128,52,5,185
"38105",1038105,133,81,13,227
"38106",1038106,150,154,15,319
"38107",1038107,45,222,4,271
"38108",1038108,75,104,4,183
"38109",1038109,82,30,4,116
"38110",1038110,224,60,12,296
"38111",1038111,48,100,0,148
"38112",1038112,80,58,6,144
"38113",1038113,67,235,17,319
"38114",1038114,47,123,1,171
"38115",1038115,17,22,1,40
"38116",1038116,167,29,4,200
"38117",1038117,235,45,8,288
"38118",1038118,42,139,18,199
"38119",1038119,246,7,4,257
"38120",1038120,109,74,8,191
"38121",1038121,31,192,0,223
"38122",1038122,136,113,11,260
"38123",1038123,235,30,5,270
"38124",1038124,138,70,18,226
"38125",1038125,201,37,8,246
"38126",1038126,70,76,8,154
"38127",1038127,31,250,8,289
"38128",1038128,109,81,6,196
"38129",1038129,45,105,8,158
"38130",1038130,93,60,9,162
"38131",1038131,34,174,7,215
"38132",1038132,202,36,5,243
"38133",1038133,43,87,6,136
"38134",1038134,69,228,7,304
"38135",1038135,76,190,5,271
"38136",1038136,9,14,0,23
"38137",1038137,120,128,11,259
"38138",1038138,102,179,21,302
"38139",1038139,143,83,14,240
"38140",1038140,170,72,12,254
"38141",1038141,162,137,15,314
"38142",1038142,138,156,10,304
"38143",1038143,48,191,12,251
"38144",1038144,205,78,16,299
"38145",1038145,91,111,12,214
"38146",1038146,137,101,4,242
"38147",1038147,1,2,3,6
"38148",1038148,135,54,7,196
"38149",1038149,136,81,10,227
"38150",1038150,25,2,1,28
"38151",1038151,102,159,10,271
"38152",1038152,33,169,2,204
"38153",1038153,93,182,13,288
"38154",1038154,20,73,2,95
"38155",1038155,73,149,4,226
"38156",1038156,154,115,13,282
"38157",1038157,150,31,9,190
"38158",1038158,153,89,2,244
"38159",1038159,47,193,7,247
"38160",1038160,170,16,2,188
"38161",1038161,110,45,5,160
"38162",1038162,31,35,0,66
"38163",1038163,31,191,5,227
"38164",1038164,38,280,11,329
"38165",1038165,169,55,9,233
"38166",1038166,93,70,7,170
"38167",1038167,73,175,14,262
"38168",1038168,196,52,21,269
"38169",1038169,24,225,3,252
"38170",1038170,170,22,7,199
"38171",1038171,24,167,8,199
"38172",1038172,149,89,21,259
"38173",1038173,79,145,9,233
"38174",1038174,16,14,3,33
"38175",1038175,139,67,5,211
"38176",1038176,82,189,10,281
"38177",1038177,101,102,8,211
"38178",1038178,279,31,5,315
"38179",1038179,129,28,6,163
"38180",1038180,66,71,4,141
"38181",1038181,85,173,19,277
"38182",1038182,107,87,15,209
"38183",1038183,227,5,6,238
"38184",1038184,177,19,8,204
"38185",1038185,50,18,4,72
"38186",1038186,159,102,2,263
"38187",1038187,95,183,9,287
"38188",1038188,259,16,5,280
"38189",1038189,80,222,5,307
"38190",1038190,80,51,4,135
"38191",1038191,7,42,1,50
"38192",1038192,166,101,5,272
"38193",1038193,107,142,16,265
"38194",1038194,193,37,5,235
"38195",1038195,137,176,17,330
"38196",1038196,127,61,10,198
"38197",1038197,119,131,7,257
"38198",1038198,55,215,10,280
"38199",1038199,31,153,2,186
"38200",1038200,123,38,7,168
"38201",1038201,17,229,0,246
"38202",1038202,138,103,14,255
"38203",1038203,71,70,6,147
"38204",1038204,162,11,5,178
"38205",1038205,76,63,13,152
"38206",1038206,155,54,5,214
"38207",1038207,118,202,18,338
"38208",1038208,21,16,1,38
"38209",1038209,139,88,8,235
"38210",1038210,153,127,13,293
"38211",1038211,159,73,1,233
"38212",1038212,99,89,3,191
"38213",1038213,80,248,5,333
"38214",1038214,56,209,2,267
"38215",1038215,59,137,2,198
"38216",1038216,117,165,7,289
"38217",1038217,190,22,6,218
"38218",1038218,123,48,7,178
"38219",1038219,61,192,17,270
"38220",1038220,62,218,19,299
"38221",1038221,61,20,1,82
"38222",1038222,121,74,7,202
"38223",1038223,92,178,10,280
"38224",1038224,97,178,10,285
"38225",1038225,129,62,4,195
"38226",1038226,119,156,13,288
"38227",1038227,90,160,11,261
"38228",1038228,10,203,6,219
"38229",1038229,50,96,8,154
"38230",1038230,83,64,4,151
"38231",1038231,134,90,7,231
"38232",1038232,76,193,6,275
"38233",1038233,170,95,15,280
"38234",1038234,107,163,8,278
"38235",1038235,186,4,20,210
"38236",1038236,186,83,10,279
"38237",1038237,203,74,3,280
"38238",1038238,129,19,5,153
"38239",1038239,134,18,7,159
"38240",1038240,20,207,0,227
"38241",1038241,159,24,2,185
"38242",1038242,77,174,15,266
"38243",1038243,194,116,10,320
"38244",1038244,56,175,17,248
"38245",1038245,112,32,18,162
"38246",1038246,204,39,3,246
"38247",1038247,150,22,5,177
"38248",1038248,182,114,6,302
"38249",1038249,19,3,0,22
"38250",1038250,92,134,5,231
"38251",1038251,107,136,7,250
"38252",1038252,206,21,9,236
"38253",1038253,177,68,8,253
"38254",1038254,65,176,18,259
"38255",1038255,64,226,5,295
"38256",1038256,57,37,1,95
"38257",1038257,203,99,14,316
"38258",1038258,51,15,4,70
"38259",1038259,157,60,8,225
"38260",1038260,182,34,9,225
"38261",1038261,86,111,3,200
"38262",1038262,123,76,6,205
"38263",1038263,37,189,4,230
"38264",1038264,60,108,7,175
"38265",1038265,173,54,9,236
"38266",1038266,1,5,0,6
"38267",1038267,167,120,17,304
"38268",1038268,120,111,5,236
"38269",1038269,142,44,7,193
"38270",1038270,56,222,9,287
"38271",1038271,21,211,4,236
"38272",1038272,67,202,26,295
"38273",1038273,60,20,4,84
"38274",1038274,88,11,3,102
"38275",1038275,23,29,2,54
"38276",1038276,14,13,0,27
"38277",1038277,227,37,9,273
"38278",1038278,176,44,10,230
"38279",1038279,187,94,13,294
"38280",1038280,52,60,2,114
"38281",1038281,77,186,8,271
"38282",1038282,132,53,4,189
"38283",1038283,115,80,16,211
"38284",1038284,146,76,8,230
"38285",1038285,15,57,0,72
"38286",1038286,144,47,7,198
"38287",1038287,77,184,4,265
"38288",1038288,184,33,6,223
"38289",1038289,30,152,9,191
"38290",1038290,112,93,13,218
"38291",1038291,90,182,3,275
"38292",1038292,117,124,8,249
"38293",1038293,86,108,13,207
"38294",1038294,169,117,11,297
"38295",1038295,176,48,4,228
"38296",1038296,118,41,6,165
"38297",1038297,171,107,15,293
"38298",1038298,32,26,0,58
"38299",1038299,143,53,6,202
"38300",1038300,146,32,4,182
"38301",1038301,186,110,10,306
"38302",1038302,46,236,11,293
"38303",1038303,145,153,15,313
"38304",1038304,202,16,4,222
"38305",1038305,23,211,3,237
"38306",1038306,45,65,2,112
"38307",1038307,18,2,4,24
"38308",1038308,55,226,8,289
"38309",1038309,57,58,1,116
"38310",1038310,144,56,4,204
"38311",1038311,215,36,5,256
"38312",1038312,169,68,7,244
"38313",1038313,102,224,15,341
"38314",1038314,22,1,0,23
"38315",1038315,57,218,2,277
"38316",1038316,97,98,15,210
"38317",1038317,137,27,31,195
"38318",1038318,60,101,5,166
"38319",1038319,139,50,4,193
"38320",1038320,10,6,0,16
"38321",1038321,168,65,12,245
"38322",1038322,86,75,10,171
"38323",1038323,78,148,12,238
"38324",1038324,137,145,8,290
"38325",1038325,83,177,8,268
"38326",1038326,120,46,4,170
"38327",1038327,104,84,14,202
"38328",1038328,32,207,3,242
"38329",1038329,67,262,1,330
"38330",1038330,36,92,5,133
"38331",1038331,89,98,9,196
"38332",1038332,58,216,11,285
"38333",1038333,180,40,10,230
"38334",1038334,198,79,9,286
"38335",1038335,74,246,12,332
"38336",1038336,248,7,1,256
"38337",1038337,17,23,2,42
"38338",1038338,44,36,4,84
"38339",1038339,101,144,4,249
"38340",1038340,186,102,12,300
"38341",1038341,152,74,15,241
"38342",1038342,143,85,10,238
"38343",1038343,90,162,17,269
"38344",1038344,194,61,7,262
"38345",1038345,28,213,13,254
"38346",1038346,110,58,15,183
"38347",1038347,111,127,4,242
"38348",1038348,120,107,13,240
"38349",1038349,155,74,12,241
"38350",1038350,102,58,6,166
"38351",1038351,120,50,10,180
"38352",1038352,52,186,4,242
"38353",1038353,61,43,5,109
"38354",1038354,130,68,8,206
"38355",1038355,134,49,5,188
"38356",1038356,139,42,6,187
"38357",1038357,82,213,3,298
"38358",1038358,138,54,4,196
"38359",1038359,117,56,10,183
"38360",1038360,143,116,15,274
"38361",1038361,98,106,4,208
"38362",1038362,54,272,6,332
"38363",1038363,109,179,5,293
"38364",1038364,65,214,4,283
"38365",1038365,90,73,7,170
"38366",1038366,61,0,0,61
"38367",1038367,173,131,10,314
"38368",1038368,92,183,3,278
"38369",1038369,16,107,4,127
"38370",1038370,101,62,13,176
"38371",1038371,181,20,9,210
"38372",1038372,63,55,0,118
"38373",1038373,83,27,1,111
"38374",1038374,134,35,6,175
"38375",1038375,118,81,16,215
"38376",1038376,113,138,17,268
"38377",1038377,151,93,4,248
"38378",1038378,26,202,4,232
"38379",1038379,31,77,0,108
"38380",1038380,181,82,12,275
"38381",1038381,80,117,5,202
"38382",1038382,198,85,11,294
"38383",1038383,246,159,17,422
"38384",1038384,103,55,11,169
"38385",1038385,62,64,13,139
"38386",1038386,226,60,12,298
"38387",1038387,219,83,9,311
"38388",1038388,20,14,1,35
"38389",1038389,133,95,9,237
"38390",1038390,24,5,1,30
"38391",1038391,202,24,3,229
"38392",1038392,49,164,8,221
"38393",1038393,7,71,2,80
"38394",1038394,160,75,8,243
"38395",1038395,156,109,19,284
"38396",1038396,83,86,6,175
"38397",1038397,133,64,5,202
"38398",1038398,151,109,19,279
"38399",1038399,143,101,10,254
"38400",1038400,32,150,0,182
"38401",1038401,116,130,8,254
"38402",1038402,176,86,16,278
"38403",1038403,151,9,5,165
"38404",1038404,148,119,5,272
"38405",1038405,133,85,10,228
"38406",1038406,146,33,10,189
"38407",1038407,239,50,7,296
"38408",1038408,80,237,16,333
"38409",1038409,99,126,12,237
"38410",1038410,151,37,7,195
"38411",1038411,161,90,12,263
"38412",1038412,136,50,7,193
"38413",1038413,64,128,9,201
"38414",1038414,51,206,12,269
"38415",1038415,113,151,11,275
"38416",1038416,26,173,7,206
"38417",1038417,173,65,16,254
"38418",1038418,93,186,19,298
"38419",1038419,122,148,7,277
"38420",1038420,185,22,7,214
"38421",1038421,177,97,19,293
"38422",1038422,207,35,3,245
"38423",1038423,229,82,10,321
"38424",1038424,109,125,10,244
"38425",1038425,214,32,8,254
"38426",1038426,59,181,14,254
"38427",1038427,210,20,3,233
"38428",1038428,48,49,1,98
"38429",1038429,163,132,12,307
"38430",1038430,45,198,1,244
"38431",1038431,109,93,7,209
"38432",1038432,62,157,3,222
"38433",1038433,123,193,3,319
"38434",1038434,90,138,14,242
"38435",1038435,102,123,2,227
"38436",1038436,73,114,18,205
"38437",1038437,225,61,20,306
"38438",1038438,114,50,5,169
"38439",1038439,29,271,4,304
"38440",1038440,94,64,10,168
"38441",1038441,117,170,25,312
"38442",1038442,156,142,10,308
"38443",1038443,129,22,7,158
"38444",1038444,133,159,3,295
"38445",1038445,126,52,4,182
"38446",1038446,98,181,16,295
"38447",1038447,135,44,11,190
"38448",1038448,82,175,5,262
"38449",1038449,147,32,2,181
"38450",1038450,68,213,8,289
"38451",1038451,56,98,3,157
"38452",1038452,211,83,10,304
"38453",1038453,83,17,5,105
"38454",1038454,140,58,10,208
"38455",1038455,145,117,12,274
"38456",1038456,242,73,15,330
"38457",1038457,122,168,8,298
"38458",1038458,66,63,3,132
"38459",1038459,132,79,4,215
"38460",1038460,8,135,1,144
"38461",1038461,205,45,9,259
"38462",1038462,257,50,12,319
"38463",1038463,166,130,16,312
"38464",1038464,178,124,15,317
"38465",1038465,60,189,7,256
"38466",1038466,123,120,0,243
"38467",1038467,78,8,0,86
"38468",1038468,5,47,1,53
"38469",1038469,177,154,13,344
"38470",1038470,52,234,5,291
"38471",1038471,123,53,9,185
"38472",1038472,131,199,11,341
"38473",1038473,119,40,11,170
"38474",1038474,22,151,4,177
"38475",1038475,70,150,9,229
"38476",1038476,233,34,12,279
"38477",1038477,83,176,6,265
"38478",1038478,157,63,8,228
"38479",1038479,161,80,18,259
"38480",1038480,177,107,16,300
"38481",1038481,120,110,3,233
"38482",1038482,185,53,13,251
"38483",1038483,50,276,3,329
"38484",1038484,73,51,2,126
"38485",1038485,5,7,0,12
"38486",1038486,149,74,7,230
"38487",1038487,45,256,4,305
"38488",1038488,122,102,8,232
"38489",1038489,125,55,11,191
"38490",1038490,141,142,8,291
"38491",1038491,167,77,3,247
"38492",1038492,120,116,6,242
"38493",1038493,28,132,14,174
"38494",1038494,9,1,1,11
"38495",1038495,161,21,8,190
"38496",1038496,53,237,5,295
"38497",1038497,24,17,3,44
"38498",1038498,127,93,5,225
"38499",1038499,68,80,9,157
"38500",1038500,18,19,1,38
"38501",1038501,72,67,0,139
"38502",1038502,30,61,1,92
"38503",1038503,8,0,0,8
"38504",1038504,215,16,7,238
"38505",1038505,20,71,10,101
"38506",1038506,119,166,9,294
"38507",1038507,100,80,16,196
"38508",1038508,123,158,7,288
"38509",1038509,220,41,11,272
"38510",1038510,44,179,6,229
"38511",1038511,154,44,12,210
"38512",1038512,167,98,8,273
"38513",1038513,20,206,0,226
"38514",1038514,18,317,3,338
"38515",1038515,79,155,16,250
"38516",1038516,188,16,7,211
"38517",1038517,149,123,22,294
"38518",1038518,200,9,1,210
"38519",1038519,233,131,12,376
"38520",1038520,131,85,18,234
"38521",1038521,183,67,12,262
"38522",1038522,25,176,9,210
"38523",1038523,52,16,5,73
"38524",1038524,181,60,11,252
"38525",1038525,148,120,23,291
"38526",1038526,110,177,12,299
"38527",1038527,125,148,3,276
"38528",1038528,189,42,8,239
"38529",1038529,70,176,6,252
"38530",1038530,63,161,22,246
"38531",1038531,148,164,13,325
"38532",1038532,6,29,1,36
"38533",1038533,54,250,1,305
"38534",1038534,255,35,5,295
"38535",1038535,195,49,8,252
"38536",1038536,80,171,9,260
"38537",1038537,196,42,10,248
"38538",1038538,68,79,9,156
"38539",1038539,107,143,15,265
"38540",1038540,44,224,3,271
"38541",1038541,118,153,18,289
"38542",1038542,77,204,5,286
"38543",1038543,150,74,4,228
"38544",1038544,174,24,4,202
"38545",1038545,70,62,3,135
"38546",1038546,47,57,3,107
"38547",1038547,171,40,4,215
"38548",1038548,178,71,3,252
"38549",1038549,190,44,11,245
"38550",1038550,233,50,6,289
"38551",1038551,72,75,9,156
"38552",1038552,88,195,10,293
"38553",1038553,32,85,0,117
"38554",1038554,38,31,4,73
"38555",1038555,40,20,4,64
"38556",1038556,148,114,6,268
"38557",1038557,163,43,6,212
"38558",1038558,99,170,3,272
"38559",1038559,187,22,8,217
"38560",1038560,166,102,9,277
"38561",1038561,66,200,13,279
"38562",1038562,29,1,0,30
"38563",1038563,2,2,0,4
"38564",1038564,27,3,0,30
"38565",1038565,126,107,7,240
"38566",1038566,208,61,8,277
"38567",1038567,58,58,2,118
"38568",1038568,30,323,4,357
"38569",1038569,98,161,13,272
"38570",1038570,89,9,4,102
"38571",1038571,93,179,9,281
"38572",1038572,4,54,0,58
"38573",1038573,137,96,10,243
"38574",1038574,93,28,5,126
"38575",1038575,10,19,4,33
"38576",1038576,103,169,14,286
"38577",1038577,17,181,5,203
"38578",1038578,48,214,5,267
"38579",1038579,143,104,7,254
"38580",1038580,141,26,38,205
"38581",1038581,69,133,3,205
"38582",1038582,205,83,14,302
"38583",1038583,178,7,3,188
"38584",1038584,150,13,7,170
"38585",1038585,73,123,3,199
"38586",1038586,77,124,3,204
"38587",1038587,137,30,12,179
"38588",1038588,76,75,23,174
"38589",1038589,190,45,8,243
"38590",1038590,173,136,18,327
"38591",1038591,169,53,6,228
"38592",1038592,183,74,21,278
"38593",1038593,151,85,9,245
"38594",1038594,103,82,4,189
"38595",1038595,61,172,7,240
"38596",1038596,163,80,9,252
"38597",1038597,17,31,2,50
"38598",1038598,218,72,1,291
"38599",1038599,194,119,10,323
"38600",1038600,32,168,11,211
"38601",1038601,135,28,3,166
"38602",1038602,33,149,4,186
"38603",1038603,100,61,13,174
"38604",1038604,146,43,5,194
"38605",1038605,197,22,3,222
"38606",1038606,14,205,2,221
"38607",1038607,20,16,2,38
"38608",1038608,108,71,5,184
"38609",1038609,176,24,6,206
"38610",1038610,77,67,8,152
"38611",1038611,145,79,4,228
"38612",1038612,27,238,5,270
"38613",1038613,102,22,5,129
"38614",1038614,117,54,5,176
"38615",1038615,154,93,5,252
"38616",1038616,111,159,6,276
"38617",1038617,113,31,3,147
"38618",1038618,45,110,4,159
"38619",1038619,38,13,2,53
"38620",1038620,42,183,8,233
"38621",1038621,99,45,9,153
"38622",1038622,98,77,8,183
"38623",1038623,124,76,5,205
"38624",1038624,101,65,10,176
"38625",1038625,41,203,3,247
"38626",1038626,166,68,14,248
"38627",1038627,69,188,2,259
"38628",1038628,119,169,13,301
"38629",1038629,100,80,2,182
"38630",1038630,72,134,12,218
"38631",1038631,106,145,16,267
"38632",1038632,114,70,17,201
"38633",1038633,27,179,4,210
"38634",1038634,34,26,5,65
"38635",1038635,111,143,17,271
"38636",1038636,70,94,17,181
"38637",1038637,160,15,2,177
"38638",1038638,86,81,5,172
"38639",1038639,76,129,5,210
"38640",1038640,191,82,6,279
"38641",1038641,40,71,3,114
"38642",1038642,165,55,17,237
"38643",1038643,34,171,6,211
"38644",1038644,231,6,3,240
"38645",1038645,175,129,10,314
"38646",1038646,75,35,2,112
"38647",1038647,154,59,2,215
"38648",1038648,65,100,10,175
"38649",1038649,102,24,2,128
"38650",1038650,154,76,5,235
"38651",1038651,9,11,1,21
"38652",1038652,138,83,4,225
"38653",1038653,32,8,1,41
"38654",1038654,61,152,4,217
"38655",1038655,178,85,7,270
"38656",1038656,114,56,7,177
"38657",1038657,186,49,11,246
"38658",1038658,27,133,10,170
"38659",1038659,177,69,7,253
"38660",1038660,48,208,8,264
"38661",1038661,27,187,6,220
"38662",1038662,33,240,25,298
"38663",1038663,113,69,14,196
"38664",1038664,94,190,10,294
"38665",1038665,61,150,9,220
"38666",1038666,127,135,11,273
"38667",1038667,70,177,20,267
"38668",1038668,177,108,16,301
"38669",1038669,89,137,21,247
"38670",1038670,66,177,8,251
"38671",1038671,181,44,8,233
"38672",1038672,94,129,9,232
"38673",1038673,165,38,4,207
"38674",1038674,163,18,2,183
"38675",1038675,27,197,2,226
"38676",1038676,55,221,8,284
"38677",1038677,96,77,5,178
"38678",1038678,29,6,1,36
"38679",1038679,197,20,4,221
"38680",1038680,168,93,11,272
"38681",1038681,84,114,11,209
"38682",1038682,180,13,5,198
"38683",1038683,109,180,23,312
"38684",1038684,88,169,7,264
"38685",1038685,83,213,15,311
"38686",1038686,174,73,5,252
"38687",1038687,116,118,9,243
"38688",1038688,128,38,3,169
"38689",1038689,59,102,2,163
"38690",1038690,38,47,5,90
"38691",1038691,104,60,4,168
"38692",1038692,99,144,8,251
"38693",1038693,167,128,10,305
"38694",1038694,60,181,14,255
"38695",1038695,97,113,14,224
"38696",1038696,151,136,10,297
"38697",1038697,109,56,5,170
"38698",1038698,207,26,9,242
"38699",1038699,78,4,0,82
"38700",1038700,62,99,4,165
"38701",1038701,43,252,6,301
"38702",1038702,52,269,3,324
"38703",1038703,115,56,8,179
"38704",1038704,216,27,7,250
"38705",1038705,77,210,13,300
"38706",1038706,103,107,8,218
"38707",1038707,42,133,9,184
"38708",1038708,99,32,9,140
"38709",1038709,90,120,16,226
"38710",1038710,61,104,8,173
"38711",1038711,31,205,5,241
"38712",1038712,136,160,16,312
"38713",1038713,46,62,6,114
"38714",1038714,18,256,3,277
"38715",1038715,237,68,14,319
"38716",1038716,16,282,1,299
"38717",1038717,165,62,5,232
"38718",1038718,106,142,18,266
"38719",1038719,126,142,12,280
"38720",1038720,106,203,3,312
"38721",1038721,47,259,4,310
"38722",1038722,142,142,13,297
"38723",1038723,77,207,13,297
"38724",1038724,79,231,7,317
"38725",1038725,115,62,11,188
"38726",1038726,50,172,5,227
"38727",1038727,144,65,8,217
"38728",1038728,132,13,5,150
"38729",1038729,109,128,8,245
"38730",1038730,58,261,3,322
"38731",1038731,271,54,7,332
"38732",1038732,196,24,4,224
"38733",1038733,134,144,10,288
"38734",1038734,109,65,3,177
"38735",1038735,114,49,3,166
"38736",1038736,189,78,24,291
"38737",1038737,10,1,1,12
"38738",1038738,25,28,2,55
"38739",1038739,23,260,8,291
"38740",1038740,32,309,4,345
"38741",1038741,97,135,8,240
"38742",1038742,141,56,5,202
"38743",1038743,69,155,4,228
"38744",1038744,124,112,6,242
"38745",1038745,146,49,7,202
"38746",1038746,24,74,4,102
"38747",1038747,19,82,3,104
"38748",1038748,94,111,7,212
"38749",1038749,145,121,3,269
"38750",1038750,202,60,13,275
"38751",1038751,126,159,9,294
"38752",1038752,167,105,12,284
"38753",1038753,109,115,14,238
"38754",1038754,130,50,10,190
"38755",1038755,118,45,2,165
"38756",1038756,211,66,9,286
"38757",1038757,102,17,4,123
"38758",1038758,17,184,6,207
"38759",1038759,57,179,9,245
"38760",1038760,262,29,8,299
"38761",1038761,122,52,9,183
"38762",1038762,14,164,3,181
"38763",1038763,52,242,9,303
"38764",1038764,146,81,10,237
"38765",1038765,50,217,9,276
"38766",1038766,207,24,12,243
"38767",1038767,117,86,4,207
"38768",1038768,79,191,9,279
"38769",1038769,164,51,10,225
"38770",1038770,70,136,5,211
"38771",1038771,101,141,8,250
"38772",1038772,162,73,12,247
"38773",1038773,33,102,9,144
"38774",1038774,241,16,5,262
"38775",1038775,107,130,12,249
"38776",1038776,105,136,9,250
"38777",1038777,28,186,7,221
"38778",1038778,108,173,7,288
"38779",1038779,125,72,12,209
"38780",1038780,22,191,0,213
"38781",1038781,47,283,5,335
"38782",1038782,70,159,2,231
"38783",1038783,109,23,2,134
"38784",1038784,116,159,13,288
"38785",1038785,12,75,2,89
"38786",1038786,171,122,7,300
"38787",1038787,223,65,19,307
"38788",1038788,99,13,1,113
"38789",1038789,253,24,5,282
"38790",1038790,203,91,13,307
"38791",1038791,4,3,0,7
"38792",1038792,27,12,2,41
"38793",1038793,156,43,9,208
"38794",1038794,43,276,2,321
"38795",1038795,134,118,12,264
"38796",1038796,69,209,11,289
"38797",1038797,35,67,1,103
"38798",1038798,88,206,6,300
"38799",1038799,171,78,13,262
"38800",1038800,186,34,4,224
"38801",1038801,86,155,3,244
"38802",1038802,103,162,15,280
"38803",1038803,110,95,0,205
"38804",1038804,106,178,16,300
"38805",1038805,28,121,0,149
"38806",1038806,18,37,2,57
"38807",1038807,48,209,8,265
"38808",1038808,130,37,5,172
"38809",1038809,154,44,7,205
"38810",1038810,64,144,4,212
"38811",1038811,81,161,5,247
"38812",1038812,137,109,9,255
"38813",1038813,133,47,1,181
"38814",1038814,122,137,22,281
"38815",1038815,108,125,3,236
"38816",1038816,58,168,15,241
"38817",1038817,108,137,20,265
"38818",1038818,69,189,8,266
"38819",1038819,175,62,2,239
"38820",1038820,93,138,3,234
"38821",1038821,97,54,5,156
"38822",1038822,169,110,14,293
"38823",1038823,94,83,10,187
"38824",1038824,167,0,2,169
"38825",1038825,185,89,17,291
"38826",1038826,89,135,9,233
"38827",1038827,93,88,3,184
"38828",1038828,18,5,1,24
"38829",1038829,145,56,4,205
"38830",1038830,84,179,5,268
"38831",1038831,136,18,4,158
"38832",1038832,63,134,7,204
"38833",1038833,55,214,8,277
"38834",1038834,50,240,4,294
"38835",1038835,125,90,5,220
"38836",1038836,70,86,5,161
"38837",1038837,168,71,6,245
"38838",1038838,163,80,15,258
"38839",1038839,164,127,7,298
"38840",1038840,161,51,11,223
"38841",1038841,76,162,9,247
"38842",1038842,103,173,8,284
"38843",1038843,206,39,3,248
"38844",1038844,159,94,5,258
"38845",1038845,74,147,0,221
"38846",1038846,14,105,6,125
"38847",1038847,18,9,2,29
"38848",1038848,103,115,5,223
"38849",1038849,179,29,2,210
"38850",1038850,107,159,6,272
"38851",1038851,62,231,7,300
"38852",1038852,95,203,10,308
"38853",1038853,45,46,4,95
"38854",1038854,43,228,4,275
"38855",1038855,54,61,16,131
"38856",1038856,175,98,17,290
"38857",1038857,184,17,1,202
"38858",1038858,224,44,12,280
"38859",1038859,99,159,6,264
"38860",1038860,15,10,0,25
"38861",1038861,66,165,5,236
"38862",1038862,24,7,1,32
"38863",1038863,177,129,14,320
"38864",1038864,95,116,14,225
"38865",1038865,39,205,5,249
"38866",1038866,190,62,4,256
"38867",1038867,63,142,19,224
"38868",1038868,114,23,5,142
"38869",1038869,46,209,15,270
"38870",1038870,192,68,3,263
"38871",1038871,76,5,1,82
"38872",1038872,184,66,6,256
"38873",1038873,130,103,9,242
"38874",1038874,191,82,13,286
"38875",1038875,73,200,5,278
"38876",1038876,172,52,7,231
"38877",1038877,81,182,5,268
"38878",1038878,98,205,2,305
"38879",1038879,117,151,9,277
"38880",1038880,91,187,6,284
"38881",1038881,14,248,3,265
"38882",1038882,115,144,20,279
"38883",1038883,46,164,4,214
"38884",1038884,76,92,17,185
"38885",1038885,46,339,4,389
"38886",1038886,73,248,8,329
"38887",1038887,184,46,4,234
"38888",1038888,143,45,3,191
"38889",1038889,120,129,1,250
"38890",1038890,152,74,24,250
"38891",1038891,185,83,14,282
"38892",1038892,160,34,3,197
"38893",1038893,82,152,9,243
"38894",1038894,47,58,2,107
"38895",1038895,134,73,16,223
"38896",1038896,145,64,6,215
"38897",1038897,48,183,3,234
"38898",1038898,28,187,1,216
"38899",1038899,167,32,3,202
"38900",1038900,88,180,13,281
"38901",1038901,130,112,10,252
"38902",1038902,153,129,13,295
"38903",1038903,77,30,3,110
"38904",1038904,209,22,11,242
"38905",1038905,48,226,3,277
"38906",1038906,117,188,5,310
"38907",1038907,161,52,7,220
"38908",1038908,181,24,4,209
"38909",1038909,186,72,3,261
"38910",1038910,158,44,6,208
"38911",1038911,160,15,5,180
"38912",1038912,208,52,17,277
"38913",1038913,101,152,17,270
"38914",1038914,5,5,0,10
"38915",1038915,85,272,15,372
"38916",1038916,112,177,17,306
"38917",1038917,72,179,9,260
"38918",1038918,74,167,16,257
"38919",1038919,112,61,2,175
"38920",1038920,82,175,4,261
"38921",1038921,129,34,8,171
"38922",1038922,62,150,9,221
"38923",1038923,110,39,3,152
"38924",1038924,96,31,8,135
"38925",1038925,143,74,8,225
"38926",1038926,20,50,1,71
"38927",1038927,162,75,7,244
"38928",1038928,136,134,23,293
"38929",1038929,0,0,0,0
"38930",1038930,137,126,4,267
"38931",1038931,137,70,2,209
"38932",1038932,113,118,9,240
"38933",1038933,30,53,4,87
"38934",1038934,117,143,24,284
"38935",1038935,107,83,11,201
"38936",1038936,117,119,15,251
"38937",1038937,46,233,4,283
"38938",1038938,17,110,4,131
"38939",1038939,112,18,2,132
"38940",1038940,155,34,6,195
"38941",1038941,41,1,1,43
"38942",1038942,164,48,6,218
"38943",1038943,214,50,12,276
"38944",1038944,165,52,6,223
"38945",1038945,31,221,3,255
"38946",1038946,75,150,13,238
"38947",1038947,182,52,11,245
"38948",1038948,83,128,11,222
"38949",1038949,100,69,19,188
"38950",1038950,63,44,4,111
"38951",1038951,173,65,12,250
"38952",1038952,76,173,11,260
"38953",1038953,66,67,6,139
"38954",1038954,209,66,7,282
"38955",1038955,163,100,4,267
"38956",1038956,106,76,11,193
"38957",1038957,45,199,10,254
"38958",1038958,56,240,9,305
"38959",1038959,158,48,6,212
"38960",1038960,94,167,14,275
"38961",1038961,107,46,12,165
"38962",1038962,224,56,26,306
"38963",1038963,126,92,7,225
"38964",1038964,60,131,10,201
"38965",1038965,56,255,2,313
"38966",1038966,41,221,4,266
"38967",1038967,211,40,16,267
"38968",1038968,56,167,16,239
"38969",1038969,182,18,3,203
"38970",1038970,40,104,3,147
"38971",1038971,193,42,7,242
"38972",1038972,194,88,3,285
"38973",1038973,67,210,15,292
"38974",1038974,118,62,12,192
"38975",1038975,163,95,12,270
"38976",1038976,25,164,3,192
"38977",1038977,72,109,6,187
"38978",1038978,105,18,6,129
"38979",1038979,33,168,0,201
"38980",1038980,146,115,8,269
"38981",1038981,55,213,1,269
"38982",1038982,166,38,7,211
"38983",1038983,160,113,11,284
"38984",1038984,70,192,10,272
"38985",1038985,142,127,10,279
"38986",1038986,136,96,4,236
"38987",1038987,145,17,19,181
"38988",1038988,75,135,11,221
"38989",1038989,103,83,5,191
"38990",1038990,98,128,14,240
"38991",1038991,92,120,9,221
"38992",1038992,221,35,17,273
"38993",1038993,232,50,11,293
"38994",1038994,62,37,4,103
"38995",1038995,81,185,3,269
"38996",1038996,91,67,11,169
"38997",1038997,176,47,5,228
"38998",1038998,42,184,3,229
"38999",1038999,94,170,11,275
"39000",1039000,60,152,11,223
"39001",1039001,49,165,5,219
"39002",1039002,160,38,6,204
"39003",1039003,161,53,7,221
"39004",1039004,84,156,20,260
"39005",1039005,94,65,4,163
"39006",1039006,41,78,3,122
"39007",1039007,125,92,15,232
"39008",1039008,78,173,8,259
"39009",1039009,204,33,6,243
"39010",1039010,202,31,10,243
"39011",1039011,149,101,4,254
"39012",1039012,235,30,8,273
"39013",1039013,142,116,17,275
"39014",1039014,121,17,6,144
"39015",1039015,84,146,12,242
"39016",1039016,82,96,7,185
"39017",1039017,180,56,15,251
"39018",1039018,179,117,9,305
"39019",1039019,36,281,3,320
"39020",1039020,92,98,15,205
"39021",1039021,179,71,8,258
"39022",1039022,98,22,1,121
"39023",1039023,60,27,4,91
"39024",1039024,40,139,8,187
"39025",1039025,90,119,12,221
"39026",1039026,47,80,8,135
"39027",1039027,164,58,9,231
"39028",1039028,144,103,9,256
"39029",1039029,176,345,31,552
"39030",1039030,38,247,5,290
"39031",1039031,81,143,5,229
"39032",1039032,128,85,14,227
"39033",1039033,132,178,17,327
"39034",1039034,57,110,4,171
"39035",1039035,78,107,6,191
"39036",1039036,22,190,3,215
"39037",1039037,156,55,14,225
"39038",1039038,23,203,3,229
"39039",1039039,180,34,6,220
"39040",1039040,143,153,4,300
"39041",1039041,122,117,3,242
"39042",1039042,107,193,18,318
"39043",1039043,203,119,8,330
"39044",1039044,63,210,8,281
"39045",1039045,71,153,7,231
"39046",1039046,160,86,7,253
"39047",1039047,160,67,9,236
"39048",1039048,136,62,6,204
"39049",1039049,18,74,2,94
"39050",1039050,156,102,12,270
"39051",1039051,170,36,6,212
"39052",1039052,107,64,15,186
"39053",1039053,29,215,5,249
"39054",1039054,157,54,7,218
"39055",1039055,111,124,12,247
"39056",1039056,203,24,6,233
"39057",1039057,46,258,7,311
"39058",1039058,160,124,11,295
"39059",1039059,92,42,3,137
"39060",1039060,65,247,3,315
"39061",1039061,52,212,4,268
"39062",1039062,33,151,2,186
"39063",1039063,99,55,7,161
"39064",1039064,61,244,3,308
"39065",1039065,45,114,1,160
"39066",1039066,160,156,8,324
"39067",1039067,61,143,1,205
"39068",1039068,101,45,9,155
"39069",1039069,31,126,6,163
"39070",1039070,129,81,17,227
"39071",1039071,138,70,21,229
"39072",1039072,130,22,4,156
"39073",1039073,185,7,3,195
"39074",1039074,21,94,7,122
"39075",1039075,79,183,14,276
"39076",1039076,132,130,13,275
"39077",1039077,26,13,0,39
"39078",1039078,146,65,12,223
"39079",1039079,130,22,3,155
"39080",1039080,97,46,11,154
"39081",1039081,92,51,10,153
"39082",1039082,47,193,3,243
"39083",1039083,49,260,12,321
"39084",1039084,73,20,1,94
"39085",1039085,208,33,7,248
"39086",1039086,87,77,5,169
"39087",1039087,121,27,7,155
"39088",1039088,182,73,14,269
"39089",1039089,236,52,6,294
"39090",1039090,29,193,3,225
"39091",1039091,144,44,4,192
"39092",1039092,190,39,9,238
"39093",1039093,26,142,6,174
"39094",1039094,106,163,7,276
"39095",1039095,153,21,10,184
"39096",1039096,245,74,9,328
"39097",1039097,175,43,13,231
"39098",1039098,71,73,1,145
"39099",1039099,188,68,5,261
"39100",1039100,135,39,3,177
"39101",1039101,17,12,2,31
"39102",1039102,198,67,10,275
"39103",1039103,84,113,4,201
"39104",1039104,57,58,5,120
"39105",1039105,161,67,12,240
"39106",1039106,158,99,12,269
"39107",1039107,161,51,9,221
"39108",1039108,151,127,22,300
"39109",1039109,115,165,1,281
"39110",1039110,37,237,12,286
"39111",1039111,80,191,15,286
"39112",1039112,68,56,0,124
"39113",1039113,134,156,12,302
"39114",1039114,38,196,9,243
"39115",1039115,26,18,1,45
"39116",1039116,145,75,7,227
"39117",1039117,53,106,12,171
"39118",1039118,47,10,1,58
"39119",1039119,76,135,9,220
"39120",1039120,79,157,11,247
"39121",1039121,88,180,20,288
"39122",1039122,116,128,4,248
"39123",1039123,228,27,15,270
"39124",1039124,198,226,12,436
"39125",1039125,304,6,7,317
"39126",1039126,119,120,13,252
"39127",1039127,164,274,30,468
"39128",1039128,24,221,5,250
"39129",1039129,66,148,22,236
"39130",1039130,17,66,2,85
"39131",1039131,151,131,6,288
"39132",1039132,38,117,3,158
"39133",1039133,110,75,16,201
"39134",1039134,57,186,16,259
"39135",1039135,179,84,17,280
"39136",1039136,69,71,6,146
"39137",1039137,176,89,13,278
"39138",1039138,159,101,14,274
"39139",1039139,33,93,4,130
"39140",1039140,222,1,1,224
"39141",1039141,66,149,8,223
"39142",1039142,53,192,4,249
"39143",1039143,50,204,3,257
"39144",1039144,212,35,9,256
"39145",1039145,157,65,5,227
"39146",1039146,242,23,7,272
"39147",1039147,181,143,11,335
"39148",1039148,79,230,1,310
"39149",1039149,141,130,18,289
"39150",1039150,51,166,7,224
"39151",1039151,157,129,13,299
"39152",1039152,155,61,8,224
"39153",1039153,129,158,17,304
"39154",1039154,142,44,8,194
"39155",1039155,101,81,7,189
"39156",1039156,165,32,2,199
"39157",1039157,34,12,2,48
"39158",1039158,72,86,7,165
"39159",1039159,9,17,0,26
"39160",1039160,30,63,3,96
"39161",1039161,73,66,5,144
"39162",1039162,71,79,9,159
"39163",1039163,109,153,19,281
"39164",1039164,175,74,6,255
"39165",1039165,155,63,8,226
"39166",1039166,7,219,8,234
"39167",1039167,174,146,12,332
"39168",1039168,84,155,5,244
"39169",1039169,192,75,1,268
"39170",1039170,112,52,5,169
"39171",1039171,139,45,7,191
"39172",1039172,48,22,2,72
"39173",1039173,177,93,12,282
"39174",1039174,266,35,9,310
"39175",1039175,101,97,3,201
"39176",1039176,101,159,6,266
"39177",1039177,54,21,5,80
"39178",1039178,129,126,12,267
"39179",1039179,131,175,10,316
"39180",1039180,159,70,10,239
"39181",1039181,99,95,2,196
"39182",1039182,20,253,3,276
"39183",1039183,91,12,4,107
"39184",1039184,46,98,9,153
"39185",1039185,23,141,5,169
"39186",1039186,97,40,9,146
"39187",1039187,142,61,14,217
"39188",1039188,116,57,3,176
"39189",1039189,26,145,5,176
"39190",1039190,235,36,9,280
"39191",1039191,62,123,2,187
"39192",1039192,106,129,5,240
"39193",1039193,19,5,0,24
"39194",1039194,194,50,8,252
"39195",1039195,102,162,9,273
"39196",1039196,244,60,13,317
"39197",1039197,121,50,8,179
"39198",1039198,123,110,16,249
"39199",1039199,184,14,7,205
"39200",1039200,101,56,7,164
"39201",1039201,53,240,6,299
"39202",1039202,324,52,13,389
"39203",1039203,223,20,4,247
"39204",1039204,92,127,6,225
"39205",1039205,64,270,9,343
"39206",1039206,71,222,10,303
"39207",1039207,38,236,4,278
"39208",1039208,112,73,3,188
"39209",1039209,129,142,5,276
"39210",1039210,117,165,16,298
"39211",1039211,20,304,1,325
"39212",1039212,157,6,5,168
"39213",1039213,118,75,9,202
"39214",1039214,56,174,11,241
"39215",1039215,93,77,12,182
"39216",1039216,11,12,1,24
"39217",1039217,195,95,5,295
"39218",1039218,91,50,3,144
"39219",1039219,182,93,7,282
"39220",1039220,166,61,2,229
"39221",1039221,140,163,11,314
"39222",1039222,97,195,2,294
"39223",1039223,44,176,2,222
"39224",1039224,8,16,1,25
"39225",1039225,253,18,6,277
"39226",1039226,156,36,5,197
"39227",1039227,182,90,16,288
"39228",1039228,100,138,15,253
"39229",1039229,117,116,4,237
"39230",1039230,51,146,6,203
"39231",1039231,81,117,14,212
"39232",1039232,141,124,10,275
"39233",1039233,96,128,14,238
"39234",1039234,34,269,8,311
"39235",1039235,26,223,3,252
"39236",1039236,20,75,0,95
"39237",1039237,45,234,24,303
"39238",1039238,127,9,6,142
"39239",1039239,69,203,14,286
"39240",1039240,149,93,4,246
"39241",1039241,277,38,9,324
"39242",1039242,104,203,8,315
"39243",1039243,144,72,10,226
"39244",1039244,20,188,0,208
"39245",1039245,106,91,7,204
"39246",1039246,138,42,7,187
"39247",1039247,142,91,21,254
"39248",1039248,124,74,2,200
"39249",1039249,165,104,5,274
"39250",1039250,47,175,0,222
"39251",1039251,81,71,11,163
"39252",1039252,54,28,4,86
"39253",1039253,132,45,9,186
"39254",1039254,173,37,4,214
"39255",1039255,184,67,7,258
"39256",1039256,157,55,1,213
"39257",1039257,127,32,3,162
"39258",1039258,93,102,15,210
"39259",1039259,4,71,2,77
"39260",1039260,195,27,5,227
"39261",1039261,141,88,0,229
"39262",1039262,154,99,8,261
"39263",1039263,181,72,8,261
"39264",1039264,38,227,3,268
"39265",1039265,47,250,6,303
"39266",1039266,167,118,5,290
"39267",1039267,126,93,3,222
"39268",1039268,89,39,6,134
"39269",1039269,74,195,6,275
"39270",1039270,31,11,2,44
"39271",1039271,38,220,5,263
"39272",1039272,143,54,8,205
"39273",1039273,196,100,18,314
"39274",1039274,149,27,3,179
"39275",1039275,187,89,23,299
"39276",1039276,18,84,1,103
"39277",1039277,61,152,20,233
"39278",1039278,189,23,10,222
"39279",1039279,173,82,14,269
"39280",1039280,80,148,2,230
"39281",1039281,14,25,4,43
"39282",1039282,170,74,7,251
"39283",1039283,99,188,8,295
"39284",1039284,153,36,9,198
"39285",1039285,155,14,4,173
"39286",1039286,82,74,12,168
"39287",1039287,188,64,6,258
"39288",1039288,124,137,11,272
"39289",1039289,46,82,10,138
"39290",1039290,151,113,16,280
"39291",1039291,5,1,3,9
"39292",1039292,223,43,3,269
"39293",1039293,32,118,3,153
"39294",1039294,194,24,7,225
"39295",1039295,7,3,1,11
"39296",1039296,25,225,3,253
"39297",1039297,74,31,9,114
"39298",1039298,30,14,3,47
"39299",1039299,248,23,9,280
"39300",1039300,214,63,5,282
"39301",1039301,195,72,5,272
"39302",1039302,112,62,1,175
"39303",1039303,57,144,5,206
"39304",1039304,121,51,7,179
"39305",1039305,129,125,14,268
"39306",1039306,91,45,2,138
"39307",1039307,194,57,8,259
"39308",1039308,60,193,9,262
"39309",1039309,57,71,4,132
"39310",1039310,19,216,2,237
"39311",1039311,58,262,10,330
"39312",1039312,102,85,14,201
"39313",1039313,55,164,9,228
"39314",1039314,194,76,17,287
"39315",1039315,70,84,11,165
"39316",1039316,181,93,5,279
"39317",1039317,40,275,8,323
"39318",1039318,68,32,4,104
"39319",1039319,174,109,13,296
"39320",1039320,141,69,2,212
"39321",1039321,32,178,5,215
"39322",1039322,82,130,13,225
"39323",1039323,164,104,15,283
"39324",1039324,89,188,8,285
"39325",1039325,144,85,10,239
"39326",1039326,58,196,4,258
"39327",1039327,109,59,3,171
"39328",1039328,114,173,16,303
"39329",1039329,88,72,3,163
"39330",1039330,11,17,2,30
"39331",1039331,78,186,3,267
"39332",1039332,42,157,5,204
"39333",1039333,131,97,17,245
"39334",1039334,125,160,14,299
"39335",1039335,94,126,12,232
"39336",1039336,165,84,15,264
"39337",1039337,73,102,15,190
"39338",1039338,206,137,11,354
"39339",1039339,173,84,0,257
"39340",1039340,81,88,4,173
"39341",1039341,123,55,16,194
"39342",1039342,169,46,4,219
"39343",1039343,246,52,16,314
"39344",1039344,100,170,3,273
"39345",1039345,19,6,0,25
"39346",1039346,23,18,4,45
"39347",1039347,30,238,6,274
"39348",1039348,118,45,2,165
"39349",1039349,70,196,4,270
"39350",1039350,172,21,7,200
"39351",1039351,120,108,8,236
"39352",1039352,56,77,3,136
"39353",1039353,39,237,7,283
"39354",1039354,67,82,7,156
"39355",1039355,121,32,9,162
"39356",1039356,47,93,5,145
"39357",1039357,56,92,6,154
"39358",1039358,100,194,8,302
"39359",1039359,275,34,10,319
"39360",1039360,146,97,9,252
"39361",1039361,162,32,15,209
"39362",1039362,10,7,0,17
"39363",1039363,66,260,7,333
"39364",1039364,118,179,10,307
"39365",1039365,56,218,7,281
"39366",1039366,110,25,2,137
"39367",1039367,160,66,8,234
"39368",1039368,144,49,10,203
"39369",1039369,202,120,20,342
"39370",1039370,146,117,1,264
"39371",1039371,72,218,9,299
"39372",1039372,151,124,9,284
"39373",1039373,7,294,0,301
"39374",1039374,129,189,11,329
"39375",1039375,43,257,2,302
"39376",1039376,61,2,1,64
"39377",1039377,231,76,10,317
"39378",1039378,156,81,5,242
"39379",1039379,215,40,2,257
"39380",1039380,186,47,3,236
"39381",1039381,40,186,4,230
"39382",1039382,118,130,5,253
"39383",1039383,117,132,18,267
"39384",1039384,144,43,9,196
"39385",1039385,115,32,8,155
"39386",1039386,119,36,1,156
"39387",1039387,203,93,16,312
"39388",1039388,154,78,7,239
"39389",1039389,74,217,10,301
"39390",1039390,121,100,11,232
"39391",1039391,3,11,0,14
"39392",1039392,236,16,6,258
"39393",1039393,200,63,8,271
"39394",1039394,30,230,4,264
"39395",1039395,56,154,3,213
"39396",1039396,133,85,17,235
"39397",1039397,206,92,11,309
"39398",1039398,42,103,11,156
"39399",1039399,58,119,15,192
"39400",1039400,130,113,6,249
"39401",1039401,91,128,13,232
"39402",1039402,95,138,14,247
"39403",1039403,183,36,8,227
"39404",1039404,96,224,7,327
"39405",1039405,109,132,3,244
"39406",1039406,61,193,1,255
"39407",1039407,122,74,1,197
"39408",1039408,122,111,1,234
"39409",1039409,88,170,16,274
"39410",1039410,109,94,12,215
"39411",1039411,60,180,11,251
"39412",1039412,138,57,11,206
"39413",1039413,142,102,17,261
"39414",1039414,104,15,16,135
"39415",1039415,136,143,1,280
"39416",1039416,99,150,12,261
"39417",1039417,156,20,11,187
"39418",1039418,172,32,3,207
"39419",1039419,88,139,13,240
"39420",1039420,198,70,5,273
"39421",1039421,111,84,15,210
"39422",1039422,88,179,7,274
"39423",1039423,116,81,15,212
"39424",1039424,28,8,1,37
"39425",1039425,127,99,3,229
"39426",1039426,191,32,4,227
"39427",1039427,149,60,8,217
"39428",1039428,115,41,4,160
"39429",1039429,60,60,1,121
"39430",1039430,133,68,13,214
"39431",1039431,82,153,3,238
"39432",1039432,80,201,5,286
"39433",1039433,267,8,7,282
"39434",1039434,138,103,4,245
"39435",1039435,123,57,9,189
"39436",1039436,158,25,1,184
"39437",1039437,34,207,4,245
"39438",1039438,119,149,12,280
"39439",1039439,152,26,7,185
"39440",1039440,141,75,11,227
"39441",1039441,184,31,9,224
"39442",1039442,292,2,5,299
"39443",1039443,187,41,11,239
"39444",1039444,145,136,11,292
"39445",1039445,220,22,19,261
"39446",1039446,39,150,3,192
"39447",1039447,6,181,0,187
"39448",1039448,12,87,1,100
"39449",1039449,133,65,7,205
"39450",1039450,139,150,3,292
"39451",1039451,163,81,6,250
"39452",1039452,80,176,10,266
"39453",1039453,171,124,10,305
"39454",1039454,113,83,15,211
"39455",1039455,146,128,7,281
"39456",1039456,25,16,2,43
"39457",1039457,98,115,8,221
"39458",1039458,10,65,1,76
"39459",1039459,139,96,13,248
"39460",1039460,209,40,6,255
"39461",1039461,188,36,7,231
"39462",1039462,71,176,5,252
"39463",1039463,81,157,8,246
"39464",1039464,47,225,6,278
"39465",1039465,128,75,7,210
"39466",1039466,70,114,10,194
"39467",1039467,6,4,0,10
"39468",1039468,46,245,5,296
"39469",1039469,83,183,10,276
"39470",1039470,54,160,2,216
"39471",1039471,151,50,3,204
"39472",1039472,172,121,19,312
"39473",1039473,175,6,2,183
"39474",1039474,82,62,4,148
"39475",1039475,216,26,11,253
"39476",1039476,168,27,14,209
"39477",1039477,52,135,1,188
"39478",1039478,78,83,21,182
"39479",1039479,95,145,19,259
"39480",1039480,17,3,0,20
"39481",1039481,184,69,12,265
"39482",1039482,55,43,7,105
"39483",1039483,65,61,0,126
"39484",1039484,140,110,18,268
"39485",1039485,78,117,13,208
"39486",1039486,138,36,0,174
"39487",1039487,93,66,9,168
"39488",1039488,61,179,22,262
"39489",1039489,144,101,8,253
"39490",1039490,90,180,8,278
"39491",1039491,210,40,7,257
"39492",1039492,100,8,6,114
"39493",1039493,156,35,12,203
"39494",1039494,66,131,17,214
"39495",1039495,52,146,8,206
"39496",1039496,207,50,11,268
"39497",1039497,177,49,16,242
"39498",1039498,108,74,8,190
"39499",1039499,169,93,11,273
"39500",1039500,52,261,11,324
"39501",1039501,31,58,2,91
"39502",1039502,68,62,9,139
"39503",1039503,107,163,0,270
"39504",1039504,201,8,5,214
"39505",1039505,55,203,6,264
"39506",1039506,57,174,10,241
"39507",1039507,100,129,15,244
"39508",1039508,141,104,2,247
"39509",1039509,101,63,5,169
"39510",1039510,7,8,0,15
"39511",1039511,77,160,8,245
"39512",1039512,81,177,12,270
"39513",1039513,108,74,16,198
"39514",1039514,23,147,2,172
"39515",1039515,122,58,8,188
"39516",1039516,148,116,12,276
"39517",1039517,158,113,15,286
"39518",1039518,157,42,5,204
"39519",1039519,138,102,12,252
"39520",1039520,163,75,13,251
"39521",1039521,166,117,4,287
"39522",1039522,47,179,3,229
"39523",1039523,74,195,12,281
"39524",1039524,149,41,5,195
"39525",1039525,51,186,2,239
"39526",1039526,93,66,9,168
"39527",1039527,60,223,9,292
"39528",1039528,31,219,2,252
"39529",1039529,61,156,1,218
"39530",1039530,181,30,3,214
"39531",1039531,3,6,2,11
"39532",1039532,164,66,3,233
"39533",1039533,143,146,16,305
"39534",1039534,112,123,5,240
"39535",1039535,43,37,6,86
"39536",1039536,130,162,11,303
"39537",1039537,35,210,10,255
"39538",1039538,154,223,12,389
"39539",1039539,97,71,5,173
"39540",1039540,62,144,1,207
"39541",1039541,45,178,13,236
"39542",1039542,37,11,2,50
"39543",1039543,175,59,10,244
"39544",1039544,120,172,17,309
"39545",1039545,74,180,8,262
"39546",1039546,127,60,12,199
"39547",1039547,83,107,6,196
"39548",1039548,42,150,8,200
"39549",1039549,155,46,9,210
"39550",1039550,59,163,11,233
"39551",1039551,129,67,5,201
"39552",1039552,79,174,3,256
"39553",1039553,221,67,7,295
"39554",1039554,11,30,1,42
"39555",1039555,91,220,9,320
"39556",1039556,144,66,13,223
"39557",1039557,79,149,24,252
"39558",1039558,78,186,12,276
"39559",1039559,42,0,3,45
"39560",1039560,152,37,13,202
"39561",1039561,127,128,15,270
"39562",1039562,175,74,3,252
"39563",1039563,211,49,11,271
"39564",1039564,100,170,21,291
"39565",1039565,110,157,22,289
"39566",1039566,183,63,7,253
"39567",1039567,193,16,6,215
"39568",1039568,45,36,4,85
"39569",1039569,177,118,11,306
"39570",1039570,119,36,10,165
"39571",1039571,71,19,2,92
"39572",1039572,140,104,8,252
"39573",1039573,161,80,6,247
"39574",1039574,249,61,2,312
"39575",1039575,199,26,2,227
"39576",1039576,193,62,8,263
"39577",1039577,52,231,13,296
"39578",1039578,70,58,13,141
"39579",1039579,82,58,4,144
"39580",1039580,154,18,4,176
"39581",1039581,131,156,14,301
"39582",1039582,109,102,4,215
"39583",1039583,79,130,8,217
"39584",1039584,170,87,8,265
"39585",1039585,157,59,6,222
"39586",1039586,198,12,7,217
"39587",1039587,49,241,3,293
"39588",1039588,66,136,13,215
"39589",1039589,41,210,0,251
"39590",1039590,199,22,7,228
"39591",1039591,59,285,7,351
"39592",1039592,131,50,5,186
"39593",1039593,156,117,5,278
"39594",1039594,180,49,7,236
"39595",1039595,66,167,20,253
"39596",1039596,143,145,12,300
"39597",1039597,112,93,11,216
"39598",1039598,104,55,10,169
"39599",1039599,212,65,11,288
"39600",1039600,128,58,6,192
"39601",1039601,63,46,5,114
"39602",1039602,9,26,0,35
"39603",1039603,74,125,5,204
"39604",1039604,182,21,3,206
"39605",1039605,188,88,3,279
"39606",1039606,226,34,9,269
"39607",1039607,172,53,9,234
"39608",1039608,131,148,5,284
"39609",1039609,119,40,3,162
"39610",1039610,18,177,4,199
"39611",1039611,121,154,20,295
"39612",1039612,100,166,7,273
"39613",1039613,161,77,4,242
"39614",1039614,52,205,7,264
"39615",1039615,50,177,2,229
"39616",1039616,128,176,19,323
"39617",1039617,62,31,1,94
"39618",1039618,71,257,7,335
"39619",1039619,41,255,3,299
"39620",1039620,109,76,6,191
"39621",1039621,24,213,7,244
"39622",1039622,165,110,22,297
"39623",1039623,224,3,2,229
"39624",1039624,133,65,7,205
"39625",1039625,32,241,4,277
"39626",1039626,8,109,1,118
"39627",1039627,101,173,3,277
"39628",1039628,36,270,3,309
"39629",1039629,29,232,2,263
"39630",1039630,168,73,14,255
"39631",1039631,74,162,10,246
"39632",1039632,142,49,5,196
"39633",1039633,25,137,1,163
"39634",1039634,48,235,4,287
"39635",1039635,147,141,9,297
"39636",1039636,222,30,10,262
"39637",1039637,158,155,6,319
"39638",1039638,123,52,8,183
"39639",1039639,136,170,12,318
"39640",1039640,109,56,6,171
"39641",1039641,62,129,6,197
"39642",1039642,60,144,15,219
"39643",1039643,36,240,6,282
"39644",1039644,40,279,9,328
"39645",1039645,66,180,1,247
"39646",1039646,22,10,1,33
"39647",1039647,132,112,15,259
"39648",1039648,114,145,25,284
"39649",1039649,119,40,12,171
"39650",1039650,77,142,10,229
"39651",1039651,31,248,1,280
"39652",1039652,190,69,4,263
"39653",1039653,208,134,6,348
"39654",1039654,99,78,11,188
"39655",1039655,89,65,8,162
"39656",1039656,107,73,7,187
"39657",1039657,240,41,12,293
"39658",1039658,71,138,9,218
"39659",1039659,32,81,3,116
"39660",1039660,214,16,4,234
"39661",1039661,96,202,7,305
"39662",1039662,19,75,2,96
"39663",1039663,107,58,4,169
"39664",1039664,64,226,6,296
"39665",1039665,154,162,8,324
"39666",1039666,214,36,5,255
"39667",1039667,139,115,14,268
"39668",1039668,224,30,10,264
"39669",1039669,77,227,3,307
"39670",1039670,164,69,5,238
"39671",1039671,6,11,3,20
"39672",1039672,96,113,8,217
"39673",1039673,52,181,16,249
"39674",1039674,105,45,2,152
"39675",1039675,88,167,23,278
"39676",1039676,184,95,14,293
"39677",1039677,36,33,3,72
"39678",1039678,95,39,0,134
"39679",1039679,67,138,9,214
"39680",1039680,56,186,3,245
"39681",1039681,12,21,0,33
"39682",1039682,157,133,12,302
"39683",1039683,4,5,0,9
"39684",1039684,166,85,14,265
"39685",1039685,208,27,5,240
"39686",1039686,105,172,7,284
"39687",1039687,20,15,1,36
"39688",1039688,149,114,13,276
"39689",1039689,99,73,9,181
"39690",1039690,14,22,1,37
"39691",1039691,29,3,2,34
"39692",1039692,159,83,15,257
"39693",1039693,49,40,3,92
"39694",1039694,57,151,8,216
"39695",1039695,198,60,2,260
"39696",1039696,61,103,4,168
"39697",1039697,63,172,18,253
"39698",1039698,201,36,11,248
"39699",1039699,137,50,3,190
"39700",1039700,148,51,0,199
"39701",1039701,92,2,0,94
"39702",1039702,91,126,1,218
"39703",1039703,51,37,0,88
"39704",1039704,162,45,8,215
"39705",1039705,171,57,3,231
"39706",1039706,132,156,10,298
"39707",1039707,102,141,14,257
"39708",1039708,201,70,21,292
"39709",1039709,111,70,1,182
"39710",1039710,78,25,3,106
"39711",1039711,168,67,6,241
"39712",1039712,204,39,5,248
"39713",1039713,333,5,2,340
"39714",1039714,93,52,6,151
"39715",1039715,55,193,6,254
"39716",1039716,210,25,3,238
"39717",1039717,40,64,4,108
"39718",1039718,208,74,6,288
"39719",1039719,75,240,7,322
"39720",1039720,112,55,5,172
"39721",1039721,85,51,6,142
"39722",1039722,149,152,19,320
"39723",1039723,212,79,12,303
"39724",1039724,199,94,1,294
"39725",1039725,121,208,8,337
"39726",1039726,114,169,6,289
"39727",1039727,35,28,4,67
"39728",1039728,121,167,6,294
"39729",1039729,37,191,3,231
"39730",1039730,143,143,15,301
"39731",1039731,146,83,13,242
"39732",1039732,12,116,3,131
"39733",1039733,67,93,2,162
"39734",1039734,120,27,4,151
"39735",1039735,214,68,16,298
"39736",1039736,85,126,7,218
"39737",1039737,108,74,4,186
"39738",1039738,102,133,2,237
"39739",1039739,127,75,2,204
"39740",1039740,113,91,7,211
"39741",1039741,149,48,5,202
"39742",1039742,137,160,20,317
"39743",1039743,68,137,13,218
"39744",1039744,85,187,5,277
"39745",1039745,52,73,1,126
"39746",1039746,127,116,15,258
"39747",1039747,54,118,2,174
"39748",1039748,113,68,7,188
"39749",1039749,210,21,6,237
"39750",1039750,66,54,10,130
"39751",1039751,78,59,2,139
"39752",1039752,190,71,12,273
"39753",1039753,247,19,9,275
"39754",1039754,92,171,19,282
"39755",1039755,156,64,9,229
"39756",1039756,251,38,10,299
"39757",1039757,14,25,1,40
"39758",1039758,142,103,4,249
"39759",1039759,128,45,4,177
"39760",1039760,44,228,2,274
"39761",1039761,141,51,7,199
"39762",1039762,151,74,4,229
"39763",1039763,149,163,16,328
"39764",1039764,41,168,15,224
"39765",1039765,144,25,9,178
"39766",1039766,116,93,5,214
"39767",1039767,109,67,6,182
"39768",1039768,206,56,4,266
"39769",1039769,145,84,8,237
"39770",1039770,76,114,4,194
"39771",1039771,121,38,2,161
"39772",1039772,12,6,0,18
"39773",1039773,144,57,25,226
"39774",1039774,161,13,4,178
"39775",1039775,180,109,14,303
"39776",1039776,207,25,4,236
"39777",1039777,185,138,11,334
"39778",1039778,187,136,24,347
"39779",1039779,105,144,11,260
"39780",1039780,23,11,0,34
"39781",1039781,157,37,22,216
"39782",1039782,140,122,3,265
"39783",1039783,13,67,1,81
"39784",1039784,90,90,4,184
"39785",1039785,173,101,13,287
"39786",1039786,101,99,7,207
"39787",1039787,71,188,13,272
"39788",1039788,101,114,9,224
"39789",1039789,125,96,5,226
"39790",1039790,154,49,12,215
"39791",1039791,22,247,3,272
"39792",1039792,199,88,18,305
"39793",1039793,51,130,7,188
"39794",1039794,34,45,5,84
"39795",1039795,49,226,3,278
"39796",1039796,219,28,11,258
"39797",1039797,46,202,3,251
"39798",1039798,106,209,11,326
"39799",1039799,57,228,10,295
"39800",1039800,41,197,2,240
"39801",1039801,77,209,12,298
"39802",1039802,153,37,28,218
"39803",1039803,115,91,3,209
"39804",1039804,54,6,1,61
"39805",1039805,151,110,13,274
"39806",1039806,84,81,7,172
"39807",1039807,158,113,8,279
"39808",1039808,77,48,5,130
"39809",1039809,153,54,11,218
"39810",1039810,156,64,11,231
"39811",1039811,59,42,5,106
"39812",1039812,198,42,5,245
"39813",1039813,173,64,7,244
"39814",1039814,277,9,1,287
"39815",1039815,142,46,5,193
"39816",1039816,117,9,0,126
"39817",1039817,75,83,6,164
"39818",1039818,108,80,12,200
"39819",1039819,61,216,7,284
"39820",1039820,57,10,4,71
"39821",1039821,102,148,6,256
"39822",1039822,110,7,3,120
"39823",1039823,174,116,14,304
"39824",1039824,74,190,18,282
"39825",1039825,109,117,3,229
"39826",1039826,36,16,1,53
"39827",1039827,117,28,2,147
"39828",1039828,26,242,4,272
"39829",1039829,53,167,5,225
"39830",1039830,105,111,6,222
"39831",1039831,179,99,17,295
"39832",1039832,206,50,4,260
"39833",1039833,87,116,4,207
"39834",1039834,94,200,8,302
"39835",1039835,19,89,7,115
"39836",1039836,168,56,4,228
"39837",1039837,67,101,11,179
"39838",1039838,162,51,8,221
"39839",1039839,88,110,8,206
"39840",1039840,1,2,0,3
"39841",1039841,109,139,3,251
"39842",1039842,76,198,5,279
"39843",1039843,32,125,4,161
"39844",1039844,40,203,5,248
"39845",1039845,60,172,4,236
"39846",1039846,167,74,12,253
"39847",1039847,235,39,12,286
"39848",1039848,32,277,4,313
"39849",1039849,49,111,5,165
"39850",1039850,98,86,4,188
"39851",1039851,15,15,1,31
"39852",1039852,173,91,9,273
"39853",1039853,70,195,5,270
"39854",1039854,120,86,6,212
"39855",1039855,51,193,0,244
"39856",1039856,159,27,6,192
"39857",1039857,85,126,4,215
"39858",1039858,102,176,9,287
"39859",1039859,48,48,0,96
"39860",1039860,72,208,21,301
"39861",1039861,83,166,5,254
"39862",1039862,173,133,6,312
"39863",1039863,86,200,2,288
"39864",1039864,34,222,3,259
"39865",1039865,75,142,11,228
"39866",1039866,167,71,11,249
"39867",1039867,198,61,13,272
"39868",1039868,282,47,9,338
"39869",1039869,119,130,7,256
"39870",1039870,160,39,2,201
"39871",1039871,75,60,1,136
"39872",1039872,303,6,2,311
"39873",1039873,167,48,5,220
"39874",1039874,201,126,20,347
"39875",1039875,37,252,7,296
"39876",1039876,182,25,4,211
"39877",1039877,143,56,13,212
"39878",1039878,15,136,5,156
"39879",1039879,85,161,9,255
"39880",1039880,201,29,4,234
"39881",1039881,168,11,5,184
"39882",1039882,20,141,2,163
"39883",1039883,60,208,9,277
"39884",1039884,189,90,2,281
"39885",1039885,158,129,5,292
"39886",1039886,29,161,5,195
"39887",1039887,100,229,6,335
"39888",1039888,34,224,1,259
"39889",1039889,143,16,9,168
"39890",1039890,154,67,6,227
"39891",1039891,126,115,9,250
"39892",1039892,181,52,14,247
"39893",1039893,112,39,10,161
"39894",1039894,92,87,18,197
"39895",1039895,199,96,5,300
"39896",1039896,59,6,0,65
"39897",1039897,6,22,0,28
"39898",1039898,0,9,0,9
"39899",1039899,116,166,11,293
"39900",1039900,136,55,12,203
"39901",1039901,132,191,7,330
"39902",1039902,155,120,16,291
"39903",1039903,170,20,3,193
"39904",1039904,107,54,1,162
"39905",1039905,163,22,3,188
"39906",1039906,82,178,4,264
"39907",1039907,193,84,6,283
"39908",1039908,204,53,18,275
"39909",1039909,16,61,2,79
"39910",1039910,200,86,20,306
"39911",1039911,181,84,14,279
"39912",1039912,107,72,10,189
"39913",1039913,98,70,3,171
"39914",1039914,131,141,16,288
"39915",1039915,54,185,8,247
"39916",1039916,177,16,3,196
"39917",1039917,10,7,2,19
"39918",1039918,192,18,14,224
"39919",1039919,61,57,5,123
"39920",1039920,95,200,7,302
"39921",1039921,139,105,8,252
"39922",1039922,145,58,6,209
"39923",1039923,90,189,16,295
"39924",1039924,78,172,6,256
"39925",1039925,20,154,6,180
"39926",1039926,181,54,10,245
"39927",1039927,153,13,4,170
"39928",1039928,9,2,0,11
"39929",1039929,136,35,2,173
"39930",1039930,57,18,8,83
"39931",1039931,45,250,3,298
"39932",1039932,82,232,4,318
"39933",1039933,100,132,5,237
"39934",1039934,100,77,9,186
"39935",1039935,200,74,12,286
"39936",1039936,62,127,7,196
"39937",1039937,185,49,6,240
"39938",1039938,131,96,3,230
"39939",1039939,116,135,5,256
"39940",1039940,101,120,8,229
"39941",1039941,94,138,8,240
"39942",1039942,24,109,2,135
"39943",1039943,88,68,3,159
"39944",1039944,174,109,18,301
"39945",1039945,175,115,3,293
"39946",1039946,186,56,10,252
"39947",1039947,9,117,5,131
"39948",1039948,144,70,13,227
"39949",1039949,126,146,9,281
"39950",1039950,86,166,15,267
"39951",1039951,181,31,14,226
"39952",1039952,70,213,3,286
"39953",1039953,186,31,3,220
"39954",1039954,170,45,6,221
"39955",1039955,127,147,10,284
"39956",1039956,79,61,7,147
"39957",1039957,91,191,8,290
"39958",1039958,188,51,5,244
"39959",1039959,116,216,9,341
"39960",1039960,67,237,9,313
"39961",1039961,106,62,9,177
"39962",1039962,138,7,3,148
"39963",1039963,125,40,8,173
"39964",1039964,3,2,0,5
"39965",1039965,67,187,6,260
"39966",1039966,41,167,13,221
"39967",1039967,99,94,5,198
"39968",1039968,141,129,8,278
"39969",1039969,33,234,2,269
"39970",1039970,187,31,11,229
"39971",1039971,137,133,18,288
"39972",1039972,98,174,8,280
"39973",1039973,43,198,1,242
"39974",1039974,32,74,5,111
"39975",1039975,183,118,8,309
"39976",1039976,160,22,5,187
"39977",1039977,164,68,11,243
"39978",1039978,272,1,3,276
"39979",1039979,115,58,7,180
"39980",1039980,179,58,16,253
"39981",1039981,172,24,10,206
"39982",1039982,77,82,9,168
"39983",1039983,123,97,2,222
"39984",1039984,108,62,5,175
"39985",1039985,30,229,3,262
"39986",1039986,161,95,0,256
"39987",1039987,31,163,5,199
"39988",1039988,91,184,21,296
"39989",1039989,186,34,9,229
"39990",1039990,97,72,8,177
"39991",1039991,87,140,10,237
"39992",1039992,127,123,20,270
"39993",1039993,52,256,8,316
"39994",1039994,125,66,2,193
"39995",1039995,53,154,6,213
"39996",1039996,24,151,1,176
"39997",1039997,108,49,6,163
"39998",1039998,45,100,8,153
"39999",1039999,52,148,22,222
"40000",1040000,229,63,21,313
"40001",1040001,214,42,10,266
"40002",1040002,234,253,22,509
"40003",1040003,46,30,4,80
"40004",1040004,36,173,6,215
"40005",1040005,124,31,6,161
"40006",1040006,83,178,4,265
"40007",1040007,21,48,1,70
"40008",1040008,80,44,2,126
"40009",1040009,3,7,0,10
"40010",1040010,149,130,19,298
"40011",1040011,264,42,9,315
"40012",1040012,0,1,0,1
"40013",1040013,155,104,12,271
"40014",1040014,35,217,3,255
"40015",1040015,47,245,7,299
"40016",1040016,91,176,6,273
"40017",1040017,103,115,11,229
"40018",1040018,184,16,8,208
"40019",1040019,90,37,7,134
"40020",1040020,131,146,14,291
"40021",1040021,90,191,9,290
"40022",1040022,15,1,1,17
"40023",1040023,20,176,6,202
"40024",1040024,171,90,6,267
"40025",1040025,77,18,2,97
"40026",1040026,93,111,12,216
"40027",1040027,23,229,3,255
"40028",1040028,118,163,21,302
"40029",1040029,168,35,3,206
"40030",1040030,134,8,1,143
"40031",1040031,111,181,11,303
"40032",1040032,22,276,3,301
"40033",1040033,185,90,17,292
"40034",1040034,17,12,1,30
"40035",1040035,48,109,9,166
"40036",1040036,57,209,1,267
"40037",1040037,203,8,2,213
"40038",1040038,220,8,5,233
"40039",1040039,34,184,5,223
"40040",1040040,172,42,10,224
"40041",1040041,66,132,3,201
"40042",1040042,259,47,5,311
"40043",1040043,79,28,5,112
"40044",1040044,25,134,7,166
"40045",1040045,34,234,2,270
"40046",1040046,174,91,15,280
"40047",1040047,148,43,5,196
"40048",1040048,127,7,4,138
"40049",1040049,208,56,13,277
"40050",1040050,140,99,6,245
"40051",1040051,60,31,4,95
"40052",1040052,109,150,5,264
"40053",1040053,3,229,4,236
"40054",1040054,92,154,5,251
"40055",1040055,141,131,13,285
"40056",1040056,128,162,6,296
"40057",1040057,33,9,0,42
"40058",1040058,60,122,1,183
"40059",1040059,148,46,7,201
"40060",1040060,93,146,7,246
"40061",1040061,56,193,13,262
"40062",1040062,114,153,8,275
"40063",1040063,74,130,11,215
"40064",1040064,148,44,4,196
"40065",1040065,122,130,2,254
"40066",1040066,127,119,11,257
"40067",1040067,19,0,1,20
"40068",1040068,43,100,5,148
"40069",1040069,136,0,0,136
"40070",1040070,173,46,2,221
"40071",1040071,70,196,13,279
"40072",1040072,82,47,10,139
"40073",1040073,82,26,4,112
"40074",1040074,36,171,6,213
"40075",1040075,202,20,11,233
"40076",1040076,96,110,12,218
"40077",1040077,165,75,3,243
"40078",1040078,75,73,0,148
"40079",1040079,129,60,12,201
"40080",1040080,147,80,6,233
"40081",1040081,192,20,10,222
"40082",1040082,158,37,10,205
"40083",1040083,69,149,10,228
"40084",1040084,3,4,0,7
"40085",1040085,46,24,5,75
"40086",1040086,83,169,8,260
"40087",1040087,16,199,9,224
"40088",1040088,44,98,3,145
"40089",1040089,209,32,3,244
"40090",1040090,39,241,8,288
"40091",1040091,36,173,9,218
"40092",1040092,11,11,1,23
"40093",1040093,175,125,8,308
"40094",1040094,110,170,17,297
"40095",1040095,36,0,1,37
"40096",1040096,112,43,4,159
"40097",1040097,117,60,5,182
"40098",1040098,176,26,3,205
"40099",1040099,51,49,2,102
"40100",1040100,105,47,6,158
"40101",1040101,24,69,2,95
"40102",1040102,29,186,3,218
"40103",1040103,134,85,11,230
"40104",1040104,146,119,17,282
"40105",1040105,217,19,2,238
"40106",1040106,38,26,0,64
"40107",1040107,157,96,15,268
"40108",1040108,71,111,12,194
"40109",1040109,138,54,7,199
"40110",1040110,42,48,4,94
"40111",1040111,59,240,9,308
"40112",1040112,57,231,6,294
"40113",1040113,180,17,6,203
"40114",1040114,136,120,9,265
"40115",1040115,98,240,4,342
"40116",1040116,26,84,3,113
"40117",1040117,219,88,13,320
"40118",1040118,169,95,8,272
"40119",1040119,211,9,4,224
"40120",1040120,124,212,6,342
"40121",1040121,108,99,8,215
"40122",1040122,10,5,3,18
"40123",1040123,157,85,12,254
"40124",1040124,128,150,8,286
"40125",1040125,32,200,4,236
"40126",1040126,59,190,17,266
"40127",1040127,151,82,9,242
"40128",1040128,62,254,2,318
"40129",1040129,177,100,17,294
"40130",1040130,123,139,16,278
"40131",1040131,86,24,3,113
"40132",1040132,10,147,4,161
"40133",1040133,146,46,10,202
"40134",1040134,28,213,6,247
"40135",1040135,119,32,9,160
"40136",1040136,122,113,18,253
"40137",1040137,141,82,8,231
"40138",1040138,58,132,5,195
"40139",1040139,63,214,6,283
"40140",1040140,105,14,10,129
"40141",1040141,125,163,14,302
"40142",1040142,86,68,11,165
"40143",1040143,113,38,5,156
"40144",1040144,1,7,2,10
"40145",1040145,157,8,5,170
"40146",1040146,158,166,5,329
"40147",1040147,85,71,9,165
"40148",1040148,89,248,7,344
"40149",1040149,200,78,10,288
"40150",1040150,160,49,3,212
"40151",1040151,75,19,4,98
"40152",1040152,97,124,4,225
"40153",1040153,200,121,17,338
"40154",1040154,231,68,7,306
"40155",1040155,57,217,7,281
"40156",1040156,111,176,4,291
"40157",1040157,114,171,17,302
"40158",1040158,12,10,1,23
"40159",1040159,75,102,4,181
"40160",1040160,83,152,5,240
"40161",1040161,78,144,6,228
"40162",1040162,99,123,6,228
"40163",1040163,15,7,0,22
"40164",1040164,212,35,24,271
"40165",1040165,144,135,16,295
"40166",1040166,203,27,8,238
"40167",1040167,30,263,7,300
"40168",1040168,51,222,1,274
"40169",1040169,244,59,15,318
"40170",1040170,99,44,14,157
"40171",1040171,58,8,1,67
"40172",1040172,105,149,4,258
"40173",1040173,127,57,5,189
"40174",1040174,32,178,5,215
"40175",1040175,137,79,4,220
"40176",1040176,81,188,16,285
"40177",1040177,46,150,5,201
"40178",1040178,110,29,2,141
"40179",1040179,148,85,10,243
"40180",1040180,166,0,1,167
"40181",1040181,111,128,2,241
"40182",1040182,71,209,13,293
"40183",1040183,1,31,1,33
"40184",1040184,136,59,13,208
"40185",1040185,65,249,6,320
"40186",1040186,99,24,2,125
"40187",1040187,69,169,6,244
"40188",1040188,83,176,9,268
"40189",1040189,152,26,6,184
"40190",1040190,36,237,6,279
"40191",1040191,211,14,7,232
"40192",1040192,14,19,3,36
"40193",1040193,191,10,9,210
"40194",1040194,111,124,5,240
"40195",1040195,49,226,8,283
"40196",1040196,1,10,0,11
"40197",1040197,78,199,6,283
"40198",1040198,24,144,5,173
"40199",1040199,162,63,9,234
"40200",1040200,222,66,9,297
"40201",1040201,25,212,2,239
"40202",1040202,41,215,4,260
"40203",1040203,54,226,7,287
"40204",1040204,65,90,13,168
"40205",1040205,72,138,4,214
"40206",1040206,99,61,4,164
"40207",1040207,90,87,9,186
"40208",1040208,117,166,8,291
"40209",1040209,52,221,14,287
"40210",1040210,42,141,9,192
"40211",1040211,111,124,7,242
"40212",1040212,25,5,0,30
"40213",1040213,107,51,5,163
"40214",1040214,83,35,3,121
"40215",1040215,155,79,14,248
"40216",1040216,181,65,19,265
"40217",1040217,154,42,2,198
"40218",1040218,214,27,13,254
"40219",1040219,184,37,3,224
"40220",1040220,156,43,7,206
"40221",1040221,76,24,4,104
"40222",1040222,296,5,7,308
"40223",1040223,13,111,1,125
"40224",1040224,115,170,23,308
"40225",1040225,59,211,18,288
"40226",1040226,154,54,7,215
"40227",1040227,61,156,21,238
"40228",1040228,106,27,8,141
"40229",1040229,210,17,7,234
"40230",1040230,192,87,11,290
"40231",1040231,177,69,17,263
"40232",1040232,75,66,1,142
"40233",1040233,73,105,3,181
"40234",1040234,139,86,9,234
"40235",1040235,182,24,8,214
"40236",1040236,126,152,13,291
"40237",1040237,152,50,11,213
"40238",1040238,59,165,6,230
"40239",1040239,39,262,1,302
"40240",1040240,146,119,7,272
"40241",1040241,6,2,0,8
"40242",1040242,59,158,11,228
"40243",1040243,95,172,17,284
"40244",1040244,116,113,8,237
"40245",1040245,141,143,8,292
"40246",1040246,200,53,12,265
"40247",1040247,105,136,16,257
"40248",1040248,5,10,1,16
"40249",1040249,106,26,3,135
"40250",1040250,20,157,1,178
"40251",1040251,14,130,0,144
"40252",1040252,10,2,0,12
"40253",1040253,101,61,9,171
"40254",1040254,47,154,22,223
"40255",1040255,162,29,10,201
"40256",1040256,173,94,5,272
"40257",1040257,140,101,21,262
"40258",1040258,84,95,2,181
"40259",1040259,155,43,5,203
"40260",1040260,199,26,8,233
"40261",1040261,156,51,9,216
"40262",1040262,170,93,10,273
"40263",1040263,9,6,2,17
"40264",1040264,105,171,8,284
"40265",1040265,186,43,5,234
"40266",1040266,135,71,11,217
"40267",1040267,9,41,0,50
"40268",1040268,132,90,15,237
"40269",1040269,171,90,2,263
"40270",1040270,106,118,7,231
"40271",1040271,83,173,18,274
"40272",1040272,120,121,7,248
"40273",1040273,94,103,0,197
"40274",1040274,185,86,16,287
"40275",1040275,167,20,4,191
"40276",1040276,161,93,14,268
"40277",1040277,42,142,9,193
"40278",1040278,70,259,19,348
"40279",1040279,75,38,3,116
"40280",1040280,63,103,5,171
"40281",1040281,205,70,9,284
"40282",1040282,198,55,2,255
"40283",1040283,193,26,5,224
"40284",1040284,140,168,14,322
"40285",1040285,62,130,6,198
"40286",1040286,41,23,2,66
"40287",1040287,56,25,8,89
"40288",1040288,148,153,15,316
"40289",1040289,118,142,10,270
"40290",1040290,86,169,11,266
"40291",1040291,204,75,8,287
"40292",1040292,107,28,2,137
"40293",1040293,60,185,8,253
"40294",1040294,17,42,0,59
"40295",1040295,44,225,5,274
"40296",1040296,45,144,8,197
"40297",1040297,33,112,3,148
"40298",1040298,66,262,13,341
"40299",1040299,132,142,11,285
"40300",1040300,60,222,4,286
"40301",1040301,142,21,3,166
"40302",1040302,138,89,6,233
"40303",1040303,222,92,11,325
"40304",1040304,195,49,8,252
"40305",1040305,48,190,14,252
"40306",1040306,118,183,12,313
"40307",1040307,148,59,2,209
"40308",1040308,68,72,2,142
"40309",1040309,107,15,3,125
"40310",1040310,133,51,11,195
"40311",1040311,45,64,12,121
"40312",1040312,47,133,1,181
"40313",1040313,96,70,7,173
"40314",1040314,27,154,1,182
"40315",1040315,39,49,4,92
"40316",1040316,12,13,1,26
"40317",1040317,130,109,7,246
"40318",1040318,165,56,3,224
"40319",1040319,31,245,7,283
"40320",1040320,166,110,22,298
"40321",1040321,126,153,16,295
"40322",1040322,13,7,2,22
"40323",1040323,125,19,1,145
"40324",1040324,184,78,10,272
"40325",1040325,256,40,13,309
"40326",1040326,60,46,6,112
"40327",1040327,12,7,0,19
"40328",1040328,76,42,12,130
"40329",1040329,125,13,3,141
"40330",1040330,62,76,11,149
"40331",1040331,124,145,6,275
"40332",1040332,178,35,4,217
"40333",1040333,77,188,12,277
"40334",1040334,46,284,3,333
"40335",1040335,156,80,11,247
"40336",1040336,116,57,6,179
"40337",1040337,65,143,7,215
"40338",1040338,30,185,4,219
"40339",1040339,95,63,7,165
"40340",1040340,127,59,2,188
"40341",1040341,190,83,6,279
"40342",1040342,108,189,7,304
"40343",1040343,39,60,9,108
"40344",1040344,157,101,13,271
"40345",1040345,60,93,7,160
"40346",1040346,53,234,5,292
"40347",1040347,204,14,7,225
"40348",1040348,104,72,5,181
"40349",1040349,113,135,34,282
"40350",1040350,21,37,1,59
"40351",1040351,24,269,3,296
"40352",1040352,27,246,5,278
"40353",1040353,84,200,15,299
"40354",1040354,122,138,14,274
"40355",1040355,82,216,15,313
"40356",1040356,109,33,5,147
"40357",1040357,136,125,7,268
"40358",1040358,140,78,12,230
"40359",1040359,154,72,6,232
"40360",1040360,2,6,0,8
"40361",1040361,145,76,13,234
"40362",1040362,74,27,7,108
"40363",1040363,37,222,6,265
"40364",1040364,69,154,0,223
"40365",1040365,60,173,8,241
"40366",1040366,167,51,10,228
"40367",1040367,84,185,10,279
"40368",1040368,129,142,10,281
"40369",1040369,0,0,0,0
"40370",1040370,73,24,5,102
"40371",1040371,136,100,12,248
"40372",1040372,188,71,16,275
"40373",1040373,114,156,10,280
"40374",1040374,173,103,12,288
"40375",1040375,113,55,7,175
"40376",1040376,168,45,6,219
"40377",1040377,49,118,12,179
"40378",1040378,58,87,5,150
"40379",1040379,240,235,17,492
"40380",1040380,15,13,2,30
"40381",1040381,104,152,11,267
"40382",1040382,217,46,11,274
"40383",1040383,76,81,1,158
"40384",1040384,232,32,14,278
"40385",1040385,46,15,1,62
"40386",1040386,140,68,2,210
"40387",1040387,24,77,0,101
"40388",1040388,213,21,6,240
"40389",1040389,45,145,3,193
"40390",1040390,188,27,5,220
"40391",1040391,46,27,3,76
"40392",1040392,89,70,12,171
"40393",1040393,141,10,2,153
"40394",1040394,73,87,2,162
"40395",1040395,38,136,5,179
"40396",1040396,35,133,7,175
"40397",1040397,141,24,8,173
"40398",1040398,32,236,6,274
"40399",1040399,157,57,6,220
"40400",1040400,157,44,3,204
"40401",1040401,182,31,5,218
"40402",1040402,25,96,2,123
"40403",1040403,128,31,4,163
"40404",1040404,53,192,8,253
"40405",1040405,30,138,14,182
"40406",1040406,100,35,4,139
"40407",1040407,136,127,9,272
"40408",1040408,22,6,1,29
"40409",1040409,92,80,6,178
"40410",1040410,78,152,11,241
"40411",1040411,89,79,6,174
"40412",1040412,40,214,4,258
"40413",1040413,70,58,3,131
"40414",1040414,102,82,6,190
"40415",1040415,49,256,2,307
"40416",1040416,125,170,7,302
"40417",1040417,191,75,18,284
"40418",1040418,80,161,9,250
"40419",1040419,253,54,12,319
"40420",1040420,147,116,9,272
"40421",1040421,144,103,5,252
"40422",1040422,47,159,7,213
"40423",1040423,157,36,11,204
"40424",1040424,8,15,0,23
"40425",1040425,114,165,2,281
"40426",1040426,21,42,5,68
"40427",1040427,139,72,2,213
"40428",1040428,160,189,11,360
"40429",1040429,115,72,3,190
"40430",1040430,126,121,4,251
"40431",1040431,139,28,0,167
"40432",1040432,175,73,9,257
"40433",1040433,63,116,4,183
"40434",1040434,91,116,19,226
"40435",1040435,71,77,5,153
"40436",1040436,3,83,3,89
"40437",1040437,81,139,16,236
"40438",1040438,46,230,4,280
"40439",1040439,189,70,4,263
"40440",1040440,259,20,3,282
"40441",1040441,55,141,7,203
"40442",1040442,40,157,7,204
"40443",1040443,34,213,7,254
"40444",1040444,21,4,0,25
"40445",1040445,108,135,29,272
"40446",1040446,116,88,11,215
"40447",1040447,76,389,12,477
"40448",1040448,120,32,17,169
"40449",1040449,173,28,4,205
"40450",1040450,88,150,15,253
"40451",1040451,12,7,1,20
"40452",1040452,49,193,5,247
"40453",1040453,221,41,11,273
"40454",1040454,124,16,3,143
"40455",1040455,126,89,14,229
"40456",1040456,184,30,5,219
"40457",1040457,75,130,7,212
"40458",1040458,101,44,6,151
"40459",1040459,9,35,0,44
"40460",1040460,115,82,12,209
"40461",1040461,27,40,4,71
"40462",1040462,159,50,18,227
"40463",1040463,50,141,7,198
"40464",1040464,150,70,5,225
"40465",1040465,205,32,9,246
"40466",1040466,145,69,12,226
"40467",1040467,40,162,9,211
"40468",1040468,63,225,6,294
"40469",1040469,156,87,8,251
"40470",1040470,154,62,3,219
"40471",1040471,101,15,1,117
"40472",1040472,109,27,4,140
"40473",1040473,139,56,5,200
"40474",1040474,89,90,4,183
"40475",1040475,171,102,9,282
"40476",1040476,168,34,5,207
"40477",1040477,198,43,9,250
"40478",1040478,189,64,9,262
"40479",1040479,172,45,8,225
"40480",1040480,87,100,11,198
"40481",1040481,24,108,3,135
"40482",1040482,123,134,13,270
"40483",1040483,13,268,3,284
"40484",1040484,134,89,10,233
"40485",1040485,16,133,2,151
"40486",1040486,80,198,12,290
"40487",1040487,50,143,6,199
"40488",1040488,0,0,0,0
"40489",1040489,8,66,2,76
"40490",1040490,64,161,26,251
"40491",1040491,42,282,4,328
"40492",1040492,71,200,14,285
"40493",1040493,80,83,15,178
"40494",1040494,70,131,10,211
"40495",1040495,129,104,8,241
"40496",1040496,201,39,7,247
"40497",1040497,12,4,1,17
"40498",1040498,89,142,7,238
"40499",1040499,17,46,0,63
"40500",1040500,111,69,3,183
"40501",1040501,58,39,1,98
"40502",1040502,52,145,16,213
"40503",1040503,162,46,5,213
"40504",1040504,186,3,0,189
"40505",1040505,185,2,1,188
"40506",1040506,36,110,3,149
"40507",1040507,41,193,10,244
"40508",1040508,77,64,12,153
"40509",1040509,129,66,5,200
"40510",1040510,31,159,9,199
"40511",1040511,50,14,3,67
"40512",1040512,77,137,5,219
"40513",1040513,154,61,13,228
"40514",1040514,115,66,14,195
"40515",1040515,24,46,1,71
"40516",1040516,110,122,3,235
"40517",1040517,125,28,6,159
"40518",1040518,31,197,5,233
"40519",1040519,41,303,2,346
"40520",1040520,186,56,1,243
"40521",1040521,107,25,5,137
"40522",1040522,121,58,11,190
"40523",1040523,72,114,17,203
"40524",1040524,105,192,8,305
"40525",1040525,162,93,14,269
"40526",1040526,157,113,9,279
"40527",1040527,35,210,2,247
"40528",1040528,206,13,7,226
"40529",1040529,18,90,3,111
"40530",1040530,147,86,6,239
"40531",1040531,150,71,1,222
"40532",1040532,181,104,6,291
"40533",1040533,107,95,14,216
"40534",1040534,148,64,2,214
"40535",1040535,146,38,12,196
"40536",1040536,146,170,22,338
"40537",1040537,66,257,23,346
"40538",1040538,24,193,0,217
"40539",1040539,117,57,12,186
"40540",1040540,238,28,10,276
"40541",1040541,97,95,6,198
"40542",1040542,94,367,40,501
"40543",1040543,257,8,2,267
"40544",1040544,83,111,8,202
"40545",1040545,26,2,1,29
"40546",1040546,80,137,22,239
"40547",1040547,89,161,16,266
"40548",1040548,65,197,24,286
"40549",1040549,100,11,7,118
"40550",1040550,57,14,6,77
"40551",1040551,121,133,9,263
"40552",1040552,60,25,9,94
"40553",1040553,28,236,1,265
"40554",1040554,92,153,8,253
"40555",1040555,113,215,8,336
"40556",1040556,116,103,18,237
"40557",1040557,251,45,6,302
"40558",1040558,76,188,11,275
"40559",1040559,259,7,9,275
"40560",1040560,99,118,11,228
"40561",1040561,7,51,5,63
"40562",1040562,113,115,5,233
"40563",1040563,114,163,19,296
"40564",1040564,110,93,8,211
"40565",1040565,80,157,29,266
"40566",1040566,114,49,9,172
"40567",1040567,43,122,7,172
"40568",1040568,16,112,2,130
"40569",1040569,169,44,4,217
"40570",1040570,72,149,10,231
"40571",1040571,116,171,11,298
"40572",1040572,90,163,6,259
"40573",1040573,47,122,10,179
"40574",1040574,91,58,3,152
"40575",1040575,67,144,15,226
"40576",1040576,96,156,5,257
"40577",1040577,330,53,3,386
"40578",1040578,100,28,6,134
"40579",1040579,183,45,6,234
"40580",1040580,11,24,2,37
"40581",1040581,139,35,4,178
"40582",1040582,111,52,5,168
"40583",1040583,43,241,15,299
"40584",1040584,78,187,17,282
"40585",1040585,105,120,6,231
"40586",1040586,94,109,8,211
"40587",1040587,224,20,10,254
"40588",1040588,195,116,17,328
"40589",1040589,157,72,8,237
"40590",1040590,103,99,7,209
"40591",1040591,81,177,10,268
"40592",1040592,93,39,4,136
"40593",1040593,54,256,6,316
"40594",1040594,90,96,8,194
"40595",1040595,48,213,6,267
"40596",1040596,39,311,2,352
"40597",1040597,123,25,7,155
"40598",1040598,272,7,3,282
"40599",1040599,202,56,13,271
"40600",1040600,87,151,1,239
"40601",1040601,162,75,10,247
"40602",1040602,178,91,11,280
"40603",1040603,164,80,8,252
"40604",1040604,39,16,1,56
"40605",1040605,47,135,5,187
"40606",1040606,187,19,7,213
"40607",1040607,43,48,3,94
"40608",1040608,239,23,4,266
"40609",1040609,135,66,10,211
"40610",1040610,27,48,4,79
"40611",1040611,110,143,4,257
"40612",1040612,131,122,11,264
"40613",1040613,76,56,0,132
"40614",1040614,81,150,13,244
"40615",1040615,152,134,17,303
"40616",1040616,136,155,10,301
"40617",1040617,175,72,6,253
"40618",1040618,178,110,18,306
"40619",1040619,32,266,4,302
"40620",1040620,204,128,13,345
"40621",1040621,42,129,13,184
"40622",1040622,131,156,10,297
"40623",1040623,189,82,15,286
"40624",1040624,86,124,9,219
"40625",1040625,93,121,10,224
"40626",1040626,33,54,4,91
"40627",1040627,195,80,10,285
"40628",1040628,202,8,4,214
"40629",1040629,76,169,8,253
"40630",1040630,181,23,9,213
"40631",1040631,35,196,8,239
"40632",1040632,169,97,17,283
"40633",1040633,137,51,4,192
"40634",1040634,70,154,6,230
"40635",1040635,112,166,3,281
"40636",1040636,89,101,8,198
"40637",1040637,127,94,14,235
"40638",1040638,203,5,3,211
"40639",1040639,138,98,1,237
"40640",1040640,82,131,10,223
"40641",1040641,182,79,7,268
"40642",1040642,100,40,3,143
"40643",1040643,120,129,21,270
"40644",1040644,172,37,13,222
"40645",1040645,39,102,8,149
"40646",1040646,146,30,4,180
"40647",1040647,117,131,12,260
"40648",1040648,72,206,8,286
"40649",1040649,222,11,5,238
"40650",1040650,12,150,2,164
"40651",1040651,138,112,12,262
"40652",1040652,126,167,6,299
"40653",1040653,235,13,3,251
"40654",1040654,139,94,13,246
"40655",1040655,100,166,11,277
"40656",1040656,68,181,8,257
"40657",1040657,112,157,8,277
"40658",1040658,176,50,2,228
"40659",1040659,174,108,23,305
"40660",1040660,134,124,9,267
"40661",1040661,85,126,13,224
"40662",1040662,11,15,3,29
"40663",1040663,83,196,11,290
"40664",1040664,137,59,4,200
"40665",1040665,44,138,10,192
"40666",1040666,74,118,2,194
"40667",1040667,171,137,13,321
"40668",1040668,60,55,0,115
"40669",1040669,62,200,2,264
"40670",1040670,114,24,1,139
"40671",1040671,111,150,8,269
"40672",1040672,120,70,11,201
"40673",1040673,11,1,0,12
"40674",1040674,102,107,4,213
"40675",1040675,34,221,2,257
"40676",1040676,69,30,11,110
"40677",1040677,134,105,10,249
"40678",1040678,158,93,11,262
"40679",1040679,58,216,13,287
"40680",1040680,39,207,4,250
"40681",1040681,117,114,11,242
"40682",1040682,120,123,4,247
"40683",1040683,114,44,7,165
"40684",1040684,14,9,2,25
"40685",1040685,54,111,6,171
"40686",1040686,164,30,2,196
"40687",1040687,109,101,17,227
"40688",1040688,172,65,12,249
"40689",1040689,127,175,19,321
"40690",1040690,157,15,8,180
"40691",1040691,25,267,2,294
"40692",1040692,111,86,11,208
"40693",1040693,218,16,4,238
"40694",1040694,34,143,6,183
"40695",1040695,186,92,5,283
"40696",1040696,92,97,4,193
"40697",1040697,163,41,7,211
"40698",1040698,207,40,9,256
"40699",1040699,231,76,8,315
"40700",1040700,163,104,17,284
"40701",1040701,134,52,8,194
"40702",1040702,164,114,18,296
"40703",1040703,88,164,18,270
"40704",1040704,45,67,6,118
"40705",1040705,179,50,8,237
"40706",1040706,135,76,15,226
"40707",1040707,86,79,5,170
"40708",1040708,138,129,9,276
"40709",1040709,82,117,11,210
"40710",1040710,17,92,1,110
"40711",1040711,158,84,11,253
"40712",1040712,70,161,3,234
"40713",1040713,112,136,10,258
"40714",1040714,180,56,1,237
"40715",1040715,30,238,1,269
"40716",1040716,23,168,4,195
"40717",1040717,52,156,2,210
"40718",1040718,55,231,4,290
"40719",1040719,10,1,0,11
"40720",1040720,83,11,2,96
"40721",1040721,64,270,3,337
"40722",1040722,141,151,20,312
"40723",1040723,194,77,16,287
"40724",1040724,110,63,5,178
"40725",1040725,36,174,2,212
"40726",1040726,173,89,8,270
"40727",1040727,75,50,13,138
"40728",1040728,29,265,6,300
"40729",1040729,99,81,6,186
"40730",1040730,128,62,2,192
"40731",1040731,241,14,3,258
"40732",1040732,4,76,0,80
"40733",1040733,139,84,12,235
"40734",1040734,68,114,8,190
"40735",1040735,97,104,6,207
"40736",1040736,80,71,4,155
"40737",1040737,19,239,2,260
"40738",1040738,137,66,4,207
"40739",1040739,234,47,15,296
"40740",1040740,179,45,5,229
"40741",1040741,71,198,10,279
"40742",1040742,86,205,15,306
"40743",1040743,115,98,14,227
"40744",1040744,217,35,17,269
"40745",1040745,103,110,12,225
"40746",1040746,198,39,7,244
"40747",1040747,192,46,23,261
"40748",1040748,65,7,0,72
"40749",1040749,27,319,9,355
"40750",1040750,73,81,4,158
"40751",1040751,141,115,8,264
"40752",1040752,108,34,10,152
"40753",1040753,84,216,13,313
"40754",1040754,110,103,2,215
"40755",1040755,133,177,8,318
"40756",1040756,85,44,5,134
"40757",1040757,102,110,13,225
"40758",1040758,151,43,5,199
"40759",1040759,84,166,13,263
"40760",1040760,196,28,4,228
"40761",1040761,84,84,8,176
"40762",1040762,203,35,6,244
"40763",1040763,55,39,5,99
"40764",1040764,146,142,15,303
"40765",1040765,100,84,17,201
"40766",1040766,274,1,2,277
"40767",1040767,95,18,0,113
"40768",1040768,62,31,9,102
"40769",1040769,34,144,2,180
"40770",1040770,151,89,12,252
"40771",1040771,74,51,2,127
"40772",1040772,164,94,12,270
"40773",1040773,138,15,1,154
"40774",1040774,108,243,10,361
"40775",1040775,65,38,6,109
"40776",1040776,57,67,4,128
"40777",1040777,161,108,7,276
"40778",1040778,62,256,12,330
"40779",1040779,109,159,7,275
"40780",1040780,112,177,8,297
"40781",1040781,111,198,5,314
"40782",1040782,144,67,6,217
"40783",1040783,175,9,3,187
"40784",1040784,78,189,4,271
"40785",1040785,56,224,7,287
"40786",1040786,4,0,0,4
"40787",1040787,53,195,12,260
"40788",1040788,82,155,14,251
"40789",1040789,66,243,19,328
"40790",1040790,42,52,1,95
"40791",1040791,110,77,5,192
"40792",1040792,101,49,3,153
"40793",1040793,51,156,15,222
"40794",1040794,171,131,4,306
"40795",1040795,236,56,21,313
"40796",1040796,79,62,2,143
"40797",1040797,71,130,11,212
"40798",1040798,2,3,0,5
"40799",1040799,42,149,3,194
"40800",1040800,107,71,9,187
"40801",1040801,180,96,13,289
"40802",1040802,46,214,5,265
"40803",1040803,179,117,12,308
"40804",1040804,91,224,7,322
"40805",1040805,62,174,9,245
"40806",1040806,57,219,6,282
"40807",1040807,29,88,1,118
"40808",1040808,182,20,4,206
"40809",1040809,137,150,40,327
"40810",1040810,200,19,5,224
"40811",1040811,187,9,3,199
"40812",1040812,45,0,1,46
"40813",1040813,60,121,20,201
"40814",1040814,112,131,16,259
"40815",1040815,209,58,14,281
"40816",1040816,214,57,7,278
"40817",1040817,77,40,6,123
"40818",1040818,42,192,1,235
"40819",1040819,136,102,4,242
"40820",1040820,111,156,27,294
"40821",1040821,146,101,4,251
"40822",1040822,191,100,18,309
"40823",1040823,214,23,5,242
"40824",1040824,59,39,8,106
"40825",1040825,69,67,9,145
"40826",1040826,27,10,1,38
"40827",1040827,31,154,3,188
"40828",1040828,86,188,7,281
"40829",1040829,35,133,3,171
"40830",1040830,89,147,5,241
"40831",1040831,82,130,19,231
"40832",1040832,155,34,9,198
"40833",1040833,149,38,19,206
"40834",1040834,38,230,3,271
"40835",1040835,155,87,12,254
"40836",1040836,183,76,4,263
"40837",1040837,48,224,6,278
"40838",1040838,33,215,5,253
"40839",1040839,131,43,3,177
"40840",1040840,59,170,18,247
"40841",1040841,100,148,5,253
"40842",1040842,124,10,8,142
"40843",1040843,210,70,18,298
"40844",1040844,73,138,11,222
"40845",1040845,68,48,0,116
"40846",1040846,126,64,9,199
"40847",1040847,80,84,10,174
"40848",1040848,75,151,0,226
"40849",1040849,161,17,7,185
"40850",1040850,87,236,11,334
"40851",1040851,43,89,1,133
"40852",1040852,88,148,5,241
"40853",1040853,144,50,6,200
"40854",1040854,162,79,9,250
"40855",1040855,78,153,11,242
"40856",1040856,59,152,15,226
"40857",1040857,65,1,1,67
"40858",1040858,144,111,19,274
"40859",1040859,174,30,4,208
"40860",1040860,66,72,3,141
"40861",1040861,153,70,9,232
"40862",1040862,143,75,5,223
"40863",1040863,234,72,8,314
"40864",1040864,55,68,1,124
"40865",1040865,228,47,8,283
"40866",1040866,36,264,4,304
"40867",1040867,119,106,10,235
"40868",1040868,115,170,18,303
"40869",1040869,177,107,18,302
"40870",1040870,84,138,12,234
"40871",1040871,54,147,5,206
"40872",1040872,124,102,6,232
"40873",1040873,47,148,4,199
"40874",1040874,60,190,3,253
"40875",1040875,6,83,0,89
"40876",1040876,86,224,15,325
"40877",1040877,147,52,5,204
"40878",1040878,170,68,6,244
"40879",1040879,158,62,10,230
"40880",1040880,149,33,10,192
"40881",1040881,49,230,13,292
"40882",1040882,154,61,7,222
"40883",1040883,81,89,3,173
"40884",1040884,84,34,8,126
"40885",1040885,107,170,20,297
"40886",1040886,34,265,1,300
"40887",1040887,129,87,8,224
"40888",1040888,27,12,0,39
"40889",1040889,103,98,8,209
"40890",1040890,156,38,9,203
"40891",1040891,149,88,5,242
"40892",1040892,91,184,11,286
"40893",1040893,118,8,1,127
"40894",1040894,72,107,1,180
"40895",1040895,107,192,10,309
"40896",1040896,65,158,10,233
"40897",1040897,115,53,9,177
"40898",1040898,142,48,11,201
"40899",1040899,63,33,7,103
"40900",1040900,95,1,1,97
"40901",1040901,77,194,7,278
"40902",1040902,147,18,2,167
"40903",1040903,276,14,21,311
"40904",1040904,145,49,29,223
"40905",1040905,210,27,3,240
"40906",1040906,219,39,8,266
"40907",1040907,120,81,14,215
"40908",1040908,132,112,9,253
"40909",1040909,64,79,9,152
"40910",1040910,147,38,9,194
"40911",1040911,201,96,17,314
"40912",1040912,106,70,8,184
"40913",1040913,155,162,16,333
"40914",1040914,79,12,2,93
"40915",1040915,31,230,10,271
"40916",1040916,93,103,12,208
"40917",1040917,204,36,1,241
"40918",1040918,87,81,1,169
"40919",1040919,47,199,3,249
"40920",1040920,269,18,21,308
"40921",1040921,152,52,5,209
"40922",1040922,119,131,15,265
"40923",1040923,0,18,1,19
"40924",1040924,59,100,3,162
"40925",1040925,105,96,12,213
"40926",1040926,150,79,13,242
"40927",1040927,19,215,0,234
"40928",1040928,164,104,5,273
"40929",1040929,92,197,23,312
"40930",1040930,43,262,10,315
"40931",1040931,198,106,19,323
"40932",1040932,186,40,6,232
"40933",1040933,159,54,14,227
"40934",1040934,223,84,10,317
"40935",1040935,183,21,5,209
"40936",1040936,132,109,11,252
"40937",1040937,86,210,7,303
"40938",1040938,115,33,2,150
"40939",1040939,96,203,28,327
"40940",1040940,15,14,2,31
"40941",1040941,208,66,10,284
"40942",1040942,42,241,7,290
"40943",1040943,133,33,3,169
"40944",1040944,162,98,4,264
"40945",1040945,145,109,14,268
"40946",1040946,87,154,14,255
"40947",1040947,228,77,9,314
"40948",1040948,78,20,0,98
"40949",1040949,100,187,11,298
"40950",1040950,69,183,12,264
"40951",1040951,162,37,8,207
"40952",1040952,139,26,9,174
"40953",1040953,131,37,8,176
"40954",1040954,52,52,10,114
"40955",1040955,59,261,9,329
"40956",1040956,217,33,11,261
"40957",1040957,219,65,17,301
"40958",1040958,145,68,5,218
"40959",1040959,44,0,1,45
"40960",1040960,206,99,5,310
"40961",1040961,87,72,18,177
"40962",1040962,102,99,4,205
"40963",1040963,95,175,15,285
"40964",1040964,60,260,15,335
"40965",1040965,27,14,1,42
"40966",1040966,96,98,12,206
"40967",1040967,220,54,11,285
"40968",1040968,202,31,3,236
"40969",1040969,184,41,1,226
"40970",1040970,124,113,5,242
"40971",1040971,194,65,9,268
"40972",1040972,54,193,5,252
"40973",1040973,155,70,18,243
"40974",1040974,53,283,6,342
"40975",1040975,143,45,2,190
"40976",1040976,156,62,9,227
"40977",1040977,139,69,18,226
"40978",1040978,76,72,4,152
"40979",1040979,201,22,10,233
"40980",1040980,148,18,3,169
"40981",1040981,248,56,13,317
"40982",1040982,265,69,8,342
"40983",1040983,40,253,15,308
"40984",1040984,12,221,4,237
"40985",1040985,226,29,7,262
"40986",1040986,82,169,4,255
"40987",1040987,22,66,2,90
"40988",1040988,135,173,8,316
"40989",1040989,202,49,3,254
"40990",1040990,115,109,8,232
"40991",1040991,21,28,4,53
"40992",1040992,150,84,9,243
"40993",1040993,66,191,5,262
"40994",1040994,164,19,7,190
"40995",1040995,135,102,6,243
"40996",1040996,56,0,1,57
"40997",1040997,124,139,10,273
"40998",1040998,151,67,4,222
"40999",1040999,169,79,7,255
"41000",1041000,121,53,9,183
"41001",1041001,230,68,11,309
"41002",1041002,134,101,12,247
"41003",1041003,112,117,14,243
"41004",1041004,64,121,9,194
"41005",1041005,110,85,3,198
"41006",1041006,79,187,6,272
"41007",1041007,123,102,8,233
"41008",1041008,165,89,4,258
"41009",1041009,64,137,8,209
"41010",1041010,159,184,9,352
"41011",1041011,58,259,8,325
"41012",1041012,191,53,12,256
"41013",1041013,66,175,2,243
"41014",1041014,28,177,11,216
"41015",1041015,19,205,1,225
"41016",1041016,61,185,9,255
"41017",1041017,196,30,6,232
"41018",1041018,186,104,0,290
"41019",1041019,63,155,9,227
"41020",1041020,6,32,0,38
"41021",1041021,65,213,19,297
"41022",1041022,36,47,7,90
"41023",1041023,38,292,7,337
"41024",1041024,251,46,18,315
"41025",1041025,91,204,1,296
"41026",1041026,8,188,4,200
"41027",1041027,18,211,2,231
"41028",1041028,52,270,14,336
"41029",1041029,118,60,5,183
"41030",1041030,63,116,3,182
"41031",1041031,182,52,9,243
"41032",1041032,7,3,1,11
"41033",1041033,91,52,3,146
"41034",1041034,9,208,6,223
"41035",1041035,148,109,13,270
"41036",1041036,159,86,6,251
"41037",1041037,65,132,6,203
"41038",1041038,135,108,5,248
"41039",1041039,115,17,6,138
"41040",1041040,20,193,5,218
"41041",1041041,160,63,5,228
"41042",1041042,123,32,4,159
"41043",1041043,113,74,6,193
"41044",1041044,117,53,2,172
"41045",1041045,96,181,6,283
"41046",1041046,217,42,6,265
"41047",1041047,101,58,8,167
"41048",1041048,70,23,3,96
"41049",1041049,126,8,5,139
"41050",1041050,55,176,5,236
"41051",1041051,139,109,8,256
"41052",1041052,132,56,4,192
"41053",1041053,144,46,8,198
"41054",1041054,83,110,12,205
"41055",1041055,159,53,1,213
"41056",1041056,143,22,2,167
"41057",1041057,135,21,7,163
"41058",1041058,155,94,3,252
"41059",1041059,180,29,4,213
"41060",1041060,153,135,2,290
"41061",1041061,171,82,14,267
"41062",1041062,99,50,10,159
"41063",1041063,200,68,16,284
"41064",1041064,94,107,24,225
"41065",1041065,12,33,2,47
"41066",1041066,89,78,7,174
"41067",1041067,199,47,4,250
"41068",1041068,119,162,18,299
"41069",1041069,70,38,1,109
"41070",1041070,236,6,7,249
"41071",1041071,100,105,8,213
"41072",1041072,232,18,5,255
"41073",1041073,157,94,15,266
"41074",1041074,142,168,13,323
"41075",1041075,97,152,10,259
"41076",1041076,25,147,2,174
"41077",1041077,15,62,1,78
"41078",1041078,46,45,3,94
"41079",1041079,88,70,2,160
"41080",1041080,87,54,6,147
"41081",1041081,76,56,5,137
"41082",1041082,40,113,10,163
"41083",1041083,189,29,7,225
"41084",1041084,75,164,7,246
"41085",1041085,67,161,18,246
"41086",1041086,228,84,11,323
"41087",1041087,222,40,9,271
"41088",1041088,146,45,4,195
"41089",1041089,234,89,11,334
"41090",1041090,179,119,15,313
"41091",1041091,5,18,1,24
"41092",1041092,88,138,1,227
"41093",1041093,78,204,17,299
"41094",1041094,42,173,8,223
"41095",1041095,22,39,0,61
"41096",1041096,26,249,1,276
"41097",1041097,159,55,13,227
"41098",1041098,18,0,2,20
"41099",1041099,134,109,23,266
"41100",1041100,110,155,8,273
"41101",1041101,12,161,0,173
"41102",1041102,57,169,6,232
"41103",1041103,180,84,12,276
"41104",1041104,109,57,31,197
"41105",1041105,103,187,5,295
"41106",1041106,41,162,8,211
"41107",1041107,95,68,5,168
"41108",1041108,116,79,5,200
"41109",1041109,140,51,16,207
"41110",1041110,18,149,4,171
"41111",1041111,51,249,8,308
"41112",1041112,88,134,7,229
"41113",1041113,119,108,7,234
"41114",1041114,149,89,16,254
"41115",1041115,154,34,6,194
"41116",1041116,162,125,23,310
"41117",1041117,112,88,17,217
"41118",1041118,215,53,7,275
"41119",1041119,128,158,11,297
"41120",1041120,46,122,14,182
"41121",1041121,70,97,13,180
"41122",1041122,28,154,1,183
"41123",1041123,47,185,3,235
"41124",1041124,114,30,10,154
"41125",1041125,134,77,5,216
"41126",1041126,173,52,10,235
"41127",1041127,174,40,7,221
"41128",1041128,134,91,13,238
"41129",1041129,81,9,3,93
"41130",1041130,7,2,2,11
"41131",1041131,112,100,8,220
"41132",1041132,33,123,5,161
"41133",1041133,5,21,0,26
"41134",1041134,65,22,3,90
"41135",1041135,181,106,5,292
"41136",1041136,93,92,11,196
"41137",1041137,213,75,16,304
"41138",1041138,189,66,17,272
"41139",1041139,125,32,6,163
"41140",1041140,126,182,7,315
"41141",1041141,131,37,11,179
"41142",1041142,210,34,14,258
"41143",1041143,93,106,1,200
"41144",1041144,216,8,1,225
"41145",1041145,69,145,3,217
"41146",1041146,23,36,3,62
"41147",1041147,37,107,5,149
"41148",1041148,71,180,9,260
"41149",1041149,220,27,7,254
"41150",1041150,42,186,8,236
"41151",1041151,60,222,5,287
"41152",1041152,180,59,5,244
"41153",1041153,166,131,9,306
"41154",1041154,30,210,5,245
"41155",1041155,3,23,2,28
"41156",1041156,245,43,16,304
"41157",1041157,97,198,17,312
"41158",1041158,58,37,2,97
"41159",1041159,37,140,3,180
"41160",1041160,118,170,11,299
"41161",1041161,73,186,9,268
"41162",1041162,21,54,2,77
"41163",1041163,25,63,3,91
"41164",1041164,51,47,2,100
"41165",1041165,60,18,8,86
"41166",1041166,110,129,11,250
"41167",1041167,27,58,1,86
"41168",1041168,151,106,6,263
"41169",1041169,167,30,4,201
"41170",1041170,23,108,2,133
"41171",1041171,192,51,5,248
"41172",1041172,121,12,2,135
"41173",1041173,4,13,0,17
"41174",1041174,211,58,5,274
"41175",1041175,17,156,1,174
"41176",1041176,121,64,2,187
"41177",1041177,22,166,5,193
"41178",1041178,125,148,10,283
"41179",1041179,121,39,3,163
"41180",1041180,48,174,18,240
"41181",1041181,0,1,0,1
"41182",1041182,202,51,11,264
"41183",1041183,85,70,17,172
"41184",1041184,46,131,0,177
"41185",1041185,47,24,2,73
"41186",1041186,140,84,13,237
"41187",1041187,70,33,6,109
"41188",1041188,110,52,4,166
"41189",1041189,66,207,10,283
"41190",1041190,117,51,6,174
"41191",1041191,106,121,12,239
"41192",1041192,159,88,7,254
"41193",1041193,213,15,5,233
"41194",1041194,98,172,16,286
"41195",1041195,50,205,3,258
"41196",1041196,51,72,6,129
"41197",1041197,87,152,12,251
"41198",1041198,106,41,5,152
"41199",1041199,51,169,8,228
"41200",1041200,48,215,14,277
"41201",1041201,37,218,2,257
"41202",1041202,121,87,4,212
"41203",1041203,107,134,10,251
"41204",1041204,116,107,34,257
"41205",1041205,115,124,14,253
"41206",1041206,103,59,5,167
"41207",1041207,34,138,9,181
"41208",1041208,197,0,5,202
"41209",1041209,105,76,7,188
"41210",1041210,141,153,15,309
"41211",1041211,136,103,8,247
"41212",1041212,236,42,12,290
"41213",1041213,157,16,5,178
"41214",1041214,74,3,3,80
"41215",1041215,149,150,20,319
"41216",1041216,179,120,8,307
"41217",1041217,5,10,0,15
"41218",1041218,190,44,13,247
"41219",1041219,10,140,1,151
"41220",1041220,142,138,18,298
"41221",1041221,73,118,6,197
"41222",1041222,93,64,7,164
"41223",1041223,155,57,8,220
"41224",1041224,8,90,3,101
"41225",1041225,182,27,7,216
"41226",1041226,7,33,0,40
"41227",1041227,138,132,21,291
"41228",1041228,41,7,1,49
"41229",1041229,43,118,2,163
"41230",1041230,93,184,5,282
"41231",1041231,61,203,7,271
"41232",1041232,41,120,7,168
"41233",1041233,20,8,1,29
"41234",1041234,107,13,5,125
"41235",1041235,115,33,4,152
"41236",1041236,76,94,9,179
"41237",1041237,151,80,4,235
"41238",1041238,155,21,7,183
"41239",1041239,148,128,12,288
"41240",1041240,90,153,3,246
"41241",1041241,119,125,17,261
"41242",1041242,40,229,3,272
"41243",1041243,182,20,3,205
"41244",1041244,3,32,1,36
"41245",1041245,175,19,7,201
"41246",1041246,137,94,9,240
"41247",1041247,147,71,6,224
"41248",1041248,153,87,7,247
"41249",1041249,52,193,7,252
"41250",1041250,97,115,5,217
"41251",1041251,48,55,12,115
"41252",1041252,145,44,3,192
"41253",1041253,178,11,8,197
"41254",1041254,160,60,4,224
"41255",1041255,116,134,21,271
"41256",1041256,37,210,10,257
"41257",1041257,175,62,12,249
"41258",1041258,177,66,0,243
"41259",1041259,24,74,0,98
"41260",1041260,220,53,9,282
"41261",1041261,77,65,17,159
"41262",1041262,228,17,6,251
"41263",1041263,167,73,17,257
"41264",1041264,165,82,9,256
"41265",1041265,112,121,9,242
"41266",1041266,149,114,1,264
"41267",1041267,145,64,5,214
"41268",1041268,62,41,3,106
"41269",1041269,262,41,8,311
"41270",1041270,114,22,3,139
"41271",1041271,176,118,6,300
"41272",1041272,193,58,13,264
"41273",1041273,120,75,0,195
"41274",1041274,167,122,16,305
"41275",1041275,31,115,4,150
"41276",1041276,95,96,1,192
"41277",1041277,146,94,4,244
"41278",1041278,169,68,10,247
"41279",1041279,106,108,13,227
"41280",1041280,22,97,6,125
"41281",1041281,216,107,22,345
"41282",1041282,119,81,15,215
"41283",1041283,151,43,6,200
"41284",1041284,105,54,11,170
"41285",1041285,201,55,11,267
"41286",1041286,273,18,11,302
"41287",1041287,140,34,5,179
"41288",1041288,6,4,0,10
"41289",1041289,185,82,19,286
"41290",1041290,16,1,0,17
"41291",1041291,126,44,5,175
"41292",1041292,226,68,15,309
"41293",1041293,93,162,13,268
"41294",1041294,154,118,11,283
"41295",1041295,79,130,8,217
"41296",1041296,36,214,10,260
"41297",1041297,163,85,3,251
"41298",1041298,182,35,7,224
"41299",1041299,52,215,5,272
"41300",1041300,173,42,15,230
"41301",1041301,80,161,7,248
"41302",1041302,82,203,3,288
"41303",1041303,27,60,4,91
"41304",1041304,147,192,13,352
"41305",1041305,75,145,14,234
"41306",1041306,140,171,23,334
"41307",1041307,65,204,12,281
"41308",1041308,41,222,5,268
"41309",1041309,54,106,6,166
"41310",1041310,10,10,3,23
"41311",1041311,193,28,6,227
"41312",1041312,187,110,6,303
"41313",1041313,64,144,4,212
"41314",1041314,117,95,9,221
"41315",1041315,3,8,0,11
"41316",1041316,88,18,3,109
"41317",1041317,124,101,12,237
"41318",1041318,49,213,8,270
"41319",1041319,55,269,10,334
"41320",1041320,82,198,7,287
"41321",1041321,40,143,1,184
"41322",1041322,79,179,11,269
"41323",1041323,70,144,8,222
"41324",1041324,42,81,3,126
"41325",1041325,17,61,2,80
"41326",1041326,188,57,13,258
"41327",1041327,128,49,7,184
"41328",1041328,136,9,2,147
"41329",1041329,187,129,9,325
"41330",1041330,23,276,1,300
"41331",1041331,107,174,11,292
"41332",1041332,119,97,12,228
"41333",1041333,61,170,10,241
"41334",1041334,56,174,17,247
"41335",1041335,101,139,25,265
"41336",1041336,159,56,8,223
"41337",1041337,23,157,18,198
"41338",1041338,82,201,13,296
"41339",1041339,81,121,3,205
"41340",1041340,32,142,10,184
"41341",1041341,191,89,4,284
"41342",1041342,193,41,10,244
"41343",1041343,102,14,3,119
"41344",1041344,37,244,1,282
"41345",1041345,174,49,4,227
"41346",1041346,31,265,7,303
"41347",1041347,44,191,5,240
"41348",1041348,136,17,10,163
"41349",1041349,184,61,7,252
"41350",1041350,2,10,0,12
"41351",1041351,217,44,11,272
"41352",1041352,5,1,1,7
"41353",1041353,131,54,10,195
"41354",1041354,134,115,8,257
"41355",1041355,38,181,10,229
"41356",1041356,70,108,13,191
"41357",1041357,227,14,6,247
"41358",1041358,40,20,2,62
"41359",1041359,166,79,11,256
"41360",1041360,110,74,8,192
"41361",1041361,199,17,9,225
"41362",1041362,154,120,18,292
"41363",1041363,74,166,4,244
"41364",1041364,158,62,16,236
"41365",1041365,127,2,2,131
"41366",1041366,178,188,17,383
"41367",1041367,43,25,1,69
"41368",1041368,128,118,6,252
"41369",1041369,108,107,17,232
"41370",1041370,173,49,10,232
"41371",1041371,89,31,2,122
"41372",1041372,114,79,15,208
"41373",1041373,178,34,9,221
"41374",1041374,51,156,0,207
"41375",1041375,150,19,6,175
"41376",1041376,43,222,8,273
"41377",1041377,277,13,6,296
"41378",1041378,63,82,6,151
"41379",1041379,46,218,18,282
"41380",1041380,169,25,7,201
"41381",1041381,93,86,16,195
"41382",1041382,168,67,10,245
"41383",1041383,88,61,4,153
"41384",1041384,85,114,5,204
"41385",1041385,53,233,10,296
"41386",1041386,53,181,21,255
"41387",1041387,180,70,8,258
"41388",1041388,74,102,6,182
"41389",1041389,154,19,8,181
"41390",1041390,196,62,14,272
"41391",1041391,3,4,0,7
"41392",1041392,155,67,10,232
"41393",1041393,135,35,2,172
"41394",1041394,146,190,17,353
"41395",1041395,13,1,0,14
"41396",1041396,52,195,9,256
"41397",1041397,198,83,10,291
"41398",1041398,114,140,4,258
"41399",1041399,162,64,6,232
"41400",1041400,69,63,3,135
"41401",1041401,91,233,13,337
"41402",1041402,89,59,4,152
"41403",1041403,44,39,3,86
"41404",1041404,172,89,23,284
"41405",1041405,149,114,8,271
"41406",1041406,85,109,9,203
"41407",1041407,39,195,7,241
"41408",1041408,79,166,5,250
"41409",1041409,11,221,9,241
"41410",1041410,187,61,11,259
"41411",1041411,180,86,8,274
"41412",1041412,142,104,7,253
"41413",1041413,41,70,4,115
"41414",1041414,77,186,1,264
"41415",1041415,190,86,17,293
"41416",1041416,214,105,10,329
"41417",1041417,134,138,10,282
"41418",1041418,44,254,3,301
"41419",1041419,64,199,15,278
"41420",1041420,63,65,6,134
"41421",1041421,181,30,4,215
"41422",1041422,71,201,10,282
"41423",1041423,85,203,8,296
"41424",1041424,121,173,11,305
"41425",1041425,48,156,3,207
"41426",1041426,42,154,2,198
"41427",1041427,7,6,1,14
"41428",1041428,185,93,9,287
"41429",1041429,48,164,5,217
"41430",1041430,61,158,10,229
"41431",1041431,91,133,23,247
"41432",1041432,153,107,22,282
"41433",1041433,290,30,9,329
"41434",1041434,122,43,4,169
"41435",1041435,97,166,19,282
"41436",1041436,93,189,15,297
"41437",1041437,107,166,19,292
"41438",1041438,72,139,6,217
"41439",1041439,138,84,4,226
"41440",1041440,125,43,5,173
"41441",1041441,139,62,5,206
"41442",1041442,49,216,1,266
"41443",1041443,103,174,19,296
"41444",1041444,227,76,21,324
"41445",1041445,62,114,4,180
"41446",1041446,121,87,9,217
"41447",1041447,11,107,1,119
"41448",1041448,61,5,0,66
"41449",1041449,150,72,15,237
"41450",1041450,2,8,0,10
"41451",1041451,133,41,8,182
"41452",1041452,98,136,4,238
"41453",1041453,51,217,4,272
"41454",1041454,51,132,11,194
"41455",1041455,109,148,8,265
"41456",1041456,177,39,7,223
"41457",1041457,37,224,8,269
"41458",1041458,133,55,4,192
"41459",1041459,160,58,7,225
"41460",1041460,175,53,9,237
"41461",1041461,20,178,3,201
"41462",1041462,73,61,10,144
"41463",1041463,95,86,22,203
"41464",1041464,30,195,1,226
"41465",1041465,245,97,15,357
"41466",1041466,172,74,5,251
"41467",1041467,198,95,10,303
"41468",1041468,153,91,9,253
"41469",1041469,187,73,9,269
"41470",1041470,224,51,12,287
"41471",1041471,56,93,6,155
"41472",1041472,82,196,10,288
"41473",1041473,180,79,13,272
"41474",1041474,44,238,11,293
"41475",1041475,88,204,12,304
"41476",1041476,191,68,14,273
"41477",1041477,187,74,3,264
"41478",1041478,121,47,10,178
"41479",1041479,165,57,5,227
"41480",1041480,248,44,6,298
"41481",1041481,5,81,3,89
"41482",1041482,15,9,1,25
"41483",1041483,61,71,16,148
"41484",1041484,85,161,8,254
"41485",1041485,147,81,13,241
"41486",1041486,130,73,5,208
"41487",1041487,111,28,5,144
"41488",1041488,188,43,1,232
"41489",1041489,88,174,11,273
"41490",1041490,76,59,1,136
"41491",1041491,16,54,4,74
"41492",1041492,71,175,5,251
"41493",1041493,135,20,4,159
"41494",1041494,126,66,8,200
"41495",1041495,129,110,15,254
"41496",1041496,139,30,5,174
"41497",1041497,31,209,0,240
"41498",1041498,186,127,19,332
"41499",1041499,130,91,12,233
"41500",1041500,141,92,4,237
"41501",1041501,81,192,12,285
"41502",1041502,23,194,5,222
"41503",1041503,150,79,12,241
"41504",1041504,84,52,7,143
"41505",1041505,173,67,17,257
"41506",1041506,133,36,3,172
"41507",1041507,130,72,7,209
"41508",1041508,19,213,3,235
"41509",1041509,44,259,6,309
"41510",1041510,181,54,17,252
"41511",1041511,86,124,6,216
"41512",1041512,33,183,12,228
"41513",1041513,62,119,17,198
"41514",1041514,154,65,6,225
"41515",1041515,109,85,4,198
"41516",1041516,126,99,7,232
"41517",1041517,107,41,10,158
"41518",1041518,163,38,4,205
"41519",1041519,202,61,8,271
"41520",1041520,174,95,9,278
"41521",1041521,205,45,10,260
"41522",1041522,13,237,1,251
"41523",1041523,159,33,11,203
"41524",1041524,51,190,7,248
"41525",1041525,128,148,30,306
"41526",1041526,23,210,7,240
"41527",1041527,159,3,6,168
"41528",1041528,146,89,3,238
"41529",1041529,126,138,11,275
"41530",1041530,126,35,4,165
"41531",1041531,150,95,3,248
"41532",1041532,87,111,6,204
"41533",1041533,166,45,6,217
"41534",1041534,183,3,3,189
"41535",1041535,72,85,16,173
"41536",1041536,164,100,18,282
"41537",1041537,46,120,4,170
"41538",1041538,189,92,7,288
"41539",1041539,181,112,8,301
"41540",1041540,23,18,2,43
"41541",1041541,123,101,5,229
"41542",1041542,89,25,1,115
"41543",1041543,124,168,8,300
"41544",1041544,82,177,9,268
"41545",1041545,121,56,7,184
"41546",1041546,128,161,4,293
"41547",1041547,171,53,11,235
"41548",1041548,186,60,7,253
"41549",1041549,104,157,1,262
"41550",1041550,115,202,4,321
"41551",1041551,19,105,4,128
"41552",1041552,136,164,20,320
"41553",1041553,18,97,4,119
"41554",1041554,65,35,4,104
"41555",1041555,190,50,10,250
"41556",1041556,81,107,5,193
"41557",1041557,134,115,16,265
"41558",1041558,60,168,3,231
"41559",1041559,122,140,11,273
"41560",1041560,31,64,0,95
"41561",1041561,168,138,13,319
"41562",1041562,132,19,2,153
"41563",1041563,85,230,2,317
"41564",1041564,47,252,1,300
"41565",1041565,122,10,8,140
"41566",1041566,150,85,4,239
"41567",1041567,25,209,3,237
"41568",1041568,51,257,5,313
"41569",1041569,128,171,9,308
"41570",1041570,129,144,13,286
"41571",1041571,137,128,5,270
"41572",1041572,162,88,9,259
"41573",1041573,134,129,10,273
"41574",1041574,145,80,7,232
"41575",1041575,185,116,9,310
"41576",1041576,128,113,3,244
"41577",1041577,13,327,3,343
"41578",1041578,145,130,11,286
"41579",1041579,0,0,0,0
"41580",1041580,95,78,21,194
"41581",1041581,92,120,3,215
"41582",1041582,96,208,14,318
"41583",1041583,115,23,4,142
"41584",1041584,127,65,7,199
"41585",1041585,28,244,15,287
"41586",1041586,119,155,10,284
"41587",1041587,123,99,5,227
"41588",1041588,191,65,9,265
"41589",1041589,150,88,6,244
"41590",1041590,96,10,1,107
"41591",1041591,35,72,13,120
"41592",1041592,0,24,0,24
"41593",1041593,147,115,7,269
"41594",1041594,197,109,19,325
"41595",1041595,219,124,11,354
"41596",1041596,164,101,8,273
"41597",1041597,68,104,10,182
"41598",1041598,116,64,17,197
"41599",1041599,299,5,6,310
"41600",1041600,57,208,13,278
"41601",1041601,168,107,7,282
"41602",1041602,175,105,9,289
"41603",1041603,81,219,16,316
"41604",1041604,31,25,3,59
"41605",1041605,37,228,3,268
"41606",1041606,75,150,9,234
"41607",1041607,134,78,10,222
"41608",1041608,37,242,7,286
"41609",1041609,88,208,12,308
"41610",1041610,59,271,0,330
"41611",1041611,171,9,6,186
"41612",1041612,39,20,2,61
"41613",1041613,39,166,4,209
"41614",1041614,82,181,16,279
"41615",1041615,138,181,3,322
"41616",1041616,251,43,18,312
"41617",1041617,66,194,7,267
"41618",1041618,141,62,3,206
"41619",1041619,76,63,5,144
"41620",1041620,84,102,7,193
"41621",1041621,60,125,6,191
"41622",1041622,32,119,7,158
"41623",1041623,51,223,3,277
"41624",1041624,64,106,5,175
"41625",1041625,19,16,2,37
"41626",1041626,61,141,1,203
"41627",1041627,60,243,2,305
"41628",1041628,35,225,4,264
"41629",1041629,2,4,0,6
"41630",1041630,65,69,2,136
"41631",1041631,149,57,4,210
"41632",1041632,6,18,0,24
"41633",1041633,117,44,4,165
"41634",1041634,90,162,4,256
"41635",1041635,174,106,7,287
"41636",1041636,189,22,9,220
"41637",1041637,185,91,19,295
"41638",1041638,93,22,0,115
"41639",1041639,20,74,0,94
"41640",1041640,154,72,6,232
"41641",1041641,20,36,1,57
"41642",1041642,186,90,13,289
"41643",1041643,23,21,1,45
"41644",1041644,66,223,9,298
"41645",1041645,199,86,6,291
"41646",1041646,195,99,13,307
"41647",1041647,94,46,8,148
"41648",1041648,194,20,4,218
"41649",1041649,62,139,1,202
"41650",1041650,114,106,4,224
"41651",1041651,57,177,7,241
"41652",1041652,43,220,5,268
"41653",1041653,164,119,19,302
"41654",1041654,162,120,12,294
"41655",1041655,137,182,15,334
"41656",1041656,180,26,5,211
"41657",1041657,40,225,11,276
"41658",1041658,71,228,14,313
"41659",1041659,78,35,3,116
"41660",1041660,73,151,18,242
"41661",1041661,61,239,1,301
"41662",1041662,130,112,3,245
"41663",1041663,72,93,3,168
"41664",1041664,147,49,10,206
"41665",1041665,112,131,7,250
"41666",1041666,91,16,2,109
"41667",1041667,22,109,2,133
"41668",1041668,61,197,6,264
"41669",1041669,53,106,6,165
"41670",1041670,150,21,4,175
"41671",1041671,130,127,6,263
"41672",1041672,88,143,17,248
"41673",1041673,79,141,7,227
"41674",1041674,68,41,6,115
"41675",1041675,122,10,1,133
"41676",1041676,43,238,2,283
"41677",1041677,117,121,5,243
"41678",1041678,188,65,3,256
"41679",1041679,136,58,10,204
"41680",1041680,62,13,4,79
"41681",1041681,220,50,19,289
"41682",1041682,89,230,10,329
"41683",1041683,168,55,13,236
"41684",1041684,145,54,9,208
"41685",1041685,65,197,4,266
"41686",1041686,160,52,9,221
"41687",1041687,31,19,1,51
"41688",1041688,105,66,8,179
"41689",1041689,172,72,7,251
"41690",1041690,223,5,19,247
"41691",1041691,97,65,8,170
"41692",1041692,160,134,12,306
"41693",1041693,177,70,17,264
"41694",1041694,47,89,5,141
"41695",1041695,0,0,0,0
"41696",1041696,180,23,2,205
"41697",1041697,29,124,6,159
"41698",1041698,137,118,9,264
"41699",1041699,109,140,13,262
"41700",1041700,68,116,13,197
"41701",1041701,72,180,12,264
"41702",1041702,169,69,8,246
"41703",1041703,68,42,3,113
"41704",1041704,62,235,11,308
"41705",1041705,67,161,6,234
"41706",1041706,139,89,10,238
"41707",1041707,43,99,13,155
"41708",1041708,215,70,8,293
"41709",1041709,205,60,2,267
"41710",1041710,56,24,3,83
"41711",1041711,8,22,4,34
"41712",1041712,121,117,8,246
"41713",1041713,66,123,5,194
"41714",1041714,223,32,59,314
"41715",1041715,121,114,6,241
"41716",1041716,118,83,7,208
"41717",1041717,49,45,7,101
"41718",1041718,118,53,6,177
"41719",1041719,106,17,8,131
"41720",1041720,53,156,13,222
"41721",1041721,87,72,8,167
"41722",1041722,162,31,11,204
"41723",1041723,169,35,11,215
"41724",1041724,120,90,16,226
"41725",1041725,110,138,18,266
"41726",1041726,89,110,7,206
"41727",1041727,74,34,10,118
"41728",1041728,78,198,27,303
"41729",1041729,209,61,11,281
"41730",1041730,63,157,3,223
"41731",1041731,184,72,20,276
"41732",1041732,36,234,6,276
"41733",1041733,100,184,7,291
"41734",1041734,75,147,9,231
"41735",1041735,133,103,10,246
"41736",1041736,68,190,4,262
"41737",1041737,140,39,8,187
"41738",1041738,113,140,10,263
"41739",1041739,145,41,6,192
"41740",1041740,64,202,11,277
"41741",1041741,226,42,11,279
"41742",1041742,149,146,10,305
"41743",1041743,19,187,3,209
"41744",1041744,17,23,1,41
"41745",1041745,120,147,15,282
"41746",1041746,138,60,11,209
"41747",1041747,87,119,10,216
"41748",1041748,73,184,6,263
"41749",1041749,50,216,4,270
"41750",1041750,111,83,9,203
"41751",1041751,41,87,6,134
"41752",1041752,92,86,2,180
"41753",1041753,37,2,2,41
"41754",1041754,112,15,2,129
"41755",1041755,105,49,3,157
"41756",1041756,151,56,5,212
"41757",1041757,24,9,0,33
"41758",1041758,49,125,6,180
"41759",1041759,184,30,6,220
"41760",1041760,24,225,3,252
"41761",1041761,135,42,1,178
"41762",1041762,53,121,9,183
"41763",1041763,131,46,11,188
"41764",1041764,146,69,5,220
"41765",1041765,173,57,10,240
"41766",1041766,203,82,17,302
"41767",1041767,178,135,16,329
"41768",1041768,145,74,10,229
"41769",1041769,17,5,2,24
"41770",1041770,144,44,8,196
"41771",1041771,83,78,11,172
"41772",1041772,87,104,13,204
"41773",1041773,186,31,9,226
"41774",1041774,93,221,4,318
"41775",1041775,125,145,14,284
"41776",1041776,29,256,7,292
"41777",1041777,236,37,9,282
"41778",1041778,56,92,5,153
"41779",1041779,130,133,8,271
"41780",1041780,190,43,6,239
"41781",1041781,203,31,5,239
"41782",1041782,91,205,12,308
"41783",1041783,55,158,6,219
"41784",1041784,110,57,5,172
"41785",1041785,120,135,6,261
"41786",1041786,142,33,3,178
"41787",1041787,162,101,11,274
"41788",1041788,75,211,12,298
"41789",1041789,179,116,12,307
"41790",1041790,29,180,2,211
"41791",1041791,250,37,4,291
"41792",1041792,111,152,9,272
"41793",1041793,73,92,6,171
"41794",1041794,110,82,14,206
"41795",1041795,197,68,6,271
"41796",1041796,155,42,6,203
"41797",1041797,30,36,8,74
"41798",1041798,119,168,10,297
"41799",1041799,191,64,17,272
"41800",1041800,104,77,8,189
"41801",1041801,89,142,3,234
"41802",1041802,177,66,14,257
"41803",1041803,84,211,12,307
"41804",1041804,104,143,2,249
"41805",1041805,40,160,10,210
"41806",1041806,116,20,1,137
"41807",1041807,90,14,4,108
"41808",1041808,34,146,3,183
"41809",1041809,98,218,9,325
"41810",1041810,120,72,13,205
"41811",1041811,53,217,11,281
"41812",1041812,229,17,6,252
"41813",1041813,84,206,15,305
"41814",1041814,141,33,13,187
"41815",1041815,131,117,8,256
"41816",1041816,192,80,13,285
"41817",1041817,103,33,6,142
"41818",1041818,57,74,5,136
"41819",1041819,85,192,7,284
"41820",1041820,68,168,38,274
"41821",1041821,49,128,10,187
"41822",1041822,151,60,10,221
"41823",1041823,99,115,11,225
"41824",1041824,62,5,1,68
"41825",1041825,127,189,3,319
"41826",1041826,145,110,7,262
"41827",1041827,133,2,0,135
"41828",1041828,195,68,10,273
"41829",1041829,116,126,5,247
"41830",1041830,256,18,6,280
"41831",1041831,34,14,1,49
"41832",1041832,105,85,10,200
"41833",1041833,97,197,25,319
"41834",1041834,187,105,13,305
"41835",1041835,30,199,1,230
"41836",1041836,127,44,5,176
"41837",1041837,118,142,14,274
"41838",1041838,93,97,15,205
"41839",1041839,105,83,3,191
"41840",1041840,171,67,11,249
"41841",1041841,259,48,8,315
"41842",1041842,143,24,16,183
"41843",1041843,43,189,5,237
"41844",1041844,4,2,1,7
"41845",1041845,39,212,5,256
"41846",1041846,128,93,6,227
"41847",1041847,150,28,3,181
"41848",1041848,47,243,15,305
"41849",1041849,132,20,9,161
"41850",1041850,150,70,14,234
"41851",1041851,138,47,7,192
"41852",1041852,135,92,4,231
"41853",1041853,47,166,8,221
"41854",1041854,12,379,1,392
"41855",1041855,47,263,4,314
"41856",1041856,17,59,2,78
"41857",1041857,50,150,5,205
"41858",1041858,148,46,23,217
"41859",1041859,135,200,14,349
"41860",1041860,48,237,2,287
"41861",1041861,164,22,2,188
"41862",1041862,158,1,1,160
"41863",1041863,90,149,11,250
"41864",1041864,156,125,18,299
"41865",1041865,64,205,8,277
"41866",1041866,107,65,12,184
"41867",1041867,119,93,4,216
"41868",1041868,195,31,3,229
"41869",1041869,140,139,26,305
"41870",1041870,194,32,5,231
"41871",1041871,165,58,0,223
"41872",1041872,183,74,11,268
"41873",1041873,127,16,4,147
"41874",1041874,100,162,9,271
"41875",1041875,54,194,3,251
"41876",1041876,6,260,3,269
"41877",1041877,52,251,12,315
"41878",1041878,2,16,0,18
"41879",1041879,143,41,1,185
"41880",1041880,64,133,4,201
"41881",1041881,51,1,0,52
"41882",1041882,189,139,5,333
"41883",1041883,75,108,13,196
"41884",1041884,36,267,4,307
"41885",1041885,64,185,9,258
"41886",1041886,107,124,6,237
"41887",1041887,154,43,7,204
"41888",1041888,130,71,6,207
"41889",1041889,163,94,10,267
"41890",1041890,172,83,6,261
"41891",1041891,20,236,2,258
"41892",1041892,137,33,8,178
"41893",1041893,96,189,21,306
"41894",1041894,1,1,0,2
"41895",1041895,177,52,8,237
"41896",1041896,65,188,11,264
"41897",1041897,261,2,0,263
"41898",1041898,170,17,3,190
"41899",1041899,35,16,0,51
"41900",1041900,72,26,6,104
"41901",1041901,201,22,2,225
"41902",1041902,25,195,9,229
"41903",1041903,26,171,5,202
"41904",1041904,201,85,9,295
"41905",1041905,127,196,10,333
"41906",1041906,120,198,7,325
"41907",1041907,147,151,16,314
"41908",1041908,73,226,2,301
"41909",1041909,65,185,8,258
"41910",1041910,89,155,6,250
"41911",1041911,34,250,8,292
"41912",1041912,162,27,7,196
"41913",1041913,40,148,9,197
"41914",1041914,62,170,12,244
"41915",1041915,205,16,5,226
"41916",1041916,89,20,3,112
"41917",1041917,177,86,15,278
"41918",1041918,178,72,4,254
"41919",1041919,143,59,11,213
"41920",1041920,151,128,10,289
"41921",1041921,122,88,7,217
"41922",1041922,241,57,18,316
"41923",1041923,211,67,30,308
"41924",1041924,110,71,8,189
"41925",1041925,48,223,10,281
"41926",1041926,173,56,6,235
"41927",1041927,93,45,8,146
"41928",1041928,146,59,14,219
"41929",1041929,68,161,6,235
"41930",1041930,144,42,7,193
"41931",1041931,129,165,8,302
"41932",1041932,73,164,11,248
"41933",1041933,79,121,10,210
"41934",1041934,112,217,20,349
"41935",1041935,17,154,6,177
"41936",1041936,155,67,7,229
"41937",1041937,166,89,15,270
"41938",1041938,46,246,1,293
"41939",1041939,65,121,19,205
"41940",1041940,97,167,17,281
"41941",1041941,31,27,2,60
"41942",1041942,66,270,3,339
"41943",1041943,89,150,4,243
"41944",1041944,192,197,6,395
"41945",1041945,119,76,11,206
"41946",1041946,119,86,4,209
"41947",1041947,153,86,8,247
"41948",1041948,120,108,11,239
"41949",1041949,182,96,7,285
"41950",1041950,4,124,1,129
"41951",1041951,209,60,12,281
"41952",1041952,99,123,16,238
"41953",1041953,116,4,2,122
"41954",1041954,48,238,6,292
"41955",1041955,100,30,6,136
"41956",1041956,229,68,12,309
"41957",1041957,101,169,9,279
"41958",1041958,75,189,8,272
"41959",1041959,148,88,8,244
"41960",1041960,104,148,9,261
"41961",1041961,178,55,10,243
"41962",1041962,57,188,6,251
"41963",1041963,88,155,18,261
"41964",1041964,204,47,16,267
"41965",1041965,176,95,15,286
"41966",1041966,61,180,6,247
"41967",1041967,10,13,0,23
"41968",1041968,146,122,7,275
"41969",1041969,70,94,2,166
"41970",1041970,149,16,3,168
"41971",1041971,59,159,3,221
"41972",1041972,186,67,13,266
"41973",1041973,87,128,5,220
"41974",1041974,68,197,8,273
"41975",1041975,197,24,10,231
"41976",1041976,78,164,13,255
"41977",1041977,121,64,5,190
"41978",1041978,127,114,7,248
"41979",1041979,83,190,5,278
"41980",1041980,20,205,1,226
"41981",1041981,63,280,3,346
"41982",1041982,204,36,9,249
"41983",1041983,41,186,3,230
"41984",1041984,88,203,10,301
"41985",1041985,77,153,13,243
"41986",1041986,36,84,7,127
"41987",1041987,93,87,2,182
"41988",1041988,33,26,5,64
"41989",1041989,205,26,14,245
"41990",1041990,25,202,0,227
"41991",1041991,104,179,3,286
"41992",1041992,21,144,1,166
"41993",1041993,139,37,8,184
"41994",1041994,217,54,18,289
"41995",1041995,82,45,12,139
"41996",1041996,35,227,7,269
"41997",1041997,164,57,7,228
"41998",1041998,65,200,6,271
"41999",1041999,155,58,7,220
"42000",1042000,116,73,9,198
"42001",1042001,182,66,9,257
"42002",1042002,77,89,2,168
"42003",1042003,43,205,16,264
"42004",1042004,36,283,1,320
"42005",1042005,180,122,11,313
"42006",1042006,28,208,2,238
"42007",1042007,32,5,0,37
"42008",1042008,85,82,7,174
"42009",1042009,213,67,4,284
"42010",1042010,49,209,8,266
"42011",1042011,57,47,8,112
"42012",1042012,22,185,2,209
"42013",1042013,237,20,3,260
"42014",1042014,66,185,22,273
"42015",1042015,138,110,13,261
"42016",1042016,2,46,0,48
"42017",1042017,211,68,11,290
"42018",1042018,5,2,0,7
"42019",1042019,151,25,5,181
"42020",1042020,62,188,12,262
"42021",1042021,109,76,13,198
"42022",1042022,114,143,14,271
"42023",1042023,155,52,4,211
"42024",1042024,261,36,7,304
"42025",1042025,212,70,16,298
"42026",1042026,75,97,9,181
"42027",1042027,138,162,3,303
"42028",1042028,144,93,9,246
"42029",1042029,106,125,9,240
"42030",1042030,170,72,5,247
"42031",1042031,176,43,14,233
"42032",1042032,150,52,18,220
"42033",1042033,69,59,6,134
"42034",1042034,41,256,9,306
"42035",1042035,92,57,5,154
"42036",1042036,72,182,10,264
"42037",1042037,161,28,3,192
"42038",1042038,82,122,2,206
"42039",1042039,152,73,8,233
"42040",1042040,137,29,6,172
"42041",1042041,208,30,7,245
"42042",1042042,142,70,11,223
"42043",1042043,107,147,4,258
"42044",1042044,73,161,12,246
"42045",1042045,67,124,3,194
"42046",1042046,92,139,18,249
"42047",1042047,123,27,6,156
"42048",1042048,106,70,8,184
"42049",1042049,185,87,18,290
"42050",1042050,95,95,13,203
"42051",1042051,105,17,0,122
"42052",1042052,24,226,6,256
"42053",1042053,118,122,35,275
"42054",1042054,90,212,6,308
"42055",1042055,254,41,8,303
"42056",1042056,59,218,11,288
"42057",1042057,48,46,5,99
"42058",1042058,121,163,16,300
"42059",1042059,59,187,7,253
"42060",1042060,150,114,4,268
"42061",1042061,204,104,13,321
"42062",1042062,38,211,4,253
"42063",1042063,192,15,2,209
"42064",1042064,98,121,18,237
"42065",1042065,60,225,7,292
"42066",1042066,95,20,4,119
"42067",1042067,163,14,7,184
"42068",1042068,212,80,9,301
"42069",1042069,220,21,7,248
"42070",1042070,53,230,16,299
"42071",1042071,85,106,17,208
"42072",1042072,84,82,8,174
"42073",1042073,164,49,7,220
"42074",1042074,203,31,9,243
"42075",1042075,143,114,7,264
"42076",1042076,97,115,6,218
"42077",1042077,109,87,5,201
"42078",1042078,196,67,36,299
"42079",1042079,82,167,11,260
"42080",1042080,129,65,9,203
"42081",1042081,126,330,15,471
"42082",1042082,23,107,5,135
"42083",1042083,121,36,5,162
"42084",1042084,102,17,1,120
"42085",1042085,40,184,4,228
"42086",1042086,42,192,7,241
"42087",1042087,138,6,5,149
"42088",1042088,116,118,5,239
"42089",1042089,160,59,2,221
"42090",1042090,105,54,7,166
"42091",1042091,108,144,9,261
"42092",1042092,119,90,5,214
"42093",1042093,122,45,5,172
"42094",1042094,53,122,5,180
"42095",1042095,15,302,6,323
"42096",1042096,161,56,0,217
"42097",1042097,203,49,19,271
"42098",1042098,28,17,0,45
"42099",1042099,111,112,4,227
"42100",1042100,142,176,10,328
"42101",1042101,153,131,14,298
"42102",1042102,151,86,14,251
"42103",1042103,56,94,8,158
"42104",1042104,34,226,9,269
"42105",1042105,86,73,0,159
"42106",1042106,98,136,14,248
"42107",1042107,59,53,0,112
"42108",1042108,83,89,17,189
"42109",1042109,83,73,8,164
"42110",1042110,101,127,10,238
"42111",1042111,36,234,7,277
"42112",1042112,153,15,9,177
"42113",1042113,46,247,3,296
"42114",1042114,38,196,2,236
"42115",1042115,227,68,3,298
"42116",1042116,54,65,0,119
"42117",1042117,125,66,16,207
"42118",1042118,170,54,12,236
"42119",1042119,81,22,7,110
"42120",1042120,70,167,4,241
"42121",1042121,104,95,11,210
"42122",1042122,81,116,10,207
"42123",1042123,166,43,5,214
"42124",1042124,62,146,10,218
"42125",1042125,146,68,11,225
"42126",1042126,160,70,10,240
"42127",1042127,83,168,17,268
"42128",1042128,160,77,10,247
"42129",1042129,131,95,14,240
"42130",1042130,87,181,11,279
"42131",1042131,198,32,10,240
"42132",1042132,79,1,3,83
"42133",1042133,73,109,11,193
"42134",1042134,74,162,4,240
"42135",1042135,166,94,8,268
"42136",1042136,183,72,4,259
"42137",1042137,93,211,9,313
"42138",1042138,8,5,0,13
"42139",1042139,36,274,4,314
"42140",1042140,29,241,1,271
"42141",1042141,211,46,7,264
"42142",1042142,86,126,5,217
"42143",1042143,53,179,5,237
"42144",1042144,45,256,3,304
"42145",1042145,141,34,3,178
"42146",1042146,216,105,24,345
"42147",1042147,57,237,8,302
"42148",1042148,52,33,5,90
"42149",1042149,101,94,8,203
"42150",1042150,23,11,3,37
"42151",1042151,15,14,2,31
"42152",1042152,118,207,14,339
"42153",1042153,99,133,9,241
"42154",1042154,150,13,5,168
"42155",1042155,92,121,5,218
"42156",1042156,141,87,7,235
"42157",1042157,70,243,6,319
"42158",1042158,87,126,7,220
"42159",1042159,96,83,13,192
"42160",1042160,167,98,8,273
"42161",1042161,88,150,3,241
"42162",1042162,66,45,3,114
"42163",1042163,55,103,4,162
"42164",1042164,142,60,5,207
"42165",1042165,93,55,16,164
"42166",1042166,203,30,8,241
"42167",1042167,134,47,11,192
"42168",1042168,70,137,11,218
"42169",1042169,55,97,4,156
"42170",1042170,186,25,8,219
"42171",1042171,132,105,11,248
"42172",1042172,89,132,3,224
"42173",1042173,277,34,7,318
"42174",1042174,263,58,7,328
"42175",1042175,78,66,8,152
"42176",1042176,98,69,0,167
"42177",1042177,54,165,4,223
"42178",1042178,93,120,17,230
"42179",1042179,153,74,7,234
"42180",1042180,135,123,8,266
"42181",1042181,100,81,12,193
"42182",1042182,107,151,11,269
"42183",1042183,72,48,0,120
"42184",1042184,54,83,8,145
"42185",1042185,165,70,9,244
"42186",1042186,103,60,6,169
"42187",1042187,3,3,0,6
"42188",1042188,193,29,7,229
"42189",1042189,160,53,9,222
"42190",1042190,121,86,11,218
"42191",1042191,43,51,8,102
"42192",1042192,77,78,11,166
"42193",1042193,169,64,2,235
"42194",1042194,106,43,12,161
"42195",1042195,100,164,13,277
"42196",1042196,171,62,9,242
"42197",1042197,14,76,2,92
"42198",1042198,37,196,4,237
"42199",1042199,31,279,2,312
"42200",1042200,107,170,8,285
"42201",1042201,110,100,10,220
"42202",1042202,30,291,5,326
"42203",1042203,145,103,19,267
"42204",1042204,169,76,12,257
"42205",1042205,184,98,11,293
"42206",1042206,4,254,2,260
"42207",1042207,210,109,5,324
"42208",1042208,54,175,9,238
"42209",1042209,60,85,19,164
"42210",1042210,175,108,17,300
"42211",1042211,235,40,9,284
"42212",1042212,54,258,3,315
"42213",1042213,178,44,20,242
"42214",1042214,125,97,12,234
"42215",1042215,45,242,10,297
"42216",1042216,14,4,2,20
"42217",1042217,23,49,8,80
"42218",1042218,69,12,1,82
"42219",1042219,164,51,16,231
"42220",1042220,179,90,12,281
"42221",1042221,74,55,19,148
"42222",1042222,130,50,4,184
"42223",1042223,112,155,2,269
"42224",1042224,190,31,7,228
"42225",1042225,199,140,13,352
"42226",1042226,169,44,8,221
"42227",1042227,113,41,4,158
"42228",1042228,153,83,6,242
"42229",1042229,78,116,2,196
"42230",1042230,80,189,4,273
"42231",1042231,100,147,14,261
"42232",1042232,115,0,2,117
"42233",1042233,113,16,1,130
"42234",1042234,127,130,12,269
"42235",1042235,10,8,2,20
"42236",1042236,97,185,10,292
"42237",1042237,167,121,17,305
"42238",1042238,56,172,4,232
"42239",1042239,101,132,8,241
"42240",1042240,26,17,1,44
"42241",1042241,141,44,4,189
"42242",1042242,104,209,5,318
"42243",1042243,33,231,2,266
"42244",1042244,199,56,13,268
"42245",1042245,55,94,1,150
"42246",1042246,30,137,3,170
"42247",1042247,114,139,13,266
"42248",1042248,85,227,14,326
"42249",1042249,120,133,9,262
"42250",1042250,227,76,12,315
"42251",1042251,179,38,6,223
"42252",1042252,103,100,10,213
"42253",1042253,173,22,8,203
"42254",1042254,202,33,8,243
"42255",1042255,157,55,14,226
"42256",1042256,150,15,9,174
"42257",1042257,96,203,13,312
"42258",1042258,116,84,5,205
"42259",1042259,48,57,3,108
"42260",1042260,26,188,2,216
"42261",1042261,152,127,6,285
"42262",1042262,109,173,6,288
"42263",1042263,127,130,28,285
"42264",1042264,32,143,3,178
"42265",1042265,120,80,5,205
"42266",1042266,166,115,17,298
"42267",1042267,68,150,6,224
"42268",1042268,209,51,8,268
"42269",1042269,236,27,5,268
"42270",1042270,65,139,5,209
"42271",1042271,112,119,2,233
"42272",1042272,161,105,14,280
"42273",1042273,118,80,4,202
"42274",1042274,84,54,11,149
"42275",1042275,35,74,2,111
"42276",1042276,138,58,7,203
"42277",1042277,188,44,6,238
"42278",1042278,137,27,3,167
"42279",1042279,173,72,12,257
"42280",1042280,103,50,7,160
"42281",1042281,158,164,9,331
"42282",1042282,190,82,10,282
"42283",1042283,46,128,16,190
"42284",1042284,74,105,11,190
"42285",1042285,56,234,15,305
"42286",1042286,168,84,18,270
"42287",1042287,54,176,4,234
"42288",1042288,126,134,14,274
"42289",1042289,196,54,9,259
"42290",1042290,94,202,11,307
"42291",1042291,15,335,0,350
"42292",1042292,5,7,0,12
"42293",1042293,172,73,13,258
"42294",1042294,88,53,9,150
"42295",1042295,92,71,9,172
"42296",1042296,186,71,8,265
"42297",1042297,134,53,4,191
"42298",1042298,77,134,11,222
"42299",1042299,104,139,1,244
"42300",1042300,26,31,4,61
"42301",1042301,65,245,11,321
"42302",1042302,10,7,0,17
"42303",1042303,200,106,1,307
"42304",1042304,107,162,7,276
"42305",1042305,41,100,9,150
"42306",1042306,70,129,16,215
"42307",1042307,48,10,2,60
"42308",1042308,47,187,11,245
"42309",1042309,139,124,14,277
"42310",1042310,212,70,16,298
"42311",1042311,169,20,10,199
"42312",1042312,177,28,15,220
"42313",1042313,83,168,8,259
"42314",1042314,31,19,0,50
"42315",1042315,176,108,17,301
"42316",1042316,116,54,8,178
"42317",1042317,48,172,3,223
"42318",1042318,46,25,2,73
"42319",1042319,134,71,2,207
"42320",1042320,57,243,6,306
"42321",1042321,100,11,8,119
"42322",1042322,344,177,22,543
"42323",1042323,117,65,15,197
"42324",1042324,50,154,6,210
"42325",1042325,84,45,2,131
"42326",1042326,123,40,5,168
"42327",1042327,270,78,10,358
"42328",1042328,82,131,9,222
"42329",1042329,59,221,16,296
"42330",1042330,110,112,2,224
"42331",1042331,88,154,12,254
"42332",1042332,100,194,7,301
"42333",1042333,31,6,4,41
"42334",1042334,173,70,11,254
"42335",1042335,50,15,0,65
"42336",1042336,32,280,4,316
"42337",1042337,120,155,15,290
"42338",1042338,97,80,9,186
"42339",1042339,137,169,21,327
"42340",1042340,67,60,12,139
"42341",1042341,93,53,5,151
"42342",1042342,31,141,11,183
"42343",1042343,130,119,7,256
"42344",1042344,129,178,6,313
"42345",1042345,99,189,8,296
"42346",1042346,54,235,14,303
"42347",1042347,131,93,19,243
"42348",1042348,88,96,6,190
"42349",1042349,200,41,7,248
"42350",1042350,145,56,6,207
"42351",1042351,213,106,13,332
"42352",1042352,67,157,7,231
"42353",1042353,190,21,4,215
"42354",1042354,11,290,1,302
"42355",1042355,129,96,24,249
"42356",1042356,164,47,5,216
"42357",1042357,73,94,4,171
"42358",1042358,159,41,8,208
"42359",1042359,143,58,8,209
"42360",1042360,116,117,7,240
"42361",1042361,42,159,14,215
"42362",1042362,256,60,6,322
"42363",1042363,44,136,14,194
"42364",1042364,202,41,11,254
"42365",1042365,63,165,7,235
"42366",1042366,128,35,10,173
"42367",1042367,20,23,2,45
"42368",1042368,174,87,12,273
"42369",1042369,186,28,6,220
"42370",1042370,59,170,3,232
"42371",1042371,174,31,9,214
"42372",1042372,16,204,1,221
"42373",1042373,24,62,1,87
"42374",1042374,118,128,9,255
"42375",1042375,104,23,2,129
"42376",1042376,29,226,4,259
"42377",1042377,118,127,11,256
"42378",1042378,72,0,0,72
"42379",1042379,26,174,2,202
"42380",1042380,138,119,9,266
"42381",1042381,37,186,4,227
"42382",1042382,178,3,8,189
"42383",1042383,143,75,9,227
"42384",1042384,104,113,6,223
"42385",1042385,218,43,14,275
"42386",1042386,144,71,12,227
"42387",1042387,89,44,5,138
"42388",1042388,33,166,9,208
"42389",1042389,25,193,8,226
"42390",1042390,107,132,2,241
"42391",1042391,51,131,8,190
"42392",1042392,255,33,7,295
"42393",1042393,141,142,11,294
"42394",1042394,90,183,13,286
"42395",1042395,207,28,6,241
"42396",1042396,16,8,2,26
"42397",1042397,57,250,6,313
"42398",1042398,93,134,11,238
"42399",1042399,15,30,0,45
"42400",1042400,32,250,3,285
"42401",1042401,28,201,6,235
"42402",1042402,54,166,18,238
"42403",1042403,11,3,1,15
"42404",1042404,178,119,7,304
"42405",1042405,100,9,5,114
"42406",1042406,153,54,4,211
"42407",1042407,31,232,1,264
"42408",1042408,206,18,7,231
"42409",1042409,55,85,2,142
"42410",1042410,262,26,11,299
"42411",1042411,138,144,15,297
"42412",1042412,32,19,1,52
"42413",1042413,74,152,11,237
"42414",1042414,75,105,7,187
"42415",1042415,69,165,5,239
"42416",1042416,130,101,8,239
"42417",1042417,223,63,7,293
"42418",1042418,238,67,6,311
"42419",1042419,132,168,7,307
"42420",1042420,3,3,0,6
"42421",1042421,12,248,2,262
"42422",1042422,167,99,16,282
"42423",1042423,139,116,12,267
"42424",1042424,183,16,5,204
"42425",1042425,71,182,3,256
"42426",1042426,121,64,5,190
"42427",1042427,57,92,4,153
"42428",1042428,158,101,13,272
"42429",1042429,87,211,12,310
"42430",1042430,11,40,1,52
"42431",1042431,122,157,25,304
"42432",1042432,99,153,6,258
"42433",1042433,151,24,2,177
"42434",1042434,110,125,8,243
"42435",1042435,198,26,12,236
"42436",1042436,125,175,8,308
"42437",1042437,155,61,8,224
"42438",1042438,173,44,9,226
"42439",1042439,40,131,7,178
"42440",1042440,172,30,5,207
"42441",1042441,22,269,6,297
"42442",1042442,15,134,1,150
"42443",1042443,34,171,7,212
"42444",1042444,64,120,5,189
"42445",1042445,180,72,12,264
"42446",1042446,86,176,16,278
"42447",1042447,198,93,12,303
"42448",1042448,214,41,12,267
"42449",1042449,98,152,10,260
"42450",1042450,127,98,8,233
"42451",1042451,106,175,11,292
"42452",1042452,170,42,7,219
"42453",1042453,91,93,10,194
"42454",1042454,47,216,1,264
"42455",1042455,113,150,4,267
"42456",1042456,218,46,8,272
"42457",1042457,196,39,5,240
"42458",1042458,166,34,5,205
"42459",1042459,202,40,5,247
"42460",1042460,112,116,2,230
"42461",1042461,25,172,8,205
"42462",1042462,121,113,7,241
"42463",1042463,117,102,4,223
"42464",1042464,37,116,14,167
"42465",1042465,278,207,54,539
"42466",1042466,17,6,2,25
"42467",1042467,41,170,5,216
"42468",1042468,147,95,8,250
"42469",1042469,126,100,7,233
"42470",1042470,146,76,8,230
"42471",1042471,131,50,2,183
"42472",1042472,43,150,9,202
"42473",1042473,71,222,4,297
"42474",1042474,44,249,12,305
"42475",1042475,220,54,14,288
"42476",1042476,104,121,3,228
"42477",1042477,249,17,8,274
"42478",1042478,109,20,6,135
"42479",1042479,233,11,5,249
"42480",1042480,12,6,1,19
"42481",1042481,91,143,11,245
"42482",1042482,105,123,12,240
"42483",1042483,133,67,3,203
"42484",1042484,179,42,9,230
"42485",1042485,100,72,9,181
"42486",1042486,1,60,0,61
"42487",1042487,119,44,4,167
"42488",1042488,212,109,12,333
"42489",1042489,51,160,3,214
"42490",1042490,152,171,9,332
"42491",1042491,1,3,1,5
"42492",1042492,10,138,2,150
"42493",1042493,109,115,1,225
"42494",1042494,181,18,9,208
"42495",1042495,127,32,12,171
"42496",1042496,51,123,2,176
"42497",1042497,62,168,5,235
"42498",1042498,81,55,1,137
"42499",1042499,77,218,3,298
"42500",1042500,186,94,4,284
"42501",1042501,164,52,4,220
"42502",1042502,107,119,15,241
"42503",1042503,136,44,13,193
"42504",1042504,222,53,5,280
"42505",1042505,104,102,10,216
"42506",1042506,226,25,3,254
"42507",1042507,225,93,10,328
"42508",1042508,167,57,16,240
"42509",1042509,186,47,11,244
"42510",1042510,98,215,6,319
"42511",1042511,234,18,4,256
"42512",1042512,167,60,11,238
"42513",1042513,93,113,12,218
"42514",1042514,54,215,24,293
"42515",1042515,171,58,8,237
"42516",1042516,60,194,17,271
"42517",1042517,201,51,11,263
"42518",1042518,139,87,12,238
"42519",1042519,111,58,5,174
"42520",1042520,61,155,10,226
"42521",1042521,206,66,9,281
"42522",1042522,88,120,12,220
"42523",1042523,63,40,2,105
"42524",1042524,125,24,1,150
"42525",1042525,46,206,2,254
"42526",1042526,116,124,8,248
"42527",1042527,106,114,5,225
"42528",1042528,109,46,4,159
"42529",1042529,82,152,4,238
"42530",1042530,20,187,5,212
"42531",1042531,230,29,23,282
"42532",1042532,199,49,11,259
"42533",1042533,90,159,5,254
"42534",1042534,171,40,5,216
"42535",1042535,121,109,9,239
"42536",1042536,42,144,17,203
"42537",1042537,117,77,3,197
"42538",1042538,89,80,5,174
"42539",1042539,150,114,5,269
"42540",1042540,101,103,12,216
"42541",1042541,139,37,7,183
"42542",1042542,37,161,9,207
"42543",1042543,213,15,2,230
"42544",1042544,6,186,0,192
"42545",1042545,96,125,9,230
"42546",1042546,51,123,5,179
"42547",1042547,33,103,2,138
"42548",1042548,154,75,0,229
"42549",1042549,18,10,3,31
"42550",1042550,143,56,8,207
"42551",1042551,120,67,1,188
"42552",1042552,91,147,8,246
"42553",1042553,102,175,8,285
"42554",1042554,140,33,9,182
"42555",1042555,86,130,8,224
"42556",1042556,168,72,16,256
"42557",1042557,86,179,8,273
"42558",1042558,123,79,3,205
"42559",1042559,114,153,9,276
"42560",1042560,132,57,12,201
"42561",1042561,180,70,11,261
"42562",1042562,100,47,4,151
"42563",1042563,97,74,1,172
"42564",1042564,113,118,6,237
"42565",1042565,137,158,21,316
"42566",1042566,93,157,6,256
"42567",1042567,73,74,14,161
"42568",1042568,212,44,3,259
"42569",1042569,124,124,1,249
"42570",1042570,31,277,4,312
"42571",1042571,177,88,9,274
"42572",1042572,38,4,19,61
"42573",1042573,138,124,11,273
"42574",1042574,110,162,24,296
"42575",1042575,175,79,3,257
"42576",1042576,38,124,6,168
"42577",1042577,46,288,8,342
"42578",1042578,139,74,27,240
"42579",1042579,69,51,1,121
"42580",1042580,97,17,35,149
"42581",1042581,157,61,13,231
"42582",1042582,53,92,7,152
"42583",1042583,225,30,7,262
"42584",1042584,142,101,11,254
"42585",1042585,251,36,11,298
"42586",1042586,103,206,5,314
"42587",1042587,83,38,4,125
"42588",1042588,37,214,3,254
"42589",1042589,200,45,8,253
"42590",1042590,74,123,7,204
"42591",1042591,173,77,6,256
"42592",1042592,165,45,8,218
"42593",1042593,82,141,5,228
"42594",1042594,54,98,2,154
"42595",1042595,189,49,8,246
"42596",1042596,126,58,8,192
"42597",1042597,140,86,9,235
"42598",1042598,79,180,6,265
"42599",1042599,242,49,9,300
"42600",1042600,56,202,6,264
"42601",1042601,26,93,0,119
"42602",1042602,35,19,0,54
"42603",1042603,87,176,6,269
"42604",1042604,59,197,3,259
"42605",1042605,66,149,3,218
"42606",1042606,32,258,15,305
"42607",1042607,170,152,18,340
"42608",1042608,99,39,16,154
"42609",1042609,212,40,3,255
"42610",1042610,86,141,5,232
"42611",1042611,125,128,12,265
"42612",1042612,108,93,8,209
"42613",1042613,19,17,0,36
"42614",1042614,18,210,5,233
"42615",1042615,128,62,12,202
"42616",1042616,212,67,8,287
"42617",1042617,152,122,14,288
"42618",1042618,23,194,8,225
"42619",1042619,160,30,3,193
"42620",1042620,55,176,3,234
"42621",1042621,38,117,2,157
"42622",1042622,4,0,0,4
"42623",1042623,35,25,0,60
"42624",1042624,113,109,15,237
"42625",1042625,331,3,5,339
"42626",1042626,30,29,2,61
"42627",1042627,70,112,7,189
"42628",1042628,65,77,3,145
"42629",1042629,216,39,11,266
"42630",1042630,68,114,0,182
"42631",1042631,76,129,10,215
"42632",1042632,175,46,14,235
"42633",1042633,14,13,1,28
"42634",1042634,76,143,16,235
"42635",1042635,80,183,8,271
"42636",1042636,179,20,5,204
"42637",1042637,133,130,8,271
"42638",1042638,263,116,7,386
"42639",1042639,144,87,13,244
"42640",1042640,70,13,1,84
"42641",1042641,188,52,4,244
"42642",1042642,43,17,3,63
"42643",1042643,107,13,3,123
"42644",1042644,142,150,9,301
"42645",1042645,163,63,7,233
"42646",1042646,115,197,11,323
"42647",1042647,129,75,10,214
"42648",1042648,59,45,3,107
"42649",1042649,224,76,12,312
"42650",1042650,191,39,13,243
"42651",1042651,70,209,15,294
"42652",1042652,214,24,2,240
"42653",1042653,125,30,3,158
"42654",1042654,217,64,10,291
"42655",1042655,11,96,1,108
"42656",1042656,14,8,1,23
"42657",1042657,158,51,8,217
"42658",1042658,156,87,10,253
"42659",1042659,80,82,9,171
"42660",1042660,111,39,6,156
"42661",1042661,24,109,4,137
"42662",1042662,71,124,4,199
"42663",1042663,199,32,3,234
"42664",1042664,110,72,3,185
"42665",1042665,129,160,5,294
"42666",1042666,223,19,3,245
"42667",1042667,33,239,3,275
"42668",1042668,86,136,16,238
"42669",1042669,87,96,7,190
"42670",1042670,105,123,20,248
"42671",1042671,58,120,8,186
"42672",1042672,161,13,2,176
"42673",1042673,127,122,8,257
"42674",1042674,98,108,13,219
"42675",1042675,61,73,4,138
"42676",1042676,101,123,15,239
"42677",1042677,76,91,2,169
"42678",1042678,226,52,6,284
"42679",1042679,178,53,8,239
"42680",1042680,87,222,4,313
"42681",1042681,70,90,3,163
"42682",1042682,36,98,5,139
"42683",1042683,146,83,8,237
"42684",1042684,77,163,6,246
"42685",1042685,1,12,0,13
"42686",1042686,155,26,4,185
"42687",1042687,194,48,0,242
"42688",1042688,178,126,15,319
"42689",1042689,152,61,3,216
"42690",1042690,86,165,14,265
"42691",1042691,71,214,12,297
"42692",1042692,171,72,4,247
"42693",1042693,44,31,2,77
"42694",1042694,77,2,0,79
"42695",1042695,153,99,3,255
"42696",1042696,207,45,19,271
"42697",1042697,184,36,5,225
"42698",1042698,233,29,1,263
"42699",1042699,233,62,7,302
"42700",1042700,211,50,7,268
"42701",1042701,113,27,2,142
"42702",1042702,86,193,17,296
"42703",1042703,42,58,4,104
"42704",1042704,118,16,4,138
"42705",1042705,25,8,4,37
"42706",1042706,2,33,1,36
"42707",1042707,154,74,8,236
"42708",1042708,247,46,6,299
"42709",1042709,56,73,3,132
"42710",1042710,78,173,4,255
"42711",1042711,207,54,12,273
"42712",1042712,67,173,17,257
"42713",1042713,97,166,20,283
"42714",1042714,103,142,9,254
"42715",1042715,194,28,3,225
"42716",1042716,65,129,8,202
"42717",1042717,158,167,24,349
"42718",1042718,229,29,8,266
"42719",1042719,13,13,0,26
"42720",1042720,179,113,5,297
"42721",1042721,63,191,6,260
"42722",1042722,189,47,9,245
"42723",1042723,157,64,3,224
"42724",1042724,33,184,2,219
"42725",1042725,175,60,4,239
"42726",1042726,15,130,3,148
"42727",1042727,83,173,13,269
"42728",1042728,105,89,6,200
"42729",1042729,80,141,11,232
"42730",1042730,125,85,14,224
"42731",1042731,128,94,14,236
"42732",1042732,130,24,1,155
"42733",1042733,188,68,20,276
"42734",1042734,61,39,4,104
"42735",1042735,135,32,4,171
"42736",1042736,4,3,0,7
"42737",1042737,24,160,6,190
"42738",1042738,90,90,18,198
"42739",1042739,118,121,7,246
"42740",1042740,202,26,6,234
"42741",1042741,19,22,3,44
"42742",1042742,8,140,0,148
"42743",1042743,157,20,6,183
"42744",1042744,146,35,4,185
"42745",1042745,45,188,15,248
"42746",1042746,88,106,2,196
"42747",1042747,34,162,3,199
"42748",1042748,121,107,6,234
"42749",1042749,68,78,14,160
"42750",1042750,133,158,4,295
"42751",1042751,90,176,4,270
"42752",1042752,145,68,16,229
"42753",1042753,103,123,2,228
"42754",1042754,152,27,1,180
"42755",1042755,131,84,6,221
"42756",1042756,95,4,1,100
"42757",1042757,203,80,27,310
"42758",1042758,92,35,7,134
"42759",1042759,125,169,11,305
"42760",1042760,105,165,21,291
"42761",1042761,196,44,7,247
"42762",1042762,159,25,9,193
"42763",1042763,11,21,2,34
"42764",1042764,64,187,2,253
"42765",1042765,122,131,10,263
"42766",1042766,133,115,6,254
"42767",1042767,204,28,5,237
"42768",1042768,125,74,6,205
"42769",1042769,156,74,5,235
"42770",1042770,201,64,15,280
"42771",1042771,93,17,7,117
"42772",1042772,201,43,3,247
"42773",1042773,169,56,1,226
"42774",1042774,140,48,4,192
"42775",1042775,116,73,12,201
"42776",1042776,56,208,7,271
"42777",1042777,67,140,10,217
"42778",1042778,47,243,12,302
"42779",1042779,174,57,12,243
"42780",1042780,22,9,2,33
"42781",1042781,165,82,16,263
"42782",1042782,110,175,13,298
"42783",1042783,118,94,11,223
"42784",1042784,56,186,10,252
"42785",1042785,189,46,2,237
"42786",1042786,90,246,8,344
"42787",1042787,156,18,7,181
"42788",1042788,129,128,12,269
"42789",1042789,139,55,5,199
"42790",1042790,108,92,3,203
"42791",1042791,58,1,1,60
"42792",1042792,107,181,12,300
"42793",1042793,79,165,4,248
"42794",1042794,47,208,5,260
"42795",1042795,43,213,5,261
"42796",1042796,29,247,1,277
"42797",1042797,102,88,4,194
"42798",1042798,93,148,12,253
"42799",1042799,170,60,7,237
"42800",1042800,67,112,4,183
"42801",1042801,55,227,10,292
"42802",1042802,143,117,4,264
"42803",1042803,70,182,15,267
"42804",1042804,165,95,7,267
"42805",1042805,26,10,1,37
"42806",1042806,9,0,0,9
"42807",1042807,147,50,9,206
"42808",1042808,133,130,20,283
"42809",1042809,157,54,6,217
"42810",1042810,131,85,5,221
"42811",1042811,157,139,15,311
"42812",1042812,74,149,6,229
"42813",1042813,27,246,0,273
"42814",1042814,4,37,0,41
"42815",1042815,127,150,17,294
"42816",1042816,59,215,13,287
"42817",1042817,38,225,5,268
"42818",1042818,153,66,3,222
"42819",1042819,277,14,5,296
"42820",1042820,67,5,1,73
"42821",1042821,144,100,17,261
"42822",1042822,63,110,4,177
"42823",1042823,7,89,6,102
"42824",1042824,91,73,11,175
"42825",1042825,122,15,2,139
"42826",1042826,168,73,3,244
"42827",1042827,150,142,22,314
"42828",1042828,73,168,5,246
"42829",1042829,141,82,9,232
"42830",1042830,202,22,1,225
"42831",1042831,134,126,12,272
"42832",1042832,54,202,3,259
"42833",1042833,65,203,18,286
"42834",1042834,154,58,5,217
"42835",1042835,122,178,13,313
"42836",1042836,181,60,15,256
"42837",1042837,89,129,6,224
"42838",1042838,151,62,55,268
"42839",1042839,77,122,18,217
"42840",1042840,82,233,15,330
"42841",1042841,127,105,6,238
"42842",1042842,21,3,2,26
"42843",1042843,104,110,2,216
"42844",1042844,81,149,1,231
"42845",1042845,37,186,5,228
"42846",1042846,100,108,16,224
"42847",1042847,113,95,11,219
"42848",1042848,191,116,8,315
"42849",1042849,116,174,8,298
"42850",1042850,129,81,4,214
"42851",1042851,199,130,6,335
"42852",1042852,82,84,2,168
"42853",1042853,105,225,10,340
"42854",1042854,111,85,7,203
"42855",1042855,175,75,7,257
"42856",1042856,134,131,10,275
"42857",1042857,30,118,4,152
"42858",1042858,81,181,6,268
"42859",1042859,135,147,10,292
"42860",1042860,33,141,4,178
"42861",1042861,177,44,3,224
"42862",1042862,45,150,7,202
"42863",1042863,70,69,3,142
"42864",1042864,183,53,5,241
"42865",1042865,204,70,6,280
"42866",1042866,192,90,4,286
"42867",1042867,76,164,27,267
"42868",1042868,57,152,4,213
"42869",1042869,177,49,7,233
"42870",1042870,51,154,5,210
"42871",1042871,109,151,6,266
"42872",1042872,245,32,4,281
"42873",1042873,107,116,12,235
"42874",1042874,218,25,9,252
"42875",1042875,102,102,6,210
"42876",1042876,54,142,10,206
"42877",1042877,137,29,5,171
"42878",1042878,117,127,13,257
"42879",1042879,26,179,2,207
"42880",1042880,53,132,3,188
"42881",1042881,74,33,8,115
"42882",1042882,95,145,21,261
"42883",1042883,35,35,2,72
"42884",1042884,26,19,2,47
"42885",1042885,42,111,2,155
"42886",1042886,129,112,2,243
"42887",1042887,160,43,5,208
"42888",1042888,195,32,3,230
"42889",1042889,108,146,15,269
"42890",1042890,91,54,4,149
"42891",1042891,78,180,3,261
"42892",1042892,35,168,9,212
"42893",1042893,185,85,23,293
"42894",1042894,142,140,10,292
"42895",1042895,64,216,6,286
"42896",1042896,49,252,1,302
"42897",1042897,189,113,11,313
"42898",1042898,237,27,10,274
"42899",1042899,158,121,17,296
"42900",1042900,47,201,4,252
"42901",1042901,87,157,1,245
"42902",1042902,33,289,4,326
"42903",1042903,156,85,16,257
"42904",1042904,102,145,25,272
"42905",1042905,168,59,5,232
"42906",1042906,141,43,5,189
"42907",1042907,88,34,5,127
"42908",1042908,79,130,7,216
"42909",1042909,219,57,20,296
"42910",1042910,239,29,7,275
"42911",1042911,171,109,15,295
"42912",1042912,87,62,2,151
"42913",1042913,56,25,1,82
"42914",1042914,54,169,5,228
"42915",1042915,37,257,9,303
"42916",1042916,183,67,5,255
"42917",1042917,144,32,5,181
"42918",1042918,186,118,15,319
"42919",1042919,107,200,14,321
"42920",1042920,63,200,2,265
"42921",1042921,155,121,13,289
"42922",1042922,12,234,6,252
"42923",1042923,20,213,4,237
"42924",1042924,78,99,8,185
"42925",1042925,45,259,5,309
"42926",1042926,103,105,11,219
"42927",1042927,53,218,4,275
"42928",1042928,241,61,10,312
"42929",1042929,60,49,2,111
"42930",1042930,180,117,7,304
"42931",1042931,146,139,20,305
"42932",1042932,129,75,5,209
"42933",1042933,109,98,18,225
"42934",1042934,185,27,13,225
"42935",1042935,69,97,10,176
"42936",1042936,135,93,8,236
"42937",1042937,81,165,4,250
"42938",1042938,144,157,12,313
"42939",1042939,88,63,3,154
"42940",1042940,121,117,15,253
"42941",1042941,58,208,7,273
"42942",1042942,47,175,6,228
"42943",1042943,93,99,11,203
"42944",1042944,49,17,3,69
"42945",1042945,252,17,5,274
"42946",1042946,153,103,8,264
"42947",1042947,194,42,6,242
"42948",1042948,124,60,4,188
"42949",1042949,117,60,3,180
"42950",1042950,60,230,5,295
"42951",1042951,12,1,0,13
"42952",1042952,57,201,14,272
"42953",1042953,35,49,3,87
"42954",1042954,36,307,5,348
"42955",1042955,138,83,7,228
"42956",1042956,27,120,1,148
"42957",1042957,107,142,6,255
"42958",1042958,17,72,0,89
"42959",1042959,132,84,5,221
"42960",1042960,105,80,17,202
"42961",1042961,90,212,6,308
"42962",1042962,323,1,0,324
"42963",1042963,132,163,16,311
"42964",1042964,113,90,4,207
"42965",1042965,168,84,4,256
"42966",1042966,4,72,2,78
"42967",1042967,50,246,10,306
"42968",1042968,220,80,12,312
"42969",1042969,10,12,0,22
"42970",1042970,70,245,10,325
"42971",1042971,73,235,10,318
"42972",1042972,193,115,18,326
"42973",1042973,168,74,8,250
"42974",1042974,161,28,8,197
"42975",1042975,201,116,16,333
"42976",1042976,178,12,7,197
"42977",1042977,210,42,11,263
"42978",1042978,122,27,9,158
"42979",1042979,109,164,8,281
"42980",1042980,44,128,4,176
"42981",1042981,42,209,4,255
"42982",1042982,178,44,12,234
"42983",1042983,68,406,33,507
"42984",1042984,86,94,13,193
"42985",1042985,81,204,3,288
"42986",1042986,109,125,15,249
"42987",1042987,35,126,2,163
"42988",1042988,86,90,6,182
"42989",1042989,134,132,16,282
"42990",1042990,116,182,16,314
"42991",1042991,181,55,9,245
"42992",1042992,202,43,9,254
"42993",1042993,74,27,5,106
"42994",1042994,104,81,9,194
"42995",1042995,125,59,2,186
"42996",1042996,175,117,14,306
"42997",1042997,118,135,7,260
"42998",1042998,55,190,4,249
"42999",1042999,77,4,0,81
"43000",1043000,148,16,4,168
"43001",1043001,56,260,10,326
"43002",1043002,125,293,11,429
"43003",1043003,84,160,23,267
"43004",1043004,49,255,12,316
"43005",1043005,182,73,6,261
"43006",1043006,33,182,5,220
"43007",1043007,201,8,4,213
"43008",1043008,208,16,6,230
"43009",1043009,53,240,3,296
"43010",1043010,162,108,6,276
"43011",1043011,24,10,1,35
"43012",1043012,84,108,6,198
"43013",1043013,164,101,13,278
"43014",1043014,88,129,6,223
"43015",1043015,90,98,5,193
"43016",1043016,159,31,7,197
"43017",1043017,65,227,11,303
"43018",1043018,24,58,1,83
"43019",1043019,2,0,0,2
"43020",1043020,9,3,0,12
"43021",1043021,107,174,2,283
"43022",1043022,31,11,0,42
"43023",1043023,30,125,4,159
"43024",1043024,60,152,13,225
"43025",1043025,216,88,6,310
"43026",1043026,160,91,11,262
"43027",1043027,120,130,12,262
"43028",1043028,38,257,5,300
"43029",1043029,180,24,9,213
"43030",1043030,10,197,0,207
"43031",1043031,99,89,4,192
"43032",1043032,210,50,7,267
"43033",1043033,69,4,2,75
"43034",1043034,86,185,6,277
"43035",1043035,246,67,15,328
"43036",1043036,39,43,2,84
"43037",1043037,142,45,12,199
"43038",1043038,153,78,6,237
"43039",1043039,53,169,9,231
"43040",1043040,55,89,10,154
"43041",1043041,162,57,7,226
"43042",1043042,80,17,3,100
"43043",1043043,35,33,1,69
"43044",1043044,240,41,8,289
"43045",1043045,46,57,2,105
"43046",1043046,62,189,6,257
"43047",1043047,76,69,3,148
"43048",1043048,113,139,8,260
"43049",1043049,179,36,1,216
"43050",1043050,161,23,2,186
"43051",1043051,203,49,7,259
"43052",1043052,203,88,21,312
"43053",1043053,21,94,2,117
"43054",1043054,136,130,14,280
"43055",1043055,15,75,1,91
"43056",1043056,6,2,1,9
"43057",1043057,7,7,0,14
"43058",1043058,68,70,2,140
"43059",1043059,72,19,3,94
"43060",1043060,166,49,13,228
"43061",1043061,67,191,4,262
"43062",1043062,73,106,4,183
"43063",1043063,35,211,14,260
"43064",1043064,88,26,1,115
"43065",1043065,64,226,7,297
"43066",1043066,186,54,10,250
"43067",1043067,63,192,11,266
"43068",1043068,111,123,6,240
"43069",1043069,159,99,9,267
"43070",1043070,237,80,10,327
"43071",1043071,128,47,10,185
"43072",1043072,161,35,8,204
"43073",1043073,50,239,4,293
"43074",1043074,117,111,10,238
"43075",1043075,85,118,5,208
"43076",1043076,105,35,4,144
"43077",1043077,89,167,13,269
"43078",1043078,238,24,8,270
"43079",1043079,187,83,18,288
"43080",1043080,226,16,15,257
"43081",1043081,121,68,3,192
"43082",1043082,203,49,10,262
"43083",1043083,87,91,19,197
"43084",1043084,124,111,9,244
"43085",1043085,7,145,2,154
"43086",1043086,25,271,5,301
"43087",1043087,192,60,11,263
"43088",1043088,93,95,7,195
"43089",1043089,17,0,0,17
"43090",1043090,61,11,2,74
"43091",1043091,34,216,9,259
"43092",1043092,65,236,6,307
"43093",1043093,85,169,5,259
"43094",1043094,177,57,9,243
"43095",1043095,97,178,12,287
"43096",1043096,127,140,11,278
"43097",1043097,72,181,9,262
"43098",1043098,36,257,4,297
"43099",1043099,125,173,4,302
"43100",1043100,77,174,9,260
"43101",1043101,97,190,10,297
"43102",1043102,173,99,10,282
"43103",1043103,206,32,2,240
"43104",1043104,143,74,4,221
"43105",1043105,105,141,10,256
"43106",1043106,4,14,0,18
"43107",1043107,180,110,17,307
"43108",1043108,97,125,5,227
"43109",1043109,58,91,12,161
"43110",1043110,7,7,0,14
"43111",1043111,109,145,11,265
"43112",1043112,38,15,3,56
"43113",1043113,54,191,19,264
"43114",1043114,153,136,11,300
"43115",1043115,12,142,0,154
"43116",1043116,179,0,0,179
"43117",1043117,136,18,8,162
"43118",1043118,139,45,5,189
"43119",1043119,98,87,0,185
"43120",1043120,93,107,9,209
"43121",1043121,95,157,9,261
"43122",1043122,154,62,10,226
"43123",1043123,122,31,2,155
"43124",1043124,119,176,12,307
"43125",1043125,136,85,14,235
"43126",1043126,53,195,16,264
"43127",1043127,166,39,6,211
"43128",1043128,72,184,4,260
"43129",1043129,89,141,8,238
"43130",1043130,130,139,6,275
"43131",1043131,26,180,22,228
"43132",1043132,134,110,24,268
"43133",1043133,48,193,7,248
"43134",1043134,134,34,6,174
"43135",1043135,144,106,10,260
"43136",1043136,124,10,6,140
"43137",1043137,201,81,14,296
"43138",1043138,161,28,9,198
"43139",1043139,154,57,7,218
"43140",1043140,187,86,7,280
"43141",1043141,27,170,7,204
"43142",1043142,88,94,12,194
"43143",1043143,90,134,6,230
"43144",1043144,95,181,6,282
"43145",1043145,224,23,8,255
"43146",1043146,0,0,0,0
"43147",1043147,114,89,15,218
"43148",1043148,142,183,11,336
"43149",1043149,86,183,13,282
"43150",1043150,34,27,2,63
"43151",1043151,8,4,1,13
"43152",1043152,74,173,5,252
"43153",1043153,86,64,7,157
"43154",1043154,61,21,0,82
"43155",1043155,31,116,10,157
"43156",1043156,48,160,4,212
"43157",1043157,116,79,8,203
"43158",1043158,140,110,13,263
"43159",1043159,106,14,9,129
"43160",1043160,17,109,3,129
"43161",1043161,54,184,5,243
"43162",1043162,139,29,7,175
"43163",1043163,51,226,9,286
"43164",1043164,37,31,1,69
"43165",1043165,84,130,7,221
"43166",1043166,29,11,1,41
"43167",1043167,13,250,3,266
"43168",1043168,41,75,10,126
"43169",1043169,66,241,6,313
"43170",1043170,133,134,9,276
"43171",1043171,118,47,2,167
"43172",1043172,111,112,20,243
"43173",1043173,82,60,2,144
"43174",1043174,86,123,11,220
"43175",1043175,124,71,15,210
"43176",1043176,18,0,0,18
"43177",1043177,67,199,12,278
"43178",1043178,20,291,1,312
"43179",1043179,132,148,10,290
"43180",1043180,62,189,9,260
"43181",1043181,28,234,15,277
"43182",1043182,57,238,5,300
"43183",1043183,69,111,7,187
"43184",1043184,176,111,10,297
"43185",1043185,92,221,6,319
"43186",1043186,140,46,4,190
"43187",1043187,139,162,6,307
"43188",1043188,113,141,5,259
"43189",1043189,180,72,8,260
"43190",1043190,145,54,5,204
"43191",1043191,112,14,8,134
"43192",1043192,182,19,6,207
"43193",1043193,130,120,11,261
"43194",1043194,142,91,17,250
"43195",1043195,111,5,0,116
"43196",1043196,105,125,17,247
"43197",1043197,102,82,6,190
"43198",1043198,187,52,7,246
"43199",1043199,34,314,2,350
"43200",1043200,99,170,9,278
"43201",1043201,11,5,3,19
"43202",1043202,121,24,12,157
"43203",1043203,154,132,23,309
"43204",1043204,61,217,7,285
"43205",1043205,142,42,4,188
"43206",1043206,115,140,7,262
"43207",1043207,79,175,3,257
"43208",1043208,107,72,7,186
"43209",1043209,51,19,0,70
"43210",1043210,128,99,2,229
"43211",1043211,177,91,9,277
"43212",1043212,29,52,2,83
"43213",1043213,119,148,11,278
"43214",1043214,104,139,15,258
"43215",1043215,1,6,0,7
"43216",1043216,43,3,0,46
"43217",1043217,23,206,2,231
"43218",1043218,32,276,14,322
"43219",1043219,62,206,3,271
"43220",1043220,94,76,22,192
"43221",1043221,164,41,0,205
"43222",1043222,70,246,3,319
"43223",1043223,81,176,5,262
"43224",1043224,160,26,5,191
"43225",1043225,50,138,7,195
"43226",1043226,56,123,4,183
"43227",1043227,96,55,5,156
"43228",1043228,21,172,0,193
"43229",1043229,29,182,17,228
"43230",1043230,168,66,4,238
"43231",1043231,14,150,3,167
"43232",1043232,114,92,3,209
"43233",1043233,25,228,5,258
"43234",1043234,89,180,8,277
"43235",1043235,129,150,15,294
"43236",1043236,96,143,5,244
"43237",1043237,3,8,1,12
"43238",1043238,202,100,7,309
"43239",1043239,170,120,16,306
"43240",1043240,114,13,7,134
"43241",1043241,120,127,4,251
"43242",1043242,167,20,6,193
"43243",1043243,6,11,1,18
"43244",1043244,253,62,11,326
"43245",1043245,82,168,7,257
"43246",1043246,63,41,11,115
"43247",1043247,90,56,3,149
"43248",1043248,53,91,9,153
"43249",1043249,255,0,0,255
"43250",1043250,0,6,2,8
"43251",1043251,129,115,6,250
"43252",1043252,15,257,2,274
"43253",1043253,94,50,1,145
"43254",1043254,63,209,3,275
"43255",1043255,59,137,7,203
"43256",1043256,80,13,4,97
"43257",1043257,198,50,13,261
"43258",1043258,40,176,3,219
"43259",1043259,243,36,9,288
"43260",1043260,50,235,10,295
"43261",1043261,71,151,6,228
"43262",1043262,118,41,9,168
"43263",1043263,135,81,5,221
"43264",1043264,104,20,4,128
"43265",1043265,185,73,14,272
"43266",1043266,153,60,4,217
"43267",1043267,61,251,1,313
"43268",1043268,128,175,3,306
"43269",1043269,61,168,6,235
"43270",1043270,212,33,5,250
"43271",1043271,117,175,6,298
"43272",1043272,152,142,12,306
"43273",1043273,200,38,6,244
"43274",1043274,69,157,6,232
"43275",1043275,115,42,17,174
"43276",1043276,249,24,9,282
"43277",1043277,131,100,10,241
"43278",1043278,151,58,19,228
"43279",1043279,82,13,6,101
"43280",1043280,147,68,11,226
"43281",1043281,156,40,7,203
"43282",1043282,169,67,11,247
"43283",1043283,160,117,4,281
"43284",1043284,64,44,2,110
"43285",1043285,35,149,3,187
"43286",1043286,73,142,4,219
"43287",1043287,93,81,5,179
"43288",1043288,163,84,22,269
"43289",1043289,39,208,16,263
"43290",1043290,58,185,12,255
"43291",1043291,26,248,2,276
"43292",1043292,214,30,5,249
"43293",1043293,56,27,2,85
"43294",1043294,116,200,9,325
"43295",1043295,58,155,9,222
"43296",1043296,96,121,8,225
"43297",1043297,41,231,5,277
"43298",1043298,148,109,9,266
"43299",1043299,63,36,3,102
"43300",1043300,130,342,6,478
"43301",1043301,159,53,22,234
"43302",1043302,120,102,4,226
"43303",1043303,108,69,6,183
"43304",1043304,77,127,14,218
"43305",1043305,130,72,4,206
"43306",1043306,77,136,7,220
"43307",1043307,100,179,5,284
"43308",1043308,161,136,8,305
"43309",1043309,150,51,8,209
"43310",1043310,88,117,10,215
"43311",1043311,41,242,6,289
"43312",1043312,144,39,9,192
"43313",1043313,238,69,12,319
"43314",1043314,133,47,3,183
"43315",1043315,61,83,3,147
"43316",1043316,139,6,2,147
"43317",1043317,12,4,0,16
"43318",1043318,122,132,2,256
"43319",1043319,114,53,9,176
"43320",1043320,106,35,1,142
"43321",1043321,79,108,5,192
"43322",1043322,92,150,9,251
"43323",1043323,70,129,20,219
"43324",1043324,188,66,9,263
"43325",1043325,167,61,10,238
"43326",1043326,77,269,5,351
"43327",1043327,144,95,7,246
"43328",1043328,53,132,2,187
"43329",1043329,59,149,9,217
"43330",1043330,37,40,2,79
"43331",1043331,231,24,8,263
"43332",1043332,110,95,19,224
"43333",1043333,199,11,4,214
"43334",1043334,85,238,8,331
"43335",1043335,221,35,13,269
"43336",1043336,102,187,4,293
"43337",1043337,63,200,5,268
"43338",1043338,9,7,1,17
"43339",1043339,24,101,2,127
"43340",1043340,150,24,4,178
"43341",1043341,127,167,15,309
"43342",1043342,95,172,8,275
"43343",1043343,89,58,5,152
"43344",1043344,58,130,11,199
"43345",1043345,211,28,12,251
"43346",1043346,91,39,6,136
"43347",1043347,44,151,15,210
"43348",1043348,121,40,5,166
"43349",1043349,112,165,9,286
"43350",1043350,119,112,4,235
"43351",1043351,199,52,7,258
"43352",1043352,132,57,7,196
"43353",1043353,195,31,6,232
"43354",1043354,170,102,20,292
"43355",1043355,209,59,16,284
"43356",1043356,130,115,14,259
"43357",1043357,80,76,10,166
"43358",1043358,162,51,8,221
"43359",1043359,67,98,6,171
"43360",1043360,157,65,7,229
"43361",1043361,119,57,10,186
"43362",1043362,93,112,2,207
"43363",1043363,126,57,11,194
"43364",1043364,122,114,5,241
"43365",1043365,23,20,1,44
"43366",1043366,158,9,4,171
"43367",1043367,151,145,4,300
"43368",1043368,155,104,8,267
"43369",1043369,209,79,12,300
"43370",1043370,24,14,6,44
"43371",1043371,68,82,13,163
"43372",1043372,178,35,8,221
"43373",1043373,132,118,8,258
"43374",1043374,141,78,3,222
"43375",1043375,175,21,10,206
"43376",1043376,44,186,0,230
"43377",1043377,144,52,4,200
"43378",1043378,75,127,11,213
"43379",1043379,150,56,8,214
"43380",1043380,85,223,6,314
"43381",1043381,126,38,7,171
"43382",1043382,184,107,21,312
"43383",1043383,202,54,9,265
"43384",1043384,103,122,11,236
"43385",1043385,123,29,5,157
"43386",1043386,162,90,12,264
"43387",1043387,50,122,10,182
"43388",1043388,64,6,6,76
"43389",1043389,40,205,3,248
"43390",1043390,247,20,8,275
"43391",1043391,104,149,4,257
"43392",1043392,136,17,1,154
"43393",1043393,52,245,19,316
"43394",1043394,104,10,6,120
"43395",1043395,34,7,3,44
"43396",1043396,197,32,5,234
"43397",1043397,222,31,8,261
"43398",1043398,35,123,9,167
"43399",1043399,86,164,9,259
"43400",1043400,125,173,6,304
"43401",1043401,67,220,3,290
"43402",1043402,120,169,17,306
"43403",1043403,158,112,3,273
"43404",1043404,182,35,5,222
"43405",1043405,104,128,14,246
"43406",1043406,109,70,14,193
"43407",1043407,25,14,3,42
"43408",1043408,175,39,6,220
"43409",1043409,11,27,0,38
"43410",1043410,19,219,1,239
"43411",1043411,210,81,12,303
"43412",1043412,35,235,4,274
"43413",1043413,89,159,7,255
"43414",1043414,98,43,11,152
"43415",1043415,75,12,2,89
"43416",1043416,50,100,5,155
"43417",1043417,128,173,14,315
"43418",1043418,81,104,13,198
"43419",1043419,187,52,9,248
"43420",1043420,179,33,11,223
"43421",1043421,119,56,3,178
"43422",1043422,211,64,10,285
"43423",1043423,147,129,5,281
"43424",1043424,181,96,15,292
"43425",1043425,118,196,9,323
"43426",1043426,204,70,11,285
"43427",1043427,119,197,12,328
"43428",1043428,182,30,6,218
"43429",1043429,185,33,14,232
"43430",1043430,49,228,1,278
"43431",1043431,266,24,6,296
"43432",1043432,194,69,10,273
"43433",1043433,173,115,23,311
"43434",1043434,9,15,1,25
"43435",1043435,107,70,9,186
"43436",1043436,89,74,6,169
"43437",1043437,209,61,7,277
"43438",1043438,92,8,2,102
"43439",1043439,191,80,11,282
"43440",1043440,231,28,7,266
"43441",1043441,47,71,10,128
"43442",1043442,104,167,5,276
"43443",1043443,184,94,11,289
"43444",1043444,63,44,3,110
"43445",1043445,145,99,11,255
"43446",1043446,15,107,1,123
"43447",1043447,26,52,1,79
"43448",1043448,119,142,26,287
"43449",1043449,126,122,14,262
"43450",1043450,157,122,5,284
"43451",1043451,130,137,3,270
"43452",1043452,115,96,8,219
"43453",1043453,116,129,2,247
"43454",1043454,63,228,1,292
"43455",1043455,104,216,13,333
"43456",1043456,7,13,1,21
"43457",1043457,70,19,3,92
"43458",1043458,169,41,4,214
"43459",1043459,94,122,18,234
"43460",1043460,238,13,12,263
"43461",1043461,53,108,13,174
"43462",1043462,60,188,2,250
"43463",1043463,80,149,8,237
"43464",1043464,15,9,0,24
"43465",1043465,2,0,2,4
"43466",1043466,123,86,9,218
"43467",1043467,101,175,2,278
"43468",1043468,69,144,12,225
"43469",1043469,145,74,15,234
"43470",1043470,92,207,1,300
"43471",1043471,39,271,2,312
"43472",1043472,165,97,5,267
"43473",1043473,128,59,6,193
"43474",1043474,107,77,8,192
"43475",1043475,167,130,19,316
"43476",1043476,97,67,10,174
"43477",1043477,77,145,6,228
"43478",1043478,43,17,6,66
"43479",1043479,97,65,5,167
"43480",1043480,133,122,13,268
"43481",1043481,129,87,7,223
"43482",1043482,71,129,8,208
"43483",1043483,164,111,12,287
"43484",1043484,60,154,11,225
"43485",1043485,180,36,6,222
"43486",1043486,112,52,4,168
"43487",1043487,114,151,19,284
"43488",1043488,118,161,11,290
"43489",1043489,111,114,15,240
"43490",1043490,118,54,4,176
"43491",1043491,45,195,4,244
"43492",1043492,138,33,3,174
"43493",1043493,142,116,8,266
"43494",1043494,45,234,2,281
"43495",1043495,14,28,3,45
"43496",1043496,5,42,2,49
"43497",1043497,145,53,15,213
"43498",1043498,40,165,1,206
"43499",1043499,13,1,1,15
"43500",1043500,51,232,10,293
"43501",1043501,58,183,3,244
"43502",1043502,211,25,7,243
"43503",1043503,110,106,7,223
"43504",1043504,40,42,8,90
"43505",1043505,123,14,4,141
"43506",1043506,76,225,3,304
"43507",1043507,45,234,7,286
"43508",1043508,68,187,12,267
"43509",1043509,75,193,18,286
"43510",1043510,69,223,3,295
"43511",1043511,32,210,7,249
"43512",1043512,185,52,12,249
"43513",1043513,210,17,8,235
"43514",1043514,63,199,10,272
"43515",1043515,98,198,24,320
"43516",1043516,104,68,5,177
"43517",1043517,58,110,19,187
"43518",1043518,165,45,6,216
"43519",1043519,105,182,10,297
"43520",1043520,29,143,4,176
"43521",1043521,246,15,9,270
"43522",1043522,169,135,17,321
"43523",1043523,65,68,2,135
"43524",1043524,150,82,1,233
"43525",1043525,119,141,7,267
"43526",1043526,101,48,7,156
"43527",1043527,66,181,8,255
"43528",1043528,126,129,12,267
"43529",1043529,94,160,10,264
"43530",1043530,190,34,9,233
"43531",1043531,179,124,16,319
"43532",1043532,162,75,20,257
"43533",1043533,145,29,8,182
"43534",1043534,33,165,5,203
"43535",1043535,94,124,6,224
"43536",1043536,12,23,0,35
"43537",1043537,153,24,4,181
"43538",1043538,126,67,8,201
"43539",1043539,74,183,3,260
"43540",1043540,182,93,8,283
"43541",1043541,40,216,13,269
"43542",1043542,131,49,2,182
"43543",1043543,100,173,14,287
"43544",1043544,142,64,4,210
"43545",1043545,113,45,12,170
"43546",1043546,128,131,8,267
"43547",1043547,159,95,21,275
"43548",1043548,151,63,9,223
"43549",1043549,173,44,6,223
"43550",1043550,190,43,7,240
"43551",1043551,14,197,4,215
"43552",1043552,82,174,3,259
"43553",1043553,211,43,8,262
"43554",1043554,139,120,6,265
"43555",1043555,58,6,2,66
"43556",1043556,118,96,16,230
"43557",1043557,120,116,9,245
"43558",1043558,85,71,8,164
"43559",1043559,17,0,1,18
"43560",1043560,76,131,2,209
"43561",1043561,139,98,1,238
"43562",1043562,81,203,8,292
"43563",1043563,162,68,19,249
"43564",1043564,170,29,3,202
"43565",1043565,97,97,1,195
"43566",1043566,213,13,11,237
"43567",1043567,187,71,8,266
"43568",1043568,48,145,5,198
"43569",1043569,116,120,4,240
"43570",1043570,90,177,12,279
"43571",1043571,48,56,1,105
"43572",1043572,134,78,9,221
"43573",1043573,53,160,4,217
"43574",1043574,85,122,8,215
"43575",1043575,66,171,9,246
"43576",1043576,118,32,6,156
"43577",1043577,41,171,7,219
"43578",1043578,182,40,3,225
"43579",1043579,162,41,11,214
"43580",1043580,69,236,2,307
"43581",1043581,59,93,3,155
"43582",1043582,133,160,8,301
"43583",1043583,200,24,3,227
"43584",1043584,182,112,12,306
"43585",1043585,81,20,1,102
"43586",1043586,51,87,1,139
"43587",1043587,159,132,5,296
"43588",1043588,100,190,19,309
"43589",1043589,184,50,7,241
"43590",1043590,167,93,19,279
"43591",1043591,85,17,7,109
"43592",1043592,39,268,8,315
"43593",1043593,68,163,2,233
"43594",1043594,38,249,11,298
"43595",1043595,37,31,1,69
"43596",1043596,217,40,6,263
"43597",1043597,183,102,13,298
"43598",1043598,142,59,12,213
"43599",1043599,69,141,14,224
"43600",1043600,35,95,0,130
"43601",1043601,164,50,5,219
"43602",1043602,199,118,13,330
"43603",1043603,32,12,0,44
"43604",1043604,65,225,6,296
"43605",1043605,54,151,9,214
"43606",1043606,73,106,11,190
"43607",1043607,78,156,24,258
"43608",1043608,96,78,3,177
"43609",1043609,141,62,6,209
"43610",1043610,21,218,10,249
"43611",1043611,176,28,8,212
"43612",1043612,41,11,2,54
"43613",1043613,193,88,12,293
"43614",1043614,145,137,8,290
"43615",1043615,155,191,23,369
"43616",1043616,54,95,8,157
"43617",1043617,238,18,11,267
"43618",1043618,24,97,2,123
"43619",1043619,39,191,5,235
"43620",1043620,6,3,0,9
"43621",1043621,36,24,3,63
"43622",1043622,33,80,4,117
"43623",1043623,55,152,2,209
"43624",1043624,189,49,18,256
"43625",1043625,39,153,14,206
"43626",1043626,83,170,4,257
"43627",1043627,126,104,12,242
"43628",1043628,215,35,9,259
"43629",1043629,75,64,12,151
"43630",1043630,130,17,4,151
"43631",1043631,218,51,2,271
"43632",1043632,102,219,3,324
"43633",1043633,37,293,3,333
"43634",1043634,244,28,3,275
"43635",1043635,97,187,3,287
"43636",1043636,181,69,11,261
"43637",1043637,19,72,2,93
"43638",1043638,139,80,3,222
"43639",1043639,166,70,13,249
"43640",1043640,112,200,15,327
"43641",1043641,90,203,24,317
"43642",1043642,13,2,0,15
"43643",1043643,91,52,3,146
"43644",1043644,241,42,9,292
"43645",1043645,188,47,2,237
"43646",1043646,112,199,3,314
"43647",1043647,2,11,0,13
"43648",1043648,72,176,18,266
"43649",1043649,99,134,3,236
"43650",1043650,21,50,1,72
"43651",1043651,54,131,3,188
"43652",1043652,81,34,4,119
"43653",1043653,113,155,24,292
"43654",1043654,163,77,6,246
"43655",1043655,231,8,8,247
"43656",1043656,232,26,6,264
"43657",1043657,218,79,10,307
"43658",1043658,3,7,1,11
"43659",1043659,49,72,6,127
"43660",1043660,6,60,0,66
"43661",1043661,190,33,9,232
"43662",1043662,141,11,1,153
"43663",1043663,48,190,3,241
"43664",1043664,43,187,4,234
"43665",1043665,51,212,13,276
"43666",1043666,23,54,4,81
"43667",1043667,90,154,9,253
"43668",1043668,90,127,9,226
"43669",1043669,53,77,7,137
"43670",1043670,13,29,2,44
"43671",1043671,19,11,6,36
"43672",1043672,119,169,10,298
"43673",1043673,170,53,12,235
"43674",1043674,154,88,25,267
"43675",1043675,152,187,5,344
"43676",1043676,27,171,17,215
"43677",1043677,49,194,4,247
"43678",1043678,49,262,4,315
"43679",1043679,75,70,12,157
"43680",1043680,125,69,3,197
"43681",1043681,94,164,14,272
"43682",1043682,94,180,8,282
"43683",1043683,81,143,6,230
"43684",1043684,116,27,3,146
"43685",1043685,36,117,6,159
"43686",1043686,29,1,1,31
"43687",1043687,46,184,6,236
"43688",1043688,2,1,0,3
"43689",1043689,171,40,8,219
"43690",1043690,107,65,14,186
"43691",1043691,162,114,16,292
"43692",1043692,194,64,15,273
"43693",1043693,35,174,5,214
"43694",1043694,33,242,8,283
"43695",1043695,125,0,0,125
"43696",1043696,126,132,27,285
"43697",1043697,146,70,4,220
"43698",1043698,125,56,8,189
"43699",1043699,59,243,27,329
"43700",1043700,79,185,7,271
"43701",1043701,84,145,5,234
"43702",1043702,35,222,8,265
"43703",1043703,37,167,5,209
"43704",1043704,80,40,5,125
"43705",1043705,58,184,14,256
"43706",1043706,179,52,7,238
"43707",1043707,131,43,23,197
"43708",1043708,188,111,11,310
"43709",1043709,79,170,21,270
"43710",1043710,171,83,26,280
"43711",1043711,133,4,6,143
"43712",1043712,78,191,10,279
"43713",1043713,91,141,6,238
"43714",1043714,52,156,8,216
"43715",1043715,98,157,32,287
"43716",1043716,134,122,21,277
"43717",1043717,21,44,4,69
"43718",1043718,74,122,13,209
"43719",1043719,187,22,4,213
"43720",1043720,110,156,3,269
"43721",1043721,138,90,17,245
"43722",1043722,209,55,13,277
"43723",1043723,35,72,3,110
"43724",1043724,17,188,4,209
"43725",1043725,255,46,12,313
"43726",1043726,132,129,20,281
"43727",1043727,57,211,10,278
"43728",1043728,61,20,3,84
"43729",1043729,59,138,4,201
"43730",1043730,80,111,9,200
"43731",1043731,155,35,4,194
"43732",1043732,105,76,19,200
"43733",1043733,144,39,11,194
"43734",1043734,226,16,10,252
"43735",1043735,106,107,7,220
"43736",1043736,114,66,5,185
"43737",1043737,162,131,19,312
"43738",1043738,71,185,5,261
"43739",1043739,135,153,13,301
"43740",1043740,99,68,9,176
"43741",1043741,49,69,11,129
"43742",1043742,74,220,3,297
"43743",1043743,66,8,2,76
"43744",1043744,130,39,5,174
"43745",1043745,249,33,8,290
"43746",1043746,44,205,5,254
"43747",1043747,234,37,7,278
"43748",1043748,128,20,4,152
"43749",1043749,178,33,6,217
"43750",1043750,77,151,6,234
"43751",1043751,46,278,2,326
"43752",1043752,91,105,11,207
"43753",1043753,69,60,7,136
"43754",1043754,87,142,21,250
"43755",1043755,43,167,8,218
"43756",1043756,104,98,7,209
"43757",1043757,66,161,13,240
"43758",1043758,192,76,4,272
"43759",1043759,92,60,9,161
"43760",1043760,138,134,9,281
"43761",1043761,299,19,2,320
"43762",1043762,108,173,14,295
"43763",1043763,32,287,1,320
"43764",1043764,17,129,6,152
"43765",1043765,196,87,10,293
"43766",1043766,170,113,22,305
"43767",1043767,110,93,8,211
"43768",1043768,144,32,12,188
"43769",1043769,158,64,3,225
"43770",1043770,131,422,18,571
"43771",1043771,64,133,1,198
"43772",1043772,137,69,5,211
"43773",1043773,109,165,4,278
"43774",1043774,20,276,1,297
"43775",1043775,23,129,4,156
"43776",1043776,94,125,7,226
"43777",1043777,161,124,15,300
"43778",1043778,122,164,14,300
"43779",1043779,164,45,8,217
"43780",1043780,25,194,1,220
"43781",1043781,26,63,3,92
"43782",1043782,220,63,8,291
"43783",1043783,36,143,5,184
"43784",1043784,11,210,2,223
"43785",1043785,112,169,5,286
"43786",1043786,104,87,9,200
"43787",1043787,112,44,1,157
"43788",1043788,193,68,8,269
"43789",1043789,113,77,12,202
"43790",1043790,68,156,20,244
"43791",1043791,38,23,2,63
"43792",1043792,5,16,0,21
"43793",1043793,99,34,7,140
"43794",1043794,143,82,13,238
"43795",1043795,188,141,12,341
"43796",1043796,48,111,9,168
"43797",1043797,44,267,2,313
"43798",1043798,23,134,1,158
"43799",1043799,41,113,5,159
"43800",1043800,196,16,7,219
"43801",1043801,166,142,23,331
"43802",1043802,89,98,6,193
"43803",1043803,64,140,17,221
"43804",1043804,159,60,3,222
"43805",1043805,61,53,7,121
"43806",1043806,172,54,6,232
"43807",1043807,24,236,13,273
"43808",1043808,193,89,9,291
"43809",1043809,107,133,13,253
"43810",1043810,169,26,7,202
"43811",1043811,141,41,8,190
"43812",1043812,111,127,20,258
"43813",1043813,163,144,12,319
"43814",1043814,173,85,6,264
"43815",1043815,214,41,18,273
"43816",1043816,96,58,16,170
"43817",1043817,208,17,4,229
"43818",1043818,189,103,21,313
"43819",1043819,138,140,16,294
"43820",1043820,159,86,8,253
"43821",1043821,8,162,3,173
"43822",1043822,124,219,9,352
"43823",1043823,194,37,12,243
"43824",1043824,118,83,13,214
"43825",1043825,110,105,4,219
"43826",1043826,173,27,9,209
"43827",1043827,258,29,14,301
"43828",1043828,108,162,4,274
"43829",1043829,48,15,7,70
"43830",1043830,141,29,5,175
"43831",1043831,104,70,9,183
"43832",1043832,130,122,8,260
"43833",1043833,181,71,8,260
"43834",1043834,137,92,16,245
"43835",1043835,261,6,1,268
"43836",1043836,118,36,6,160
"43837",1043837,272,132,10,414
"43838",1043838,146,74,6,226
"43839",1043839,199,50,10,259
"43840",1043840,68,241,1,310
"43841",1043841,203,73,6,282
"43842",1043842,75,206,10,291
"43843",1043843,129,37,5,171
"43844",1043844,75,16,6,97
"43845",1043845,54,73,8,135
"43846",1043846,81,95,14,190
"43847",1043847,64,195,4,263
"43848",1043848,102,35,13,150
"43849",1043849,108,122,10,240
"43850",1043850,72,114,5,191
"43851",1043851,176,74,8,258
"43852",1043852,79,44,10,133
"43853",1043853,40,173,10,223
"43854",1043854,30,22,0,52
"43855",1043855,161,62,6,229
"43856",1043856,124,20,6,150
"43857",1043857,39,130,4,173
"43858",1043858,39,148,2,189
"43859",1043859,105,34,1,140
"43860",1043860,165,143,22,330
"43861",1043861,129,45,4,178
"43862",1043862,9,5,0,14
"43863",1043863,56,157,5,218
"43864",1043864,139,95,2,236
"43865",1043865,177,42,7,226
"43866",1043866,130,99,14,243
"43867",1043867,158,146,11,315
"43868",1043868,105,173,7,285
"43869",1043869,98,40,7,145
"43870",1043870,74,137,1,212
"43871",1043871,114,70,7,191
"43872",1043872,141,130,5,276
"43873",1043873,150,109,6,265
"43874",1043874,182,26,7,215
"43875",1043875,191,12,6,209
"43876",1043876,158,42,10,210
"43877",1043877,82,159,14,255
"43878",1043878,165,16,6,187
"43879",1043879,185,86,13,284
"43880",1043880,140,131,11,282
"43881",1043881,140,71,4,215
"43882",1043882,140,3,8,151
"43883",1043883,120,90,12,222
"43884",1043884,45,70,8,123
"43885",1043885,47,197,10,254
"43886",1043886,187,26,7,220
"43887",1043887,124,101,0,225
"43888",1043888,155,106,4,265
"43889",1043889,129,108,14,251
"43890",1043890,104,40,11,155
"43891",1043891,28,102,5,135
"43892",1043892,88,131,7,226
"43893",1043893,167,143,22,332
"43894",1043894,30,261,5,296
"43895",1043895,177,73,7,257
"43896",1043896,47,35,6,88
"43897",1043897,22,18,2,42
"43898",1043898,193,56,5,254
"43899",1043899,131,39,3,173
"43900",1043900,164,68,9,241
"43901",1043901,155,46,7,208
"43902",1043902,126,32,5,163
"43903",1043903,80,163,8,251
"43904",1043904,55,60,1,116
"43905",1043905,126,144,7,277
"43906",1043906,81,123,6,210
"43907",1043907,66,188,8,262
"43908",1043908,64,213,1,278
"43909",1043909,159,18,12,189
"43910",1043910,128,19,8,155
"43911",1043911,195,62,10,267
"43912",1043912,135,175,9,319
"43913",1043913,139,90,3,232
"43914",1043914,158,132,16,306
"43915",1043915,112,91,20,223
"43916",1043916,130,63,8,201
"43917",1043917,96,184,12,292
"43918",1043918,56,255,4,315
"43919",1043919,129,47,0,176
"43920",1043920,120,120,9,249
"43921",1043921,128,14,2,144
"43922",1043922,124,65,10,199
"43923",1043923,93,118,10,221
"43924",1043924,67,244,1,312
"43925",1043925,126,34,8,168
"43926",1043926,102,206,8,316
"43927",1043927,243,61,6,310
"43928",1043928,226,11,4,241
"43929",1043929,105,85,4,194
"43930",1043930,77,170,5,252
"43931",1043931,106,105,34,245
"43932",1043932,180,25,8,213
"43933",1043933,143,118,9,270
"43934",1043934,218,40,1,259
"43935",1043935,81,189,10,280
"43936",1043936,149,138,10,297
"43937",1043937,68,142,7,217
"43938",1043938,8,39,2,49
"43939",1043939,104,16,8,128
"43940",1043940,64,140,12,216
"43941",1043941,99,17,3,119
"43942",1043942,75,110,3,188
"43943",1043943,75,201,4,280
"43944",1043944,85,147,11,243
"43945",1043945,96,114,5,215
"43946",1043946,113,105,7,225
"43947",1043947,145,39,11,195
"43948",1043948,103,82,11,196
"43949",1043949,67,17,6,90
"43950",1043950,195,44,6,245
"43951",1043951,126,46,7,179
"43952",1043952,13,111,0,124
"43953",1043953,99,198,5,302
"43954",1043954,25,251,5,281
"43955",1043955,71,188,12,271
"43956",1043956,40,221,3,264
"43957",1043957,166,17,2,185
"43958",1043958,104,140,16,260
"43959",1043959,155,55,6,216
"43960",1043960,224,67,5,296
"43961",1043961,30,271,1,302
"43962",1043962,186,108,12,306
"43963",1043963,206,54,7,267
"43964",1043964,136,101,3,240
"43965",1043965,46,219,2,267
"43966",1043966,190,83,2,275
"43967",1043967,104,170,5,279
"43968",1043968,109,65,3,177
"43969",1043969,73,163,9,245
"43970",1043970,203,87,12,302
"43971",1043971,184,92,22,298
"43972",1043972,127,152,36,315
"43973",1043973,182,62,7,251
"43974",1043974,122,173,5,300
"43975",1043975,125,94,17,236
"43976",1043976,77,182,20,279
"43977",1043977,28,266,9,303
"43978",1043978,28,247,3,278
"43979",1043979,42,99,5,146
"43980",1043980,90,79,3,172
"43981",1043981,11,17,0,28
"43982",1043982,163,96,2,261
"43983",1043983,136,118,7,261
"43984",1043984,167,67,3,237
"43985",1043985,74,46,5,125
"43986",1043986,196,62,7,265
"43987",1043987,42,152,2,196
"43988",1043988,33,242,3,278
"43989",1043989,58,131,3,192
"43990",1043990,71,182,12,265
"43991",1043991,65,188,14,267
"43992",1043992,18,9,1,28
"43993",1043993,1,8,0,9
"43994",1043994,107,181,3,291
"43995",1043995,201,43,5,249
"43996",1043996,181,23,3,207
"43997",1043997,125,66,8,199
"43998",1043998,180,85,2,267
"43999",1043999,150,89,1,240
"44000",1044000,61,58,5,124
"44001",1044001,84,101,11,196
"44002",1044002,103,182,6,291
"44003",1044003,200,74,10,284
"44004",1044004,86,161,7,254
"44005",1044005,118,26,5,149
"44006",1044006,138,95,9,242
"44007",1044007,207,40,4,251
"44008",1044008,110,134,10,254
"44009",1044009,88,164,15,267
"44010",1044010,201,20,0,221
"44011",1044011,119,172,12,303
"44012",1044012,114,13,4,131
"44013",1044013,46,221,8,275
"44014",1044014,208,53,14,275
"44015",1044015,78,181,6,265
"44016",1044016,58,16,3,77
"44017",1044017,184,95,4,283
"44018",1044018,102,83,17,202
"44019",1044019,325,85,17,427
"44020",1044020,118,36,2,156
"44021",1044021,192,80,20,292
"44022",1044022,186,52,9,247
"44023",1044023,74,182,5,261
"44024",1044024,96,123,6,225
"44025",1044025,63,39,3,105
"44026",1044026,130,58,10,198
"44027",1044027,20,293,7,320
"44028",1044028,120,98,6,224
"44029",1044029,228,16,7,251
"44030",1044030,7,4,0,11
"44031",1044031,173,21,3,197
"44032",1044032,22,244,9,275
"44033",1044033,161,20,1,182
"44034",1044034,195,89,7,291
"44035",1044035,106,161,10,277
"44036",1044036,171,67,13,251
"44037",1044037,181,49,9,239
"44038",1044038,139,129,8,276
"44039",1044039,47,188,3,238
"44040",1044040,164,73,3,240
"44041",1044041,61,208,4,273
"44042",1044042,20,228,12,260
"44043",1044043,26,88,6,120
"44044",1044044,115,127,10,252
"44045",1044045,2,13,0,15
"44046",1044046,149,73,11,233
"44047",1044047,146,65,9,220
"44048",1044048,26,182,2,210
"44049",1044049,51,192,7,250
"44050",1044050,84,82,5,171
"44051",1044051,66,110,2,178
"44052",1044052,117,92,5,214
"44053",1044053,54,257,10,321
"44054",1044054,54,184,19,257
"44055",1044055,20,13,2,35
"44056",1044056,84,234,6,324
"44057",1044057,214,48,16,278
"44058",1044058,97,25,4,126
"44059",1044059,52,203,1,256
"44060",1044060,129,106,5,240
"44061",1044061,19,178,3,200
"44062",1044062,55,207,8,270
"44063",1044063,179,74,5,258
"44064",1044064,45,204,7,256
"44065",1044065,140,85,10,235
"44066",1044066,115,95,15,225
"44067",1044067,48,4,0,52
"44068",1044068,105,237,5,347
"44069",1044069,53,2,3,58
"44070",1044070,2,10,0,12
"44071",1044071,70,208,13,291
"44072",1044072,181,91,10,282
"44073",1044073,115,177,8,300
"44074",1044074,77,207,7,291
"44075",1044075,102,66,2,170
"44076",1044076,236,10,9,255
"44077",1044077,95,117,8,220
"44078",1044078,161,100,6,267
"44079",1044079,150,12,2,164
"44080",1044080,46,134,0,180
"44081",1044081,4,56,2,62
"44082",1044082,67,100,17,184
"44083",1044083,71,169,12,252
"44084",1044084,75,243,8,326
"44085",1044085,87,174,5,266
"44086",1044086,212,42,10,264
"44087",1044087,43,247,1,291
"44088",1044088,145,18,5,168
"44089",1044089,39,221,3,263
"44090",1044090,197,19,7,223
"44091",1044091,87,148,4,239
"44092",1044092,91,113,7,211
"44093",1044093,33,217,3,253
"44094",1044094,187,52,10,249
"44095",1044095,216,26,6,248
"44096",1044096,98,103,8,209
"44097",1044097,139,46,11,196
"44098",1044098,108,80,10,198
"44099",1044099,48,241,3,292
"44100",1044100,23,214,9,246
"44101",1044101,53,105,6,164
"44102",1044102,227,14,0,241
"44103",1044103,151,116,13,280
"44104",1044104,22,310,4,336
"44105",1044105,181,39,6,226
"44106",1044106,68,146,24,238
"44107",1044107,128,97,25,250
"44108",1044108,10,1,0,11
"44109",1044109,59,233,12,304
"44110",1044110,136,109,13,258
"44111",1044111,76,136,20,232
"44112",1044112,71,107,11,189
"44113",1044113,130,79,9,218
"44114",1044114,77,125,14,216
"44115",1044115,99,82,6,187
"44116",1044116,6,32,0,38
"44117",1044117,201,74,7,282
"44118",1044118,75,83,8,166
"44119",1044119,114,143,5,262
"44120",1044120,127,78,12,217
"44121",1044121,45,139,8,192
"44122",1044122,101,21,11,133
"44123",1044123,150,77,7,234
"44124",1044124,179,85,14,278
"44125",1044125,64,160,6,230
"44126",1044126,115,170,7,292
"44127",1044127,79,206,13,298
"44128",1044128,67,203,10,280
"44129",1044129,68,261,11,340
"44130",1044130,210,29,11,250
"44131",1044131,166,105,18,289
"44132",1044132,126,121,10,257
"44133",1044133,140,50,5,195
"44134",1044134,90,103,3,196
"44135",1044135,132,96,7,235
"44136",1044136,32,224,6,262
"44137",1044137,81,59,5,145
"44138",1044138,185,109,20,314
"44139",1044139,30,201,9,240
"44140",1044140,97,126,5,228
"44141",1044141,141,15,6,162
"44142",1044142,59,192,18,269
"44143",1044143,164,77,11,252
"44144",1044144,185,67,7,259
"44145",1044145,63,28,0,91
"44146",1044146,194,22,6,222
"44147",1044147,3,10,0,13
"44148",1044148,146,118,10,274
"44149",1044149,31,126,5,162
"44150",1044150,72,156,13,241
"44151",1044151,87,177,18,282
"44152",1044152,16,268,1,285
"44153",1044153,40,2,1,43
"44154",1044154,240,12,11,263
"44155",1044155,39,84,3,126
"44156",1044156,86,55,7,148
"44157",1044157,159,28,8,195
"44158",1044158,145,112,10,267
"44159",1044159,137,78,5,220
"44160",1044160,141,76,4,221
"44161",1044161,120,61,4,185
"44162",1044162,169,145,18,332
"44163",1044163,81,256,9,346
"44164",1044164,104,128,5,237
"44165",1044165,87,47,4,138
"44166",1044166,144,85,4,233
"44167",1044167,45,260,7,312
"44168",1044168,31,145,0,176
"44169",1044169,22,137,2,161
"44170",1044170,126,111,10,247
"44171",1044171,60,238,10,308
"44172",1044172,61,24,1,86
"44173",1044173,142,77,0,219
"44174",1044174,91,121,10,222
"44175",1044175,171,64,3,238
"44176",1044176,125,35,14,174
"44177",1044177,65,52,5,122
"44178",1044178,123,99,14,236
"44179",1044179,165,51,5,221
"44180",1044180,4,18,0,22
"44181",1044181,12,225,9,246
"44182",1044182,43,86,3,132
"44183",1044183,96,248,4,348
"44184",1044184,41,159,3,203
"44185",1044185,316,18,13,347
"44186",1044186,202,75,11,288
"44187",1044187,125,51,8,184
"44188",1044188,91,111,13,215
"44189",1044189,205,67,15,287
"44190",1044190,75,36,11,122
"44191",1044191,58,162,5,225
"44192",1044192,60,169,8,237
"44193",1044193,42,243,19,304
"44194",1044194,59,95,5,159
"44195",1044195,75,194,16,285
"44196",1044196,90,74,8,172
"44197",1044197,139,80,5,224
"44198",1044198,106,96,20,222
"44199",1044199,97,133,13,243
"44200",1044200,24,56,1,81
"44201",1044201,100,187,13,300
"44202",1044202,153,115,4,272
"44203",1044203,99,91,14,204
"44204",1044204,22,10,2,34
"44205",1044205,167,77,9,253
"44206",1044206,204,82,8,294
"44207",1044207,121,93,6,220
"44208",1044208,7,4,2,13
"44209",1044209,55,140,12,207
"44210",1044210,186,0,4,190
"44211",1044211,205,74,15,294
"44212",1044212,153,102,16,271
"44213",1044213,105,125,10,240
"44214",1044214,164,12,2,178
"44215",1044215,169,53,7,229
"44216",1044216,64,113,4,181
"44217",1044217,31,102,8,141
"44218",1044218,75,125,5,205
"44219",1044219,138,22,7,167
"44220",1044220,126,194,15,335
"44221",1044221,48,73,1,122
"44222",1044222,21,9,2,32
"44223",1044223,54,240,7,301
"44224",1044224,17,31,2,50
"44225",1044225,32,9,1,42
"44226",1044226,73,145,6,224
"44227",1044227,180,60,10,250
"44228",1044228,146,70,8,224
"44229",1044229,29,204,3,236
"44230",1044230,169,37,9,215
"44231",1044231,97,49,3,149
"44232",1044232,118,126,12,256
"44233",1044233,230,54,8,292
"44234",1044234,170,42,6,218
"44235",1044235,60,197,5,262
"44236",1044236,190,116,12,318
"44237",1044237,76,154,13,243
"44238",1044238,94,78,6,178
"44239",1044239,188,106,12,306
"44240",1044240,205,85,10,300
"44241",1044241,10,4,0,14
"44242",1044242,202,12,5,219
"44243",1044243,146,47,6,199
"44244",1044244,157,142,13,312
"44245",1044245,172,76,14,262
"44246",1044246,86,119,23,228
"44247",1044247,119,56,3,178
"44248",1044248,165,12,5,182
"44249",1044249,91,72,5,168
"44250",1044250,39,278,9,326
"44251",1044251,142,63,19,224
"44252",1044252,20,87,2,109
"44253",1044253,195,31,8,234
"44254",1044254,85,196,12,293
"44255",1044255,75,187,18,280
"44256",1044256,147,104,13,264
"44257",1044257,174,31,9,214
"44258",1044258,107,20,4,131
"44259",1044259,201,43,7,251
"44260",1044260,94,131,11,236
"44261",1044261,8,2,0,10
"44262",1044262,133,1,0,134
"44263",1044263,2,13,0,15
"44264",1044264,161,79,7,247
"44265",1044265,104,165,13,282
"44266",1044266,184,22,7,213
"44267",1044267,134,60,11,205
"44268",1044268,81,21,3,105
"44269",1044269,109,52,0,161
"44270",1044270,83,101,6,190
"44271",1044271,134,17,2,153
"44272",1044272,127,96,17,240
"44273",1044273,109,36,1,146
"44274",1044274,96,198,11,305
"44275",1044275,37,278,9,324
"44276",1044276,47,147,5,199
"44277",1044277,207,19,3,229
"44278",1044278,96,48,10,154
"44279",1044279,81,173,3,257
"44280",1044280,180,95,4,279
"44281",1044281,42,223,5,270
"44282",1044282,34,171,4,209
"44283",1044283,119,128,8,255
"44284",1044284,14,104,5,123
"44285",1044285,50,12,2,64
"44286",1044286,175,68,8,251
"44287",1044287,18,81,3,102
"44288",1044288,182,58,16,256
"44289",1044289,120,71,2,193
"44290",1044290,103,20,3,126
"44291",1044291,147,87,9,243
"44292",1044292,147,41,7,195
"44293",1044293,62,185,7,254
"44294",1044294,122,254,6,382
"44295",1044295,49,119,8,176
"44296",1044296,207,10,3,220
"44297",1044297,121,73,11,205
"44298",1044298,149,71,4,224
"44299",1044299,103,158,8,269
"44300",1044300,76,167,3,246
"44301",1044301,104,75,12,191
"44302",1044302,177,91,8,276
"44303",1044303,91,211,11,313
"44304",1044304,81,189,14,284
"44305",1044305,108,162,3,273
"44306",1044306,136,72,5,213
"44307",1044307,189,43,3,235
"44308",1044308,166,36,12,214
"44309",1044309,52,13,0,65
"44310",1044310,126,16,6,148
"44311",1044311,93,119,9,221
"44312",1044312,108,74,13,195
"44313",1044313,187,86,11,284
"44314",1044314,64,20,5,89
"44315",1044315,74,179,1,254
"44316",1044316,142,81,10,233
"44317",1044317,85,178,12,275
"44318",1044318,151,83,8,242
"44319",1044319,179,56,7,242
"44320",1044320,60,29,0,89
"44321",1044321,210,24,6,240
"44322",1044322,52,25,1,78
"44323",1044323,123,124,17,264
"44324",1044324,214,50,8,272
"44325",1044325,170,83,6,259
"44326",1044326,85,80,4,169
"44327",1044327,129,34,4,167
"44328",1044328,95,146,54,295
"44329",1044329,102,83,8,193
"44330",1044330,68,42,11,121
"44331",1044331,67,209,10,286
"44332",1044332,84,42,3,129
"44333",1044333,44,5,2,51
"44334",1044334,117,78,7,202
"44335",1044335,57,162,7,226
"44336",1044336,58,11,2,71
"44337",1044337,208,33,5,246
"44338",1044338,129,288,17,434
"44339",1044339,47,215,5,267
"44340",1044340,229,54,7,290
"44341",1044341,89,229,12,330
"44342",1044342,30,18,1,49
"44343",1044343,39,3,5,47
"44344",1044344,150,52,2,204
"44345",1044345,76,164,10,250
"44346",1044346,139,95,12,246
"44347",1044347,8,0,0,8
"44348",1044348,143,89,17,249
"44349",1044349,37,249,5,291
"44350",1044350,71,75,4,150
"44351",1044351,154,148,10,312
"44352",1044352,30,197,5,232
"44353",1044353,17,8,0,25
"44354",1044354,160,81,26,267
"44355",1044355,12,13,2,27
"44356",1044356,77,2,0,79
"44357",1044357,23,25,2,50
"44358",1044358,271,34,15,320
"44359",1044359,135,138,20,293
"44360",1044360,141,118,10,269
"44361",1044361,107,65,7,179
"44362",1044362,77,168,5,250
"44363",1044363,117,82,7,206
"44364",1044364,70,212,7,289
"44365",1044365,157,77,10,244
"44366",1044366,139,117,7,263
"44367",1044367,14,47,2,63
"44368",1044368,91,23,3,117
"44369",1044369,99,171,18,288
"44370",1044370,102,49,5,156
"44371",1044371,98,90,8,196
"44372",1044372,99,7,1,107
"44373",1044373,47,245,11,303
"44374",1044374,59,190,9,258
"44375",1044375,164,58,13,235
"44376",1044376,250,36,6,292
"44377",1044377,154,137,9,300
"44378",1044378,5,146,3,154
"44379",1044379,171,94,2,267
"44380",1044380,142,167,18,327
"44381",1044381,151,35,9,195
"44382",1044382,121,37,3,161
"44383",1044383,60,21,0,81
"44384",1044384,18,14,1,33
"44385",1044385,14,108,6,128
"44386",1044386,90,146,29,265
"44387",1044387,89,148,18,255
"44388",1044388,120,121,20,261
"44389",1044389,166,118,17,301
"44390",1044390,88,43,2,133
"44391",1044391,22,218,4,244
"44392",1044392,73,178,5,256
"44393",1044393,149,115,2,266
"44394",1044394,76,152,17,245
"44395",1044395,55,140,4,199
"44396",1044396,119,149,13,281
"44397",1044397,53,195,2,250
"44398",1044398,125,160,18,303
"44399",1044399,192,15,4,211
"44400",1044400,223,50,20,293
"44401",1044401,28,201,5,234
"44402",1044402,11,67,1,79
"44403",1044403,22,11,3,36
"44404",1044404,28,213,6,247
"44405",1044405,116,98,20,234
"44406",1044406,71,101,7,179
"44407",1044407,235,13,7,255
"44408",1044408,31,121,3,155
"44409",1044409,66,198,9,273
"44410",1044410,98,44,4,146
"44411",1044411,182,17,3,202
"44412",1044412,151,20,3,174
"44413",1044413,136,69,7,212
"44414",1044414,98,161,10,269
"44415",1044415,79,146,8,233
"44416",1044416,113,75,7,195
"44417",1044417,123,85,0,208
"44418",1044418,106,94,15,215
"44419",1044419,30,75,4,109
"44420",1044420,108,16,2,126
"44421",1044421,112,149,7,268
"44422",1044422,131,54,6,191
"44423",1044423,179,80,6,265
"44424",1044424,74,102,7,183
"44425",1044425,116,110,1,227
"44426",1044426,54,35,0,89
"44427",1044427,115,52,18,185
"44428",1044428,189,122,16,327
"44429",1044429,209,14,4,227
"44430",1044430,155,99,4,258
"44431",1044431,153,24,6,183
"44432",1044432,90,169,11,270
"44433",1044433,162,112,12,286
"44434",1044434,157,54,6,217
"44435",1044435,23,55,5,83
"44436",1044436,108,76,6,190
"44437",1044437,211,14,8,233
"44438",1044438,37,34,3,74
"44439",1044439,89,107,8,204
"44440",1044440,52,233,13,298
"44441",1044441,202,38,8,248
"44442",1044442,138,42,1,181
"44443",1044443,127,79,9,215
"44444",1044444,44,293,0,337
"44445",1044445,96,136,12,244
"44446",1044446,159,160,8,327
"44447",1044447,101,172,11,284
"44448",1044448,58,130,4,192
"44449",1044449,103,177,7,287
"44450",1044450,243,40,11,294
"44451",1044451,54,162,4,220
"44452",1044452,158,0,3,161
"44453",1044453,78,150,22,250
"44454",1044454,259,73,7,339
"44455",1044455,1,3,0,4
"44456",1044456,72,200,4,276
"44457",1044457,47,16,2,65
"44458",1044458,47,218,3,268
"44459",1044459,40,231,3,274
"44460",1044460,166,93,7,266
"44461",1044461,211,78,12,301
"44462",1044462,156,13,4,173
"44463",1044463,181,114,11,306
"44464",1044464,254,60,14,328
"44465",1044465,86,139,4,229
"44466",1044466,30,86,8,124
"44467",1044467,34,145,4,183
"44468",1044468,185,93,9,287
"44469",1044469,92,96,11,199
"44470",1044470,88,145,8,241
"44471",1044471,122,106,12,240
"44472",1044472,122,113,15,250
"44473",1044473,44,159,2,205
"44474",1044474,86,82,14,182
"44475",1044475,34,214,4,252
"44476",1044476,103,168,7,278
"44477",1044477,85,222,10,317
"44478",1044478,61,145,4,210
"44479",1044479,71,132,5,208
"44480",1044480,132,19,5,156
"44481",1044481,162,14,6,182
"44482",1044482,138,9,2,149
"44483",1044483,142,49,6,197
"44484",1044484,16,11,3,30
"44485",1044485,132,146,11,289
"44486",1044486,8,9,1,18
"44487",1044487,104,61,5,170
"44488",1044488,46,88,2,136
"44489",1044489,182,103,18,303
"44490",1044490,199,34,13,246
"44491",1044491,114,107,11,232
"44492",1044492,115,196,10,321
"44493",1044493,80,149,7,236
"44494",1044494,34,270,2,306
"44495",1044495,205,21,5,231
"44496",1044496,160,104,8,272
"44497",1044497,51,81,4,136
"44498",1044498,112,153,13,278
"44499",1044499,37,206,12,255
"44500",1044500,147,35,13,195
"44501",1044501,94,123,4,221
"44502",1044502,78,165,12,255
"44503",1044503,77,55,1,133
"44504",1044504,87,199,2,288
"44505",1044505,16,121,2,139
"44506",1044506,62,142,3,207
"44507",1044507,189,61,11,261
"44508",1044508,88,97,8,193
"44509",1044509,35,277,3,315
"44510",1044510,106,101,2,209
"44511",1044511,170,129,5,304
"44512",1044512,193,61,29,283
"44513",1044513,51,194,13,258
"44514",1044514,58,149,9,216
"44515",1044515,128,69,17,214
"44516",1044516,135,142,3,280
"44517",1044517,13,151,7,171
"44518",1044518,126,76,20,222
"44519",1044519,42,219,6,267
"44520",1044520,149,50,4,203
"44521",1044521,56,184,2,242
"44522",1044522,132,50,8,190
"44523",1044523,133,39,14,186
"44524",1044524,80,198,9,287
"44525",1044525,8,182,4,194
"44526",1044526,102,55,8,165
"44527",1044527,65,22,2,89
"44528",1044528,37,148,6,191
"44529",1044529,68,233,12,313
"44530",1044530,101,167,12,280
"44531",1044531,80,35,5,120
"44532",1044532,39,195,3,237
"44533",1044533,102,18,3,123
"44534",1044534,68,17,9,94
"44535",1044535,199,142,19,360
"44536",1044536,79,94,1,174
"44537",1044537,53,203,10,266
"44538",1044538,158,98,11,267
"44539",1044539,10,11,0,21
"44540",1044540,60,52,3,115
"44541",1044541,79,161,8,248
"44542",1044542,210,74,15,299
"44543",1044543,211,67,15,293
"44544",1044544,98,140,2,240
"44545",1044545,51,128,0,179
"44546",1044546,246,44,8,298
"44547",1044547,29,79,10,118
"44548",1044548,260,27,13,300
"44549",1044549,74,152,6,232
"44550",1044550,98,68,6,172
"44551",1044551,108,44,12,164
"44552",1044552,164,50,16,230
"44553",1044553,161,80,6,247
"44554",1044554,44,261,7,312
"44555",1044555,22,131,3,156
"44556",1044556,154,47,11,212
"44557",1044557,167,57,14,238
"44558",1044558,172,133,4,309
"44559",1044559,129,77,6,212
"44560",1044560,162,58,9,229
"44561",1044561,172,69,5,246
"44562",1044562,97,205,4,306
"44563",1044563,118,65,4,187
"44564",1044564,85,17,8,110
"44565",1044565,164,79,19,262
"44566",1044566,194,61,11,266
"44567",1044567,299,8,11,318
"44568",1044568,195,76,18,289
"44569",1044569,6,241,0,247
"44570",1044570,108,135,2,245
"44571",1044571,48,182,11,241
"44572",1044572,7,7,1,15
"44573",1044573,217,25,10,252
"44574",1044574,55,17,5,77
"44575",1044575,143,14,1,158
"44576",1044576,73,215,2,290
"44577",1044577,186,82,7,275
"44578",1044578,90,188,20,298
"44579",1044579,199,11,10,220
"44580",1044580,165,82,4,251
"44581",1044581,99,17,2,118
"44582",1044582,134,139,18,291
"44583",1044583,96,105,23,224
"44584",1044584,16,28,0,44
"44585",1044585,81,4,1,86
"44586",1044586,113,76,12,201
"44587",1044587,124,93,20,237
"44588",1044588,114,100,14,228
"44589",1044589,174,36,2,212
"44590",1044590,55,52,2,109
"44591",1044591,255,48,9,312
"44592",1044592,154,135,6,295
"44593",1044593,170,59,7,236
"44594",1044594,99,128,4,231
"44595",1044595,165,103,5,273
"44596",1044596,130,204,12,346
"44597",1044597,194,17,11,222
"44598",1044598,92,115,9,216
"44599",1044599,171,55,10,236
"44600",1044600,76,105,4,185
"44601",1044601,77,164,24,265
"44602",1044602,89,149,8,246
"44603",1044603,141,46,10,197
"44604",1044604,24,261,0,285
"44605",1044605,138,25,8,171
"44606",1044606,221,75,3,299
"44607",1044607,13,224,2,239
"44608",1044608,26,134,5,165
"44609",1044609,118,71,13,202
"44610",1044610,44,239,2,285
"44611",1044611,65,183,10,258
"44612",1044612,51,148,6,205
"44613",1044613,80,125,10,215
"44614",1044614,36,280,4,320
"44615",1044615,5,36,2,43
"44616",1044616,208,25,1,234
"44617",1044617,148,41,6,195
"44618",1044618,47,120,6,173
"44619",1044619,104,22,3,129
"44620",1044620,209,101,1,311
"44621",1044621,87,167,13,267
"44622",1044622,69,189,6,264
"44623",1044623,187,30,11,228
"44624",1044624,153,52,15,220
"44625",1044625,152,62,3,217
"44626",1044626,31,4,0,35
"44627",1044627,135,75,11,221
"44628",1044628,49,152,13,214
"44629",1044629,21,93,5,119
"44630",1044630,82,133,6,221
"44631",1044631,38,180,8,226
"44632",1044632,142,194,16,352
"44633",1044633,203,92,15,310
"44634",1044634,161,141,17,319
"44635",1044635,87,34,5,126
"44636",1044636,8,22,1,31
"44637",1044637,33,107,7,147
"44638",1044638,40,119,2,161
"44639",1044639,119,165,18,302
"44640",1044640,126,98,13,237
"44641",1044641,127,163,15,305
"44642",1044642,116,50,2,168
"44643",1044643,142,53,4,199
"44644",1044644,136,64,12,212
"44645",1044645,187,57,7,251
"44646",1044646,187,15,5,207
"44647",1044647,106,103,14,223
"44648",1044648,147,28,6,181
"44649",1044649,131,25,5,161
"44650",1044650,219,95,19,333
"44651",1044651,101,31,2,134
"44652",1044652,120,114,1,235
"44653",1044653,185,145,15,345
"44654",1044654,57,135,10,202
"44655",1044655,111,193,8,312
"44656",1044656,209,49,3,261
"44657",1044657,152,74,11,237
"44658",1044658,207,114,14,335
"44659",1044659,146,95,13,254
"44660",1044660,216,19,10,245
"44661",1044661,39,216,2,257
"44662",1044662,41,39,2,82
"44663",1044663,133,62,12,207
"44664",1044664,194,87,14,295
"44665",1044665,97,101,4,202
"44666",1044666,87,107,4,198
"44667",1044667,141,92,12,245
"44668",1044668,36,137,2,175
"44669",1044669,20,42,5,67
"44670",1044670,145,53,16,214
"44671",1044671,278,31,7,316
"44672",1044672,206,41,9,256
"44673",1044673,73,82,14,169
"44674",1044674,184,30,7,221
"44675",1044675,183,89,29,301
"44676",1044676,69,36,5,110
"44677",1044677,35,199,8,242
"44678",1044678,77,38,1,116
"44679",1044679,182,58,3,243
"44680",1044680,156,99,2,257
"44681",1044681,162,52,10,224
"44682",1044682,48,203,6,257
"44683",1044683,143,50,10,203
"44684",1044684,20,265,3,288
"44685",1044685,62,133,4,199
"44686",1044686,130,95,7,232
"44687",1044687,168,82,8,258
"44688",1044688,85,70,3,158
"44689",1044689,101,98,4,203
"44690",1044690,106,20,2,128
"44691",1044691,67,172,13,252
"44692",1044692,88,170,5,263
"44693",1044693,104,96,8,208
"44694",1044694,111,105,1,217
"44695",1044695,92,116,7,215
"44696",1044696,184,6,2,192
"44697",1044697,51,93,15,159
"44698",1044698,24,242,15,281
"44699",1044699,154,78,4,236
"44700",1044700,148,98,8,254
"44701",1044701,54,124,12,190
"44702",1044702,133,106,8,247
"44703",1044703,64,168,13,245
"44704",1044704,104,171,17,292
"44705",1044705,212,22,6,240
"44706",1044706,229,250,15,494
"44707",1044707,149,17,2,168
"44708",1044708,105,130,8,243
"44709",1044709,109,168,6,283
"44710",1044710,61,31,9,101
"44711",1044711,132,85,11,228
"44712",1044712,80,188,9,277
"44713",1044713,142,189,14,345
"44714",1044714,143,79,4,226
"44715",1044715,106,114,21,241
"44716",1044716,125,70,4,199
"44717",1044717,130,29,7,166
"44718",1044718,163,56,11,230
"44719",1044719,181,34,5,220
"44720",1044720,54,155,5,214
"44721",1044721,80,141,5,226
"44722",1044722,37,2,4,43
"44723",1044723,184,73,8,265
"44724",1044724,67,164,18,249
"44725",1044725,36,39,0,75
"44726",1044726,113,98,10,221
"44727",1044727,105,65,8,178
"44728",1044728,128,59,16,203
"44729",1044729,160,137,20,317
"44730",1044730,130,35,1,166
"44731",1044731,64,24,6,94
"44732",1044732,77,40,2,119
"44733",1044733,226,17,7,250
"44734",1044734,181,67,4,252
"44735",1044735,217,27,5,249
"44736",1044736,72,74,1,147
"44737",1044737,163,25,9,197
"44738",1044738,149,23,3,175
"44739",1044739,127,171,4,302
"44740",1044740,213,57,16,286
"44741",1044741,254,27,18,299
"44742",1044742,151,54,8,213
"44743",1044743,186,50,16,252
"44744",1044744,28,8,3,39
"44745",1044745,124,67,3,194
"44746",1044746,174,50,6,230
"44747",1044747,96,201,13,310
"44748",1044748,164,26,3,193
"44749",1044749,61,52,6,119
"44750",1044750,150,37,9,196
"44751",1044751,147,88,7,242
"44752",1044752,35,238,2,275
"44753",1044753,175,70,8,253
"44754",1044754,164,42,15,221
"44755",1044755,133,23,5,161
"44756",1044756,99,146,2,247
"44757",1044757,167,61,8,236
"44758",1044758,179,62,4,245
"44759",1044759,224,26,6,256
"44760",1044760,79,203,23,305
"44761",1044761,65,126,11,202
"44762",1044762,182,64,3,249
"44763",1044763,40,231,7,278
"44764",1044764,140,27,5,172
"44765",1044765,100,216,12,328
"44766",1044766,42,207,6,255
"44767",1044767,99,37,7,143
"44768",1044768,161,97,5,263
"44769",1044769,62,185,9,256
"44770",1044770,135,53,5,193
"44771",1044771,76,156,6,238
"44772",1044772,155,32,6,193
"44773",1044773,112,83,6,201
"44774",1044774,87,138,12,237
"44775",1044775,253,19,7,279
"44776",1044776,169,115,3,287
"44777",1044777,177,65,10,252
"44778",1044778,91,131,6,228
"44779",1044779,197,14,8,219
"44780",1044780,82,127,12,221
"44781",1044781,57,197,14,268
"44782",1044782,199,23,4,226
"44783",1044783,56,17,1,74
"44784",1044784,10,12,4,26
"44785",1044785,30,242,1,273
"44786",1044786,186,59,4,249
"44787",1044787,192,29,10,231
"44788",1044788,61,72,8,141
"44789",1044789,155,54,5,214
"44790",1044790,62,171,16,249
"44791",1044791,135,57,8,200
"44792",1044792,145,129,10,284
"44793",1044793,133,64,4,201
"44794",1044794,237,68,17,322
"44795",1044795,38,34,4,76
"44796",1044796,11,34,1,46
"44797",1044797,163,66,5,234
"44798",1044798,187,40,2,229
"44799",1044799,193,39,10,242
"44800",1044800,171,47,9,227
"44801",1044801,250,63,16,329
"44802",1044802,61,199,9,269
"44803",1044803,194,51,10,255
"44804",1044804,86,68,5,159
"44805",1044805,165,115,8,288
"44806",1044806,176,77,15,268
"44807",1044807,202,26,8,236
"44808",1044808,143,46,10,199
"44809",1044809,103,136,6,245
"44810",1044810,65,197,4,266
"44811",1044811,194,65,19,278
"44812",1044812,92,114,6,212
"44813",1044813,108,10,1,119
"44814",1044814,102,208,9,319
"44815",1044815,33,135,6,174
"44816",1044816,22,186,6,214
"44817",1044817,28,103,1,132
"44818",1044818,151,33,5,189
"44819",1044819,11,12,1,24
"44820",1044820,190,73,5,268
"44821",1044821,137,118,14,269
"44822",1044822,53,192,5,250
"44823",1044823,88,73,11,172
"44824",1044824,166,56,10,232
"44825",1044825,243,105,12,360
"44826",1044826,93,187,6,286
"44827",1044827,146,94,9,249
"44828",1044828,160,109,13,282
"44829",1044829,48,18,8,74
"44830",1044830,29,176,0,205
"44831",1044831,86,50,3,139
"44832",1044832,106,131,10,247
"44833",1044833,180,152,17,349
"44834",1044834,43,265,1,309
"44835",1044835,207,22,12,241
"44836",1044836,141,37,5,183
"44837",1044837,185,36,16,237
"44838",1044838,100,166,9,275
"44839",1044839,114,172,6,292
"44840",1044840,124,69,9,202
"44841",1044841,81,72,12,165
"44842",1044842,175,100,23,298
"44843",1044843,86,142,11,239
"44844",1044844,184,71,6,261
"44845",1044845,76,151,8,235
"44846",1044846,39,58,4,101
"44847",1044847,46,225,3,274
"44848",1044848,46,150,5,201
"44849",1044849,184,42,7,233
"44850",1044850,137,88,2,227
"44851",1044851,163,126,5,294
"44852",1044852,220,58,9,287
"44853",1044853,85,236,20,341
"44854",1044854,206,52,7,265
"44855",1044855,242,21,3,266
"44856",1044856,137,107,5,249
"44857",1044857,87,206,10,303
"44858",1044858,93,179,5,277
"44859",1044859,71,110,4,185
"44860",1044860,169,44,5,218
"44861",1044861,95,195,12,302
"44862",1044862,115,21,3,139
"44863",1044863,141,155,5,301
"44864",1044864,27,117,1,145
"44865",1044865,36,43,4,83
"44866",1044866,108,82,17,207
"44867",1044867,169,29,4,202
"44868",1044868,208,21,11,240
"44869",1044869,96,209,6,311
"44870",1044870,49,236,4,289
"44871",1044871,105,152,2,259
"44872",1044872,85,52,9,146
"44873",1044873,57,78,3,138
"44874",1044874,137,112,10,259
"44875",1044875,43,15,2,60
"44876",1044876,64,249,2,315
"44877",1044877,105,141,20,266
"44878",1044878,53,259,15,327
"44879",1044879,62,80,7,149
"44880",1044880,101,76,2,179
"44881",1044881,58,237,9,304
"44882",1044882,201,27,13,241
"44883",1044883,189,117,10,316
"44884",1044884,177,24,7,208
"44885",1044885,92,13,0,105
"44886",1044886,71,58,6,135
"44887",1044887,71,161,16,248
"44888",1044888,85,78,12,175
"44889",1044889,185,88,5,278
"44890",1044890,28,166,6,200
"44891",1044891,166,151,8,325
"44892",1044892,88,127,13,228
"44893",1044893,69,161,1,231
"44894",1044894,204,89,13,306
"44895",1044895,132,160,11,303
"44896",1044896,91,88,7,186
"44897",1044897,199,74,13,286
"44898",1044898,48,184,6,238
"44899",1044899,126,58,9,193
"44900",1044900,127,156,4,287
"44901",1044901,124,149,11,284
"44902",1044902,220,83,7,310
"44903",1044903,47,97,3,147
"44904",1044904,84,194,13,291
"44905",1044905,162,121,13,296
"44906",1044906,133,118,2,253
"44907",1044907,239,28,8,275
"44908",1044908,89,201,8,298
"44909",1044909,251,51,12,314
"44910",1044910,54,98,3,155
"44911",1044911,136,48,6,190
"44912",1044912,122,92,4,218
"44913",1044913,117,179,12,308
"44914",1044914,149,15,4,168
"44915",1044915,164,31,4,199
"44916",1044916,88,36,4,128
"44917",1044917,192,62,6,260
"44918",1044918,97,156,6,259
"44919",1044919,110,9,1,120
"44920",1044920,18,241,2,261
"44921",1044921,0,18,0,18
"44922",1044922,192,42,12,246
"44923",1044923,71,166,5,242
"44924",1044924,41,214,3,258
"44925",1044925,132,36,8,176
"44926",1044926,189,22,5,216
"44927",1044927,116,143,6,265
"44928",1044928,80,49,5,134
"44929",1044929,216,16,3,235
"44930",1044930,3,40,1,44
"44931",1044931,157,43,3,203
"44932",1044932,114,153,14,281
"44933",1044933,125,152,9,286
"44934",1044934,158,47,4,209
"44935",1044935,156,10,9,175
"44936",1044936,162,154,25,341
"44937",1044937,63,80,9,152
"44938",1044938,135,38,0,173
"44939",1044939,50,9,1,60
"44940",1044940,39,29,3,71
"44941",1044941,92,160,5,257
"44942",1044942,148,144,21,313
"44943",1044943,138,170,15,323
"44944",1044944,117,174,15,306
"44945",1044945,101,60,5,166
"44946",1044946,111,28,3,142
"44947",1044947,107,117,5,229
"44948",1044948,53,200,6,259
"44949",1044949,97,142,6,245
"44950",1044950,189,75,14,278
"44951",1044951,6,44,0,50
"44952",1044952,134,56,11,201
"44953",1044953,119,127,20,266
"44954",1044954,9,71,0,80
"44955",1044955,133,134,12,279
"44956",1044956,106,44,4,154
"44957",1044957,57,274,3,334
"44958",1044958,99,131,2,232
"44959",1044959,189,7,6,202
"44960",1044960,121,147,22,290
"44961",1044961,173,7,5,185
"44962",1044962,118,133,6,257
"44963",1044963,159,0,0,159
"44964",1044964,124,53,1,178
"44965",1044965,12,36,1,49
"44966",1044966,200,53,4,257
"44967",1044967,97,124,15,236
"44968",1044968,131,100,5,236
"44969",1044969,141,69,4,214
"44970",1044970,33,283,4,320
"44971",1044971,166,110,8,284
"44972",1044972,155,76,5,236
"44973",1044973,70,185,12,267
"44974",1044974,136,91,6,233
"44975",1044975,177,101,15,293
"44976",1044976,22,213,4,239
"44977",1044977,37,169,2,208
"44978",1044978,116,106,5,227
"44979",1044979,145,109,12,266
"44980",1044980,120,16,4,140
"44981",1044981,56,240,4,300
"44982",1044982,40,9,4,53
"44983",1044983,38,175,9,222
"44984",1044984,18,58,0,76
"44985",1044985,66,217,14,297
"44986",1044986,39,247,3,289
"44987",1044987,81,161,3,245
"44988",1044988,120,45,8,173
"44989",1044989,147,27,3,177
"44990",1044990,27,9,1,37
"44991",1044991,80,89,12,181
"44992",1044992,148,58,9,215
"44993",1044993,144,39,6,189
"44994",1044994,3,3,2,8
"44995",1044995,77,79,13,169
"44996",1044996,82,207,7,296
"44997",1044997,24,8,0,32
"44998",1044998,96,53,6,155
"44999",1044999,9,32,0,41
"45000",1045000,112,139,13,264
"45001",1045001,159,36,9,204
"45002",1045002,135,120,9,264
"45003",1045003,222,36,9,267
"45004",1045004,109,112,1,222
"45005",1045005,31,224,6,261
"45006",1045006,129,43,3,175
"45007",1045007,4,11,1,16
"45008",1045008,163,44,0,207
"45009",1045009,62,184,2,248
"45010",1045010,146,30,5,181
"45011",1045011,153,72,8,233
"45012",1045012,180,6,7,193
"45013",1045013,118,157,17,292
"45014",1045014,170,102,3,275
"45015",1045015,83,126,14,223
"45016",1045016,121,65,6,192
"45017",1045017,84,95,14,193
"45018",1045018,63,104,6,173
"45019",1045019,84,140,2,226
"45020",1045020,63,40,6,109
"45021",1045021,26,199,2,227
"45022",1045022,84,180,18,282
"45023",1045023,126,47,9,182
"45024",1045024,207,63,20,290
"45025",1045025,175,84,15,274
"45026",1045026,171,28,4,203
"45027",1045027,30,206,3,239
"45028",1045028,127,121,14,262
"45029",1045029,120,159,4,283
"45030",1045030,119,51,4,174
"45031",1045031,111,66,2,179
"45032",1045032,71,248,7,326
"45033",1045033,45,168,6,219
"45034",1045034,133,90,5,228
"45035",1045035,62,103,6,171
"45036",1045036,54,52,9,115
"45037",1045037,215,47,14,276
"45038",1045038,136,61,9,206
"45039",1045039,60,178,1,239
"45040",1045040,40,8,6,54
"45041",1045041,85,164,14,263
"45042",1045042,125,54,3,182
"45043",1045043,219,19,4,242
"45044",1045044,52,279,4,335
"45045",1045045,256,224,24,504
"45046",1045046,12,5,1,18
"45047",1045047,210,17,3,230
"45048",1045048,112,18,4,134
"45049",1045049,55,266,6,327
"45050",1045050,29,32,1,62
"45051",1045051,133,75,5,213
"45052",1045052,52,91,5,148
"45053",1045053,249,41,10,300
"45054",1045054,169,60,5,234
"45055",1045055,260,34,5,299
"45056",1045056,24,8,1,33
"45057",1045057,133,56,6,195
"45058",1045058,133,79,5,217
"45059",1045059,11,17,1,29
"45060",1045060,50,79,3,132
"45061",1045061,156,32,7,195
"45062",1045062,80,5,1,86
"45063",1045063,196,69,12,277
"45064",1045064,19,4,1,24
"45065",1045065,141,31,8,180
"45066",1045066,179,45,4,228
"45067",1045067,84,57,5,146
"45068",1045068,71,255,7,333
"45069",1045069,84,45,7,136
"45070",1045070,83,105,12,200
"45071",1045071,118,47,1,166
"45072",1045072,88,196,8,292
"45073",1045073,124,60,5,189
"45074",1045074,50,187,4,241
"45075",1045075,98,36,9,143
"45076",1045076,183,49,9,241
"45077",1045077,123,65,12,200
"45078",1045078,155,49,10,214
"45079",1045079,126,46,11,183
"45080",1045080,115,63,4,182
"45081",1045081,24,98,3,125
"45082",1045082,175,34,7,216
"45083",1045083,200,86,10,296
"45084",1045084,90,195,11,296
"45085",1045085,61,233,6,300
"45086",1045086,124,95,11,230
"45087",1045087,211,70,9,290
"45088",1045088,117,68,7,192
"45089",1045089,116,156,15,287
"45090",1045090,90,160,4,254
"45091",1045091,102,129,7,238
"45092",1045092,208,36,8,252
"45093",1045093,23,31,6,60
"45094",1045094,152,115,17,284
"45095",1045095,17,13,1,31
"45096",1045096,220,25,7,252
"45097",1045097,134,78,14,226
"45098",1045098,205,4,3,212
"45099",1045099,35,160,2,197
"45100",1045100,234,80,14,328
"45101",1045101,202,50,6,258
"45102",1045102,22,4,1,27
"45103",1045103,62,127,12,201
"45104",1045104,170,57,10,237
"45105",1045105,121,102,6,229
"45106",1045106,114,116,6,236
"45107",1045107,154,81,16,251
"45108",1045108,75,73,4,152
"45109",1045109,186,82,13,281
"45110",1045110,141,31,3,175
"45111",1045111,25,186,1,212
"45112",1045112,56,78,3,137
"45113",1045113,2,52,1,55
"45114",1045114,38,178,4,220
"45115",1045115,138,34,7,179
"45116",1045116,48,251,4,303
"45117",1045117,143,104,14,261
"45118",1045118,115,108,15,238
"45119",1045119,43,140,8,191
"45120",1045120,117,50,3,170
"45121",1045121,5,2,1,8
"45122",1045122,91,230,3,324
"45123",1045123,37,201,6,244
"45124",1045124,70,55,4,129
"45125",1045125,86,62,2,150
"45126",1045126,7,46,6,59
"45127",1045127,131,248,26,405
"45128",1045128,46,215,3,264
"45129",1045129,166,9,2,177
"45130",1045130,158,109,11,278
"45131",1045131,95,49,1,145
"45132",1045132,125,50,8,183
"45133",1045133,213,65,9,287
"45134",1045134,126,111,14,251
"45135",1045135,140,175,9,324
"45136",1045136,53,59,8,120
"45137",1045137,101,148,9,258
"45138",1045138,59,187,6,252
"45139",1045139,178,1,2,181
"45140",1045140,34,104,4,142
"45141",1045141,36,27,3,66
"45142",1045142,174,35,1,210
"45143",1045143,153,76,7,236
"45144",1045144,53,197,4,254
"45145",1045145,89,147,9,245
"45146",1045146,200,95,6,301
"45147",1045147,58,79,15,152
"45148",1045148,46,40,4,90
"45149",1045149,223,59,12,294
"45150",1045150,128,20,7,155
"45151",1045151,46,118,3,167
"45152",1045152,129,28,2,159
"45153",1045153,128,72,13,213
"45154",1045154,199,30,6,235
"45155",1045155,159,32,6,197
"45156",1045156,218,9,5,232
"45157",1045157,73,147,18,238
"45158",1045158,120,98,2,220
"45159",1045159,206,106,20,332
"45160",1045160,143,32,6,181
"45161",1045161,131,145,4,280
"45162",1045162,116,38,7,161
"45163",1045163,167,83,10,260
"45164",1045164,121,30,13,164
"45165",1045165,231,1,2,234
"45166",1045166,113,137,17,267
"45167",1045167,146,54,15,215
"45168",1045168,40,280,6,326
"45169",1045169,109,10,0,119
"45170",1045170,155,36,17,208
"45171",1045171,13,7,0,20
"45172",1045172,165,170,6,341
"45173",1045173,28,237,1,266
"45174",1045174,99,147,5,251
"45175",1045175,158,91,7,256
"45176",1045176,98,39,6,143
"45177",1045177,30,95,8,133
"45178",1045178,197,61,5,263
"45179",1045179,124,123,5,252
"45180",1045180,139,62,17,218
"45181",1045181,7,6,3,16
"45182",1045182,65,2,1,68
"45183",1045183,121,59,8,188
"45184",1045184,126,16,6,148
"45185",1045185,7,13,3,23
"45186",1045186,93,156,4,253
"45187",1045187,151,46,4,201
"45188",1045188,194,54,2,250
"45189",1045189,11,89,0,100
"45190",1045190,200,29,10,239
"45191",1045191,77,175,10,262
"45192",1045192,21,75,2,98
"45193",1045193,70,158,7,235
"45194",1045194,164,68,13,245
"45195",1045195,105,167,5,277
"45196",1045196,131,108,17,256
"45197",1045197,99,174,12,285
"45198",1045198,107,172,7,286
"45199",1045199,48,170,5,223
"45200",1045200,59,53,11,123
"45201",1045201,95,166,6,267
"45202",1045202,158,8,4,170
"45203",1045203,41,25,3,69
"45204",1045204,119,161,14,294
"45205",1045205,155,110,27,292
"45206",1045206,100,92,2,194
"45207",1045207,76,245,10,331
"45208",1045208,50,276,9,335
"45209",1045209,120,55,6,181
"45210",1045210,37,255,13,305
"45211",1045211,138,70,12,220
"45212",1045212,156,33,3,192
"45213",1045213,221,64,7,292
"45214",1045214,154,145,9,308
"45215",1045215,166,46,8,220
"45216",1045216,150,39,6,195
"45217",1045217,26,184,3,213
"45218",1045218,145,62,2,209
"45219",1045219,54,256,17,327
"45220",1045220,224,9,2,235
"45221",1045221,38,240,5,283
"45222",1045222,243,19,15,277
"45223",1045223,228,56,15,299
"45224",1045224,64,62,13,139
"45225",1045225,111,81,6,198
"45226",1045226,166,118,19,303
"45227",1045227,37,37,4,78
"45228",1045228,136,30,6,172
"45229",1045229,26,154,10,190
"45230",1045230,106,153,10,269
"45231",1045231,131,62,3,196
"45232",1045232,82,169,9,260
"45233",1045233,81,50,6,137
"45234",1045234,169,64,11,244
"45235",1045235,166,35,7,208
"45236",1045236,222,104,20,346
"45237",1045237,75,161,11,247
"45238",1045238,19,68,10,97
"45239",1045239,146,68,16,230
"45240",1045240,28,165,6,199
"45241",1045241,55,233,1,289
"45242",1045242,105,175,19,299
"45243",1045243,252,72,14,338
"45244",1045244,205,68,15,288
"45245",1045245,160,21,5,186
"45246",1045246,83,145,6,234
"45247",1045247,253,20,8,281
"45248",1045248,92,216,12,320
"45249",1045249,117,0,3,120
"45250",1045250,136,141,9,286
"45251",1045251,83,115,5,203
"45252",1045252,113,60,6,179
"45253",1045253,160,65,14,239
"45254",1045254,122,146,14,282
"45255",1045255,137,69,3,209
"45256",1045256,80,193,6,279
"45257",1045257,208,90,14,312
"45258",1045258,127,155,10,292
"45259",1045259,35,13,1,49
"45260",1045260,72,131,6,209
"45261",1045261,93,143,7,243
"45262",1045262,6,73,1,80
"45263",1045263,19,173,3,195
"45264",1045264,138,66,18,222
"45265",1045265,105,125,5,235
"45266",1045266,6,10,1,17
"45267",1045267,16,6,3,25
"45268",1045268,169,95,12,276
"45269",1045269,86,58,4,148
"45270",1045270,102,136,18,256
"45271",1045271,109,118,5,232
"45272",1045272,94,193,2,289
"45273",1045273,191,64,11,266
"45274",1045274,74,154,1,229
"45275",1045275,265,10,3,278
"45276",1045276,103,42,4,149
"45277",1045277,67,184,8,259
"45278",1045278,73,164,6,243
"45279",1045279,4,14,0,18
"45280",1045280,72,168,18,258
"45281",1045281,58,196,3,257
"45282",1045282,72,160,2,234
"45283",1045283,49,194,2,245
"45284",1045284,175,16,2,193
"45285",1045285,9,256,2,267
"45286",1045286,148,141,4,293
"45287",1045287,221,56,15,292
"45288",1045288,48,275,6,329
"45289",1045289,81,97,11,189
"45290",1045290,142,136,20,298
"45291",1045291,135,22,7,164
"45292",1045292,99,189,2,290
"45293",1045293,117,141,7,265
"45294",1045294,155,21,5,181
"45295",1045295,46,233,2,281
"45296",1045296,62,279,9,350
"45297",1045297,51,24,4,79
"45298",1045298,186,276,31,493
"45299",1045299,24,18,2,44
"45300",1045300,173,31,11,215
"45301",1045301,43,6,1,50
"45302",1045302,29,78,7,114
"45303",1045303,88,200,12,300
"45304",1045304,170,100,4,274
"45305",1045305,122,166,9,297
"45306",1045306,215,17,6,238
"45307",1045307,136,80,10,226
"45308",1045308,98,140,14,252
"45309",1045309,190,112,19,321
"45310",1045310,196,69,10,275
"45311",1045311,207,73,9,289
"45312",1045312,182,116,10,308
"45313",1045313,116,148,5,269
"45314",1045314,22,0,0,22
"45315",1045315,114,279,15,408
"45316",1045316,78,179,5,262
"45317",1045317,88,184,3,275
"45318",1045318,171,31,7,209
"45319",1045319,69,201,8,278
"45320",1045320,48,248,3,299
"45321",1045321,79,156,16,251
"45322",1045322,38,168,13,219
"45323",1045323,43,67,2,112
"45324",1045324,149,59,5,213
"45325",1045325,138,59,18,215
"45326",1045326,68,160,16,244
"45327",1045327,100,117,9,226
"45328",1045328,97,211,6,314
"45329",1045329,165,84,9,258
"45330",1045330,142,117,11,270
"45331",1045331,62,121,13,196
"45332",1045332,84,61,12,157
"45333",1045333,104,146,5,255
"45334",1045334,71,50,15,136
"45335",1045335,179,24,7,210
"45336",1045336,174,28,9,211
"45337",1045337,198,65,15,278
"45338",1045338,19,159,6,184
"45339",1045339,126,35,0,161
"45340",1045340,142,36,7,185
"45341",1045341,49,117,3,169
"45342",1045342,97,136,25,258
"45343",1045343,172,41,8,221
"45344",1045344,108,47,8,163
"45345",1045345,65,180,16,261
"45346",1045346,8,1,1,10
"45347",1045347,48,127,8,183
"45348",1045348,30,215,8,253
"45349",1045349,148,31,3,182
"45350",1045350,153,61,7,221
"45351",1045351,17,13,0,30
"45352",1045352,118,54,10,182
"45353",1045353,167,73,6,246
"45354",1045354,136,101,7,244
"45355",1045355,85,129,7,221
"45356",1045356,167,52,13,232
"45357",1045357,164,142,15,321
"45358",1045358,108,73,8,189
"45359",1045359,41,10,4,55
"45360",1045360,32,198,6,236
"45361",1045361,64,205,3,272
"45362",1045362,46,167,7,220
"45363",1045363,114,198,15,327
"45364",1045364,159,39,9,207
"45365",1045365,236,32,10,278
"45366",1045366,140,99,1,240
"45367",1045367,85,117,1,203
"45368",1045368,40,212,3,255
"45369",1045369,148,67,3,218
"45370",1045370,162,57,4,223
"45371",1045371,156,87,6,249
"45372",1045372,119,40,7,166
"45373",1045373,81,132,3,216
"45374",1045374,84,205,9,298
"45375",1045375,203,88,18,309
"45376",1045376,199,52,12,263
"45377",1045377,9,11,1,21
"45378",1045378,79,151,2,232
"45379",1045379,135,52,6,193
"45380",1045380,71,25,3,99
"45381",1045381,114,67,15,196
"45382",1045382,130,126,3,259
"45383",1045383,55,137,4,196
"45384",1045384,205,45,10,260
"45385",1045385,151,75,9,235
"45386",1045386,31,13,1,45
"45387",1045387,41,241,14,296
"45388",1045388,126,68,8,202
"45389",1045389,85,139,20,244
"45390",1045390,6,16,0,22
"45391",1045391,6,0,0,6
"45392",1045392,96,127,12,235
"45393",1045393,161,102,14,277
"45394",1045394,110,199,5,314
"45395",1045395,161,81,6,248
"45396",1045396,125,131,7,263
"45397",1045397,135,131,14,280
"45398",1045398,174,50,4,228
"45399",1045399,99,71,4,174
"45400",1045400,77,227,5,309
"45401",1045401,26,198,2,226
"45402",1045402,185,66,6,257
"45403",1045403,145,279,15,439
"45404",1045404,143,40,4,187
"45405",1045405,54,97,1,152
"45406",1045406,142,61,11,214
"45407",1045407,96,20,15,131
"45408",1045408,67,202,4,273
"45409",1045409,24,247,17,288
"45410",1045410,184,76,5,265
"45411",1045411,182,43,1,226
"45412",1045412,196,30,5,231
"45413",1045413,203,118,9,330
"45414",1045414,88,215,4,307
"45415",1045415,182,27,5,214
"45416",1045416,12,28,5,45
"45417",1045417,80,47,8,135
"45418",1045418,102,168,21,291
"45419",1045419,77,160,13,250
"45420",1045420,154,67,1,222
"45421",1045421,32,251,2,285
"45422",1045422,179,113,13,305
"45423",1045423,125,51,8,184
"45424",1045424,96,117,8,221
"45425",1045425,83,185,12,280
"45426",1045426,35,258,5,298
"45427",1045427,59,163,12,234
"45428",1045428,87,173,6,266
"45429",1045429,47,140,6,193
"45430",1045430,18,20,1,39
"45431",1045431,48,97,3,148
"45432",1045432,83,85,6,174
"45433",1045433,104,108,34,246
"45434",1045434,108,171,14,293
"45435",1045435,211,127,17,355
"45436",1045436,126,13,6,145
"45437",1045437,127,96,12,235
"45438",1045438,61,165,22,248
"45439",1045439,122,14,8,144
"45440",1045440,56,192,19,267
"45441",1045441,89,147,14,250
"45442",1045442,102,186,25,313
"45443",1045443,122,106,8,236
"45444",1045444,220,108,20,348
"45445",1045445,44,10,3,57
"45446",1045446,105,24,9,138
"45447",1045447,9,17,0,26
"45448",1045448,128,51,11,190
"45449",1045449,144,2,0,146
"45450",1045450,33,37,1,71
"45451",1045451,38,242,1,281
"45452",1045452,147,66,8,221
"45453",1045453,73,173,3,249
"45454",1045454,182,85,7,274
"45455",1045455,42,94,4,140
"45456",1045456,102,192,11,305
"45457",1045457,132,125,25,282
"45458",1045458,39,238,3,280
"45459",1045459,256,7,6,269
"45460",1045460,61,201,15,277
"45461",1045461,110,88,4,202
"45462",1045462,147,13,5,165
"45463",1045463,48,129,1,178
"45464",1045464,107,48,4,159
"45465",1045465,203,113,9,325
"45466",1045466,127,48,7,182
"45467",1045467,179,19,4,202
"45468",1045468,117,137,5,259
"45469",1045469,134,35,8,177
"45470",1045470,12,78,0,90
"45471",1045471,170,33,12,215
"45472",1045472,187,40,13,240
"45473",1045473,26,18,2,46
"45474",1045474,118,119,6,243
"45475",1045475,8,18,3,29
"45476",1045476,63,92,19,174
"45477",1045477,159,92,7,258
"45478",1045478,127,49,6,182
"45479",1045479,124,27,5,156
"45480",1045480,69,152,12,233
"45481",1045481,103,180,4,287
"45482",1045482,133,106,11,250
"45483",1045483,107,51,7,165
"45484",1045484,50,228,6,284
"45485",1045485,141,69,9,219
"45486",1045486,94,15,2,111
"45487",1045487,105,150,5,260
"45488",1045488,114,168,15,297
"45489",1045489,101,101,6,208
"45490",1045490,88,131,8,227
"45491",1045491,194,122,9,325
"45492",1045492,177,7,0,184
"45493",1045493,220,34,2,256
"45494",1045494,36,242,13,291
"45495",1045495,38,54,1,93
"45496",1045496,206,44,13,263
"45497",1045497,66,190,15,271
"45498",1045498,116,81,8,205
"45499",1045499,180,15,4,199
"45500",1045500,53,299,7,359
"45501",1045501,102,104,2,208
"45502",1045502,102,220,13,335
"45503",1045503,86,89,8,183
"45504",1045504,160,98,11,269
"45505",1045505,142,118,9,269
"45506",1045506,74,15,4,93
"45507",1045507,131,16,6,153
"45508",1045508,82,6,1,89
"45509",1045509,116,42,5,163
"45510",1045510,89,67,22,178
"45511",1045511,102,97,7,206
"45512",1045512,43,185,19,247
"45513",1045513,92,113,13,218
"45514",1045514,17,6,1,24
"45515",1045515,76,218,10,304
"45516",1045516,45,306,6,357
"45517",1045517,156,59,4,219
"45518",1045518,127,103,4,234
"45519",1045519,135,61,9,205
"45520",1045520,188,70,10,268
"45521",1045521,19,93,2,114
"45522",1045522,37,201,0,238
"45523",1045523,85,19,3,107
"45524",1045524,105,46,10,161
"45525",1045525,24,230,4,258
"45526",1045526,76,198,6,280
"45527",1045527,158,95,4,257
"45528",1045528,162,57,2,221
"45529",1045529,56,122,4,182
"45530",1045530,41,216,5,262
"45531",1045531,122,136,4,262
"45532",1045532,103,154,2,259
"45533",1045533,81,176,15,272
"45534",1045534,32,254,5,291
"45535",1045535,284,5,4,293
"45536",1045536,148,52,2,202
"45537",1045537,25,73,0,98
"45538",1045538,126,17,3,146
"45539",1045539,29,180,2,211
"45540",1045540,101,94,11,206
"45541",1045541,144,63,2,209
"45542",1045542,36,224,3,263
"45543",1045543,39,208,12,259
"45544",1045544,123,112,10,245
"45545",1045545,140,125,18,283
"45546",1045546,217,67,13,297
"45547",1045547,135,18,2,155
"45548",1045548,248,45,7,300
"45549",1045549,139,114,12,265
"45550",1045550,168,47,7,222
"45551",1045551,121,47,6,174
"45552",1045552,141,123,6,270
"45553",1045553,62,141,10,213
"45554",1045554,110,25,3,138
"45555",1045555,118,59,13,190
"45556",1045556,186,52,7,245
"45557",1045557,220,31,3,254
"45558",1045558,152,126,8,286
"45559",1045559,80,39,5,124
"45560",1045560,185,23,9,217
"45561",1045561,144,164,14,322
"45562",1045562,193,39,5,237
"45563",1045563,64,199,10,273
"45564",1045564,118,151,9,278
"45565",1045565,189,40,8,237
"45566",1045566,104,41,5,150
"45567",1045567,119,183,10,312
"45568",1045568,189,47,11,247
"45569",1045569,153,75,14,242
"45570",1045570,318,3,6,327
"45571",1045571,105,187,3,295
"45572",1045572,67,4,2,73
"45573",1045573,187,118,16,321
"45574",1045574,165,78,17,260
"45575",1045575,192,100,8,300
"45576",1045576,14,274,2,290
"45577",1045577,141,87,12,240
"45578",1045578,162,68,3,233
"45579",1045579,109,138,7,254
"45580",1045580,8,170,3,181
"45581",1045581,63,89,5,157
"45582",1045582,184,47,13,244
"45583",1045583,23,34,3,60
"45584",1045584,37,163,5,205
"45585",1045585,13,32,1,46
"45586",1045586,154,40,11,205
"45587",1045587,203,40,6,249
"45588",1045588,188,147,23,358
"45589",1045589,81,61,7,149
"45590",1045590,120,80,8,208
"45591",1045591,92,125,26,243
"45592",1045592,12,12,2,26
"45593",1045593,26,287,0,313
"45594",1045594,5,2,1,8
"45595",1045595,96,136,11,243
"45596",1045596,39,26,4,69
"45597",1045597,136,99,19,254
"45598",1045598,104,35,5,144
"45599",1045599,183,103,12,298
"45600",1045600,64,142,6,212
"45601",1045601,14,196,11,221
"45602",1045602,161,43,10,214
"45603",1045603,221,78,16,315
"45604",1045604,178,37,6,221
"45605",1045605,160,74,7,241
"45606",1045606,115,131,6,252
"45607",1045607,80,70,8,158
"45608",1045608,66,163,9,238
"45609",1045609,156,100,10,266
"45610",1045610,50,103,5,158
"45611",1045611,96,53,3,152
"45612",1045612,212,44,8,264
"45613",1045613,150,28,10,188
"45614",1045614,112,211,11,334
"45615",1045615,177,27,5,209
"45616",1045616,208,67,9,284
"45617",1045617,60,87,6,153
"45618",1045618,106,59,10,175
"45619",1045619,117,19,7,143
"45620",1045620,4,47,1,52
"45621",1045621,110,32,7,149
"45622",1045622,135,73,5,213
"45623",1045623,132,46,10,188
"45624",1045624,88,164,13,265
"45625",1045625,67,100,11,178
"45626",1045626,42,154,5,201
"45627",1045627,80,28,4,112
"45628",1045628,37,186,10,233
"45629",1045629,151,77,9,237
"45630",1045630,39,76,11,126
"45631",1045631,87,157,12,256
"45632",1045632,167,76,8,251
"45633",1045633,47,198,7,252
"45634",1045634,100,79,8,187
"45635",1045635,128,29,2,159
"45636",1045636,25,188,4,217
"45637",1045637,159,118,15,292
"45638",1045638,75,252,8,335
"45639",1045639,92,90,12,194
"45640",1045640,56,183,12,251
"45641",1045641,101,91,1,193
"45642",1045642,81,105,4,190
"45643",1045643,273,6,3,282
"45644",1045644,120,110,11,241
"45645",1045645,127,146,18,291
"45646",1045646,148,132,17,297
"45647",1045647,118,132,2,252
"45648",1045648,15,13,3,31
"45649",1045649,110,146,7,263
"45650",1045650,203,18,5,226
"45651",1045651,128,170,24,322
"45652",1045652,48,19,2,69
"45653",1045653,12,13,1,26
"45654",1045654,47,176,15,238
"45655",1045655,130,48,13,191
"45656",1045656,198,41,9,248
"45657",1045657,113,80,5,198
"45658",1045658,207,21,7,235
"45659",1045659,132,174,4,310
"45660",1045660,85,196,14,295
"45661",1045661,57,14,0,71
"45662",1045662,224,94,4,322
"45663",1045663,192,31,9,232
"45664",1045664,59,154,3,216
"45665",1045665,10,9,1,20
"45666",1045666,23,110,8,141
"45667",1045667,91,73,19,183
"45668",1045668,57,177,10,244
"45669",1045669,85,68,4,157
"45670",1045670,166,24,5,195
"45671",1045671,140,63,4,207
"45672",1045672,230,18,7,255
"45673",1045673,78,66,9,153
"45674",1045674,40,25,2,67
"45675",1045675,84,187,7,278
"45676",1045676,218,21,4,243
"45677",1045677,112,109,8,229
"45678",1045678,36,185,6,227
"45679",1045679,70,39,5,114
"45680",1045680,103,63,31,197
"45681",1045681,130,57,5,192
"45682",1045682,80,27,5,112
"45683",1045683,80,191,6,277
"45684",1045684,95,195,12,302
"45685",1045685,95,68,5,168
"45686",1045686,40,230,16,286
"45687",1045687,168,24,6,198
"45688",1045688,147,32,6,185
"45689",1045689,24,242,1,267
"45690",1045690,80,177,9,266
"45691",1045691,183,104,14,301
"45692",1045692,201,52,15,268
"45693",1045693,1,9,0,10
"45694",1045694,18,208,7,233
"45695",1045695,124,78,7,209
"45696",1045696,184,86,12,282
"45697",1045697,65,3,5,73
"45698",1045698,10,3,0,13
"45699",1045699,189,79,6,274
"45700",1045700,106,17,6,129
"45701",1045701,191,61,15,267
"45702",1045702,117,167,13,297
"45703",1045703,63,216,4,283
"45704",1045704,176,81,9,266
"45705",1045705,178,110,14,302
"45706",1045706,101,200,13,314
"45707",1045707,191,36,10,237
"45708",1045708,149,109,6,264
"45709",1045709,38,62,15,115
"45710",1045710,107,93,11,211
"45711",1045711,157,21,5,183
"45712",1045712,103,152,21,276
"45713",1045713,187,105,14,306
"45714",1045714,166,126,16,308
"45715",1045715,111,111,15,237
"45716",1045716,64,100,1,165
"45717",1045717,181,106,19,306
"45718",1045718,73,50,1,124
"45719",1045719,86,150,6,242
"45720",1045720,144,10,3,157
"45721",1045721,18,282,1,301
"45722",1045722,23,189,4,216
"45723",1045723,40,148,4,192
"45724",1045724,126,172,6,304
"45725",1045725,36,281,6,323
"45726",1045726,142,104,14,260
"45727",1045727,83,165,5,253
"45728",1045728,56,100,4,160
"45729",1045729,53,10,2,65
"45730",1045730,92,196,15,303
"45731",1045731,18,11,2,31
"45732",1045732,131,107,6,244
"45733",1045733,60,39,1,100
"45734",1045734,74,171,7,252
"45735",1045735,210,39,10,259
"45736",1045736,42,176,3,221
"45737",1045737,140,59,8,207
"45738",1045738,159,83,11,253
"45739",1045739,139,105,14,258
"45740",1045740,69,178,18,265
"45741",1045741,125,30,6,161
"45742",1045742,93,89,10,192
"45743",1045743,145,66,14,225
"45744",1045744,245,3,2,250
"45745",1045745,57,49,8,114
"45746",1045746,157,81,7,245
"45747",1045747,106,130,8,244
"45748",1045748,151,14,3,168
"45749",1045749,233,43,5,281
"45750",1045750,228,53,8,289
"45751",1045751,206,30,5,241
"45752",1045752,65,36,2,103
"45753",1045753,13,132,1,146
"45754",1045754,191,55,10,256
"45755",1045755,63,155,7,225
"45756",1045756,61,202,9,272
"45757",1045757,87,47,2,136
"45758",1045758,104,61,6,171
"45759",1045759,66,138,6,210
"45760",1045760,36,254,1,291
"45761",1045761,132,85,4,221
"45762",1045762,130,103,17,250
"45763",1045763,66,242,11,319
"45764",1045764,150,165,6,321
"45765",1045765,62,124,14,200
"45766",1045766,52,167,3,222
"45767",1045767,96,103,7,206
"45768",1045768,133,138,6,277
"45769",1045769,192,111,17,320
"45770",1045770,31,4,0,35
"45771",1045771,49,223,12,284
"45772",1045772,95,153,6,254
"45773",1045773,228,78,12,318
"45774",1045774,138,75,14,227
"45775",1045775,110,44,3,157
"45776",1045776,122,66,7,195
"45777",1045777,177,41,6,224
"45778",1045778,28,50,0,78
"45779",1045779,100,52,2,154
"45780",1045780,146,40,6,192
"45781",1045781,137,39,5,181
"45782",1045782,108,33,5,146
"45783",1045783,138,155,9,302
"45784",1045784,132,90,9,231
"45785",1045785,189,127,8,324
"45786",1045786,140,79,4,223
"45787",1045787,101,122,18,241
"45788",1045788,172,39,8,219
"45789",1045789,127,15,1,143
"45790",1045790,32,135,1,168
"45791",1045791,79,182,6,267
"45792",1045792,107,156,5,268
"45793",1045793,228,26,1,255
"45794",1045794,142,21,4,167
"45795",1045795,17,210,1,228
"45796",1045796,111,103,7,221
"45797",1045797,91,162,1,254
"45798",1045798,125,36,10,171
"45799",1045799,72,102,3,177
"45800",1045800,39,19,1,59
"45801",1045801,44,203,0,247
"45802",1045802,95,142,8,245
"45803",1045803,157,65,3,225
"45804",1045804,59,24,3,86
"45805",1045805,137,43,12,192
"45806",1045806,45,143,6,194
"45807",1045807,11,3,0,14
"45808",1045808,8,128,2,138
"45809",1045809,207,10,3,220
"45810",1045810,12,52,3,67
"45811",1045811,39,253,7,299
"45812",1045812,159,84,4,247
"45813",1045813,42,258,10,310
"45814",1045814,63,232,12,307
"45815",1045815,139,98,8,245
"45816",1045816,137,79,10,226
"45817",1045817,171,88,9,268
"45818",1045818,47,47,3,97
"45819",1045819,267,54,16,337
"45820",1045820,114,161,6,281
"45821",1045821,34,240,3,277
"45822",1045822,146,77,12,235
"45823",1045823,92,159,9,260
"45824",1045824,133,35,7,175
"45825",1045825,65,146,6,217
"45826",1045826,89,77,5,171
"45827",1045827,166,33,10,209
"45828",1045828,104,54,8,166
"45829",1045829,82,53,2,137
"45830",1045830,187,55,4,246
"45831",1045831,196,69,9,274
"45832",1045832,42,6,2,50
"45833",1045833,167,64,16,247
"45834",1045834,47,131,7,185
"45835",1045835,183,95,9,287
"45836",1045836,55,130,5,190
"45837",1045837,181,72,7,260
"45838",1045838,89,109,5,203
"45839",1045839,261,15,13,289
"45840",1045840,194,39,3,236
"45841",1045841,89,82,5,176
"45842",1045842,193,15,7,215
"45843",1045843,230,71,22,323
"45844",1045844,147,52,6,205
"45845",1045845,126,76,10,212
"45846",1045846,95,137,14,246
"45847",1045847,222,22,2,246
"45848",1045848,48,240,6,294
"45849",1045849,158,134,10,302
"45850",1045850,186,50,6,242
"45851",1045851,125,177,14,316
"45852",1045852,159,102,9,270
"45853",1045853,176,40,7,223
"45854",1045854,48,229,12,289
"45855",1045855,183,75,7,265
"45856",1045856,164,103,12,279
"45857",1045857,53,202,15,270
"45858",1045858,70,108,6,184
"45859",1045859,159,27,2,188
"45860",1045860,10,7,3,20
"45861",1045861,30,42,3,75
"45862",1045862,218,63,11,292
"45863",1045863,123,162,4,289
"45864",1045864,16,153,3,172
"45865",1045865,182,12,7,201
"45866",1045866,184,125,9,318
"45867",1045867,100,74,8,182
"45868",1045868,40,209,6,255
"45869",1045869,85,49,3,137
"45870",1045870,177,102,8,287
"45871",1045871,142,110,0,252
"45872",1045872,58,171,3,232
"45873",1045873,170,71,4,245
"45874",1045874,95,170,12,277
"45875",1045875,164,36,13,213
"45876",1045876,120,70,3,193
"45877",1045877,46,236,2,284
"45878",1045878,90,67,4,161
"45879",1045879,84,236,15,335
"45880",1045880,40,112,4,156
"45881",1045881,94,208,7,309
"45882",1045882,51,139,6,196
"45883",1045883,9,23,0,32
"45884",1045884,113,29,2,144
"45885",1045885,95,104,13,212
"45886",1045886,117,151,20,288
"45887",1045887,191,25,8,224
"45888",1045888,158,157,18,333
"45889",1045889,103,114,8,225
"45890",1045890,83,139,8,230
"45891",1045891,43,16,3,62
"45892",1045892,145,16,4,165
"45893",1045893,32,212,0,244
"45894",1045894,89,184,6,279
"45895",1045895,189,62,6,257
"45896",1045896,139,15,5,159
"45897",1045897,47,174,3,224
"45898",1045898,132,156,4,292
"45899",1045899,213,97,14,324
"45900",1045900,88,154,8,250
"45901",1045901,226,15,4,245
"45902",1045902,111,36,6,153
"45903",1045903,278,29,4,311
"45904",1045904,248,14,6,268
"45905",1045905,159,66,11,236
"45906",1045906,134,34,15,183
"45907",1045907,63,225,9,297
"45908",1045908,118,159,3,280
"45909",1045909,87,134,5,226
"45910",1045910,171,20,7,198
"45911",1045911,185,35,6,226
"45912",1045912,106,108,2,216
"45913",1045913,198,79,12,289
"45914",1045914,94,39,5,138
"45915",1045915,146,87,12,245
"45916",1045916,118,79,14,211
"45917",1045917,91,211,8,310
"45918",1045918,186,75,18,279
"45919",1045919,117,26,3,146
"45920",1045920,105,107,1,213
"45921",1045921,57,249,8,314
"45922",1045922,161,75,10,246
"45923",1045923,92,87,5,184
"45924",1045924,195,37,4,236
"45925",1045925,174,106,8,288
"45926",1045926,212,23,7,242
"45927",1045927,172,66,22,260
"45928",1045928,121,69,9,199
"45929",1045929,55,49,15,119
"45930",1045930,113,109,15,237
"45931",1045931,209,7,4,220
"45932",1045932,44,74,5,123
"45933",1045933,189,71,3,263
"45934",1045934,125,138,4,267
"45935",1045935,111,88,2,201
"45936",1045936,209,17,6,232
"45937",1045937,128,147,10,285
"45938",1045938,53,138,4,195
"45939",1045939,170,75,9,254
"45940",1045940,66,218,6,290
"45941",1045941,154,127,8,289
"45942",1045942,99,50,4,153
"45943",1045943,28,263,10,301
"45944",1045944,80,190,6,276
"45945",1045945,46,129,9,184
"45946",1045946,48,146,13,207
"45947",1045947,158,49,2,209
"45948",1045948,76,139,5,220
"45949",1045949,121,69,8,198
"45950",1045950,46,180,0,226
"45951",1045951,65,167,6,238
"45952",1045952,161,100,4,265
"45953",1045953,84,74,1,159
"45954",1045954,76,141,14,231
"45955",1045955,33,272,1,306
"45956",1045956,140,59,5,204
"45957",1045957,74,110,9,193
"45958",1045958,246,19,7,272
"45959",1045959,69,61,5,135
"45960",1045960,149,83,4,236
"45961",1045961,119,135,11,265
"45962",1045962,164,69,12,245
"45963",1045963,15,167,1,183
"45964",1045964,54,183,15,252
"45965",1045965,209,37,6,252
"45966",1045966,207,74,15,296
"45967",1045967,55,280,3,338
"45968",1045968,101,146,3,250
"45969",1045969,36,294,2,332
"45970",1045970,207,57,8,272
"45971",1045971,186,35,6,227
"45972",1045972,198,111,10,319
"45973",1045973,38,183,3,224
"45974",1045974,99,94,7,200
"45975",1045975,128,32,2,162
"45976",1045976,38,1,0,39
"45977",1045977,105,136,22,263
"45978",1045978,92,128,14,234
"45979",1045979,144,105,14,263
"45980",1045980,34,93,4,131
"45981",1045981,81,48,7,136
"45982",1045982,133,61,5,199
"45983",1045983,159,78,14,251
"45984",1045984,279,49,13,341
"45985",1045985,184,78,15,277
"45986",1045986,52,126,4,182
"45987",1045987,149,38,1,188
"45988",1045988,90,31,3,124
"45989",1045989,36,209,11,256
"45990",1045990,23,309,5,337
"45991",1045991,240,49,15,304
"45992",1045992,67,207,14,288
"45993",1045993,27,253,8,288
"45994",1045994,141,62,10,213
"45995",1045995,150,53,17,220
"45996",1045996,108,123,12,243
"45997",1045997,34,24,1,59
"45998",1045998,215,17,4,236
"45999",1045999,113,74,11,198
"46000",1046000,13,21,0,34
"46001",1046001,47,220,4,271
"46002",1046002,253,43,7,303
"46003",1046003,74,160,11,245
"46004",1046004,55,78,3,136
"46005",1046005,91,27,2,120
"46006",1046006,99,99,10,208
"46007",1046007,48,24,5,77
"46008",1046008,132,117,18,267
"46009",1046009,92,87,8,187
"46010",1046010,189,117,17,323
"46011",1046011,44,199,4,247
"46012",1046012,179,46,10,235
"46013",1046013,175,67,18,260
"46014",1046014,181,76,14,271
"46015",1046015,201,91,15,307
"46016",1046016,133,74,16,223
"46017",1046017,29,213,3,245
"46018",1046018,106,120,6,232
"46019",1046019,19,197,2,218
"46020",1046020,132,73,13,218
"46021",1046021,190,131,14,335
"46022",1046022,19,12,0,31
"46023",1046023,28,52,1,81
"46024",1046024,47,97,4,148
"46025",1046025,119,0,0,119
"46026",1046026,135,32,6,173
"46027",1046027,145,2,14,161
"46028",1046028,219,15,7,241
"46029",1046029,74,170,7,251
"46030",1046030,72,185,2,259
"46031",1046031,79,81,12,172
"46032",1046032,14,48,0,62
"46033",1046033,139,141,11,291
"46034",1046034,177,46,2,225
"46035",1046035,171,46,4,221
"46036",1046036,15,52,1,68
"46037",1046037,15,154,10,179
"46038",1046038,154,27,4,185
"46039",1046039,165,71,10,246
"46040",1046040,85,92,4,181
"46041",1046041,41,249,11,301
"46042",1046042,107,126,7,240
"46043",1046043,221,9,11,241
"46044",1046044,143,120,17,280
"46045",1046045,166,43,6,215
"46046",1046046,121,165,9,295
"46047",1046047,198,82,15,295
"46048",1046048,2,0,1,3
"46049",1046049,117,45,4,166
"46050",1046050,110,103,8,221
"46051",1046051,110,163,23,296
"46052",1046052,148,116,20,284
"46053",1046053,173,38,3,214
"46054",1046054,147,33,18,198
"46055",1046055,91,45,9,145
"46056",1046056,33,203,5,241
"46057",1046057,180,70,6,256
"46058",1046058,224,59,21,304
"46059",1046059,169,36,4,209
"46060",1046060,47,151,0,198
"46061",1046061,34,245,6,285
"46062",1046062,108,157,10,275
"46063",1046063,101,43,20,164
"46064",1046064,193,61,5,259
"46065",1046065,118,16,2,136
"46066",1046066,111,50,10,171
"46067",1046067,75,166,4,245
"46068",1046068,174,115,8,297
"46069",1046069,19,145,5,169
"46070",1046070,213,50,10,273
"46071",1046071,226,86,18,330
"46072",1046072,49,167,9,225
"46073",1046073,108,82,2,192
"46074",1046074,121,84,12,217
"46075",1046075,147,79,7,233
"46076",1046076,134,85,18,237
"46077",1046077,129,111,6,246
"46078",1046078,213,24,11,248
"46079",1046079,154,274,11,439
"46080",1046080,30,163,5,198
"46081",1046081,45,37,2,84
"46082",1046082,176,96,23,295
"46083",1046083,117,86,3,206
"46084",1046084,155,44,9,208
"46085",1046085,149,90,12,251
"46086",1046086,129,141,20,290
"46087",1046087,88,80,0,168
"46088",1046088,122,18,4,144
"46089",1046089,337,102,46,485
"46090",1046090,121,46,5,172
"46091",1046091,2,20,2,24
"46092",1046092,187,55,7,249
"46093",1046093,66,184,10,260
"46094",1046094,44,33,2,79
"46095",1046095,17,13,4,34
"46096",1046096,144,67,14,225
"46097",1046097,68,152,11,231
"46098",1046098,48,105,8,161
"46099",1046099,53,47,1,101
"46100",1046100,74,46,4,124
"46101",1046101,48,181,7,236
"46102",1046102,83,130,7,220
"46103",1046103,110,27,3,140
"46104",1046104,45,193,6,244
"46105",1046105,93,54,15,162
"46106",1046106,114,146,10,270
"46107",1046107,113,108,7,228
"46108",1046108,12,241,6,259
"46109",1046109,108,34,9,151
"46110",1046110,108,65,9,182
"46111",1046111,46,22,0,68
"46112",1046112,33,128,9,170
"46113",1046113,58,225,15,298
"46114",1046114,273,11,6,290
"46115",1046115,9,7,0,16
"46116",1046116,56,49,4,109
"46117",1046117,86,193,3,282
"46118",1046118,72,122,24,218
"46119",1046119,4,1,0,5
"46120",1046120,91,147,5,243
"46121",1046121,100,78,10,188
"46122",1046122,116,38,6,160
"46123",1046123,143,137,17,297
"46124",1046124,145,89,2,236
"46125",1046125,15,189,3,207
"46126",1046126,110,154,6,270
"46127",1046127,92,172,11,275
"46128",1046128,225,39,16,280
"46129",1046129,222,66,23,311
"46130",1046130,6,9,2,17
"46131",1046131,127,148,18,293
"46132",1046132,18,90,12,120
"46133",1046133,76,127,1,204
"46134",1046134,125,94,11,230
"46135",1046135,102,27,2,131
"46136",1046136,48,184,5,237
"46137",1046137,48,43,5,96
"46138",1046138,113,201,5,319
"46139",1046139,152,61,5,218
"46140",1046140,173,11,8,192
"46141",1046141,118,166,4,288
"46142",1046142,129,49,3,181
"46143",1046143,136,103,6,245
"46144",1046144,142,174,6,322
"46145",1046145,5,16,1,22
"46146",1046146,113,48,6,167
"46147",1046147,92,92,6,190
"46148",1046148,51,50,4,105
"46149",1046149,46,254,7,307
"46150",1046150,121,74,4,199
"46151",1046151,203,85,15,303
"46152",1046152,30,38,5,73
"46153",1046153,41,165,5,211
"46154",1046154,218,76,8,302
"46155",1046155,126,51,7,184
"46156",1046156,171,99,10,280
"46157",1046157,29,9,5,43
"46158",1046158,73,195,18,286
"46159",1046159,115,106,11,232
"46160",1046160,48,167,6,221
"46161",1046161,148,125,4,277
"46162",1046162,60,190,9,259
"46163",1046163,269,20,2,291
"46164",1046164,30,225,2,257
"46165",1046165,108,18,3,129
"46166",1046166,128,75,5,208
"46167",1046167,141,40,10,191
"46168",1046168,47,74,6,127
"46169",1046169,116,68,1,185
"46170",1046170,121,192,20,333
"46171",1046171,195,36,12,243
"46172",1046172,119,102,6,227
"46173",1046173,149,145,10,304
"46174",1046174,14,10,2,26
"46175",1046175,172,44,8,224
"46176",1046176,44,146,4,194
"46177",1046177,20,61,3,84
"46178",1046178,118,45,14,177
"46179",1046179,151,33,5,189
"46180",1046180,104,30,0,134
"46181",1046181,42,196,2,240
"46182",1046182,35,204,17,256
"46183",1046183,100,163,18,281
"46184",1046184,102,61,6,169
"46185",1046185,22,178,1,201
"46186",1046186,106,84,25,215
"46187",1046187,27,22,2,51
"46188",1046188,47,45,2,94
"46189",1046189,107,48,11,166
"46190",1046190,117,151,1,269
"46191",1046191,40,242,6,288
"46192",1046192,99,5,1,105
"46193",1046193,120,68,17,205
"46194",1046194,120,117,20,257
"46195",1046195,81,66,12,159
"46196",1046196,60,40,2,102
"46197",1046197,116,27,7,150
"46198",1046198,204,50,9,263
"46199",1046199,13,18,1,32
"46200",1046200,34,138,3,175
"46201",1046201,179,92,4,275
"46202",1046202,81,52,3,136
"46203",1046203,167,67,16,250
"46204",1046204,212,36,6,254
"46205",1046205,7,7,1,15
"46206",1046206,127,18,5,150
"46207",1046207,49,138,2,189
"46208",1046208,51,147,5,203
"46209",1046209,177,101,11,289
"46210",1046210,91,113,14,218
"46211",1046211,25,173,6,204
"46212",1046212,184,88,12,284
"46213",1046213,211,72,16,299
"46214",1046214,205,28,5,238
"46215",1046215,132,2,6,140
"46216",1046216,62,109,0,171
"46217",1046217,134,35,4,173
"46218",1046218,108,19,0,127
"46219",1046219,191,85,28,304
"46220",1046220,41,147,4,192
"46221",1046221,122,91,8,221
"46222",1046222,7,2,0,9
"46223",1046223,22,8,1,31
"46224",1046224,144,52,8,204
"46225",1046225,76,225,6,307
"46226",1046226,178,78,3,259
"46227",1046227,98,20,6,124
"46228",1046228,97,171,6,274
"46229",1046229,150,28,8,186
"46230",1046230,140,53,12,205
"46231",1046231,178,116,10,304
"46232",1046232,100,120,11,231
"46233",1046233,149,66,9,224
"46234",1046234,45,90,12,147
"46235",1046235,198,86,15,299
"46236",1046236,56,98,6,160
"46237",1046237,80,70,10,160
"46238",1046238,138,38,4,180
"46239",1046239,96,141,4,241
"46240",1046240,83,124,7,214
"46241",1046241,113,15,3,131
"46242",1046242,116,203,20,339
"46243",1046243,77,234,8,319
"46244",1046244,139,19,4,162
"46245",1046245,54,176,18,248
"46246",1046246,189,63,11,263
"46247",1046247,188,38,5,231
"46248",1046248,139,34,4,177
"46249",1046249,6,64,1,71
"46250",1046250,231,9,1,241
"46251",1046251,107,106,4,217
"46252",1046252,127,12,5,144
"46253",1046253,131,110,6,247
"46254",1046254,344,103,32,479
"46255",1046255,124,68,14,206
"46256",1046256,93,118,4,215
"46257",1046257,15,283,3,301
"46258",1046258,67,80,1,148
"46259",1046259,68,201,10,279
"46260",1046260,78,115,14,207
"46261",1046261,41,71,5,117
"46262",1046262,3,6,0,9
"46263",1046263,161,33,3,197
"46264",1046264,98,104,15,217
"46265",1046265,165,50,12,227
"46266",1046266,121,128,5,254
"46267",1046267,102,176,6,284
"46268",1046268,97,110,9,216
"46269",1046269,174,68,6,248
"46270",1046270,165,45,1,211
"46271",1046271,188,107,15,310
"46272",1046272,94,65,6,165
"46273",1046273,181,33,9,223
"46274",1046274,121,126,0,247
"46275",1046275,123,93,10,226
"46276",1046276,61,200,11,272
"46277",1046277,85,18,3,106
"46278",1046278,203,96,10,309
"46279",1046279,46,263,2,311
"46280",1046280,196,17,9,222
"46281",1046281,156,42,14,212
"46282",1046282,35,57,2,94
"46283",1046283,123,89,2,214
"46284",1046284,32,101,2,135
"46285",1046285,21,10,0,31
"46286",1046286,175,47,10,232
"46287",1046287,71,111,5,187
"46288",1046288,6,2,1,9
"46289",1046289,227,17,13,257
"46290",1046290,97,168,8,273
"46291",1046291,58,128,3,189
"46292",1046292,174,53,21,248
"46293",1046293,139,63,15,217
"46294",1046294,213,81,13,307
"46295",1046295,81,28,3,112
"46296",1046296,63,133,3,199
"46297",1046297,32,218,25,275
"46298",1046298,113,142,8,263
"46299",1046299,49,179,8,236
"46300",1046300,74,166,7,247
"46301",1046301,145,60,3,208
"46302",1046302,73,122,4,199
"46303",1046303,21,44,6,71
"46304",1046304,5,23,0,28
"46305",1046305,125,73,6,204
"46306",1046306,25,206,5,236
"46307",1046307,152,133,4,289
"46308",1046308,97,167,14,278
"46309",1046309,72,126,4,202
"46310",1046310,242,46,9,297
"46311",1046311,128,105,5,238
"46312",1046312,62,46,5,113
"46313",1046313,155,44,12,211
"46314",1046314,155,58,7,220
"46315",1046315,123,145,3,271
"46316",1046316,44,46,0,90
"46317",1046317,155,74,6,235
"46318",1046318,77,185,3,265
"46319",1046319,27,173,5,205
"46320",1046320,194,78,1,273
"46321",1046321,33,191,3,227
"46322",1046322,182,76,16,274
"46323",1046323,90,170,10,270
"46324",1046324,48,190,13,251
"46325",1046325,17,83,1,101
"46326",1046326,227,53,13,293
"46327",1046327,121,177,10,308
"46328",1046328,114,17,1,132
"46329",1046329,33,270,5,308
"46330",1046330,26,219,7,252
"46331",1046331,69,167,6,242
"46332",1046332,153,18,4,175
"46333",1046333,173,79,9,261
"46334",1046334,163,22,6,191
"46335",1046335,51,305,1,357
"46336",1046336,108,166,14,288
"46337",1046337,24,43,0,67
"46338",1046338,105,55,9,169
"46339",1046339,61,217,10,288
"46340",1046340,135,80,8,223
"46341",1046341,134,47,10,191
"46342",1046342,126,77,4,207
"46343",1046343,105,118,11,234
"46344",1046344,118,39,10,167
"46345",1046345,0,1,0,1
"46346",1046346,98,153,7,258
"46347",1046347,90,194,2,286
"46348",1046348,155,61,12,228
"46349",1046349,28,254,14,296
"46350",1046350,195,33,5,233
"46351",1046351,7,33,1,41
"46352",1046352,158,108,12,278
"46353",1046353,65,163,6,234
"46354",1046354,117,105,3,225
"46355",1046355,83,187,11,281
"46356",1046356,74,155,7,236
"46357",1046357,31,219,9,259
"46358",1046358,97,148,7,252
"46359",1046359,8,16,1,25
"46360",1046360,71,166,18,255
"46361",1046361,66,29,0,95
"46362",1046362,164,73,6,243
"46363",1046363,62,138,6,206
"46364",1046364,87,136,3,226
"46365",1046365,116,174,9,299
"46366",1046366,89,174,12,275
"46367",1046367,107,151,4,262
"46368",1046368,93,125,15,233
"46369",1046369,150,90,4,244
"46370",1046370,193,55,8,256
"46371",1046371,42,11,0,53
"46372",1046372,17,14,0,31
"46373",1046373,172,47,8,227
"46374",1046374,67,151,6,224
"46375",1046375,98,41,8,147
"46376",1046376,58,101,12,171
"46377",1046377,68,132,9,209
"46378",1046378,98,170,9,277
"46379",1046379,68,221,6,295
"46380",1046380,267,21,10,298
"46381",1046381,101,22,4,127
"46382",1046382,156,96,7,259
"46383",1046383,106,135,21,262
"46384",1046384,181,97,15,293
"46385",1046385,140,128,12,280
"46386",1046386,23,153,3,179
"46387",1046387,129,36,7,172
"46388",1046388,100,88,6,194
"46389",1046389,147,118,13,278
"46390",1046390,47,243,5,295
"46391",1046391,207,54,8,269
"46392",1046392,83,154,17,254
"46393",1046393,127,254,11,392
"46394",1046394,91,221,11,323
"46395",1046395,215,55,10,280
"46396",1046396,118,132,3,253
"46397",1046397,10,141,1,152
"46398",1046398,36,239,1,276
"46399",1046399,82,174,17,273
"46400",1046400,70,104,2,176
"46401",1046401,183,24,8,215
"46402",1046402,166,24,7,197
"46403",1046403,85,185,12,282
"46404",1046404,102,51,4,157
"46405",1046405,257,9,2,268
"46406",1046406,173,65,9,247
"46407",1046407,123,129,2,254
"46408",1046408,57,203,21,281
"46409",1046409,63,225,6,294
"46410",1046410,194,53,9,256
"46411",1046411,71,100,0,171
"46412",1046412,13,1,2,16
"46413",1046413,188,23,4,215
"46414",1046414,52,37,4,93
"46415",1046415,137,85,3,225
"46416",1046416,161,2,1,164
"46417",1046417,36,107,3,146
"46418",1046418,142,67,5,214
"46419",1046419,11,5,2,18
"46420",1046420,51,165,9,225
"46421",1046421,112,12,4,128
"46422",1046422,155,62,5,222
"46423",1046423,56,64,8,128
"46424",1046424,77,107,3,187
"46425",1046425,132,49,4,185
"46426",1046426,126,53,2,181
"46427",1046427,100,107,19,226
"46428",1046428,208,15,1,224
"46429",1046429,184,42,12,238
"46430",1046430,199,70,24,293
"46431",1046431,168,88,14,270
"46432",1046432,45,78,5,128
"46433",1046433,146,46,4,196
"46434",1046434,103,148,5,256
"46435",1046435,50,51,1,102
"46436",1046436,112,34,6,152
"46437",1046437,11,41,0,52
"46438",1046438,9,26,0,35
"46439",1046439,186,102,28,316
"46440",1046440,245,2,11,258
"46441",1046441,282,40,15,337
"46442",1046442,228,14,7,249
"46443",1046443,52,216,15,283
"46444",1046444,144,79,9,232
"46445",1046445,12,66,0,78
"46446",1046446,88,240,17,345
"46447",1046447,114,102,8,224
"46448",1046448,45,191,7,243
"46449",1046449,154,42,2,198
"46450",1046450,28,10,1,39
"46451",1046451,56,158,5,219
"46452",1046452,3,12,0,15
"46453",1046453,137,67,7,211
"46454",1046454,84,206,14,304
"46455",1046455,118,73,5,196
"46456",1046456,180,78,4,262
"46457",1046457,108,41,4,153
"46458",1046458,159,58,6,223
"46459",1046459,188,79,14,281
"46460",1046460,44,264,10,318
"46461",1046461,96,75,6,177
"46462",1046462,76,152,4,232
"46463",1046463,97,175,5,277
"46464",1046464,74,104,8,186
"46465",1046465,155,58,7,220
"46466",1046466,90,55,4,149
"46467",1046467,119,113,13,245
"46468",1046468,109,50,2,161
"46469",1046469,14,272,5,291
"46470",1046470,60,256,4,320
"46471",1046471,175,31,9,215
"46472",1046472,152,134,22,308
"46473",1046473,152,29,1,182
"46474",1046474,121,72,9,202
"46475",1046475,46,196,4,246
"46476",1046476,102,194,5,301
"46477",1046477,187,110,8,305
"46478",1046478,131,141,23,295
"46479",1046479,137,116,5,258
"46480",1046480,164,98,13,275
"46481",1046481,183,33,7,223
"46482",1046482,99,36,2,137
"46483",1046483,54,76,2,132
"46484",1046484,56,180,4,240
"46485",1046485,28,76,3,107
"46486",1046486,173,94,11,278
"46487",1046487,48,8,3,59
"46488",1046488,132,130,7,269
"46489",1046489,48,115,3,166
"46490",1046490,85,212,18,315
"46491",1046491,100,179,5,284
"46492",1046492,226,22,7,255
"46493",1046493,117,18,5,140
"46494",1046494,75,25,2,102
"46495",1046495,123,135,9,267
"46496",1046496,12,72,1,85
"46497",1046497,24,220,7,251
"46498",1046498,78,44,6,128
"46499",1046499,106,184,8,298
"46500",1046500,60,93,2,155
"46501",1046501,103,158,17,278
"46502",1046502,29,234,4,267
"46503",1046503,91,73,7,171
"46504",1046504,81,201,15,297
"46505",1046505,183,0,0,183
"46506",1046506,158,65,4,227
"46507",1046507,43,245,11,299
"46508",1046508,163,87,16,266
"46509",1046509,129,149,13,291
"46510",1046510,87,153,8,248
"46511",1046511,85,81,18,184
"46512",1046512,45,200,1,246
"46513",1046513,113,48,8,169
"46514",1046514,161,68,6,235
"46515",1046515,101,110,11,222
"46516",1046516,150,106,8,264
"46517",1046517,82,221,2,305
"46518",1046518,111,99,4,214
"46519",1046519,129,65,5,199
"46520",1046520,150,132,6,288
"46521",1046521,144,58,9,211
"46522",1046522,79,175,13,267
"46523",1046523,74,223,4,301
"46524",1046524,278,5,6,289
"46525",1046525,166,79,12,257
"46526",1046526,53,127,9,189
"46527",1046527,114,52,3,169
"46528",1046528,139,67,9,215
"46529",1046529,213,47,3,263
"46530",1046530,129,42,11,182
"46531",1046531,183,141,12,336
"46532",1046532,83,178,11,272
"46533",1046533,231,16,3,250
"46534",1046534,147,77,10,234
"46535",1046535,73,181,7,261
"46536",1046536,53,198,5,256
"46537",1046537,163,41,5,209
"46538",1046538,52,142,5,199
"46539",1046539,44,11,0,55
"46540",1046540,174,68,10,252
"46541",1046541,172,95,9,276
"46542",1046542,88,73,8,169
"46543",1046543,183,71,17,271
"46544",1046544,114,21,2,137
"46545",1046545,142,95,12,249
"46546",1046546,145,71,7,223
"46547",1046547,118,22,3,143
"46548",1046548,106,137,13,256
"46549",1046549,247,48,16,311
"46550",1046550,117,88,2,207
"46551",1046551,104,132,5,241
"46552",1046552,65,200,5,270
"46553",1046553,94,34,5,133
"46554",1046554,76,12,1,89
"46555",1046555,141,67,6,214
"46556",1046556,179,85,15,279
"46557",1046557,212,107,10,329
"46558",1046558,54,62,4,120
"46559",1046559,161,60,2,223
"46560",1046560,170,75,8,253
"46561",1046561,190,18,8,216
"46562",1046562,238,24,4,266
"46563",1046563,144,163,10,317
"46564",1046564,33,270,2,305
"46565",1046565,65,55,5,125
"46566",1046566,176,98,8,282
"46567",1046567,128,118,9,255
"46568",1046568,151,62,6,219
"46569",1046569,93,115,1,209
"46570",1046570,193,56,2,251
"46571",1046571,171,122,13,306
"46572",1046572,42,24,2,68
"46573",1046573,145,96,25,266
"46574",1046574,47,242,16,305
"46575",1046575,42,156,9,207
"46576",1046576,203,72,20,295
"46577",1046577,156,95,7,258
"46578",1046578,185,90,8,283
"46579",1046579,164,55,16,235
"46580",1046580,168,98,1,267
"46581",1046581,114,82,9,205
"46582",1046582,134,15,4,153
"46583",1046583,151,8,3,162
"46584",1046584,73,179,19,271
"46585",1046585,96,178,9,283
"46586",1046586,69,180,9,258
"46587",1046587,102,89,8,199
"46588",1046588,134,96,7,237
"46589",1046589,90,200,5,295
"46590",1046590,136,84,5,225
"46591",1046591,224,34,7,265
"46592",1046592,182,35,6,223
"46593",1046593,40,33,1,74
"46594",1046594,78,167,1,246
"46595",1046595,145,120,15,280
"46596",1046596,55,19,11,85
"46597",1046597,12,0,0,12
"46598",1046598,7,10,0,17
"46599",1046599,153,82,15,250
"46600",1046600,50,115,7,172
"46601",1046601,57,134,3,194
"46602",1046602,187,90,12,289
"46603",1046603,141,45,5,191
"46604",1046604,146,27,0,173
"46605",1046605,199,31,8,238
"46606",1046606,35,173,2,210
"46607",1046607,127,101,3,231
"46608",1046608,116,98,7,221
"46609",1046609,173,19,5,197
"46610",1046610,133,58,6,197
"46611",1046611,107,183,9,299
"46612",1046612,204,25,4,233
"46613",1046613,117,34,10,161
"46614",1046614,90,65,7,162
"46615",1046615,150,116,10,276
"46616",1046616,200,60,12,272
"46617",1046617,137,85,7,229
"46618",1046618,16,340,5,361
"46619",1046619,213,302,23,538
"46620",1046620,158,36,16,210
"46621",1046621,39,223,3,265
"46622",1046622,53,151,2,206
"46623",1046623,264,7,3,274
"46624",1046624,134,171,13,318
"46625",1046625,150,35,6,191
"46626",1046626,55,94,1,150
"46627",1046627,39,35,1,75
"46628",1046628,97,87,12,196
"46629",1046629,69,161,7,237
"46630",1046630,82,146,10,238
"46631",1046631,144,103,13,260
"46632",1046632,93,49,6,148
"46633",1046633,30,222,2,254
"46634",1046634,78,130,12,220
"46635",1046635,166,111,4,281
"46636",1046636,73,123,9,205
"46637",1046637,2,6,0,8
"46638",1046638,131,166,5,302
"46639",1046639,116,149,23,288
"46640",1046640,165,50,8,223
"46641",1046641,15,86,3,104
"46642",1046642,20,9,2,31
"46643",1046643,85,187,10,282
"46644",1046644,137,147,23,307
"46645",1046645,209,29,2,240
"46646",1046646,11,25,0,36
"46647",1046647,48,183,8,239
"46648",1046648,104,170,8,282
"46649",1046649,41,88,5,134
"46650",1046650,217,18,6,241
"46651",1046651,176,63,7,246
"46652",1046652,165,49,3,217
"46653",1046653,91,98,4,193
"46654",1046654,46,211,18,275
"46655",1046655,169,132,15,316
"46656",1046656,82,144,7,233
"46657",1046657,74,51,3,128
"46658",1046658,136,165,5,306
"46659",1046659,306,10,5,321
"46660",1046660,205,19,4,228
"46661",1046661,29,199,4,232
"46662",1046662,206,48,6,260
"46663",1046663,82,21,1,104
"46664",1046664,103,120,7,230
"46665",1046665,123,80,13,216
"46666",1046666,265,46,20,331
"46667",1046667,188,23,6,217
"46668",1046668,145,89,13,247
"46669",1046669,59,100,10,169
"46670",1046670,103,71,15,189
"46671",1046671,139,87,6,232
"46672",1046672,11,48,4,63
"46673",1046673,151,32,4,187
"46674",1046674,74,161,3,238
"46675",1046675,73,225,2,300
"46676",1046676,115,144,14,273
"46677",1046677,146,128,22,296
"46678",1046678,123,170,16,309
"46679",1046679,152,121,26,299
"46680",1046680,119,153,6,278
"46681",1046681,62,144,8,214
"46682",1046682,13,62,3,78
"46683",1046683,124,56,6,186
"46684",1046684,67,237,6,310
"46685",1046685,147,169,15,331
"46686",1046686,110,140,4,254
"46687",1046687,98,154,11,263
"46688",1046688,144,110,12,266
"46689",1046689,68,197,5,270
"46690",1046690,145,123,11,279
"46691",1046691,76,93,14,183
"46692",1046692,78,214,4,296
"46693",1046693,23,6,1,30
"46694",1046694,88,29,9,126
"46695",1046695,135,122,7,264
"46696",1046696,14,10,1,25
"46697",1046697,85,122,11,218
"46698",1046698,197,82,14,293
"46699",1046699,139,26,3,168
"46700",1046700,184,30,7,221
"46701",1046701,139,140,28,307
"46702",1046702,111,102,10,223
"46703",1046703,193,67,10,270
"46704",1046704,84,160,14,258
"46705",1046705,97,125,2,224
"46706",1046706,100,136,4,240
"46707",1046707,81,44,6,131
"46708",1046708,88,159,4,251
"46709",1046709,83,43,11,137
"46710",1046710,185,43,16,244
"46711",1046711,77,174,4,255
"46712",1046712,74,176,16,266
"46713",1046713,102,210,13,325
"46714",1046714,92,88,16,196
"46715",1046715,60,175,5,240
"46716",1046716,34,74,1,109
"46717",1046717,139,72,10,221
"46718",1046718,34,102,2,138
"46719",1046719,119,64,10,193
"46720",1046720,61,150,3,214
"46721",1046721,30,185,3,218
"46722",1046722,65,77,8,150
"46723",1046723,110,151,6,267
"46724",1046724,108,20,3,131
"46725",1046725,54,192,8,254
"46726",1046726,102,110,13,225
"46727",1046727,81,185,13,279
"46728",1046728,96,152,3,251
"46729",1046729,88,6,3,97
"46730",1046730,81,196,4,281
"46731",1046731,139,59,8,206
"46732",1046732,45,199,2,246
"46733",1046733,169,33,5,207
"46734",1046734,139,40,5,184
"46735",1046735,201,85,16,302
"46736",1046736,222,85,13,320
"46737",1046737,132,56,39,227
"46738",1046738,129,172,4,305
"46739",1046739,84,166,12,262
"46740",1046740,132,48,5,185
"46741",1046741,96,146,33,275
"46742",1046742,139,67,7,213
"46743",1046743,102,159,4,265
"46744",1046744,69,7,2,78
"46745",1046745,89,4,0,93
"46746",1046746,166,28,5,199
"46747",1046747,58,245,1,304
"46748",1046748,131,55,10,196
"46749",1046749,118,156,17,291
"46750",1046750,112,77,9,198
"46751",1046751,182,31,8,221
"46752",1046752,30,79,2,111
"46753",1046753,141,90,8,239
"46754",1046754,96,114,13,223
"46755",1046755,97,197,18,312
"46756",1046756,73,187,10,270
"46757",1046757,153,27,9,189
"46758",1046758,139,43,11,193
"46759",1046759,169,44,4,217
"46760",1046760,252,29,4,285
"46761",1046761,111,179,12,302
"46762",1046762,86,87,2,175
"46763",1046763,85,203,5,293
"46764",1046764,63,27,0,90
"46765",1046765,60,32,4,96
"46766",1046766,135,134,17,286
"46767",1046767,188,22,4,214
"46768",1046768,148,25,4,177
"46769",1046769,225,20,1,246
"46770",1046770,132,58,14,204
"46771",1046771,63,192,4,259
"46772",1046772,214,30,12,256
"46773",1046773,70,158,7,235
"46774",1046774,46,189,7,242
"46775",1046775,61,40,6,107
"46776",1046776,63,136,7,206
"46777",1046777,42,69,5,116
"46778",1046778,66,217,6,289
"46779",1046779,132,55,16,203
"46780",1046780,202,90,15,307
"46781",1046781,200,46,0,246
"46782",1046782,114,129,11,254
"46783",1046783,163,43,4,210
"46784",1046784,124,165,10,299
"46785",1046785,90,154,13,257
"46786",1046786,144,24,5,173
"46787",1046787,170,41,11,222
"46788",1046788,73,119,20,212
"46789",1046789,165,87,7,259
"46790",1046790,190,28,6,224
"46791",1046791,79,202,13,294
"46792",1046792,98,134,12,244
"46793",1046793,91,7,0,98
"46794",1046794,33,183,4,220
"46795",1046795,43,205,3,251
"46796",1046796,164,39,11,214
"46797",1046797,86,71,2,159
"46798",1046798,168,0,0,168
"46799",1046799,42,130,6,178
"46800",1046800,70,187,4,261
"46801",1046801,74,117,6,197
"46802",1046802,183,73,7,263
"46803",1046803,167,54,2,223
"46804",1046804,148,67,12,227
"46805",1046805,109,28,8,145
"46806",1046806,72,230,7,309
"46807",1046807,136,107,5,248
"46808",1046808,197,29,7,233
"46809",1046809,158,115,20,293
"46810",1046810,54,291,4,349
"46811",1046811,51,227,10,288
"46812",1046812,27,132,7,166
"46813",1046813,47,140,1,188
"46814",1046814,266,25,13,304
"46815",1046815,138,116,12,266
"46816",1046816,53,134,5,192
"46817",1046817,52,33,2,87
"46818",1046818,118,75,12,205
"46819",1046819,110,19,7,136
"46820",1046820,79,152,11,242
"46821",1046821,144,81,5,230
"46822",1046822,148,49,8,205
"46823",1046823,193,60,11,264
"46824",1046824,202,15,4,221
"46825",1046825,202,21,9,232
"46826",1046826,12,5,1,18
"46827",1046827,82,150,18,250
"46828",1046828,56,192,6,254
"46829",1046829,142,79,15,236
"46830",1046830,106,56,6,168
"46831",1046831,11,356,3,370
"46832",1046832,119,58,6,183
"46833",1046833,2,10,2,14
"46834",1046834,84,185,8,277
"46835",1046835,79,144,32,255
"46836",1046836,201,26,2,229
"46837",1046837,210,47,11,268
"46838",1046838,122,39,7,168
"46839",1046839,10,266,2,278
"46840",1046840,119,114,6,239
"46841",1046841,36,86,2,124
"46842",1046842,103,188,10,301
"46843",1046843,168,86,17,271
"46844",1046844,34,157,3,194
"46845",1046845,174,36,8,218
"46846",1046846,172,7,4,183
"46847",1046847,55,208,7,270
"46848",1046848,114,152,4,270
"46849",1046849,128,97,6,231
"46850",1046850,146,62,3,211
"46851",1046851,156,92,13,261
"46852",1046852,81,127,12,220
"46853",1046853,198,94,12,304
"46854",1046854,185,33,3,221
"46855",1046855,279,21,6,306
"46856",1046856,79,186,10,275
"46857",1046857,205,78,15,298
"46858",1046858,65,93,5,163
"46859",1046859,166,80,19,265
"46860",1046860,54,134,7,195
"46861",1046861,94,157,11,262
"46862",1046862,171,118,5,294
"46863",1046863,72,185,24,281
"46864",1046864,133,104,13,250
"46865",1046865,83,36,3,122
"46866",1046866,56,177,7,240
"46867",1046867,81,207,12,300
"46868",1046868,33,62,5,100
"46869",1046869,124,27,5,156
"46870",1046870,54,121,13,188
"46871",1046871,120,78,15,213
"46872",1046872,170,61,0,231
"46873",1046873,216,86,8,310
"46874",1046874,141,136,10,287
"46875",1046875,144,154,14,312
"46876",1046876,227,40,8,275
"46877",1046877,197,20,4,221
"46878",1046878,139,120,6,265
"46879",1046879,53,210,10,273
"46880",1046880,81,188,18,287
"46881",1046881,131,0,0,131
"46882",1046882,149,54,3,206
"46883",1046883,53,198,1,252
"46884",1046884,178,55,6,239
"46885",1046885,92,80,6,178
"46886",1046886,129,119,24,272
"46887",1046887,163,134,12,309
"46888",1046888,19,23,4,46
"46889",1046889,6,67,0,73
"46890",1046890,253,79,10,342
"46891",1046891,184,83,10,277
"46892",1046892,158,97,15,270
"46893",1046893,146,60,3,209
"46894",1046894,234,30,7,271
"46895",1046895,202,21,3,226
"46896",1046896,110,60,6,176
"46897",1046897,180,43,9,232
"46898",1046898,110,146,9,265
"46899",1046899,127,45,9,181
"46900",1046900,107,166,21,294
"46901",1046901,339,12,0,351
"46902",1046902,162,63,3,228
"46903",1046903,127,15,16,158
"46904",1046904,161,93,4,258
"46905",1046905,101,34,1,136
"46906",1046906,74,18,2,94
"46907",1046907,77,24,2,103
"46908",1046908,146,129,5,280
"46909",1046909,205,85,11,301
"46910",1046910,107,89,7,203
"46911",1046911,159,38,2,199
"46912",1046912,154,51,9,214
"46913",1046913,165,105,13,283
"46914",1046914,158,60,20,238
"46915",1046915,123,58,7,188
"46916",1046916,109,61,12,182
"46917",1046917,61,28,5,94
"46918",1046918,188,103,16,307
"46919",1046919,52,108,4,164
"46920",1046920,196,50,9,255
"46921",1046921,182,92,17,291
"46922",1046922,97,74,14,185
"46923",1046923,81,211,10,302
"46924",1046924,52,72,5,129
"46925",1046925,78,168,1,247
"46926",1046926,51,216,8,275
"46927",1046927,77,71,2,150
"46928",1046928,131,70,7,208
"46929",1046929,86,145,7,238
"46930",1046930,77,168,12,257
"46931",1046931,186,18,2,206
"46932",1046932,56,124,8,188
"46933",1046933,128,141,15,284
"46934",1046934,12,3,1,16
"46935",1046935,169,110,8,287
"46936",1046936,1,8,0,9
"46937",1046937,170,67,2,239
"46938",1046938,67,104,7,178
"46939",1046939,62,118,3,183
"46940",1046940,63,169,15,247
"46941",1046941,72,18,2,92
"46942",1046942,5,3,1,9
"46943",1046943,144,156,15,315
"46944",1046944,161,39,6,206
"46945",1046945,95,10,5,110
"46946",1046946,41,235,4,280
"46947",1046947,138,117,12,267
"46948",1046948,45,95,4,144
"46949",1046949,91,167,6,264
"46950",1046950,41,196,3,240
"46951",1046951,36,244,1,281
"46952",1046952,17,9,1,27
"46953",1046953,75,166,8,249
"46954",1046954,125,44,11,180
"46955",1046955,139,57,7,203
"46956",1046956,79,219,19,317
"46957",1046957,134,123,8,265
"46958",1046958,15,123,3,141
"46959",1046959,155,77,10,242
"46960",1046960,206,57,8,271
"46961",1046961,181,13,5,199
"46962",1046962,65,218,3,286
"46963",1046963,19,3,0,22
"46964",1046964,182,53,3,238
"46965",1046965,145,70,6,221
"46966",1046966,60,124,5,189
"46967",1046967,55,129,4,188
"46968",1046968,134,93,7,234
"46969",1046969,173,23,5,201
"46970",1046970,29,253,3,285
"46971",1046971,186,80,11,277
"46972",1046972,46,247,13,306
"46973",1046973,45,241,8,294
"46974",1046974,178,39,7,224
"46975",1046975,73,209,13,295
"46976",1046976,160,50,6,216
"46977",1046977,49,114,7,170
"46978",1046978,73,87,3,163
"46979",1046979,110,94,3,207
"46980",1046980,129,79,10,218
"46981",1046981,121,166,10,297
"46982",1046982,94,146,11,251
"46983",1046983,29,256,2,287
"46984",1046984,106,72,8,186
"46985",1046985,157,37,8,202
"46986",1046986,168,34,5,207
"46987",1046987,227,46,12,285
"46988",1046988,47,125,4,176
"46989",1046989,177,86,9,272
"46990",1046990,67,226,3,296
"46991",1046991,93,122,8,223
"46992",1046992,10,21,2,33
"46993",1046993,102,151,14,267
"46994",1046994,138,80,1,219
"46995",1046995,151,75,17,243
"46996",1046996,186,18,12,216
"46997",1046997,179,96,13,288
"46998",1046998,208,79,8,295
"46999",1046999,117,120,1,238
"47000",1047000,139,86,11,236
"47001",1047001,41,43,1,85
"47002",1047002,71,141,14,226
"47003",1047003,179,31,3,213
"47004",1047004,131,142,10,283
"47005",1047005,251,39,6,296
"47006",1047006,71,185,10,266
"47007",1047007,188,89,4,281
"47008",1047008,61,88,3,152
"47009",1047009,131,167,7,305
"47010",1047010,106,40,1,147
"47011",1047011,69,130,13,212
"47012",1047012,129,88,4,221
"47013",1047013,123,68,8,199
"47014",1047014,62,263,5,330
"47015",1047015,104,51,5,160
"47016",1047016,69,196,9,274
"47017",1047017,178,101,22,301
"47018",1047018,100,19,2,121
"47019",1047019,191,215,15,421
"47020",1047020,18,166,7,191
"47021",1047021,96,197,12,305
"47022",1047022,65,189,5,259
"47023",1047023,123,25,8,156
"47024",1047024,87,160,16,263
"47025",1047025,110,181,10,301
"47026",1047026,68,198,13,279
"47027",1047027,251,13,6,270
"47028",1047028,163,26,5,194
"47029",1047029,166,124,7,297
"47030",1047030,53,190,12,255
"47031",1047031,58,234,4,296
"47032",1047032,96,136,15,247
"47033",1047033,119,110,5,234
"47034",1047034,249,51,13,313
"47035",1047035,88,186,10,284
"47036",1047036,48,196,12,256
"47037",1047037,38,219,6,263
"47038",1047038,58,107,2,167
"47039",1047039,85,39,2,126
"47040",1047040,116,16,4,136
"47041",1047041,214,34,10,258
"47042",1047042,5,12,0,17
"47043",1047043,165,92,7,264
"47044",1047044,22,213,6,241
"47045",1047045,39,29,1,69
"47046",1047046,102,45,2,149
"47047",1047047,14,221,2,237
"47048",1047048,95,63,2,160
"47049",1047049,25,147,2,174
"47050",1047050,77,34,7,118
"47051",1047051,130,121,3,254
"47052",1047052,56,202,10,268
"47053",1047053,47,224,8,279
"47054",1047054,128,59,5,192
"47055",1047055,108,155,10,273
"47056",1047056,127,158,9,294
"47057",1047057,181,25,8,214
"47058",1047058,12,226,2,240
"47059",1047059,156,171,8,335
"47060",1047060,117,124,25,266
"47061",1047061,64,13,3,80
"47062",1047062,128,111,10,249
"47063",1047063,145,126,11,282
"47064",1047064,65,167,22,254
"47065",1047065,89,60,3,152
"47066",1047066,28,161,0,189
"47067",1047067,29,15,2,46
"47068",1047068,33,143,3,179
"47069",1047069,57,36,5,98
"47070",1047070,92,98,8,198
"47071",1047071,223,47,13,283
"47072",1047072,206,16,9,231
"47073",1047073,39,167,4,210
"47074",1047074,10,15,2,27
"47075",1047075,66,154,6,226
"47076",1047076,13,29,1,43
"47077",1047077,172,102,10,284
"47078",1047078,127,100,9,236
"47079",1047079,231,44,10,285
"47080",1047080,20,313,4,337
"47081",1047081,104,203,6,313
"47082",1047082,56,105,17,178
"47083",1047083,188,25,6,219
"47084",1047084,38,259,11,308
"47085",1047085,36,146,4,186
"47086",1047086,204,56,6,266
"47087",1047087,147,59,2,208
"47088",1047088,73,240,3,316
"47089",1047089,120,30,5,155
"47090",1047090,154,96,4,254
"47091",1047091,88,113,8,209
"47092",1047092,52,201,9,262
"47093",1047093,38,41,1,80
"47094",1047094,73,74,2,149
"47095",1047095,115,135,17,267
"47096",1047096,178,20,10,208
"47097",1047097,139,85,12,236
"47098",1047098,38,104,6,148
"47099",1047099,42,207,6,255
"47100",1047100,171,73,9,253
"47101",1047101,205,53,3,261
"47102",1047102,44,91,1,136
"47103",1047103,111,39,3,153
"47104",1047104,49,221,14,284
"47105",1047105,199,33,7,239
"47106",1047106,165,85,3,253
"47107",1047107,155,44,5,204
"47108",1047108,111,113,12,236
"47109",1047109,155,150,11,316
"47110",1047110,116,100,14,230
"47111",1047111,83,103,9,195
"47112",1047112,107,77,5,189
"47113",1047113,111,148,7,266
"47114",1047114,135,131,7,273
"47115",1047115,31,137,5,173
"47116",1047116,207,44,1,252
"47117",1047117,191,77,14,282
"47118",1047118,228,31,14,273
"47119",1047119,114,131,17,262
"47120",1047120,118,82,1,201
"47121",1047121,102,82,15,199
"47122",1047122,72,182,4,258
"47123",1047123,117,161,8,286
"47124",1047124,30,293,6,329
"47125",1047125,73,127,13,213
"47126",1047126,130,144,9,283
"47127",1047127,139,17,4,160
"47128",1047128,110,92,5,207
"47129",1047129,194,8,4,206
"47130",1047130,124,86,9,219
"47131",1047131,190,55,3,248
"47132",1047132,244,44,13,301
"47133",1047133,124,27,3,154
"47134",1047134,211,39,14,264
"47135",1047135,124,102,2,228
"47136",1047136,199,8,3,210
"47137",1047137,207,15,8,230
"47138",1047138,77,202,15,294
"47139",1047139,177,88,21,286
"47140",1047140,150,98,11,259
"47141",1047141,31,106,7,144
"47142",1047142,15,210,1,226
"47143",1047143,162,147,6,315
"47144",1047144,148,48,3,199
"47145",1047145,77,165,6,248
"47146",1047146,166,74,8,248
"47147",1047147,44,204,4,252
"47148",1047148,178,28,4,210
"47149",1047149,47,195,7,249
"47150",1047150,150,104,18,272
"47151",1047151,201,123,10,334
"47152",1047152,112,99,4,215
"47153",1047153,128,96,14,238
"47154",1047154,109,126,13,248
"47155",1047155,126,40,9,175
"47156",1047156,312,1,10,323
"47157",1047157,86,129,4,219
"47158",1047158,32,192,4,228
"47159",1047159,32,177,3,212
"47160",1047160,265,19,5,289
"47161",1047161,265,18,10,293
"47162",1047162,149,61,11,221
"47163",1047163,21,27,2,50
"47164",1047164,105,95,15,215
"47165",1047165,113,108,13,234
"47166",1047166,86,142,11,239
"47167",1047167,265,38,5,308
"47168",1047168,192,27,2,221
"47169",1047169,134,135,8,277
"47170",1047170,147,32,6,185
"47171",1047171,39,217,8,264
"47172",1047172,93,135,9,237
"47173",1047173,81,136,20,237
"47174",1047174,19,139,6,164
"47175",1047175,127,139,17,283
"47176",1047176,134,182,12,328
"47177",1047177,137,145,9,291
"47178",1047178,163,74,10,247
"47179",1047179,96,107,7,210
"47180",1047180,12,201,7,220
"47181",1047181,29,20,5,54
"47182",1047182,60,203,5,268
"47183",1047183,132,93,21,246
"47184",1047184,23,204,5,232
"47185",1047185,69,204,22,295
"47186",1047186,66,220,8,294
"47187",1047187,108,134,10,252
"47188",1047188,0,3,0,3
"47189",1047189,99,23,7,129
"47190",1047190,257,8,10,275
"47191",1047191,91,182,17,290
"47192",1047192,106,61,7,174
"47193",1047193,114,35,3,152
"47194",1047194,66,199,21,286
"47195",1047195,21,284,6,311
"47196",1047196,115,94,15,224
"47197",1047197,75,41,5,121
"47198",1047198,103,22,2,127
"47199",1047199,77,218,16,311
"47200",1047200,151,178,19,348
"47201",1047201,128,20,2,150
"47202",1047202,11,70,1,82
"47203",1047203,27,9,1,37
"47204",1047204,42,306,4,352
"47205",1047205,142,81,7,230
"47206",1047206,175,64,19,258
"47207",1047207,7,46,1,54
"47208",1047208,83,8,0,91
"47209",1047209,49,240,3,292
"47210",1047210,141,124,8,273
"47211",1047211,233,46,3,282
"47212",1047212,26,24,2,52
"47213",1047213,50,274,5,329
"47214",1047214,193,102,5,300
"47215",1047215,104,112,18,234
"47216",1047216,154,62,3,219
"47217",1047217,107,59,3,169
"47218",1047218,184,58,4,246
"47219",1047219,93,178,12,283
"47220",1047220,216,43,11,270
"47221",1047221,171,70,8,249
"47222",1047222,150,62,1,213
"47223",1047223,66,182,11,259
"47224",1047224,116,132,11,259
"47225",1047225,48,32,3,83
"47226",1047226,104,13,1,118
"47227",1047227,241,45,22,308
"47228",1047228,152,106,6,264
"47229",1047229,118,63,3,184
"47230",1047230,124,120,8,252
"47231",1047231,92,76,4,172
"47232",1047232,54,246,12,312
"47233",1047233,116,27,8,151
"47234",1047234,61,100,2,163
"47235",1047235,62,0,1,63
"47236",1047236,126,52,17,195
"47237",1047237,100,105,20,225
"47238",1047238,11,0,0,11
"47239",1047239,233,0,1,234
"47240",1047240,140,131,9,280
"47241",1047241,49,147,5,201
"47242",1047242,48,95,10,153
"47243",1047243,185,34,17,236
"47244",1047244,82,187,24,293
"47245",1047245,110,78,5,193
"47246",1047246,66,29,6,101
"47247",1047247,110,184,9,303
"47248",1047248,254,40,8,302
"47249",1047249,137,49,0,186
"47250",1047250,183,30,5,218
"47251",1047251,82,116,13,211
"47252",1047252,152,118,24,294
"47253",1047253,46,158,12,216
"47254",1047254,63,67,3,133
"47255",1047255,135,48,11,194
"47256",1047256,18,11,2,31
"47257",1047257,13,124,1,138
"47258",1047258,116,0,0,116
"47259",1047259,6,11,1,18
"47260",1047260,205,22,9,236
"47261",1047261,204,27,4,235
"47262",1047262,106,104,6,216
"47263",1047263,208,65,10,283
"47264",1047264,135,70,8,213
"47265",1047265,124,198,16,338
"47266",1047266,38,125,1,164
"47267",1047267,32,234,6,272
"47268",1047268,193,40,12,245
"47269",1047269,137,41,6,184
"47270",1047270,99,130,10,239
"47271",1047271,85,200,9,294
"47272",1047272,181,82,10,273
"47273",1047273,34,30,2,66
"47274",1047274,182,44,6,232
"47275",1047275,201,35,25,261
"47276",1047276,150,12,7,169
"47277",1047277,195,41,6,242
"47278",1047278,189,48,7,244
"47279",1047279,27,250,5,282
"47280",1047280,146,64,6,216
"47281",1047281,69,160,8,237
"47282",1047282,105,151,14,270
"47283",1047283,287,38,7,332
"47284",1047284,81,47,4,132
"47285",1047285,114,9,5,128
"47286",1047286,76,62,7,145
"47287",1047287,22,2,1,25
"47288",1047288,105,45,3,153
"47289",1047289,61,203,29,293
"47290",1047290,177,72,3,252
"47291",1047291,58,37,2,97
"47292",1047292,57,148,11,216
"47293",1047293,139,56,6,201
"47294",1047294,240,41,8,289
"47295",1047295,76,145,12,233
"47296",1047296,158,114,14,286
"47297",1047297,207,37,13,257
"47298",1047298,56,112,4,172
"47299",1047299,134,163,15,312
"47300",1047300,217,92,13,322
"47301",1047301,155,107,8,270
"47302",1047302,141,48,8,197
"47303",1047303,112,162,15,289
"47304",1047304,99,51,17,167
"47305",1047305,35,182,6,223
"47306",1047306,55,158,3,216
"47307",1047307,209,70,11,290
"47308",1047308,159,56,8,223
"47309",1047309,104,147,14,265
"47310",1047310,182,84,9,275
"47311",1047311,133,104,3,240
"47312",1047312,6,2,1,9
"47313",1047313,11,58,2,71
"47314",1047314,169,4,3,176
"47315",1047315,214,38,3,255
"47316",1047316,107,105,6,218
"47317",1047317,173,90,4,267
"47318",1047318,156,67,9,232
"47319",1047319,121,153,8,282
"47320",1047320,209,31,9,249
"47321",1047321,64,133,9,206
"47322",1047322,140,37,3,180
"47323",1047323,173,85,2,260
"47324",1047324,46,152,13,211
"47325",1047325,197,73,4,274
"47326",1047326,105,114,16,235
"47327",1047327,117,76,13,206
"47328",1047328,137,48,3,188
"47329",1047329,87,154,2,243
"47330",1047330,142,17,2,161
"47331",1047331,208,24,10,242
"47332",1047332,100,135,19,254
"47333",1047333,64,179,4,247
"47334",1047334,92,83,5,180
"47335",1047335,118,138,7,263
"47336",1047336,25,244,4,273
"47337",1047337,29,0,5,34
"47338",1047338,79,215,12,306
"47339",1047339,138,13,2,153
"47340",1047340,154,36,7,197
"47341",1047341,155,88,10,253
"47342",1047342,129,140,5,274
"47343",1047343,243,34,6,283
"47344",1047344,136,33,3,172
"47345",1047345,22,78,1,101
"47346",1047346,199,80,16,295
"47347",1047347,40,167,16,223
"47348",1047348,188,44,13,245
"47349",1047349,62,114,13,189
"47350",1047350,154,57,9,220
"47351",1047351,148,130,23,301
"47352",1047352,95,177,8,280
"47353",1047353,182,46,6,234
"47354",1047354,56,204,6,266
"47355",1047355,42,239,6,287
"47356",1047356,78,41,8,127
"47357",1047357,40,144,6,190
"47358",1047358,28,58,10,96
"47359",1047359,17,106,2,125
"47360",1047360,96,161,5,262
"47361",1047361,71,215,4,290
"47362",1047362,12,218,5,235
"47363",1047363,54,119,2,175
"47364",1047364,164,86,9,259
"47365",1047365,44,43,1,88
"47366",1047366,71,169,25,265
"47367",1047367,188,23,6,217
"47368",1047368,12,20,1,33
"47369",1047369,65,38,2,105
"47370",1047370,199,78,13,290
"47371",1047371,213,62,22,297
"47372",1047372,101,191,8,300
"47373",1047373,115,160,7,282
"47374",1047374,156,20,6,182
"47375",1047375,66,196,15,277
"47376",1047376,122,110,23,255
"47377",1047377,109,126,5,240
"47378",1047378,168,28,7,203
"47379",1047379,121,108,8,237
"47380",1047380,51,155,8,214
"47381",1047381,275,55,11,341
"47382",1047382,219,16,3,238
"47383",1047383,75,101,9,185
"47384",1047384,155,57,5,217
"47385",1047385,147,62,10,219
"47386",1047386,84,164,27,275
"47387",1047387,162,50,12,224
"47388",1047388,76,98,12,186
"47389",1047389,123,89,3,215
"47390",1047390,155,70,7,232
"47391",1047391,136,33,1,170
"47392",1047392,77,157,11,245
"47393",1047393,154,70,7,231
"47394",1047394,202,41,8,251
"47395",1047395,286,35,5,326
"47396",1047396,162,115,8,285
"47397",1047397,31,17,3,51
"47398",1047398,54,83,1,138
"47399",1047399,5,133,2,140
"47400",1047400,51,170,7,228
"47401",1047401,30,60,4,94
"47402",1047402,133,26,6,165
"47403",1047403,61,18,3,82
"47404",1047404,25,40,3,68
"47405",1047405,235,67,15,317
"47406",1047406,56,193,1,250
"47407",1047407,120,101,8,229
"47408",1047408,92,85,6,183
"47409",1047409,172,73,11,256
"47410",1047410,49,154,3,206
"47411",1047411,90,112,10,212
"47412",1047412,134,113,23,270
"47413",1047413,80,170,1,251
"47414",1047414,48,23,2,73
"47415",1047415,108,116,28,252
"47416",1047416,141,61,4,206
"47417",1047417,132,1,2,135
"47418",1047418,84,166,9,259
"47419",1047419,207,89,10,306
"47420",1047420,243,46,11,300
"47421",1047421,26,232,4,262
"47422",1047422,79,133,6,218
"47423",1047423,80,194,7,281
"47424",1047424,143,147,24,314
"47425",1047425,264,11,9,284
"47426",1047426,176,27,4,207
"47427",1047427,102,115,12,229
"47428",1047428,98,134,14,246
"47429",1047429,111,70,5,186
"47430",1047430,59,204,15,278
"47431",1047431,38,133,4,175
"47432",1047432,168,120,6,294
"47433",1047433,49,17,2,68
"47434",1047434,126,90,7,223
"47435",1047435,130,113,9,252
"47436",1047436,85,107,9,201
"47437",1047437,150,53,4,207
"47438",1047438,148,12,8,168
"47439",1047439,92,170,7,269
"47440",1047440,41,41,2,84
"47441",1047441,140,35,3,178
"47442",1047442,164,92,11,267
"47443",1047443,139,79,12,230
"47444",1047444,45,55,1,101
"47445",1047445,37,230,4,271
"47446",1047446,105,21,1,127
"47447",1047447,35,137,1,173
"47448",1047448,79,153,9,241
"47449",1047449,198,49,11,258
"47450",1047450,123,81,6,210
"47451",1047451,38,226,3,267
"47452",1047452,122,5,8,135
"47453",1047453,72,93,0,165
"47454",1047454,170,70,6,246
"47455",1047455,2,9,1,12
"47456",1047456,173,65,9,247
"47457",1047457,191,49,10,250
"47458",1047458,121,71,8,200
"47459",1047459,158,126,10,294
"47460",1047460,177,143,18,338
"47461",1047461,112,74,10,196
"47462",1047462,71,143,9,223
"47463",1047463,2,254,4,260
"47464",1047464,137,64,3,204
"47465",1047465,102,132,11,245
"47466",1047466,159,58,2,219
"47467",1047467,191,63,13,267
"47468",1047468,115,97,10,222
"47469",1047469,128,100,13,241
"47470",1047470,8,9,1,18
"47471",1047471,128,110,19,257
"47472",1047472,191,37,6,234
"47473",1047473,98,119,11,228
"47474",1047474,29,234,2,265
"47475",1047475,145,76,13,234
"47476",1047476,35,112,3,150
"47477",1047477,20,6,2,28
"47478",1047478,89,103,10,202
"47479",1047479,170,65,10,245
"47480",1047480,146,75,12,233
"47481",1047481,122,129,5,256
"47482",1047482,208,41,4,253
"47483",1047483,52,235,4,291
"47484",1047484,6,5,1,12
"47485",1047485,69,70,4,143
"47486",1047486,84,156,5,245
"47487",1047487,140,77,12,229
"47488",1047488,61,165,18,244
"47489",1047489,106,73,7,186
"47490",1047490,146,58,9,213
"47491",1047491,47,195,3,245
"47492",1047492,55,168,7,230
"47493",1047493,144,155,5,304
"47494",1047494,4,28,4,36
"47495",1047495,64,186,8,258
"47496",1047496,58,198,2,258
"47497",1047497,30,92,1,123
"47498",1047498,62,154,7,223
"47499",1047499,67,196,15,278
"47500",1047500,85,123,14,222
"47501",1047501,239,5,5,249
"47502",1047502,61,170,3,234
"47503",1047503,105,114,9,228
"47504",1047504,9,10,0,19
"47505",1047505,39,8,2,49
"47506",1047506,64,85,6,155
"47507",1047507,174,41,8,223
"47508",1047508,31,240,6,277
"47509",1047509,65,12,2,79
"47510",1047510,44,86,2,132
"47511",1047511,133,2,4,139
"47512",1047512,135,57,1,193
"47513",1047513,252,60,14,326
"47514",1047514,131,38,8,177
"47515",1047515,148,76,16,240
"47516",1047516,33,51,2,86
"47517",1047517,56,143,4,203
"47518",1047518,131,143,15,289
"47519",1047519,41,26,1,68
"47520",1047520,96,147,9,252
"47521",1047521,32,26,2,60
"47522",1047522,42,238,7,287
"47523",1047523,119,241,11,371
"47524",1047524,144,50,4,198
"47525",1047525,46,98,7,151
"47526",1047526,92,99,8,199
"47527",1047527,105,98,13,216
"47528",1047528,193,17,3,213
"47529",1047529,53,86,3,142
"47530",1047530,103,21,7,131
"47531",1047531,98,108,6,212
"47532",1047532,168,40,6,214
"47533",1047533,223,31,8,262
"47534",1047534,117,80,1,198
"47535",1047535,146,32,4,182
"47536",1047536,141,85,7,233
"47537",1047537,167,78,9,254
"47538",1047538,146,194,7,347
"47539",1047539,94,184,6,284
"47540",1047540,37,242,1,280
"47541",1047541,98,112,9,219
"47542",1047542,101,119,9,229
"47543",1047543,166,35,8,209
"47544",1047544,103,18,7,128
"47545",1047545,8,3,0,11
"47546",1047546,240,24,5,269
"47547",1047547,140,75,12,227
"47548",1047548,90,88,3,181
"47549",1047549,74,62,11,147
"47550",1047550,95,62,7,164
"47551",1047551,29,202,2,233
"47552",1047552,152,32,4,188
"47553",1047553,95,131,13,239
"47554",1047554,56,214,3,273
"47555",1047555,64,160,5,229
"47556",1047556,201,25,5,231
"47557",1047557,101,113,6,220
"47558",1047558,284,31,8,323
"47559",1047559,147,48,6,201
"47560",1047560,41,132,3,176
"47561",1047561,75,145,12,232
"47562",1047562,76,9,3,88
"47563",1047563,121,18,3,142
"47564",1047564,149,16,10,175
"47565",1047565,41,201,2,244
"47566",1047566,37,173,2,212
"47567",1047567,25,266,13,304
"47568",1047568,131,74,5,210
"47569",1047569,177,61,6,244
"47570",1047570,169,10,2,181
"47571",1047571,56,246,3,305
"47572",1047572,164,24,3,191
"47573",1047573,104,137,24,265
"47574",1047574,56,225,15,296
"47575",1047575,168,86,12,266
"47576",1047576,128,96,10,234
"47577",1047577,216,15,4,235
"47578",1047578,212,2,6,220
"47579",1047579,62,275,4,341
"47580",1047580,111,114,14,239
"47581",1047581,98,111,13,222
"47582",1047582,37,274,7,318
"47583",1047583,100,97,3,200
"47584",1047584,75,160,12,247
"47585",1047585,44,124,3,171
"47586",1047586,123,4,0,127
"47587",1047587,36,236,5,277
"47588",1047588,42,273,8,323
"47589",1047589,122,179,8,309
"47590",1047590,95,15,3,113
"47591",1047591,98,71,6,175
"47592",1047592,73,14,1,88
"47593",1047593,25,198,7,230
"47594",1047594,155,110,5,270
"47595",1047595,117,81,1,199
"47596",1047596,126,15,1,142
"47597",1047597,84,134,7,225
"47598",1047598,8,14,0,22
"47599",1047599,62,65,3,130
"47600",1047600,27,136,1,164
"47601",1047601,97,188,6,291
"47602",1047602,59,43,2,104
"47603",1047603,178,63,8,249
"47604",1047604,87,211,4,302
"47605",1047605,203,42,5,250
"47606",1047606,84,166,12,262
"47607",1047607,74,115,10,199
"47608",1047608,135,61,5,201
"47609",1047609,95,184,7,286
"47610",1047610,156,107,6,269
"47611",1047611,13,129,4,146
"47612",1047612,90,15,1,106
"47613",1047613,163,46,10,219
"47614",1047614,96,157,8,261
"47615",1047615,42,190,8,240
"47616",1047616,106,93,14,213
"47617",1047617,202,31,6,239
"47618",1047618,27,235,7,269
"47619",1047619,221,30,10,261
"47620",1047620,13,219,4,236
"47621",1047621,56,33,1,90
"47622",1047622,112,87,16,215
"47623",1047623,145,43,5,193
"47624",1047624,158,69,15,242
"47625",1047625,100,171,18,289
"47626",1047626,96,110,7,213
"47627",1047627,50,208,7,265
"47628",1047628,88,130,9,227
"47629",1047629,139,135,23,297
"47630",1047630,28,225,3,256
"47631",1047631,86,179,11,276
"47632",1047632,139,75,2,216
"47633",1047633,121,108,8,237
"47634",1047634,151,77,12,240
"47635",1047635,133,55,3,191
"47636",1047636,144,107,3,254
"47637",1047637,61,173,5,239
"47638",1047638,239,27,3,269
"47639",1047639,125,24,5,154
"47640",1047640,44,294,11,349
"47641",1047641,115,48,3,166
"47642",1047642,73,152,17,242
"47643",1047643,99,135,12,246
"47644",1047644,193,17,1,211
"47645",1047645,91,122,3,216
"47646",1047646,69,157,8,234
"47647",1047647,203,50,12,265
"47648",1047648,149,47,2,198
"47649",1047649,85,176,25,286
"47650",1047650,206,33,5,244
"47651",1047651,98,129,3,230
"47652",1047652,148,82,18,248
"47653",1047653,58,171,4,233
"47654",1047654,36,161,4,201
"47655",1047655,0,19,2,21
"47656",1047656,162,46,3,211
"47657",1047657,101,54,19,174
"47658",1047658,57,163,2,222
"47659",1047659,181,81,13,275
"47660",1047660,329,6,8,343
"47661",1047661,148,132,16,296
"47662",1047662,102,131,10,243
"47663",1047663,155,9,6,170
"47664",1047664,14,20,1,35
"47665",1047665,157,114,12,283
"47666",1047666,29,248,3,280
"47667",1047667,113,192,6,311
"47668",1047668,44,80,10,134
"47669",1047669,39,226,5,270
"47670",1047670,97,114,9,220
"47671",1047671,19,30,0,49
"47672",1047672,203,52,14,269
"47673",1047673,192,125,10,327
"47674",1047674,180,58,2,240
"47675",1047675,148,112,10,270
"47676",1047676,107,64,6,177
"47677",1047677,108,36,0,144
"47678",1047678,145,109,4,258
"47679",1047679,176,81,18,275
"47680",1047680,197,20,8,225
"47681",1047681,26,35,6,67
"47682",1047682,54,168,9,231
"47683",1047683,38,222,3,263
"47684",1047684,31,217,3,251
"47685",1047685,44,224,17,285
"47686",1047686,118,147,3,268
"47687",1047687,40,60,3,103
"47688",1047688,169,93,13,275
"47689",1047689,200,34,6,240
"47690",1047690,34,137,3,174
"47691",1047691,66,75,4,145
"47692",1047692,171,55,14,240
"47693",1047693,43,138,9,190
"47694",1047694,39,210,9,258
"47695",1047695,167,14,3,184
"47696",1047696,107,74,3,184
"47697",1047697,120,39,4,163
"47698",1047698,74,99,11,184
"47699",1047699,22,150,2,174
"47700",1047700,48,25,5,78
"47701",1047701,9,33,0,42
"47702",1047702,177,7,3,187
"47703",1047703,115,81,3,199
"47704",1047704,161,80,8,249
"47705",1047705,142,1,0,143
"47706",1047706,44,250,9,303
"47707",1047707,43,173,6,222
"47708",1047708,104,79,10,193
"47709",1047709,86,0,2,88
"47710",1047710,121,51,8,180
"47711",1047711,119,206,9,334
"47712",1047712,115,114,9,238
"47713",1047713,269,24,15,308
"47714",1047714,173,81,7,261
"47715",1047715,101,143,10,254
"47716",1047716,169,45,11,225
"47717",1047717,91,81,17,189
"47718",1047718,109,87,1,197
"47719",1047719,154,85,8,247
"47720",1047720,102,185,4,291
"47721",1047721,86,194,6,286
"47722",1047722,213,28,6,247
"47723",1047723,153,58,13,224
"47724",1047724,45,2,2,49
"47725",1047725,154,53,3,210
"47726",1047726,101,134,15,250
"47727",1047727,16,106,1,123
"47728",1047728,153,37,9,199
"47729",1047729,257,45,13,315
"47730",1047730,188,59,5,252
"47731",1047731,40,48,5,93
"47732",1047732,40,223,7,270
"47733",1047733,30,144,2,176
"47734",1047734,39,247,5,291
"47735",1047735,197,93,8,298
"47736",1047736,73,176,10,259
"47737",1047737,206,51,6,263
"47738",1047738,49,36,2,87
"47739",1047739,148,47,9,204
"47740",1047740,102,100,2,204
"47741",1047741,45,246,18,309
"47742",1047742,91,64,2,157
"47743",1047743,172,80,7,259
"47744",1047744,55,202,8,265
"47745",1047745,25,11,3,39
"47746",1047746,34,208,10,252
"47747",1047747,90,75,2,167
"47748",1047748,63,159,13,235
"47749",1047749,111,46,10,167
"47750",1047750,84,127,11,222
"47751",1047751,197,12,3,212
"47752",1047752,122,116,19,257
"47753",1047753,41,226,9,276
"47754",1047754,131,56,3,190
"47755",1047755,131,130,24,285
"47756",1047756,60,169,6,235
"47757",1047757,184,7,1,192
"47758",1047758,52,167,10,229
"47759",1047759,38,90,3,131
"47760",1047760,110,187,12,309
"47761",1047761,31,262,29,322
"47762",1047762,40,241,10,291
"47763",1047763,52,7,1,60
"47764",1047764,62,201,7,270
"47765",1047765,208,85,8,301
"47766",1047766,194,105,22,321
"47767",1047767,33,55,1,89
"47768",1047768,72,137,15,224
"47769",1047769,105,153,15,273
"47770",1047770,192,151,6,349
"47771",1047771,91,185,7,283
"47772",1047772,7,60,3,70
"47773",1047773,93,214,14,321
"47774",1047774,77,215,7,299
"47775",1047775,205,65,9,279
"47776",1047776,97,130,5,232
"47777",1047777,172,124,11,307
"47778",1047778,100,144,7,251
"47779",1047779,173,137,4,314
"47780",1047780,7,49,0,56
"47781",1047781,282,7,11,300
"47782",1047782,21,227,2,250
"47783",1047783,6,35,0,41
"47784",1047784,110,46,10,166
"47785",1047785,63,156,19,238
"47786",1047786,135,46,4,185
"47787",1047787,28,206,2,236
"47788",1047788,72,96,10,178
"47789",1047789,89,151,5,245
"47790",1047790,66,181,4,251
"47791",1047791,202,53,3,258
"47792",1047792,98,156,8,262
"47793",1047793,76,171,5,252
"47794",1047794,90,61,5,156
"47795",1047795,112,177,7,296
"47796",1047796,42,15,4,61
"47797",1047797,119,93,8,220
"47798",1047798,6,2,0,8
"47799",1047799,57,172,3,232
"47800",1047800,84,193,8,285
"47801",1047801,31,144,8,183
"47802",1047802,52,89,12,153
"47803",1047803,164,114,12,290
"47804",1047804,1,5,0,6
"47805",1047805,235,27,13,275
"47806",1047806,119,27,0,146
"47807",1047807,35,58,5,98
"47808",1047808,19,186,9,214
"47809",1047809,55,21,2,78
"47810",1047810,201,100,2,303
"47811",1047811,134,69,12,215
"47812",1047812,93,145,21,259
"47813",1047813,66,189,28,283
"47814",1047814,2,5,0,7
"47815",1047815,72,106,2,180
"47816",1047816,171,37,2,210
"47817",1047817,146,82,5,233
"47818",1047818,151,15,6,172
"47819",1047819,57,69,6,132
"47820",1047820,145,23,10,178
"47821",1047821,97,121,12,230
"47822",1047822,160,56,8,224
"47823",1047823,11,9,0,20
"47824",1047824,97,133,9,239
"47825",1047825,60,6,2,68
"47826",1047826,44,199,6,249
"47827",1047827,33,163,4,200
"47828",1047828,51,143,14,208
"47829",1047829,52,133,11,196
"47830",1047830,95,203,12,310
"47831",1047831,11,216,4,231
"47832",1047832,93,81,10,184
"47833",1047833,114,95,2,211
"47834",1047834,176,13,2,191
"47835",1047835,128,120,7,255
"47836",1047836,48,173,8,229
"47837",1047837,98,78,5,181
"47838",1047838,137,37,3,177
"47839",1047839,83,52,6,141
"47840",1047840,7,66,3,76
"47841",1047841,90,28,3,121
"47842",1047842,153,48,7,208
"47843",1047843,43,21,7,71
"47844",1047844,122,43,7,172
"47845",1047845,272,63,13,348
"47846",1047846,106,34,4,144
"47847",1047847,141,106,5,252
"47848",1047848,235,43,7,285
"47849",1047849,211,42,8,261
"47850",1047850,72,147,6,225
"47851",1047851,174,116,12,302
"47852",1047852,191,89,14,294
"47853",1047853,135,98,6,239
"47854",1047854,173,68,8,249
"47855",1047855,43,235,6,284
"47856",1047856,206,31,13,250
"47857",1047857,97,88,8,193
"47858",1047858,143,44,10,197
"47859",1047859,78,244,3,325
"47860",1047860,136,24,3,163
"47861",1047861,40,70,8,118
"47862",1047862,43,252,4,299
"47863",1047863,175,85,12,272
"47864",1047864,125,185,19,329
"47865",1047865,40,243,7,290
"47866",1047866,110,159,12,281
"47867",1047867,90,76,6,172
"47868",1047868,29,101,1,131
"47869",1047869,55,37,3,95
"47870",1047870,29,97,1,127
"47871",1047871,64,156,2,222
"47872",1047872,83,80,6,169
"47873",1047873,33,198,11,242
"47874",1047874,35,218,5,258
"47875",1047875,125,55,11,191
"47876",1047876,84,106,5,195
"47877",1047877,37,282,4,323
"47878",1047878,127,83,12,222
"47879",1047879,123,34,3,160
"47880",1047880,180,92,12,284
"47881",1047881,238,15,6,259
"47882",1047882,180,31,10,221
"47883",1047883,188,88,8,284
"47884",1047884,209,22,9,240
"47885",1047885,85,34,3,122
"47886",1047886,126,86,4,216
"47887",1047887,146,85,7,238
"47888",1047888,68,195,2,265
"47889",1047889,133,101,5,239
"47890",1047890,99,95,15,209
"47891",1047891,81,60,9,150
"47892",1047892,254,62,12,328
"47893",1047893,144,127,6,277
"47894",1047894,98,163,5,266
"47895",1047895,14,1,1,16
"47896",1047896,214,50,5,269
"47897",1047897,104,171,11,286
"47898",1047898,58,65,2,125
"47899",1047899,75,178,7,260
"47900",1047900,38,1,0,39
"47901",1047901,43,128,1,172
"47902",1047902,141,100,15,256
"47903",1047903,155,67,9,231
"47904",1047904,152,64,5,221
"47905",1047905,143,18,6,167
"47906",1047906,61,123,12,196
"47907",1047907,170,111,8,289
"47908",1047908,108,121,6,235
"47909",1047909,5,9,2,16
"47910",1047910,211,48,5,264
"47911",1047911,51,200,4,255
"47912",1047912,166,89,10,265
"47913",1047913,18,9,0,27
"47914",1047914,131,163,12,306
"47915",1047915,34,94,7,135
"47916",1047916,110,131,6,247
"47917",1047917,121,110,10,241
"47918",1047918,152,147,24,323
"47919",1047919,52,63,5,120
"47920",1047920,80,204,15,299
"47921",1047921,94,131,5,230
"47922",1047922,16,84,0,100
"47923",1047923,42,32,5,79
"47924",1047924,172,62,11,245
"47925",1047925,51,19,2,72
"47926",1047926,162,118,11,291
"47927",1047927,111,195,10,316
"47928",1047928,21,205,3,229
"47929",1047929,108,31,11,150
"47930",1047930,173,98,1,272
"47931",1047931,116,102,9,227
"47932",1047932,185,100,11,296
"47933",1047933,94,62,10,166
"47934",1047934,143,71,3,217
"47935",1047935,102,177,4,283
"47936",1047936,164,61,4,229
"47937",1047937,136,72,5,213
"47938",1047938,175,119,11,305
"47939",1047939,140,34,13,187
"47940",1047940,76,81,5,162
"47941",1047941,6,117,3,126
"47942",1047942,149,59,10,218
"47943",1047943,119,180,7,306
"47944",1047944,154,137,6,297
"47945",1047945,205,52,13,270
"47946",1047946,72,148,2,222
"47947",1047947,102,119,7,228
"47948",1047948,43,54,2,99
"47949",1047949,33,141,5,179
"47950",1047950,46,239,12,297
"47951",1047951,3,153,0,156
"47952",1047952,199,63,7,269
"47953",1047953,87,173,6,266
"47954",1047954,70,225,9,304
"47955",1047955,15,13,1,29
"47956",1047956,144,131,14,289
"47957",1047957,134,81,13,228
"47958",1047958,57,149,12,218
"47959",1047959,56,125,3,184
"47960",1047960,172,33,4,209
"47961",1047961,137,79,18,234
"47962",1047962,122,9,2,133
"47963",1047963,136,113,6,255
"47964",1047964,83,109,5,197
"47965",1047965,222,32,13,267
"47966",1047966,68,258,11,337
"47967",1047967,42,221,5,268
"47968",1047968,160,72,14,246
"47969",1047969,104,166,3,273
"47970",1047970,65,214,4,283
"47971",1047971,220,57,15,292
"47972",1047972,78,209,5,292
"47973",1047973,127,112,13,252
"47974",1047974,209,81,13,303
"47975",1047975,167,58,5,230
"47976",1047976,148,74,5,227
"47977",1047977,93,92,4,189
"47978",1047978,82,140,16,238
"47979",1047979,196,44,12,252
"47980",1047980,81,58,8,147
"47981",1047981,114,38,6,158
"47982",1047982,246,25,2,273
"47983",1047983,192,23,3,218
"47984",1047984,53,240,7,300
"47985",1047985,272,37,5,314
"47986",1047986,194,3,2,199
"47987",1047987,255,32,6,293
"47988",1047988,142,58,4,204
"47989",1047989,95,189,2,286
"47990",1047990,49,28,2,79
"47991",1047991,81,172,17,270
"47992",1047992,77,207,6,290
"47993",1047993,81,188,10,279
"47994",1047994,105,159,15,279
"47995",1047995,104,159,6,269
"47996",1047996,130,62,13,205
"47997",1047997,58,165,6,229
"47998",1047998,176,97,4,277
"47999",1047999,154,18,4,176
"48000",1048000,137,90,7,234
"48001",1048001,74,107,15,196
"48002",1048002,159,89,24,272
"48003",1048003,118,38,1,157
"48004",1048004,60,20,3,83
"48005",1048005,59,243,6,308
"48006",1048006,52,276,2,330
"48007",1048007,216,37,3,256
"48008",1048008,51,193,3,247
"48009",1048009,45,201,4,250
"48010",1048010,77,181,2,260
"48011",1048011,164,48,5,217
"48012",1048012,94,193,12,299
"48013",1048013,35,221,5,261
"48014",1048014,137,28,6,171
"48015",1048015,196,94,9,299
"48016",1048016,180,72,11,263
"48017",1048017,125,97,6,228
"48018",1048018,64,73,3,140
"48019",1048019,22,257,6,285
"48020",1048020,142,56,3,201
"48021",1048021,145,37,7,189
"48022",1048022,114,166,2,282
"48023",1048023,153,92,12,257
"48024",1048024,79,103,7,189
"48025",1048025,64,40,1,105
"48026",1048026,122,150,17,289
"48027",1048027,104,141,6,251
"48028",1048028,133,106,7,246
"48029",1048029,116,119,12,247
"48030",1048030,131,138,11,280
"48031",1048031,136,73,4,213
"48032",1048032,63,166,10,239
"48033",1048033,21,58,5,84
"48034",1048034,55,240,11,306
"48035",1048035,138,77,8,223
"48036",1048036,88,164,9,261
"48037",1048037,70,168,10,248
"48038",1048038,126,59,11,196
"48039",1048039,92,88,2,182
"48040",1048040,53,217,7,277
"48041",1048041,183,98,28,309
"48042",1048042,140,20,3,163
"48043",1048043,236,26,6,268
"48044",1048044,120,55,6,181
"48045",1048045,102,94,8,204
"48046",1048046,92,40,1,133
"48047",1048047,106,116,10,232
"48048",1048048,78,74,3,155
"48049",1048049,27,277,6,310
"48050",1048050,109,192,20,321
"48051",1048051,213,79,14,306
"48052",1048052,53,146,8,207
"48053",1048053,217,63,8,288
"48054",1048054,39,40,5,84
"48055",1048055,57,221,5,283
"48056",1048056,160,131,2,293
"48057",1048057,167,93,10,270
"48058",1048058,50,249,3,302
"48059",1048059,36,237,6,279
"48060",1048060,29,171,2,202
"48061",1048061,220,32,11,263
"48062",1048062,120,178,6,304
"48063",1048063,140,123,7,270
"48064",1048064,59,65,14,138
"48065",1048065,34,123,2,159
"48066",1048066,84,194,16,294
"48067",1048067,145,120,7,272
"48068",1048068,160,124,11,295
"48069",1048069,195,45,6,246
"48070",1048070,96,75,3,174
"48071",1048071,83,77,1,161
"48072",1048072,156,69,10,235
"48073",1048073,114,46,3,163
"48074",1048074,96,69,7,172
"48075",1048075,176,25,6,207
"48076",1048076,62,166,6,234
"48077",1048077,239,85,15,339
"48078",1048078,46,211,15,272
"48079",1048079,28,5,0,33
"48080",1048080,33,269,7,309
"48081",1048081,140,136,7,283
"48082",1048082,124,112,15,251
"48083",1048083,162,45,7,214
"48084",1048084,62,186,18,266
"48085",1048085,8,56,1,65
"48086",1048086,118,194,9,321
"48087",1048087,110,63,7,180
"48088",1048088,50,148,9,207
"48089",1048089,167,37,10,214
"48090",1048090,98,179,6,283
"48091",1048091,99,88,1,188
"48092",1048092,57,96,8,161
"48093",1048093,70,184,30,284
"48094",1048094,188,48,18,254
"48095",1048095,81,35,8,124
"48096",1048096,38,256,2,296
"48097",1048097,127,122,1,250
"48098",1048098,98,70,5,173
"48099",1048099,163,47,3,213
"48100",1048100,64,257,16,337
"48101",1048101,280,9,5,294
"48102",1048102,5,2,0,7
"48103",1048103,50,167,4,221
"48104",1048104,160,86,10,256
"48105",1048105,38,82,5,125
"48106",1048106,83,143,3,229
"48107",1048107,35,121,6,162
"48108",1048108,152,16,6,174
"48109",1048109,74,88,17,179
"48110",1048110,167,142,12,321
"48111",1048111,200,35,14,249
"48112",1048112,64,36,5,105
"48113",1048113,270,19,15,304
"48114",1048114,66,117,5,188
"48115",1048115,35,231,8,274
"48116",1048116,47,83,1,131
"48117",1048117,191,46,12,249
"48118",1048118,59,71,2,132
"48119",1048119,231,27,6,264
"48120",1048120,61,28,5,94
"48121",1048121,187,64,7,258
"48122",1048122,35,164,3,202
"48123",1048123,45,63,1,109
"48124",1048124,90,105,16,211
"48125",1048125,136,110,10,256
"48126",1048126,79,93,3,175
"48127",1048127,68,181,21,270
"48128",1048128,204,64,10,278
"48129",1048129,128,91,8,227
"48130",1048130,56,157,7,220
"48131",1048131,161,38,6,205
"48132",1048132,191,39,7,237
"48133",1048133,61,188,2,251
"48134",1048134,85,119,4,208
"48135",1048135,150,48,5,203
"48136",1048136,109,213,7,329
"48137",1048137,173,61,9,243
"48138",1048138,92,129,8,229
"48139",1048139,155,84,7,246
"48140",1048140,160,98,12,270
"48141",1048141,63,263,9,335
"48142",1048142,139,31,7,177
"48143",1048143,15,69,1,85
"48144",1048144,89,66,17,172
"48145",1048145,126,88,5,219
"48146",1048146,215,6,7,228
"48147",1048147,91,74,2,167
"48148",1048148,50,52,11,113
"48149",1048149,3,6,0,9
"48150",1048150,105,68,12,185
"48151",1048151,180,101,14,295
"48152",1048152,90,202,15,307
"48153",1048153,159,32,6,197
"48154",1048154,156,109,13,278
"48155",1048155,115,173,3,291
"48156",1048156,177,59,8,244
"48157",1048157,33,145,4,182
"48158",1048158,54,84,4,142
"48159",1048159,188,93,8,289
"48160",1048160,109,0,0,109
"48161",1048161,250,32,14,296
"48162",1048162,67,189,20,276
"48163",1048163,91,135,5,231
"48164",1048164,192,54,11,257
"48165",1048165,122,51,8,181
"48166",1048166,134,73,7,214
"48167",1048167,106,166,16,288
"48168",1048168,19,243,5,267
"48169",1048169,51,143,11,205
"48170",1048170,39,148,3,190
"48171",1048171,186,88,5,279
"48172",1048172,151,93,23,267
"48173",1048173,108,227,14,349
"48174",1048174,37,206,10,253
"48175",1048175,168,30,12,210
"48176",1048176,169,110,15,294
"48177",1048177,95,64,11,170
"48178",1048178,77,183,6,266
"48179",1048179,104,147,12,263
"48180",1048180,155,30,4,189
"48181",1048181,168,86,11,265
"48182",1048182,32,138,5,175
"48183",1048183,17,0,0,17
"48184",1048184,224,69,25,318
"48185",1048185,36,170,3,209
"48186",1048186,27,150,3,180
"48187",1048187,73,162,4,239
"48188",1048188,26,179,6,211
"48189",1048189,186,8,2,196
"48190",1048190,69,202,10,281
"48191",1048191,56,241,9,306
"48192",1048192,153,18,5,176
"48193",1048193,120,55,10,185
"48194",1048194,135,114,6,255
"48195",1048195,75,258,11,344
"48196",1048196,160,63,5,228
"48197",1048197,104,87,1,192
"48198",1048198,142,111,18,271
"48199",1048199,102,101,16,219
"48200",1048200,85,159,2,246
"48201",1048201,178,92,7,277
"48202",1048202,103,48,4,155
"48203",1048203,155,51,6,212
"48204",1048204,45,32,5,82
"48205",1048205,184,58,3,245
"48206",1048206,116,68,6,190
"48207",1048207,62,194,12,268
"48208",1048208,95,87,6,188
"48209",1048209,12,58,4,74
"48210",1048210,99,18,16,133
"48211",1048211,54,243,6,303
"48212",1048212,140,121,13,274
"48213",1048213,173,145,15,333
"48214",1048214,32,109,5,146
"48215",1048215,82,211,11,304
"48216",1048216,164,96,12,272
"48217",1048217,32,72,3,107
"48218",1048218,82,238,9,329
"48219",1048219,69,232,9,310
"48220",1048220,88,60,0,148
"48221",1048221,27,62,3,92
"48222",1048222,138,38,6,182
"48223",1048223,59,171,5,235
"48224",1048224,51,195,9,255
"48225",1048225,129,55,9,193
"48226",1048226,137,21,11,169
"48227",1048227,88,144,5,237
"48228",1048228,65,127,2,194
"48229",1048229,141,95,3,239
"48230",1048230,29,329,7,365
"48231",1048231,172,53,2,227
"48232",1048232,77,175,10,262
"48233",1048233,126,51,4,181
"48234",1048234,140,49,11,200
"48235",1048235,183,29,6,218
"48236",1048236,124,58,9,191
"48237",1048237,227,32,17,276
"48238",1048238,132,52,5,189
"48239",1048239,105,180,10,295
"48240",1048240,152,77,11,240
"48241",1048241,141,146,14,301
"48242",1048242,107,134,4,245
"48243",1048243,17,126,6,149
"48244",1048244,77,258,5,340
"48245",1048245,131,181,6,318
"48246",1048246,131,8,1,140
"48247",1048247,209,44,12,265
"48248",1048248,101,172,5,278
"48249",1048249,177,53,17,247
"48250",1048250,72,86,3,161
"48251",1048251,196,93,28,317
"48252",1048252,54,263,0,317
"48253",1048253,149,71,18,238
"48254",1048254,173,38,9,220
"48255",1048255,80,145,7,232
"48256",1048256,73,192,7,272
"48257",1048257,189,53,14,256
"48258",1048258,75,151,11,237
"48259",1048259,182,61,4,247
"48260",1048260,108,277,16,401
"48261",1048261,102,89,16,207
"48262",1048262,166,63,5,234
"48263",1048263,41,51,3,95
"48264",1048264,198,43,9,250
"48265",1048265,118,144,7,269
"48266",1048266,110,82,2,194
"48267",1048267,146,120,13,279
"48268",1048268,22,17,0,39
"48269",1048269,59,213,6,278
"48270",1048270,136,99,6,241
"48271",1048271,81,119,7,207
"48272",1048272,156,107,10,273
"48273",1048273,103,66,17,186
"48274",1048274,141,80,8,229
"48275",1048275,238,73,16,327
"48276",1048276,75,127,8,210
"48277",1048277,130,17,4,151
"48278",1048278,34,153,2,189
"48279",1048279,105,73,9,187
"48280",1048280,67,24,4,95
"48281",1048281,68,135,7,210
"48282",1048282,128,115,6,249
"48283",1048283,110,92,10,212
"48284",1048284,189,124,16,329
"48285",1048285,123,118,5,246
"48286",1048286,82,197,15,294
"48287",1048287,118,95,12,225
"48288",1048288,131,53,1,185
"48289",1048289,92,65,3,160
"48290",1048290,46,1,1,48
"48291",1048291,102,56,2,160
"48292",1048292,108,173,11,292
"48293",1048293,60,199,5,264
"48294",1048294,112,77,1,190
"48295",1048295,64,192,12,268
"48296",1048296,171,82,10,263
"48297",1048297,116,52,5,173
"48298",1048298,15,54,3,72
"48299",1048299,23,40,1,64
"48300",1048300,192,15,4,211
"48301",1048301,24,57,3,84
"48302",1048302,164,18,7,189
"48303",1048303,110,108,6,224
"48304",1048304,206,19,7,232
"48305",1048305,237,61,12,310
"48306",1048306,120,121,9,250
"48307",1048307,132,55,7,194
"48308",1048308,106,78,6,190
"48309",1048309,91,221,1,313
"48310",1048310,53,228,8,289
"48311",1048311,87,182,8,277
"48312",1048312,167,77,15,259
"48313",1048313,6,46,0,52
"48314",1048314,141,27,5,173
"48315",1048315,104,46,11,161
"48316",1048316,64,114,12,190
"48317",1048317,175,0,0,175
"48318",1048318,34,222,3,259
"48319",1048319,32,137,5,174
"48320",1048320,88,172,12,272
"48321",1048321,98,148,6,252
"48322",1048322,142,77,21,240
"48323",1048323,169,73,19,261
"48324",1048324,60,98,9,167
"48325",1048325,166,55,6,227
"48326",1048326,76,194,12,282
"48327",1048327,90,136,14,240
"48328",1048328,20,22,6,48
"48329",1048329,130,57,4,191
"48330",1048330,40,201,0,241
"48331",1048331,75,226,4,305
"48332",1048332,133,72,3,208
"48333",1048333,68,149,12,229
"48334",1048334,185,17,5,207
"48335",1048335,133,90,10,233
"48336",1048336,35,109,9,153
"48337",1048337,18,284,7,309
"48338",1048338,274,5,8,287
"48339",1048339,19,9,2,30
"48340",1048340,50,192,8,250
"48341",1048341,94,208,9,311
"48342",1048342,114,58,5,177
"48343",1048343,5,3,1,9
"48344",1048344,161,140,25,326
"48345",1048345,128,23,6,157
"48346",1048346,93,124,5,222
"48347",1048347,145,53,9,207
"48348",1048348,163,122,3,288
"48349",1048349,35,236,8,279
"48350",1048350,90,0,3,93
"48351",1048351,201,32,7,240
"48352",1048352,166,68,12,246
"48353",1048353,85,61,3,149
"48354",1048354,79,107,1,187
"48355",1048355,65,34,3,102
"48356",1048356,131,69,13,213
"48357",1048357,52,20,7,79
"48358",1048358,47,236,6,289
"48359",1048359,190,24,7,221
"48360",1048360,110,103,3,216
"48361",1048361,199,78,10,287
"48362",1048362,186,32,10,228
"48363",1048363,93,97,6,196
"48364",1048364,33,283,2,318
"48365",1048365,181,55,16,252
"48366",1048366,136,64,12,212
"48367",1048367,41,55,2,98
"48368",1048368,173,55,6,234
"48369",1048369,104,174,19,297
"48370",1048370,110,39,7,156
"48371",1048371,20,23,2,45
"48372",1048372,101,107,12,220
"48373",1048373,19,7,0,26
"48374",1048374,141,32,11,184
"48375",1048375,203,18,8,229
"48376",1048376,187,36,7,230
"48377",1048377,11,223,1,235
"48378",1048378,127,127,16,270
"48379",1048379,1,0,0,1
"48380",1048380,43,217,8,268
"48381",1048381,104,38,5,147
"48382",1048382,25,49,2,76
"48383",1048383,191,39,7,237
"48384",1048384,278,19,5,302
"48385",1048385,30,112,4,146
"48386",1048386,60,156,7,223
"48387",1048387,158,57,11,226
"48388",1048388,141,249,19,409
"48389",1048389,61,202,8,271
"48390",1048390,87,76,10,173
"48391",1048391,34,300,10,344
"48392",1048392,177,13,2,192
"48393",1048393,53,175,10,238
"48394",1048394,98,145,8,251
"48395",1048395,74,8,0,82
"48396",1048396,17,135,5,157
"48397",1048397,61,104,6,171
"48398",1048398,124,179,11,314
"48399",1048399,114,146,7,267
"48400",1048400,38,135,3,176
"48401",1048401,122,80,9,211
"48402",1048402,121,178,10,309
"48403",1048403,56,174,15,245
"48404",1048404,134,46,5,185
"48405",1048405,44,158,6,208
"48406",1048406,110,107,1,218
"48407",1048407,17,10,0,27
"48408",1048408,162,92,6,260
"48409",1048409,23,96,1,120
"48410",1048410,53,213,3,269
"48411",1048411,147,19,2,168
"48412",1048412,42,232,2,276
"48413",1048413,186,7,4,197
"48414",1048414,124,137,16,277
"48415",1048415,104,137,2,243
"48416",1048416,60,197,15,272
"48417",1048417,118,84,4,206
"48418",1048418,192,83,21,296
"48419",1048419,27,118,3,148
"48420",1048420,42,134,10,186
"48421",1048421,125,71,13,209
"48422",1048422,63,257,2,322
"48423",1048423,90,80,8,178
"48424",1048424,167,60,11,238
"48425",1048425,161,75,4,240
"48426",1048426,211,55,13,279
"48427",1048427,53,90,5,148
"48428",1048428,263,39,10,312
"48429",1048429,77,176,22,275
"48430",1048430,26,292,4,322
"48431",1048431,101,119,0,220
"48432",1048432,11,9,1,21
"48433",1048433,65,183,14,262
"48434",1048434,211,48,10,269
"48435",1048435,98,154,18,270
"48436",1048436,62,203,9,274
"48437",1048437,159,85,2,246
"48438",1048438,13,2,1,16
"48439",1048439,192,32,8,232
"48440",1048440,79,144,16,239
"48441",1048441,75,48,6,129
"48442",1048442,105,118,9,232
"48443",1048443,47,215,2,264
"48444",1048444,81,85,11,177
"48445",1048445,92,42,3,137
"48446",1048446,77,14,4,95
"48447",1048447,78,164,2,244
"48448",1048448,31,251,4,286
"48449",1048449,96,174,8,278
"48450",1048450,94,30,6,130
"48451",1048451,237,56,3,296
"48452",1048452,179,17,7,203
"48453",1048453,126,3,1,130
"48454",1048454,181,65,18,264
"48455",1048455,126,125,8,259
"48456",1048456,95,104,16,215
"48457",1048457,95,78,3,176
"48458",1048458,217,91,15,323
"48459",1048459,162,50,9,221
"48460",1048460,45,261,4,310
"48461",1048461,146,71,8,225
"48462",1048462,218,75,13,306
"48463",1048463,135,102,8,245
"48464",1048464,52,126,7,185
"48465",1048465,138,102,4,244
"48466",1048466,84,73,6,163
"48467",1048467,142,133,5,280
"48468",1048468,137,18,5,160
"48469",1048469,162,18,8,188
"48470",1048470,46,76,4,126
"48471",1048471,71,223,5,299
"48472",1048472,31,33,4,68
"48473",1048473,77,147,12,236
"48474",1048474,32,304,1,337
"48475",1048475,6,263,3,272
"48476",1048476,19,248,11,278
"48477",1048477,119,43,5,167
"48478",1048478,37,180,3,220
"48479",1048479,171,70,4,245
"48480",1048480,122,93,16,231
"48481",1048481,84,45,3,132
"48482",1048482,98,136,3,237
"48483",1048483,20,223,4,247
"48484",1048484,28,231,1,260
"48485",1048485,133,123,12,268
"48486",1048486,72,148,10,230
"48487",1048487,45,227,9,281
"48488",1048488,69,154,7,230
"48489",1048489,136,46,11,193
"48490",1048490,47,120,26,193
"48491",1048491,58,181,7,246
"48492",1048492,74,49,2,125
"48493",1048493,153,25,6,184
"48494",1048494,125,39,18,182
"48495",1048495,46,61,0,107
"48496",1048496,19,12,1,32
"48497",1048497,155,15,3,173
"48498",1048498,36,231,5,272
"48499",1048499,70,74,4,148
"48500",1048500,99,62,8,169
"48501",1048501,77,35,0,112
"48502",1048502,166,51,9,226
"48503",1048503,129,12,7,148
"48504",1048504,66,170,5,241
"48505",1048505,88,74,14,176
"48506",1048506,9,1,0,10
"48507",1048507,125,152,4,281
"48508",1048508,148,92,4,244
"48509",1048509,127,138,17,282
"48510",1048510,173,50,8,231
"48511",1048511,151,8,2,161
"48512",1048512,102,151,10,263
"48513",1048513,233,8,5,246
"48514",1048514,102,179,3,284
"48515",1048515,14,242,3,259
"48516",1048516,113,195,10,318
"48517",1048517,103,100,8,211
"48518",1048518,0,0,0,0
"48519",1048519,4,8,0,12
"48520",1048520,133,134,4,271
"48521",1048521,55,154,8,217
"48522",1048522,60,155,9,224
"48523",1048523,166,75,5,246
"48524",1048524,186,111,19,316
"48525",1048525,100,28,2,130
"48526",1048526,258,12,0,270
"48527",1048527,28,83,3,114
"48528",1048528,29,1,0,30
"48529",1048529,15,10,0,25
"48530",1048530,135,86,3,224
"48531",1048531,57,237,20,314
"48532",1048532,57,210,5,272
"48533",1048533,123,74,4,201
"48534",1048534,103,127,6,236
"48535",1048535,64,66,4,134
"48536",1048536,90,70,2,162
"48537",1048537,80,169,7,256
"48538",1048538,191,34,6,231
"48539",1048539,122,87,7,216
"48540",1048540,4,10,0,14
"48541",1048541,180,94,16,290
"48542",1048542,142,43,8,193
"48543",1048543,123,20,7,150
"48544",1048544,16,188,1,205
"48545",1048545,94,214,2,310
"48546",1048546,162,39,3,204
"48547",1048547,64,63,6,133
"48548",1048548,171,44,7,222
"48549",1048549,95,49,10,154
"48550",1048550,20,109,15,144
"48551",1048551,208,88,7,303
"48552",1048552,70,107,5,182
"48553",1048553,46,83,10,139
"48554",1048554,142,45,3,190
"48555",1048555,62,117,4,183
"48556",1048556,46,17,6,69
"48557",1048557,25,50,0,75
"48558",1048558,163,54,17,234
"48559",1048559,130,151,15,296
"48560",1048560,42,272,16,330
"48561",1048561,116,113,2,231
"48562",1048562,110,153,10,273
"48563",1048563,80,222,15,317
"48564",1048564,201,63,7,271
"48565",1048565,88,143,7,238
"48566",1048566,117,143,10,270
"48567",1048567,66,166,6,238
"48568",1048568,196,49,9,254
"48569",1048569,201,60,1,262
"48570",1048570,130,157,8,295
"48571",1048571,51,208,7,266
"48572",1048572,119,15,1,135
"48573",1048573,57,239,5,301
"48574",1048574,153,76,12,241
"48575",1048575,69,62,7,138
"48576",1048576,115,101,9,225
"48577",1048577,173,116,16,305
"48578",1048578,193,79,15,287
"48579",1048579,197,48,14,259
"48580",1048580,194,35,3,232
"48581",1048581,46,190,9,245
"48582",1048582,97,133,7,237
"48583",1048583,16,116,4,136
"48584",1048584,203,13,9,225
"48585",1048585,146,70,7,223
"48586",1048586,74,191,11,276
"48587",1048587,31,73,3,107
"48588",1048588,136,61,4,201
"48589",1048589,151,74,6,231
"48590",1048590,149,140,10,299
"48591",1048591,164,50,8,222
"48592",1048592,128,117,5,250
"48593",1048593,237,32,6,275
"48594",1048594,124,116,7,247
"48595",1048595,79,187,17,283
"48596",1048596,102,169,20,291
"48597",1048597,84,203,5,292
"48598",1048598,166,114,15,295
"48599",1048599,116,12,1,129
"48600",1048600,73,248,5,326
"48601",1048601,93,53,7,153
"48602",1048602,56,169,9,234
"48603",1048603,192,22,5,219
"48604",1048604,73,188,5,266
"48605",1048605,204,41,8,253
"48606",1048606,28,223,5,256
"48607",1048607,210,3,5,218
"48608",1048608,120,44,11,175
"48609",1048609,207,35,10,252
"48610",1048610,224,50,16,290
"48611",1048611,90,193,8,291
"48612",1048612,45,245,9,299
"48613",1048613,89,59,2,150
"48614",1048614,50,236,3,289
"48615",1048615,24,19,2,45
"48616",1048616,142,100,5,247
"48617",1048617,111,124,12,247
"48618",1048618,105,105,13,223
"48619",1048619,141,111,19,271
"48620",1048620,80,187,4,271
"48621",1048621,133,116,10,259
"48622",1048622,264,72,18,354
"48623",1048623,166,76,3,245
"48624",1048624,230,84,8,322
"48625",1048625,50,32,1,83
"48626",1048626,19,21,2,42
"48627",1048627,13,60,2,75
"48628",1048628,8,14,0,22
"48629",1048629,51,14,0,65
"48630",1048630,67,231,8,306
"48631",1048631,32,149,7,188
"48632",1048632,58,134,5,197
"48633",1048633,66,212,16,294
"48634",1048634,85,180,6,271
"48635",1048635,188,56,14,258
"48636",1048636,108,80,6,194
"48637",1048637,179,79,9,267
"48638",1048638,47,264,3,314
"48639",1048639,189,35,6,230
"48640",1048640,163,97,12,272
"48641",1048641,150,85,18,253
"48642",1048642,57,174,19,250
"48643",1048643,181,42,6,229
"48644",1048644,15,122,0,137
"48645",1048645,183,108,2,293
"48646",1048646,184,57,15,256
"48647",1048647,152,320,27,499
"48648",1048648,58,165,4,227
"48649",1048649,24,168,21,213
"48650",1048650,127,92,8,227
"48651",1048651,53,133,9,195
"48652",1048652,29,140,12,181
"48653",1048653,54,65,3,122
"48654",1048654,77,104,4,185
"48655",1048655,101,170,11,282
"48656",1048656,72,60,8,140
"48657",1048657,116,187,14,317
"48658",1048658,99,83,11,193
"48659",1048659,25,51,2,78
"48660",1048660,228,5,23,256
"48661",1048661,64,149,8,221
"48662",1048662,17,22,1,40
"48663",1048663,29,183,4,216
"48664",1048664,132,154,15,301
"48665",1048665,132,92,12,236
"48666",1048666,126,158,11,295
"48667",1048667,14,14,1,29
"48668",1048668,65,133,2,200
"48669",1048669,131,139,17,287
"48670",1048670,77,177,10,264
"48671",1048671,107,124,12,243
"48672",1048672,167,32,3,202
"48673",1048673,164,16,2,182
"48674",1048674,24,3,2,29
"48675",1048675,72,180,5,257
"48676",1048676,119,97,4,220
"48677",1048677,211,57,4,272
"48678",1048678,76,120,13,209
"48679",1048679,184,62,9,255
"48680",1048680,174,64,9,247
"48681",1048681,143,19,5,167
"48682",1048682,112,147,5,264
"48683",1048683,139,109,8,256
"48684",1048684,139,95,9,243
"48685",1048685,121,116,4,241
"48686",1048686,60,20,2,82
"48687",1048687,33,170,8,211
"48688",1048688,42,231,7,280
"48689",1048689,104,49,4,157
"48690",1048690,61,242,3,306
"48691",1048691,31,264,3,298
"48692",1048692,38,104,2,144
"48693",1048693,139,64,11,214
"48694",1048694,105,108,1,214
"48695",1048695,42,23,2,67
"48696",1048696,17,42,5,64
"48697",1048697,67,129,19,215
"48698",1048698,146,58,8,212
"48699",1048699,181,42,11,234
"48700",1048700,50,90,6,146
"48701",1048701,131,90,13,234
"48702",1048702,46,150,16,212
"48703",1048703,139,95,1,235
"48704",1048704,76,139,5,220
"48705",1048705,4,30,0,34
"48706",1048706,196,18,1,215
"48707",1048707,178,40,9,227
"48708",1048708,142,53,16,211
"48709",1048709,140,37,7,184
"48710",1048710,119,0,0,119
"48711",1048711,98,161,10,269
"48712",1048712,64,92,10,166
"48713",1048713,146,25,2,173
"48714",1048714,29,153,8,190
"48715",1048715,69,173,8,250
"48716",1048716,147,116,12,275
"48717",1048717,39,141,9,189
"48718",1048718,88,118,4,210
"48719",1048719,54,242,13,309
"48720",1048720,119,50,7,176
"48721",1048721,204,26,8,238
"48722",1048722,110,98,6,214
"48723",1048723,158,111,7,276
"48724",1048724,88,66,4,158
"48725",1048725,102,25,5,132
"48726",1048726,50,183,1,234
"48727",1048727,147,52,7,206
"48728",1048728,120,78,10,208
"48729",1048729,156,46,6,208
"48730",1048730,97,177,18,292
"48731",1048731,36,48,0,84
"48732",1048732,151,116,9,276
"48733",1048733,102,174,14,290
"48734",1048734,64,75,4,143
"48735",1048735,0,0,0,0
"48736",1048736,122,92,13,227
"48737",1048737,36,247,5,288
"48738",1048738,111,114,27,252
"48739",1048739,53,189,4,246
"48740",1048740,125,80,9,214
"48741",1048741,171,44,10,225
"48742",1048742,76,65,4,145
"48743",1048743,46,190,0,236
"48744",1048744,35,283,5,323
"48745",1048745,194,31,7,232
"48746",1048746,138,143,20,301
"48747",1048747,75,216,14,305
"48748",1048748,19,7,0,26
"48749",1048749,224,38,7,269
"48750",1048750,158,28,6,192
"48751",1048751,76,58,6,140
"48752",1048752,167,52,13,232
"48753",1048753,71,156,7,234
"48754",1048754,80,144,13,237
"48755",1048755,225,60,17,302
"48756",1048756,107,69,8,184
"48757",1048757,15,7,2,24
"48758",1048758,157,114,6,277
"48759",1048759,112,174,7,293
"48760",1048760,220,85,4,309
"48761",1048761,159,112,18,289
"48762",1048762,124,128,16,268
"48763",1048763,86,149,6,241
"48764",1048764,113,131,9,253
"48765",1048765,110,34,12,156
"48766",1048766,104,157,9,270
"48767",1048767,124,48,4,176
"48768",1048768,94,8,2,104
"48769",1048769,157,41,8,206
"48770",1048770,127,48,2,177
"48771",1048771,33,142,4,179
"48772",1048772,184,39,2,225
"48773",1048773,141,110,5,256
"48774",1048774,124,114,11,249
"48775",1048775,221,49,4,274
"48776",1048776,224,53,19,296
"48777",1048777,129,128,17,274
"48778",1048778,12,85,1,98
"48779",1048779,72,201,6,279
"48780",1048780,71,11,3,85
"48781",1048781,56,273,15,344
"48782",1048782,191,96,8,295
"48783",1048783,71,161,10,242
"48784",1048784,161,40,7,208
"48785",1048785,145,119,10,274
"48786",1048786,33,255,5,293
"48787",1048787,39,196,2,237
"48788",1048788,29,46,2,77
"48789",1048789,36,249,12,297
"48790",1048790,31,211,14,256
"48791",1048791,76,26,4,106
"48792",1048792,94,60,12,166
"48793",1048793,105,49,5,159
"48794",1048794,139,80,11,230
"48795",1048795,126,102,21,249
"48796",1048796,207,41,10,258
"48797",1048797,36,243,9,288
"48798",1048798,217,78,10,305
"48799",1048799,170,34,7,211
"48800",1048800,148,121,5,274
"48801",1048801,109,173,11,293
"48802",1048802,165,51,10,226
"48803",1048803,92,104,5,201
"48804",1048804,86,178,6,270
"48805",1048805,140,84,8,232
"48806",1048806,196,50,12,258
"48807",1048807,219,34,8,261
"48808",1048808,238,59,11,308
"48809",1048809,45,167,7,219
"48810",1048810,130,77,6,213
"48811",1048811,77,103,15,195
"48812",1048812,29,139,8,176
"48813",1048813,187,95,11,293
"48814",1048814,212,52,6,270
"48815",1048815,200,77,8,285
"48816",1048816,126,36,2,164
"48817",1048817,0,0,0,0
"48818",1048818,164,36,6,206
"48819",1048819,78,219,6,303
"48820",1048820,77,136,6,219
"48821",1048821,165,86,11,262
"48822",1048822,137,7,10,154
"48823",1048823,19,174,2,195
"48824",1048824,170,120,29,319
"48825",1048825,96,35,4,135
"48826",1048826,55,263,3,321
"48827",1048827,26,196,8,230
"48828",1048828,83,180,12,275
"48829",1048829,207,79,18,304
"48830",1048830,230,33,5,268
"48831",1048831,131,75,10,216
"48832",1048832,142,4,8,154
"48833",1048833,15,107,3,125
"48834",1048834,48,221,7,276
"48835",1048835,64,228,3,295
"48836",1048836,18,60,4,82
"48837",1048837,145,47,7,199
"48838",1048838,74,167,5,246
"48839",1048839,16,226,6,248
"48840",1048840,50,289,21,360
"48841",1048841,178,78,6,262
"48842",1048842,147,63,10,220
"48843",1048843,113,89,2,204
"48844",1048844,72,136,5,213
"48845",1048845,22,9,2,33
"48846",1048846,49,158,2,209
"48847",1048847,29,186,11,226
"48848",1048848,96,152,9,257
"48849",1048849,209,0,3,212
"48850",1048850,32,251,3,286
"48851",1048851,45,224,6,275
"48852",1048852,132,41,4,177
"48853",1048853,80,200,8,288
"48854",1048854,15,18,1,34
"48855",1048855,143,45,4,192
"48856",1048856,107,225,3,335
"48857",1048857,223,27,6,256
"48858",1048858,76,101,9,186
"48859",1048859,11,30,4,45
"48860",1048860,142,129,10,281
"48861",1048861,2,10,1,13
"48862",1048862,101,30,3,134
"48863",1048863,145,134,8,287
"48864",1048864,43,189,3,235
"48865",1048865,159,108,5,272
"48866",1048866,228,44,11,283
"48867",1048867,188,83,2,273
"48868",1048868,132,69,10,211
"48869",1048869,79,65,1,145
"48870",1048870,159,119,5,283
"48871",1048871,111,49,5,165
"48872",1048872,152,139,21,312
"48873",1048873,68,154,1,223
"48874",1048874,52,84,4,140
"48875",1048875,184,7,3,194
"48876",1048876,62,170,5,237
"48877",1048877,74,184,11,269
"48878",1048878,55,150,5,210
"48879",1048879,29,99,5,133
"48880",1048880,208,70,21,299
"48881",1048881,54,164,0,218
"48882",1048882,48,182,15,245
"48883",1048883,143,35,4,182
"48884",1048884,133,92,13,238
"48885",1048885,92,84,7,183
"48886",1048886,95,179,20,294
"48887",1048887,115,145,17,277
"48888",1048888,161,21,8,190
"48889",1048889,98,129,11,238
"48890",1048890,97,70,7,174
"48891",1048891,81,97,5,183
"48892",1048892,117,52,6,175
"48893",1048893,82,105,9,196
"48894",1048894,174,85,4,263
"48895",1048895,14,290,3,307
"48896",1048896,41,26,1,68
"48897",1048897,136,53,11,200
"48898",1048898,48,60,4,112
"48899",1048899,36,83,1,120
"48900",1048900,24,164,3,191
"48901",1048901,209,20,4,233
"48902",1048902,207,28,10,245
"48903",1048903,179,88,7,274
"48904",1048904,32,5,1,38
"48905",1048905,105,108,6,219
"48906",1048906,63,8,5,76
"48907",1048907,4,12,0,16
"48908",1048908,198,26,6,230
"48909",1048909,208,65,14,287
"48910",1048910,216,100,10,326
"48911",1048911,298,4,10,312
"48912",1048912,34,5,4,43
"48913",1048913,88,22,4,114
"48914",1048914,106,42,7,155
"48915",1048915,200,40,9,249
"48916",1048916,109,58,16,183
"48917",1048917,201,20,4,225
"48918",1048918,146,213,30,389
"48919",1048919,68,36,5,109
"48920",1048920,117,188,15,320
"48921",1048921,103,141,2,246
"48922",1048922,204,38,3,245
"48923",1048923,29,264,7,300
"48924",1048924,120,196,13,329
"48925",1048925,192,80,15,287
"48926",1048926,254,41,7,302
"48927",1048927,75,221,13,309
"48928",1048928,121,94,6,221
"48929",1048929,77,114,8,199
"48930",1048930,67,61,6,134
"48931",1048931,149,135,16,300
"48932",1048932,99,71,1,171
"48933",1048933,7,2,0,9
"48934",1048934,53,208,5,266
"48935",1048935,60,91,6,157
"48936",1048936,218,13,6,237
"48937",1048937,133,13,5,151
"48938",1048938,147,47,11,205
"48939",1048939,201,73,9,283
"48940",1048940,68,137,3,208
"48941",1048941,156,38,4,198
"48942",1048942,96,29,4,129
"48943",1048943,128,130,2,260
"48944",1048944,7,6,1,14
"48945",1048945,144,74,15,233
"48946",1048946,80,205,18,303
"48947",1048947,116,45,3,164
"48948",1048948,128,168,8,304
"48949",1048949,22,206,3,231
"48950",1048950,198,6,7,211
"48951",1048951,110,81,8,199
"48952",1048952,57,17,5,79
"48953",1048953,178,78,1,257
"48954",1048954,162,62,15,239
"48955",1048955,132,86,3,221
"48956",1048956,49,141,14,204
"48957",1048957,165,103,7,275
"48958",1048958,135,161,2,298
"48959",1048959,141,131,12,284
"48960",1048960,158,134,7,299
"48961",1048961,69,57,3,129
"48962",1048962,141,81,7,229
"48963",1048963,35,0,0,35
"48964",1048964,68,243,5,316
"48965",1048965,142,113,8,263
"48966",1048966,80,185,11,276
"48967",1048967,44,253,2,299
"48968",1048968,96,170,9,275
"48969",1048969,112,65,16,193
"48970",1048970,102,216,5,323
"48971",1048971,119,175,10,304
"48972",1048972,135,44,5,184
"48973",1048973,122,102,9,233
"48974",1048974,45,170,10,225
"48975",1048975,76,197,13,286
"48976",1048976,12,18,4,34
"48977",1048977,168,53,4,225
"48978",1048978,93,108,13,214
"48979",1048979,63,139,3,205
"48980",1048980,169,39,6,214
"48981",1048981,213,14,1,228
"48982",1048982,46,19,1,66
"48983",1048983,134,81,7,222
"48984",1048984,33,192,5,230
"48985",1048985,64,84,7,155
"48986",1048986,179,35,4,218
"48987",1048987,116,177,13,306
"48988",1048988,2,23,1,26
"48989",1048989,206,7,6,219
"48990",1048990,124,47,5,176
"48991",1048991,138,143,10,291
"48992",1048992,153,61,4,218
"48993",1048993,29,206,10,245
"48994",1048994,84,135,7,226
"48995",1048995,147,143,9,299
"48996",1048996,160,10,0,170
"48997",1048997,113,45,6,164
"48998",1048998,94,181,12,287
"48999",1048999,115,62,6,183
"49000",1049000,88,166,4,258
"49001",1049001,51,268,11,330
"49002",1049002,98,153,23,274
"49003",1049003,86,92,7,185
"49004",1049004,51,149,9,209
"49005",1049005,68,201,11,280
"49006",1049006,117,19,6,142
"49007",1049007,176,26,11,213
"49008",1049008,93,164,18,275
"49009",1049009,40,100,4,144
"49010",1049010,23,139,5,167
"49011",1049011,41,172,10,223
"49012",1049012,130,106,3,239
"49013",1049013,19,186,2,207
"49014",1049014,137,55,5,197
"49015",1049015,87,204,16,307
"49016",1049016,89,107,2,198
"49017",1049017,60,252,6,318
"49018",1049018,34,22,5,61
"49019",1049019,40,7,0,47
"49020",1049020,123,143,7,273
"49021",1049021,97,181,7,285
"49022",1049022,107,23,3,133
"49023",1049023,13,20,1,34
"49024",1049024,45,252,5,302
"49025",1049025,37,123,10,170
"49026",1049026,126,67,3,196
"49027",1049027,48,258,2,308
"49028",1049028,52,182,9,243
"49029",1049029,141,36,4,181
"49030",1049030,215,30,8,253
"49031",1049031,12,26,1,39
"49032",1049032,17,191,1,209
"49033",1049033,41,156,6,203
"49034",1049034,49,190,2,241
"49035",1049035,50,175,7,232
"49036",1049036,53,158,7,218
"49037",1049037,171,52,5,228
"49038",1049038,128,117,12,257
"49039",1049039,126,86,9,221
"49040",1049040,106,48,8,162
"49041",1049041,84,75,4,163
"49042",1049042,79,34,9,122
"49043",1049043,59,205,11,275
"49044",1049044,75,107,8,190
"49045",1049045,113,36,6,155
"49046",1049046,29,104,5,138
"49047",1049047,53,192,5,250
"49048",1049048,172,38,7,217
"49049",1049049,194,14,5,213
"49050",1049050,146,171,6,323
"49051",1049051,46,206,8,260
"49052",1049052,224,61,8,293
"49053",1049053,173,40,11,224
"49054",1049054,103,102,8,213
"49055",1049055,71,92,5,168
"49056",1049056,2,3,0,5
"49057",1049057,139,126,16,281
"49058",1049058,153,79,9,241
"49059",1049059,172,37,2,211
"49060",1049060,124,86,4,214
"49061",1049061,27,5,1,33
"49062",1049062,191,114,23,328
"49063",1049063,51,85,2,138
"49064",1049064,126,65,11,202
"49065",1049065,152,73,6,231
"49066",1049066,82,80,8,170
"49067",1049067,70,190,1,261
"49068",1049068,238,20,4,262
"49069",1049069,161,37,16,214
"49070",1049070,79,149,2,230
"49071",1049071,135,108,4,247
"49072",1049072,61,43,2,106
"49073",1049073,86,117,11,214
"49074",1049074,182,114,9,305
"49075",1049075,211,39,12,262
"49076",1049076,196,72,16,284
"49077",1049077,114,110,0,224
"49078",1049078,51,28,3,82
"49079",1049079,27,17,2,46
"49080",1049080,65,190,5,260
"49081",1049081,17,337,4,358
"49082",1049082,47,241,11,299
"49083",1049083,85,191,20,296
"49084",1049084,38,72,3,113
"49085",1049085,90,119,14,223
"49086",1049086,117,25,3,145
"49087",1049087,175,61,7,243
"49088",1049088,194,54,2,250
"49089",1049089,77,107,23,207
"49090",1049090,179,87,4,270
"49091",1049091,39,240,6,285
"49092",1049092,162,29,2,193
"49093",1049093,50,147,11,208
"49094",1049094,156,85,5,246
"49095",1049095,100,127,20,247
"49096",1049096,107,6,1,114
"49097",1049097,98,64,7,169
"49098",1049098,65,155,10,230
"49099",1049099,125,133,13,271
"49100",1049100,162,150,18,330
"49101",1049101,37,273,2,312
"49102",1049102,121,94,6,221
"49103",1049103,202,82,14,298
"49104",1049104,138,123,8,269
"49105",1049105,20,269,10,299
"49106",1049106,124,73,3,200
"49107",1049107,259,30,12,301
"49108",1049108,107,209,13,329
"49109",1049109,136,70,10,216
"49110",1049110,28,256,6,290
"49111",1049111,153,113,14,280
"49112",1049112,125,83,3,211
"49113",1049113,155,51,3,209
"49114",1049114,68,186,10,264
"49115",1049115,55,53,6,114
"49116",1049116,25,144,6,175
"49117",1049117,16,7,1,24
"49118",1049118,48,171,4,223
"49119",1049119,86,187,8,281
"49120",1049120,99,108,17,224
"49121",1049121,133,138,11,282
"49122",1049122,32,199,5,236
"49123",1049123,165,36,13,214
"49124",1049124,68,189,12,269
"49125",1049125,66,165,13,244
"49126",1049126,159,27,6,192
"49127",1049127,147,65,11,223
"49128",1049128,136,74,13,223
"49129",1049129,175,59,13,247
"49130",1049130,67,175,8,250
"49131",1049131,161,97,7,265
"49132",1049132,41,199,2,242
"49133",1049133,200,32,12,244
"49134",1049134,139,29,3,171
"49135",1049135,99,181,6,286
"49136",1049136,74,190,11,275
"49137",1049137,46,67,3,116
"49138",1049138,92,133,9,234
"49139",1049139,87,18,2,107
"49140",1049140,88,96,12,196
"49141",1049141,161,127,15,303
"49142",1049142,88,160,8,256
"49143",1049143,156,83,12,251
"49144",1049144,136,4,0,140
"49145",1049145,95,156,15,266
"49146",1049146,61,204,8,273
"49147",1049147,175,28,3,206
"49148",1049148,52,210,15,277
"49149",1049149,26,207,4,237
"49150",1049150,109,41,2,152
"49151",1049151,79,111,6,196
"49152",1049152,83,116,8,207
"49153",1049153,14,13,0,27
"49154",1049154,159,42,8,209
"49155",1049155,43,160,3,206
"49156",1049156,61,141,10,212
"49157",1049157,155,112,18,285
"49158",1049158,104,166,13,283
"49159",1049159,83,196,6,285
"49160",1049160,39,235,3,277
"49161",1049161,188,27,6,221
"49162",1049162,189,24,6,219
"49163",1049163,47,113,7,167
"49164",1049164,136,28,1,165
"49165",1049165,16,53,1,70
"49166",1049166,94,226,17,337
"49167",1049167,206,104,10,320
"49168",1049168,88,215,4,307
"49169",1049169,151,50,7,208
"49170",1049170,174,101,12,287
"49171",1049171,54,174,12,240
"49172",1049172,52,162,2,216
"49173",1049173,159,79,9,247
"49174",1049174,20,61,0,81
"49175",1049175,54,187,10,251
"49176",1049176,128,57,7,192
"49177",1049177,161,51,13,225
"49178",1049178,99,75,12,186
"49179",1049179,90,103,6,199
"49180",1049180,25,4,1,30
"49181",1049181,27,175,1,203
"49182",1049182,54,281,3,338
"49183",1049183,127,121,17,265
"49184",1049184,85,172,12,269
"49185",1049185,33,21,4,58
"49186",1049186,15,164,10,189
"49187",1049187,0,3,0,3
"49188",1049188,110,85,10,205
"49189",1049189,10,13,2,25
"49190",1049190,19,43,5,67
"49191",1049191,36,180,2,218
"49192",1049192,118,169,10,297
"49193",1049193,215,59,8,282
"49194",1049194,195,24,9,228
"49195",1049195,37,146,4,187
"49196",1049196,93,111,8,212
"49197",1049197,77,5,1,83
"49198",1049198,147,172,15,334
"49199",1049199,107,206,7,320
"49200",1049200,119,7,7,133
"49201",1049201,148,150,15,313
"49202",1049202,164,126,17,307
"49203",1049203,72,120,5,197
"49204",1049204,142,113,20,275
"49205",1049205,43,141,1,185
"49206",1049206,152,81,14,247
"49207",1049207,61,194,16,271
"49208",1049208,84,124,15,223
"49209",1049209,100,119,3,222
"49210",1049210,68,163,9,240
"49211",1049211,201,29,2,232
"49212",1049212,77,164,29,270
"49213",1049213,18,242,1,261
"49214",1049214,145,88,7,240
"49215",1049215,72,186,9,267
"49216",1049216,259,18,12,289
"49217",1049217,137,56,10,203
"49218",1049218,119,81,14,214
"49219",1049219,154,105,13,272
"49220",1049220,81,164,10,255
"49221",1049221,53,131,7,191
"49222",1049222,138,68,13,219
"49223",1049223,34,205,7,246
"49224",1049224,153,51,3,207
"49225",1049225,147,44,8,199
"49226",1049226,17,220,2,239
"49227",1049227,38,222,9,269
"49228",1049228,112,92,12,216
"49229",1049229,21,31,2,54
"49230",1049230,166,43,8,217
"49231",1049231,56,122,8,186
"49232",1049232,12,296,3,311
"49233",1049233,86,203,8,297
"49234",1049234,160,26,13,199
"49235",1049235,63,53,3,119
"49236",1049236,53,174,4,231
"49237",1049237,70,82,9,161
"49238",1049238,180,53,13,246
"49239",1049239,111,185,12,308
"49240",1049240,63,184,14,261
"49241",1049241,150,139,25,314
"49242",1049242,154,102,11,267
"49243",1049243,146,1,2,149
"49244",1049244,8,15,1,24
"49245",1049245,122,38,5,165
"49246",1049246,182,89,6,277
"49247",1049247,100,16,5,121
"49248",1049248,95,42,15,152
"49249",1049249,30,61,2,93
"49250",1049250,135,102,8,245
"49251",1049251,135,172,13,320
"49252",1049252,212,26,12,250
"49253",1049253,72,96,9,177
"49254",1049254,37,208,6,251
"49255",1049255,169,107,10,286
"49256",1049256,158,26,5,189
"49257",1049257,146,77,10,233
"49258",1049258,157,104,3,264
"49259",1049259,165,26,2,193
"49260",1049260,62,112,6,180
"49261",1049261,13,207,2,222
"49262",1049262,14,1,1,16
"49263",1049263,126,148,17,291
"49264",1049264,120,111,9,240
"49265",1049265,89,138,8,235
"49266",1049266,85,133,6,224
"49267",1049267,218,30,6,254
"49268",1049268,161,44,6,211
"49269",1049269,144,42,7,193
"49270",1049270,150,118,7,275
"49271",1049271,73,119,6,198
"49272",1049272,176,50,2,228
"49273",1049273,125,79,14,218
"49274",1049274,148,11,3,162
"49275",1049275,97,59,7,163
"49276",1049276,158,56,5,219
"49277",1049277,40,266,1,307
"49278",1049278,134,99,3,236
"49279",1049279,43,48,3,94
"49280",1049280,148,62,8,218
"49281",1049281,158,78,22,258
"49282",1049282,137,155,8,300
"49283",1049283,167,56,8,231
"49284",1049284,81,137,6,224
"49285",1049285,138,42,10,190
"49286",1049286,54,53,3,110
"49287",1049287,63,139,4,206
"49288",1049288,192,41,9,242
"49289",1049289,51,150,16,217
"49290",1049290,110,178,8,296
"49291",1049291,84,2,7,93
"49292",1049292,147,15,6,168
"49293",1049293,128,4,4,136
"49294",1049294,16,10,1,27
"49295",1049295,108,86,10,204
"49296",1049296,127,110,7,244
"49297",1049297,187,121,7,315
"49298",1049298,27,74,2,103
"49299",1049299,85,0,0,85
"49300",1049300,177,64,13,254
"49301",1049301,189,66,7,262
"49302",1049302,119,122,12,253
"49303",1049303,55,21,2,78
"49304",1049304,194,31,8,233
"49305",1049305,59,90,19,168
"49306",1049306,137,134,6,277
"49307",1049307,48,49,0,97
"49308",1049308,154,68,11,233
"49309",1049309,213,67,8,288
"49310",1049310,183,24,5,212
"49311",1049311,206,68,7,281
"49312",1049312,62,68,9,139
"49313",1049313,126,50,6,182
"49314",1049314,157,81,9,247
"49315",1049315,72,184,6,262
"49316",1049316,36,282,8,326
"49317",1049317,74,144,7,225
"49318",1049318,78,190,10,278
"49319",1049319,59,64,8,131
"49320",1049320,150,45,14,209
"49321",1049321,116,192,10,318
"49322",1049322,225,81,3,309
"49323",1049323,143,64,4,211
"49324",1049324,90,172,8,270
"49325",1049325,135,93,5,233
"49326",1049326,69,222,6,297
"49327",1049327,85,143,4,232
"49328",1049328,23,255,6,284
"49329",1049329,66,100,5,171
"49330",1049330,88,162,6,256
"49331",1049331,193,5,22,220
"49332",1049332,151,84,5,240
"49333",1049333,135,10,5,150
"49334",1049334,119,125,17,261
"49335",1049335,119,104,11,234
"49336",1049336,97,129,6,232
"49337",1049337,70,188,5,263
"49338",1049338,74,168,6,248
"49339",1049339,90,149,3,242
"49340",1049340,80,243,14,337
"49341",1049341,53,85,5,143
"49342",1049342,109,160,12,281
"49343",1049343,258,21,5,284
"49344",1049344,52,42,3,97
"49345",1049345,173,156,18,347
"49346",1049346,6,129,0,135
"49347",1049347,81,126,11,218
"49348",1049348,98,139,13,250
"49349",1049349,71,67,2,140
"49350",1049350,173,46,3,222
"49351",1049351,184,86,5,275
"49352",1049352,38,192,10,240
"49353",1049353,241,24,11,276
"49354",1049354,57,116,4,177
"49355",1049355,91,89,9,189
"49356",1049356,72,153,9,234
"49357",1049357,198,52,2,252
"49358",1049358,149,117,10,276
"49359",1049359,109,98,9,216
"49360",1049360,194,89,6,289
"49361",1049361,27,56,5,88
"49362",1049362,107,162,11,280
"49363",1049363,102,131,13,246
"49364",1049364,71,201,7,279
"49365",1049365,131,136,9,276
"49366",1049366,46,180,2,228
"49367",1049367,48,166,2,216
"49368",1049368,102,67,6,175
"49369",1049369,142,114,26,282
"49370",1049370,76,111,11,198
"49371",1049371,136,22,3,161
"49372",1049372,79,42,2,123
"49373",1049373,69,185,1,255
"49374",1049374,151,44,3,198
"49375",1049375,59,59,12,130
"49376",1049376,73,194,12,279
"49377",1049377,111,53,6,170
"49378",1049378,20,1,3,24
"49379",1049379,128,47,5,180
"49380",1049380,54,79,8,141
"49381",1049381,79,111,3,193
"49382",1049382,101,170,17,288
"49383",1049383,69,0,1,70
"49384",1049384,56,198,2,256
"49385",1049385,4,12,0,16
"49386",1049386,146,159,18,323
"49387",1049387,57,224,8,289
"49388",1049388,26,108,0,134
"49389",1049389,177,21,11,209
"49390",1049390,73,126,11,210
"49391",1049391,60,214,13,287
"49392",1049392,161,43,9,213
"49393",1049393,65,189,1,255
"49394",1049394,147,131,25,303
"49395",1049395,204,23,8,235
"49396",1049396,109,15,4,128
"49397",1049397,112,183,9,304
"49398",1049398,114,73,6,193
"49399",1049399,106,110,6,222
"49400",1049400,119,44,7,170
"49401",1049401,90,63,12,165
"49402",1049402,140,142,9,291
"49403",1049403,38,239,9,286
"49404",1049404,62,251,2,315
"49405",1049405,53,223,5,281
"49406",1049406,117,203,14,334
"49407",1049407,131,31,5,167
"49408",1049408,132,137,9,278
"49409",1049409,155,20,7,182
"49410",1049410,232,49,11,292
"49411",1049411,176,94,8,278
"49412",1049412,81,63,1,145
"49413",1049413,51,183,5,239
"49414",1049414,104,11,5,120
"49415",1049415,170,65,9,244
"49416",1049416,65,188,1,254
"49417",1049417,25,152,5,182
"49418",1049418,133,3,15,151
"49419",1049419,173,54,3,230
"49420",1049420,257,44,4,305
"49421",1049421,185,72,4,261
"49422",1049422,100,166,16,282
"49423",1049423,140,124,10,274
"49424",1049424,43,246,4,293
"49425",1049425,89,147,12,248
"49426",1049426,54,128,11,193
"49427",1049427,27,213,5,245
"49428",1049428,90,9,2,101
"49429",1049429,66,188,9,263
"49430",1049430,49,49,4,102
"49431",1049431,75,74,13,162
"49432",1049432,40,188,3,231
"49433",1049433,80,92,16,188
"49434",1049434,9,28,2,39
"49435",1049435,70,214,9,293
"49436",1049436,160,33,2,195
"49437",1049437,17,228,4,249
"49438",1049438,7,2,2,11
"49439",1049439,96,90,18,204
"49440",1049440,121,41,1,163
"49441",1049441,49,176,13,238
"49442",1049442,137,236,5,378
"49443",1049443,173,22,7,202
"49444",1049444,9,38,2,49
"49445",1049445,47,202,7,256
"49446",1049446,142,79,6,227
"49447",1049447,225,32,7,264
"49448",1049448,97,142,17,256
"49449",1049449,62,66,9,137
"49450",1049450,129,89,11,229
"49451",1049451,123,91,10,224
"49452",1049452,64,82,0,146
"49453",1049453,61,53,2,116
"49454",1049454,108,164,11,283
"49455",1049455,5,5,0,10
"49456",1049456,102,182,6,290
"49457",1049457,98,95,7,200
"49458",1049458,107,127,2,236
"49459",1049459,69,214,9,292
"49460",1049460,51,126,4,181
"49461",1049461,11,325,6,342
"49462",1049462,97,86,6,189
"49463",1049463,107,155,3,265
"49464",1049464,98,79,5,182
"49465",1049465,132,62,14,208
"49466",1049466,133,123,8,264
"49467",1049467,114,4,0,118
"49468",1049468,52,246,6,304
"49469",1049469,167,24,3,194
"49470",1049470,23,10,1,34
"49471",1049471,169,51,14,234
"49472",1049472,81,169,13,263
"49473",1049473,95,105,10,210
"49474",1049474,98,49,7,154
"49475",1049475,129,87,20,236
"49476",1049476,26,6,1,33
"49477",1049477,103,157,16,276
"49478",1049478,43,169,4,216
"49479",1049479,111,69,8,188
"49480",1049480,97,74,8,179
"49481",1049481,98,147,10,255
"49482",1049482,102,106,16,224
"49483",1049483,8,66,1,75
"49484",1049484,185,47,9,241
"49485",1049485,160,77,8,245
"49486",1049486,95,86,9,190
"49487",1049487,148,57,15,220
"49488",1049488,93,110,9,212
"49489",1049489,141,62,2,205
"49490",1049490,117,29,6,152
"49491",1049491,169,95,18,282
"49492",1049492,159,52,1,212
"49493",1049493,80,31,7,118
"49494",1049494,29,170,3,202
"49495",1049495,161,114,30,305
"49496",1049496,146,74,15,235
"49497",1049497,302,83,9,394
"49498",1049498,229,85,19,333
"49499",1049499,47,184,7,238
"49500",1049500,99,85,7,191
"49501",1049501,123,139,15,277
"49502",1049502,176,55,8,239
"49503",1049503,130,147,10,287
"49504",1049504,66,215,6,287
"49505",1049505,80,86,4,170
"49506",1049506,28,217,3,248
"49507",1049507,60,194,5,259
"49508",1049508,26,251,4,281
"49509",1049509,11,12,4,27
"49510",1049510,55,157,11,223
"49511",1049511,52,207,12,271
"49512",1049512,130,73,6,209
"49513",1049513,32,165,6,203
"49514",1049514,65,7,3,75
"49515",1049515,192,89,10,291
"49516",1049516,74,183,12,269
"49517",1049517,166,124,5,295
"49518",1049518,37,156,6,199
"49519",1049519,228,79,18,325
"49520",1049520,46,201,8,255
"49521",1049521,165,93,6,264
"49522",1049522,71,231,8,310
"49523",1049523,37,147,6,190
"49524",1049524,172,71,2,245
"49525",1049525,165,42,10,217
"49526",1049526,125,35,5,165
"49527",1049527,113,26,2,141
"49528",1049528,153,81,9,243
"49529",1049529,124,127,28,279
"49530",1049530,49,250,8,307
"49531",1049531,17,245,4,266
"49532",1049532,182,84,9,275
"49533",1049533,5,26,1,32
"49534",1049534,31,171,10,212
"49535",1049535,162,38,11,211
"49536",1049536,120,49,5,174
"49537",1049537,187,94,16,297
"49538",1049538,165,95,14,274
"49539",1049539,143,84,15,242
"49540",1049540,75,216,3,294
"49541",1049541,65,170,2,237
"49542",1049542,152,119,11,282
"49543",1049543,46,14,2,62
"49544",1049544,94,146,12,252
"49545",1049545,24,200,3,227
"49546",1049546,49,110,11,170
"49547",1049547,111,40,8,159
"49548",1049548,85,151,10,246
"49549",1049549,56,100,13,169
"49550",1049550,56,130,1,187
"49551",1049551,129,173,11,313
"49552",1049552,63,183,1,247
"49553",1049553,66,72,5,143
"49554",1049554,18,34,2,54
"49555",1049555,190,55,7,252
"49556",1049556,111,136,17,264
"49557",1049557,151,67,7,225
"49558",1049558,191,62,24,277
"49559",1049559,170,139,14,323
"49560",1049560,154,42,5,201
"49561",1049561,132,38,6,176
"49562",1049562,149,26,7,182
"49563",1049563,76,162,3,241
"49564",1049564,224,28,5,257
"49565",1049565,84,119,9,212
"49566",1049566,93,82,14,189
"49567",1049567,152,113,13,278
"49568",1049568,47,60,2,109
"49569",1049569,134,140,8,282
"49570",1049570,103,204,8,315
"49571",1049571,120,65,2,187
"49572",1049572,45,237,10,292
"49573",1049573,43,17,2,62
"49574",1049574,40,186,1,227
"49575",1049575,90,91,8,189
"49576",1049576,218,38,9,265
"49577",1049577,82,35,4,121
"49578",1049578,25,244,1,270
"49579",1049579,130,12,1,143
"49580",1049580,58,129,0,187
"49581",1049581,166,0,3,169
"49582",1049582,160,114,5,279
"49583",1049583,181,22,8,211
"49584",1049584,158,115,23,296
"49585",1049585,144,37,5,186
"49586",1049586,146,91,18,255
"49587",1049587,29,142,4,175
"49588",1049588,215,81,17,313
"49589",1049589,50,133,9,192
"49590",1049590,51,32,2,85
"49591",1049591,109,52,6,167
"49592",1049592,60,136,3,199
"49593",1049593,69,228,2,299
"49594",1049594,119,46,4,169
"49595",1049595,132,123,14,269
"49596",1049596,117,101,20,238
"49597",1049597,27,197,2,226
"49598",1049598,178,39,10,227
"49599",1049599,94,174,10,278
"49600",1049600,105,108,15,228
"49601",1049601,82,181,5,268
"49602",1049602,150,52,6,208
"49603",1049603,90,95,3,188
"49604",1049604,192,21,8,221
"49605",1049605,146,86,6,238
"49606",1049606,160,132,16,308
"49607",1049607,8,103,1,112
"49608",1049608,133,127,22,282
"49609",1049609,100,19,3,122
"49610",1049610,106,44,4,154
"49611",1049611,78,142,11,231
"49612",1049612,183,55,7,245
"49613",1049613,184,75,12,271
"49614",1049614,152,20,3,175
"49615",1049615,131,206,13,350
"49616",1049616,81,160,4,245
"49617",1049617,148,103,2,253
"49618",1049618,138,16,1,155
"49619",1049619,123,175,19,317
"49620",1049620,167,68,14,249
"49621",1049621,100,81,4,185
"49622",1049622,185,118,21,324
"49623",1049623,167,20,3,190
"49624",1049624,61,190,15,266
"49625",1049625,74,178,10,262
"49626",1049626,128,143,3,274
"49627",1049627,100,189,7,296
"49628",1049628,138,60,7,205
"49629",1049629,121,71,9,201
"49630",1049630,162,50,7,219
"49631",1049631,73,172,16,261
"49632",1049632,168,78,7,253
"49633",1049633,112,65,12,189
"49634",1049634,24,212,2,238
"49635",1049635,178,37,3,218
"49636",1049636,170,114,7,291
"49637",1049637,67,152,10,229
"49638",1049638,75,175,10,260
"49639",1049639,116,150,7,273
"49640",1049640,37,159,10,206
"49641",1049641,109,108,9,226
"49642",1049642,182,34,8,224
"49643",1049643,196,59,14,269
"49644",1049644,101,94,4,199
"49645",1049645,84,37,7,128
"49646",1049646,196,69,9,274
"49647",1049647,149,51,17,217
"49648",1049648,139,105,10,254
"49649",1049649,69,159,4,232
"49650",1049650,162,107,17,286
"49651",1049651,167,97,12,276
"49652",1049652,88,30,1,119
"49653",1049653,44,273,5,322
"49654",1049654,130,172,4,306
"49655",1049655,108,72,11,191
"49656",1049656,72,196,7,275
"49657",1049657,155,157,6,318
"49658",1049658,180,91,9,280
"49659",1049659,13,68,2,83
"49660",1049660,88,206,10,304
"49661",1049661,38,10,2,50
"49662",1049662,148,26,3,177
"49663",1049663,75,59,5,139
"49664",1049664,208,55,15,278
"49665",1049665,180,32,7,219
"49666",1049666,46,181,1,228
"49667",1049667,57,153,7,217
"49668",1049668,87,50,5,142
"49669",1049669,112,57,6,175
"49670",1049670,15,272,2,289
"49671",1049671,138,124,6,268
"49672",1049672,104,25,1,130
"49673",1049673,223,31,4,258
"49674",1049674,114,142,3,259
"49675",1049675,32,102,1,135
"49676",1049676,197,20,8,225
"49677",1049677,232,38,11,281
"49678",1049678,98,200,12,310
"49679",1049679,151,147,9,307
"49680",1049680,115,101,5,221
"49681",1049681,90,50,9,149
"49682",1049682,85,62,8,155
"49683",1049683,67,247,3,317
"49684",1049684,123,21,5,149
"49685",1049685,59,91,13,163
"49686",1049686,223,33,7,263
"49687",1049687,41,58,3,102
"49688",1049688,76,166,12,254
"49689",1049689,72,194,7,273
"49690",1049690,219,89,9,317
"49691",1049691,104,172,17,293
"49692",1049692,117,70,8,195
"49693",1049693,93,166,10,269
"49694",1049694,147,36,7,190
"49695",1049695,46,71,3,120
"49696",1049696,169,83,6,258
"49697",1049697,123,123,12,258
"49698",1049698,62,44,0,106
"49699",1049699,209,57,10,276
"49700",1049700,54,202,7,263
"49701",1049701,237,64,8,309
"49702",1049702,213,98,10,321
"49703",1049703,29,160,6,195
"49704",1049704,209,26,4,239
"49705",1049705,12,2,0,14
"49706",1049706,102,164,13,279
"49707",1049707,19,247,5,271
"49708",1049708,62,186,11,259
"49709",1049709,249,27,4,280
"49710",1049710,18,37,1,56
"49711",1049711,102,138,29,269
"49712",1049712,187,56,7,250
"49713",1049713,129,86,17,232
"49714",1049714,117,103,14,234
"49715",1049715,160,134,22,316
"49716",1049716,12,56,4,72
"49717",1049717,141,49,5,195
"49718",1049718,19,136,4,159
"49719",1049719,37,236,2,275
"49720",1049720,53,250,9,312
"49721",1049721,127,46,2,175
"49722",1049722,224,92,5,321
"49723",1049723,38,127,1,166
"49724",1049724,96,149,8,253
"49725",1049725,113,104,12,229
"49726",1049726,103,141,8,252
"49727",1049727,183,78,12,273
"49728",1049728,211,26,11,248
"49729",1049729,191,115,17,323
"49730",1049730,116,36,4,156
"49731",1049731,3,14,1,18
"49732",1049732,75,122,4,201
"49733",1049733,57,208,9,274
"49734",1049734,85,150,7,242
"49735",1049735,199,101,12,312
"49736",1049736,120,98,10,228
"49737",1049737,53,98,6,157
"49738",1049738,51,83,15,149
"49739",1049739,190,44,7,241
"49740",1049740,73,228,13,314
"49741",1049741,238,33,10,281
"49742",1049742,136,92,10,238
"49743",1049743,73,230,12,315
"49744",1049744,173,81,11,265
"49745",1049745,88,126,33,247
"49746",1049746,209,33,5,247
"49747",1049747,3,1,0,4
"49748",1049748,106,186,15,307
"49749",1049749,152,54,7,213
"49750",1049750,139,107,7,253
"49751",1049751,20,262,7,289
"49752",1049752,75,167,9,251
"49753",1049753,235,17,9,261
"49754",1049754,109,90,6,205
"49755",1049755,76,129,6,211
"49756",1049756,112,87,14,213
"49757",1049757,102,24,3,129
"49758",1049758,45,281,10,336
"49759",1049759,146,120,11,277
"49760",1049760,225,16,10,251
"49761",1049761,86,29,7,122
"49762",1049762,87,131,18,236
"49763",1049763,121,19,6,146
"49764",1049764,51,204,10,265
"49765",1049765,138,128,3,269
"49766",1049766,51,177,12,240
"49767",1049767,74,124,11,209
"49768",1049768,88,202,14,304
"49769",1049769,181,29,5,215
"49770",1049770,157,97,6,260
"49771",1049771,8,11,2,21
"49772",1049772,143,105,5,253
"49773",1049773,43,67,2,112
"49774",1049774,82,91,14,187
"49775",1049775,149,89,11,249
"49776",1049776,143,134,7,284
"49777",1049777,44,37,10,91
"49778",1049778,11,133,0,144
"49779",1049779,223,30,11,264
"49780",1049780,96,152,18,266
"49781",1049781,184,76,16,276
"49782",1049782,152,90,6,248
"49783",1049783,232,44,2,278
"49784",1049784,56,33,4,93
"49785",1049785,117,71,8,196
"49786",1049786,214,109,15,338
"49787",1049787,106,126,14,246
"49788",1049788,66,119,11,196
"49789",1049789,227,72,24,323
"49790",1049790,97,32,4,133
"49791",1049791,212,58,7,277
"49792",1049792,85,170,10,265
"49793",1049793,131,32,4,167
"49794",1049794,35,100,6,141
"49795",1049795,133,41,2,176
"49796",1049796,120,162,10,292
"49797",1049797,110,127,22,259
"49798",1049798,179,116,21,316
"49799",1049799,129,87,5,221
"49800",1049800,210,43,10,263
"49801",1049801,22,171,1,194
"49802",1049802,115,84,10,209
"49803",1049803,139,64,1,204
"49804",1049804,50,172,4,226
"49805",1049805,67,174,14,255
"49806",1049806,34,89,7,130
"49807",1049807,159,78,7,244
"49808",1049808,259,15,4,278
"49809",1049809,141,80,4,225
"49810",1049810,52,153,12,217
"49811",1049811,151,126,22,299
"49812",1049812,22,184,5,211
"49813",1049813,5,3,0,8
"49814",1049814,97,119,8,224
"49815",1049815,50,266,2,318
"49816",1049816,126,127,13,266
"49817",1049817,88,137,8,233
"49818",1049818,199,37,8,244
"49819",1049819,49,30,1,80
"49820",1049820,124,111,5,240
"49821",1049821,119,80,3,202
"49822",1049822,121,86,4,211
"49823",1049823,166,133,17,316
"49824",1049824,135,105,6,246
"49825",1049825,140,102,10,252
"49826",1049826,144,99,17,260
"49827",1049827,116,166,9,291
"49828",1049828,140,42,8,190
"49829",1049829,149,97,14,260
"49830",1049830,59,28,1,88
"49831",1049831,65,245,7,317
"49832",1049832,135,22,6,163
"49833",1049833,18,240,7,265
"49834",1049834,54,258,16,328
"49835",1049835,137,137,15,289
"49836",1049836,203,16,3,222
"49837",1049837,24,259,5,288
"49838",1049838,168,44,9,221
"49839",1049839,158,73,12,243
"49840",1049840,79,174,14,267
"49841",1049841,197,62,3,262
"49842",1049842,56,216,13,285
"49843",1049843,35,81,3,119
"49844",1049844,52,17,1,70
"49845",1049845,152,42,6,200
"49846",1049846,175,35,7,217
"49847",1049847,158,123,25,306
"49848",1049848,121,78,11,210
"49849",1049849,87,69,8,164
"49850",1049850,141,123,17,281
"49851",1049851,98,33,3,134
"49852",1049852,46,221,4,271
"49853",1049853,267,37,13,317
"49854",1049854,177,80,11,268
"49855",1049855,153,68,8,229
"49856",1049856,141,65,7,213
"49857",1049857,64,234,25,323
"49858",1049858,192,16,3,211
"49859",1049859,106,3,0,109
"49860",1049860,89,99,6,194
"49861",1049861,112,131,3,246
"49862",1049862,150,34,17,201
"49863",1049863,88,102,14,204
"49864",1049864,46,278,5,329
"49865",1049865,16,6,1,23
"49866",1049866,45,161,4,210
"49867",1049867,62,177,2,241
"49868",1049868,155,135,6,296
"49869",1049869,125,61,11,197
"49870",1049870,135,136,9,280
"49871",1049871,82,28,4,114
"49872",1049872,134,136,22,292
"49873",1049873,180,37,12,229
"49874",1049874,74,150,7,231
"49875",1049875,111,40,10,161
"49876",1049876,108,117,12,237
"49877",1049877,158,20,2,180
"49878",1049878,38,70,6,114
"49879",1049879,58,63,3,124
"49880",1049880,47,183,3,233
"49881",1049881,61,218,7,286
"49882",1049882,139,16,0,155
"49883",1049883,202,58,11,271
"49884",1049884,178,59,3,240
"49885",1049885,21,15,2,38
"49886",1049886,76,179,5,260
"49887",1049887,62,245,3,310
"49888",1049888,42,141,8,191
"49889",1049889,84,75,5,164
"49890",1049890,84,98,1,183
"49891",1049891,45,84,1,130
"49892",1049892,168,87,6,261
"49893",1049893,14,243,3,260
"49894",1049894,110,45,2,157
"49895",1049895,30,23,1,54
"49896",1049896,76,160,5,241
"49897",1049897,120,141,19,280
"49898",1049898,136,35,5,176
"49899",1049899,101,169,7,277
"49900",1049900,23,261,7,291
"49901",1049901,69,243,15,327
"49902",1049902,134,55,8,197
"49903",1049903,7,4,0,11
"49904",1049904,119,25,11,155
"49905",1049905,92,147,13,252
"49906",1049906,187,24,6,217
"49907",1049907,33,12,5,50
"49908",1049908,37,191,1,229
"49909",1049909,110,51,4,165
"49910",1049910,149,38,12,199
"49911",1049911,63,119,4,186
"49912",1049912,135,75,6,216
"49913",1049913,58,191,10,259
"49914",1049914,204,64,24,292
"49915",1049915,112,135,1,248
"49916",1049916,59,249,5,313
"49917",1049917,73,185,3,261
"49918",1049918,152,139,18,309
"49919",1049919,67,61,2,130
"49920",1049920,133,31,1,165
"49921",1049921,179,21,3,203
"49922",1049922,137,106,15,258
"49923",1049923,23,4,2,29
"49924",1049924,173,47,5,225
"49925",1049925,181,80,12,273
"49926",1049926,76,207,5,288
"49927",1049927,65,265,12,342
"49928",1049928,163,75,8,246
"49929",1049929,62,57,7,126
"49930",1049930,161,127,2,290
"49931",1049931,196,52,12,260
"49932",1049932,123,53,5,181
"49933",1049933,62,188,4,254
"49934",1049934,141,63,15,219
"49935",1049935,173,87,15,275
"49936",1049936,154,105,14,273
"49937",1049937,131,67,7,205
"49938",1049938,162,105,13,280
"49939",1049939,42,200,10,252
"49940",1049940,91,144,12,247
"49941",1049941,39,168,15,222
"49942",1049942,215,32,11,258
"49943",1049943,124,64,9,197
"49944",1049944,276,18,9,303
"49945",1049945,72,201,14,287
"49946",1049946,129,11,14,154
"49947",1049947,144,63,9,216
"49948",1049948,215,72,24,311
"49949",1049949,113,29,11,153
"49950",1049950,41,259,6,306
"49951",1049951,154,36,7,197
"49952",1049952,150,11,5,166
"49953",1049953,109,183,8,300
"49954",1049954,163,46,12,221
"49955",1049955,151,52,0,203
"49956",1049956,3,87,0,90
"49957",1049957,87,67,13,167
"49958",1049958,70,31,3,104
"49959",1049959,159,41,7,207
"49960",1049960,69,179,3,251
"49961",1049961,21,2,2,25
"49962",1049962,101,81,8,190
"49963",1049963,77,156,1,234
"49964",1049964,174,59,1,234
"49965",1049965,35,251,2,288
"49966",1049966,89,111,16,216
"49967",1049967,183,43,6,232
"49968",1049968,271,11,7,289
"49969",1049969,178,106,18,302
"49970",1049970,240,16,6,262
"49971",1049971,79,143,6,228
"49972",1049972,128,42,4,174
"49973",1049973,41,180,3,224
"49974",1049974,77,225,1,303
"49975",1049975,130,161,21,312
"49976",1049976,67,150,3,220
"49977",1049977,45,173,14,232
"49978",1049978,96,204,2,302
"49979",1049979,49,143,7,199
"49980",1049980,151,150,9,310
"49981",1049981,119,54,5,178
"49982",1049982,77,164,5,246
"49983",1049983,130,21,5,156
"49984",1049984,112,59,9,180
"49985",1049985,162,94,6,262
"49986",1049986,97,141,23,261
"49987",1049987,178,95,19,292
"49988",1049988,104,98,15,217
"49989",1049989,221,22,7,250
"49990",1049990,305,198,6,509
"49991",1049991,43,254,3,300
"49992",1049992,123,116,6,245
"49993",1049993,49,192,4,245
"49994",1049994,157,133,15,305
"49995",1049995,19,19,0,38
"49996",1049996,82,165,4,251
"49997",1049997,78,61,4,143
"49998",1049998,141,74,23,238
"49999",1049999,28,4,0,32
"50000",1050000,29,124,10,163
"50001",1050001,165,102,13,280
"50002",1050002,34,29,5,68
"50003",1050003,119,167,18,304
"50004",1050004,61,45,1,107
"50005",1050005,119,58,9,186
"50006",1050006,159,75,13,247
"50007",1050007,42,175,3,220
"50008",1050008,21,240,2,263
"50009",1050009,100,69,4,173
"50010",1050010,98,44,4,146
"50011",1050011,18,7,1,26
"50012",1050012,85,149,4,238
"50013",1050013,166,29,11,206
"50014",1050014,210,100,9,319
"50015",1050015,203,60,10,273
"50016",1050016,58,171,5,234
"50017",1050017,42,204,8,254
"50018",1050018,71,114,4,189
"50019",1050019,65,191,3,259
"50020",1050020,51,171,2,224
"50021",1050021,53,59,3,115
"50022",1050022,150,108,9,267
"50023",1050023,159,69,16,244
"50024",1050024,130,36,4,170
"50025",1050025,70,124,15,209
"50026",1050026,148,108,10,266
"50027",1050027,109,129,8,246
"50028",1050028,198,44,7,249
"50029",1050029,58,170,7,235
"50030",1050030,8,36,2,46
"50031",1050031,75,142,6,223
"50032",1050032,163,86,4,253
"50033",1050033,170,74,16,260
"50034",1050034,48,270,4,322
"50035",1050035,154,80,7,241
"50036",1050036,22,123,2,147
"50037",1050037,137,159,14,310
"50038",1050038,140,70,14,224
"50039",1050039,165,49,2,216
"50040",1050040,89,233,14,336
"50041",1050041,173,93,4,270
"50042",1050042,113,51,11,175
"50043",1050043,146,67,8,221
"50044",1050044,57,142,5,204
"50045",1050045,163,82,15,260
"50046",1050046,53,118,8,179
"50047",1050047,40,171,3,214
"50048",1050048,150,12,4,166
"50049",1050049,179,87,10,276
"50050",1050050,66,37,3,106
"50051",1050051,153,39,9,201
"50052",1050052,70,133,8,211
"50053",1050053,2,6,0,8
"50054",1050054,35,204,11,250
"50055",1050055,127,71,11,209
"50056",1050056,155,14,3,172
"50057",1050057,9,168,0,177
"50058",1050058,39,62,3,104
"50059",1050059,117,96,4,217
"50060",1050060,59,105,8,172
"50061",1050061,161,118,7,286
"50062",1050062,81,92,4,177
"50063",1050063,86,61,9,156
"50064",1050064,197,51,9,257
"50065",1050065,56,172,7,235
"50066",1050066,146,30,4,180
"50067",1050067,138,85,6,229
"50068",1050068,175,51,3,229
"50069",1050069,185,58,8,251
"50070",1050070,70,173,11,254
"50071",1050071,121,167,22,310
"50072",1050072,37,59,2,98
"50073",1050073,153,85,16,254
"50074",1050074,77,39,3,119
"50075",1050075,42,59,0,101
"50076",1050076,156,1,1,158
"50077",1050077,96,221,12,329
"50078",1050078,121,71,13,205
"50079",1050079,96,59,2,157
"50080",1050080,126,60,12,198
"50081",1050081,61,240,7,308
"50082",1050082,242,20,3,265
"50083",1050083,175,63,14,252
"50084",1050084,84,84,4,172
"50085",1050085,179,91,14,284
"50086",1050086,86,94,11,191
"50087",1050087,79,71,10,160
"50088",1050088,161,42,8,211
"50089",1050089,161,112,16,289
"50090",1050090,170,87,11,268
"50091",1050091,61,118,10,189
"50092",1050092,57,261,10,328
"50093",1050093,119,111,10,240
"50094",1050094,139,43,7,189
"50095",1050095,106,24,5,135
"50096",1050096,99,168,18,285
"50097",1050097,23,217,5,245
"50098",1050098,45,31,3,79
"50099",1050099,196,35,8,239
"50100",1050100,56,195,15,266
"50101",1050101,162,42,8,212
"50102",1050102,41,144,3,188
"50103",1050103,69,82,9,160
"50104",1050104,81,198,5,284
"50105",1050105,70,36,1,107
"50106",1050106,77,154,9,240
"50107",1050107,191,13,3,207
"50108",1050108,49,233,1,283
"50109",1050109,86,222,11,319
"50110",1050110,177,34,4,215
"50111",1050111,172,67,10,249
"50112",1050112,62,235,10,307
"50113",1050113,141,145,9,295
"50114",1050114,16,4,2,22
"50115",1050115,94,112,14,220
"50116",1050116,98,145,10,253
"50117",1050117,33,77,2,112
"50118",1050118,172,40,3,215
"50119",1050119,169,95,2,266
"50120",1050120,193,40,23,256
"50121",1050121,107,111,21,239
"50122",1050122,90,244,6,340
"50123",1050123,50,164,0,214
"50124",1050124,155,74,1,230
"50125",1050125,279,13,7,299
"50126",1050126,90,130,8,228
"50127",1050127,61,228,9,298
"50128",1050128,71,138,0,209
"50129",1050129,64,203,6,273
"50130",1050130,112,183,6,301
"50131",1050131,151,133,11,295
"50132",1050132,150,168,8,326
"50133",1050133,87,207,4,298
"50134",1050134,166,96,14,276
"50135",1050135,90,178,11,279
"50136",1050136,108,86,3,197
"50137",1050137,39,245,3,287
"50138",1050138,87,206,12,305
"50139",1050139,179,74,6,259
"50140",1050140,64,181,22,267
"50141",1050141,28,21,1,50
"50142",1050142,208,35,3,246
"50143",1050143,20,242,3,265
"50144",1050144,172,42,4,218
"50145",1050145,108,10,3,121
"50146",1050146,99,230,9,338
"50147",1050147,226,68,13,307
"50148",1050148,86,134,13,233
"50149",1050149,30,131,9,170
"50150",1050150,38,114,12,164
"50151",1050151,139,91,12,242
"50152",1050152,123,65,4,192
"50153",1050153,82,146,4,232
"50154",1050154,138,148,8,294
"50155",1050155,205,58,4,267
"50156",1050156,79,71,4,154
"50157",1050157,102,53,5,160
"50158",1050158,41,234,4,279
"50159",1050159,231,31,8,270
"50160",1050160,129,99,10,238
"50161",1050161,227,29,8,264
"50162",1050162,48,243,6,297
"50163",1050163,109,82,7,198
"50164",1050164,200,47,7,254
"50165",1050165,146,77,7,230
"50166",1050166,163,93,13,269
"50167",1050167,208,96,5,309
"50168",1050168,19,130,12,161
"50169",1050169,166,51,4,221
"50170",1050170,0,1,0,1
"50171",1050171,75,210,19,304
"50172",1050172,72,168,0,240
"50173",1050173,171,48,5,224
"50174",1050174,60,209,11,280
"50175",1050175,55,159,2,216
"50176",1050176,93,145,11,249
"50177",1050177,114,55,12,181
"50178",1050178,113,138,8,259
"50179",1050179,189,75,9,273
"50180",1050180,100,51,3,154
"50181",1050181,130,148,11,289
"50182",1050182,142,77,5,224
"50183",1050183,169,80,11,260
"50184",1050184,166,9,7,182
"50185",1050185,158,35,6,199
"50186",1050186,95,186,13,294
"50187",1050187,81,86,13,180
"50188",1050188,56,16,3,75
"50189",1050189,32,226,9,267
"50190",1050190,71,214,20,305
"50191",1050191,198,46,6,250
"50192",1050192,79,24,3,106
"50193",1050193,157,20,6,183
"50194",1050194,64,167,3,234
"50195",1050195,194,46,12,252
"50196",1050196,62,109,4,175
"50197",1050197,173,38,17,228
"50198",1050198,145,56,8,209
"50199",1050199,181,57,11,249
"50200",1050200,119,42,5,166
"50201",1050201,130,111,4,245
"50202",1050202,86,50,1,137
"50203",1050203,150,10,2,162
"50204",1050204,199,25,8,232
"50205",1050205,115,140,12,267
"50206",1050206,65,50,0,115
"50207",1050207,38,69,3,110
"50208",1050208,55,36,6,97
"50209",1050209,152,52,5,209
"50210",1050210,71,203,12,286
"50211",1050211,114,98,2,214
"50212",1050212,34,154,2,190
"50213",1050213,108,81,8,197
"50214",1050214,167,60,2,229
"50215",1050215,157,96,22,275
"50216",1050216,164,38,7,209
"50217",1050217,115,44,3,162
"50218",1050218,121,134,7,262
"50219",1050219,123,166,18,307
"50220",1050220,27,232,1,260
"50221",1050221,36,181,1,218
"50222",1050222,67,204,13,284
"50223",1050223,156,83,8,247
"50224",1050224,181,25,4,210
"50225",1050225,65,199,5,269
"50226",1050226,97,166,5,268
"50227",1050227,200,86,16,302
"50228",1050228,33,235,11,279
"50229",1050229,49,139,10,198
"50230",1050230,10,1,0,11
"50231",1050231,77,155,11,243
"50232",1050232,128,9,6,143
"50233",1050233,26,208,2,236
"50234",1050234,169,104,13,286
"50235",1050235,144,95,11,250
"50236",1050236,152,81,7,240
"50237",1050237,104,183,11,298
"50238",1050238,111,82,13,206
"50239",1050239,146,19,4,169
"50240",1050240,62,48,1,111
"50241",1050241,62,180,9,251
"50242",1050242,182,74,10,266
"50243",1050243,51,162,17,230
"50244",1050244,136,74,7,217
"50245",1050245,101,94,7,202
"50246",1050246,25,13,1,39
"50247",1050247,184,32,12,228
"50248",1050248,93,14,3,110
"50249",1050249,160,53,12,225
"50250",1050250,144,117,9,270
"50251",1050251,172,123,21,316
"50252",1050252,41,236,7,284
"50253",1050253,165,2,2,169
"50254",1050254,164,21,8,193
"50255",1050255,45,200,9,254
"50256",1050256,253,29,9,291
"50257",1050257,39,113,4,156
"50258",1050258,149,42,5,196
"50259",1050259,202,28,6,236
"50260",1050260,68,238,10,316
"50261",1050261,182,117,6,305
"50262",1050262,17,237,5,259
"50263",1050263,29,132,7,168
"50264",1050264,69,153,2,224
"50265",1050265,34,10,3,47
"50266",1050266,56,25,5,86
"50267",1050267,118,53,1,172
"50268",1050268,84,129,2,215
"50269",1050269,158,33,4,195
"50270",1050270,47,54,3,104
"50271",1050271,101,14,3,118
"50272",1050272,186,116,6,308
"50273",1050273,77,58,1,136
"50274",1050274,90,52,7,149
"50275",1050275,109,38,7,154
"50276",1050276,189,36,2,227
"50277",1050277,110,133,11,254
"50278",1050278,123,116,13,252
"50279",1050279,184,93,10,287
"50280",1050280,37,14,3,54
"50281",1050281,269,14,10,293
"50282",1050282,137,68,5,210
"50283",1050283,36,153,4,193
"50284",1050284,8,49,1,58
"50285",1050285,62,251,5,318
"50286",1050286,158,115,15,288
"50287",1050287,45,258,13,316
"50288",1050288,228,25,6,259
"50289",1050289,138,86,9,233
"50290",1050290,110,133,14,257
"50291",1050291,82,6,2,90
"50292",1050292,26,112,4,142
"50293",1050293,218,99,15,332
"50294",1050294,55,273,7,335
"50295",1050295,75,175,8,258
"50296",1050296,145,87,15,247
"50297",1050297,90,59,5,154
"50298",1050298,5,9,0,14
"50299",1050299,27,223,3,253
"50300",1050300,22,157,4,183
"50301",1050301,26,14,2,42
"50302",1050302,110,118,6,234
"50303",1050303,32,24,2,58
"50304",1050304,130,61,4,195
"50305",1050305,68,155,9,232
"50306",1050306,56,81,5,142
"50307",1050307,62,116,2,180
"50308",1050308,136,182,18,336
"50309",1050309,84,79,6,169
"50310",1050310,105,133,5,243
"50311",1050311,257,23,6,286
"50312",1050312,96,62,10,168
"50313",1050313,149,57,11,217
"50314",1050314,52,186,2,240
"50315",1050315,148,85,34,267
"50316",1050316,128,83,13,224
"50317",1050317,107,130,14,251
"50318",1050318,66,115,3,184
"50319",1050319,53,25,1,79
"50320",1050320,140,146,17,303
"50321",1050321,147,13,4,164
"50322",1050322,35,183,11,229
"50323",1050323,115,147,6,268
"50324",1050324,56,54,3,113
"50325",1050325,144,37,3,184
"50326",1050326,190,50,10,250
"50327",1050327,66,199,14,279
"50328",1050328,132,36,13,181
"50329",1050329,46,225,1,272
"50330",1050330,72,155,11,238
"50331",1050331,148,76,4,228
"50332",1050332,170,68,9,247
"50333",1050333,154,94,2,250
"50334",1050334,27,205,15,247
"50335",1050335,121,53,3,177
"50336",1050336,124,147,8,279
"50337",1050337,93,90,9,192
"50338",1050338,132,111,10,253
"50339",1050339,70,89,2,161
"50340",1050340,62,162,3,227
"50341",1050341,227,52,11,290
"50342",1050342,154,117,10,281
"50343",1050343,161,34,9,204
"50344",1050344,64,84,2,150
"50345",1050345,141,24,5,170
"50346",1050346,81,156,18,255
"50347",1050347,220,48,11,279
"50348",1050348,148,67,6,221
"50349",1050349,75,251,16,342
"50350",1050350,65,99,8,172
"50351",1050351,172,65,11,248
"50352",1050352,22,192,8,222
"50353",1050353,32,166,22,220
"50354",1050354,74,194,5,273
"50355",1050355,80,103,6,189
"50356",1050356,159,73,22,254
"50357",1050357,56,216,4,276
"50358",1050358,97,121,4,222
"50359",1050359,83,0,1,84
"50360",1050360,94,74,17,185
"50361",1050361,213,17,9,239
"50362",1050362,109,250,6,365
"50363",1050363,102,6,5,113
"50364",1050364,50,81,2,133
"50365",1050365,77,64,5,146
"50366",1050366,22,210,3,235
"50367",1050367,38,26,1,65
"50368",1050368,117,53,5,175
"50369",1050369,145,71,4,220
"50370",1050370,241,19,5,265
"50371",1050371,143,8,3,154
"50372",1050372,50,268,6,324
"50373",1050373,22,26,0,48
"50374",1050374,98,192,13,303
"50375",1050375,68,204,6,278
"50376",1050376,72,118,10,200
"50377",1050377,49,125,6,180
"50378",1050378,36,12,2,50
"50379",1050379,275,33,10,318
"50380",1050380,150,96,4,250
"50381",1050381,103,91,16,210
"50382",1050382,158,100,13,271
"50383",1050383,246,29,10,285
"50384",1050384,44,209,1,254
"50385",1050385,70,228,9,307
"50386",1050386,102,89,9,200
"50387",1050387,30,11,4,45
"50388",1050388,86,189,19,294
"50389",1050389,70,157,6,233
"50390",1050390,46,184,6,236
"50391",1050391,88,69,4,161
"50392",1050392,191,37,5,233
"50393",1050393,90,111,27,228
"50394",1050394,93,156,3,252
"50395",1050395,117,148,26,291
"50396",1050396,90,6,1,97
"50397",1050397,199,40,4,243
"50398",1050398,123,121,16,260
"50399",1050399,99,147,4,250
"50400",1050400,169,108,9,286
"50401",1050401,135,22,5,162
"50402",1050402,112,94,6,212
"50403",1050403,68,223,3,294
"50404",1050404,90,204,5,299
"50405",1050405,142,64,6,212
"50406",1050406,136,149,7,292
"50407",1050407,80,131,9,220
"50408",1050408,30,18,0,48
"50409",1050409,54,213,7,274
"50410",1050410,29,212,5,246
"50411",1050411,174,43,8,225
"50412",1050412,13,72,0,85
"50413",1050413,209,45,4,258
"50414",1050414,168,96,15,279
"50415",1050415,64,7,2,73
"50416",1050416,70,50,1,121
"50417",1050417,57,172,12,241
"50418",1050418,172,44,9,225
"50419",1050419,43,130,5,178
"50420",1050420,174,53,4,231
"50421",1050421,39,301,5,345
"50422",1050422,11,8,4,23
"50423",1050423,110,144,11,265
"50424",1050424,161,56,7,224
"50425",1050425,71,166,15,252
"50426",1050426,132,68,9,209
"50427",1050427,126,121,10,257
"50428",1050428,101,36,7,144
"50429",1050429,24,29,4,57
"50430",1050430,174,46,7,227
"50431",1050431,160,47,7,214
"50432",1050432,57,207,11,275
"50433",1050433,3,13,0,16
"50434",1050434,84,157,16,257
"50435",1050435,97,189,22,308
"50436",1050436,121,7,4,132
"50437",1050437,95,120,15,230
"50438",1050438,77,129,2,208
"50439",1050439,39,151,16,206
"50440",1050440,12,50,1,63
"50441",1050441,108,165,10,283
"50442",1050442,51,112,6,169
"50443",1050443,30,7,0,37
"50444",1050444,202,69,16,287
"50445",1050445,101,176,20,297
"50446",1050446,80,57,1,138
"50447",1050447,260,37,7,304
"50448",1050448,36,194,3,233
"50449",1050449,76,21,0,97
"50450",1050450,147,80,4,231
"50451",1050451,71,165,6,242
"50452",1050452,143,24,7,174
"50453",1050453,121,99,1,221
"50454",1050454,126,147,8,281
"50455",1050455,151,99,11,261
"50456",1050456,66,263,4,333
"50457",1050457,83,175,5,263
"50458",1050458,33,239,3,275
"50459",1050459,39,113,2,154
"50460",1050460,159,6,8,173
"50461",1050461,99,119,12,230
"50462",1050462,79,20,6,105
"50463",1050463,73,103,13,189
"50464",1050464,119,185,6,310
"50465",1050465,31,164,6,201
"50466",1050466,52,184,6,242
"50467",1050467,124,50,7,181
"50468",1050468,126,96,2,224
"50469",1050469,124,130,10,264
"50470",1050470,150,24,2,176
"50471",1050471,190,143,11,344
"50472",1050472,224,39,13,276
"50473",1050473,130,125,11,266
"50474",1050474,49,245,3,297
"50475",1050475,126,110,13,249
"50476",1050476,117,93,9,219
"50477",1050477,44,19,4,67
"50478",1050478,159,162,9,330
"50479",1050479,106,59,4,169
"50480",1050480,174,44,15,233
"50481",1050481,9,3,2,14
"50482",1050482,7,7,1,15
"50483",1050483,118,136,11,265
"50484",1050484,77,171,9,257
"50485",1050485,179,125,4,308
"50486",1050486,82,91,10,183
"50487",1050487,195,98,10,303
"50488",1050488,140,148,25,313
"50489",1050489,26,8,0,34
"50490",1050490,146,59,3,208
"50491",1050491,18,51,0,69
"50492",1050492,151,137,6,294
"50493",1050493,162,142,11,315
"50494",1050494,120,110,15,245
"50495",1050495,65,193,6,264
"50496",1050496,179,28,2,209
"50497",1050497,188,62,5,255
"50498",1050498,139,98,3,240
"50499",1050499,152,39,8,199
"50500",1050500,196,9,4,209
"50501",1050501,138,119,9,266
"50502",1050502,139,31,6,176
"50503",1050503,138,34,6,178
"50504",1050504,57,216,11,284
"50505",1050505,142,144,3,289
"50506",1050506,195,75,4,274
"50507",1050507,161,80,7,248
"50508",1050508,96,204,2,302
"50509",1050509,81,126,8,215
"50510",1050510,16,108,7,131
"50511",1050511,139,123,11,273
"50512",1050512,257,252,26,535
"50513",1050513,112,161,16,289
"50514",1050514,98,35,5,138
"50515",1050515,131,153,5,289
"50516",1050516,7,10,1,18
"50517",1050517,96,58,7,161
"50518",1050518,109,25,3,137
"50519",1050519,55,167,7,229
"50520",1050520,93,73,4,170
"50521",1050521,37,70,2,109
"50522",1050522,49,181,6,236
"50523",1050523,92,136,18,246
"50524",1050524,94,160,7,261
"50525",1050525,162,1,0,163
"50526",1050526,14,59,0,73
"50527",1050527,123,171,10,304
"50528",1050528,161,100,7,268
"50529",1050529,33,19,1,53
"50530",1050530,34,117,2,153
"50531",1050531,17,101,7,125
"50532",1050532,254,11,10,275
"50533",1050533,73,188,6,267
"50534",1050534,125,122,4,251
"50535",1050535,126,74,8,208
"50536",1050536,39,202,15,256
"50537",1050537,27,68,2,97
"50538",1050538,97,53,0,150
"50539",1050539,133,63,7,203
"50540",1050540,59,48,3,110
"50541",1050541,137,122,18,277
"50542",1050542,178,2,1,181
"50543",1050543,77,183,5,265
"50544",1050544,229,12,8,249
"50545",1050545,34,209,4,247
"50546",1050546,92,150,19,261
"50547",1050547,86,113,2,201
"50548",1050548,173,55,10,238
"50549",1050549,182,59,9,250
"50550",1050550,64,144,7,215
"50551",1050551,64,75,4,143
"50552",1050552,134,58,4,196
"50553",1050553,160,72,9,241
"50554",1050554,99,109,4,212
"50555",1050555,170,166,16,352
"50556",1050556,154,49,8,211
"50557",1050557,121,66,9,196
"50558",1050558,42,161,8,211
"50559",1050559,86,203,1,290
"50560",1050560,76,143,13,232
"50561",1050561,171,135,16,322
"50562",1050562,143,53,0,196
"50563",1050563,129,136,5,270
"50564",1050564,201,74,10,285
"50565",1050565,16,5,1,22
"50566",1050566,59,96,6,161
"50567",1050567,41,214,3,258
"50568",1050568,99,175,7,281
"50569",1050569,43,191,7,241
"50570",1050570,25,127,9,161
"50571",1050571,135,117,19,271
"50572",1050572,250,8,10,268
"50573",1050573,42,162,0,204
"50574",1050574,163,193,4,360
"50575",1050575,140,168,8,316
"50576",1050576,215,18,4,237
"50577",1050577,33,250,2,285
"50578",1050578,37,202,7,246
"50579",1050579,80,247,7,334
"50580",1050580,198,7,4,209
"50581",1050581,113,128,7,248
"50582",1050582,143,78,14,235
"50583",1050583,48,91,5,144
"50584",1050584,58,127,15,200
"50585",1050585,157,77,9,243
"50586",1050586,174,38,4,216
"50587",1050587,26,6,0,32
"50588",1050588,145,41,8,194
"50589",1050589,159,40,6,205
"50590",1050590,54,92,5,151
"50591",1050591,253,11,14,278
"50592",1050592,81,153,8,242
"50593",1050593,87,142,10,239
"50594",1050594,139,38,2,179
"50595",1050595,137,41,3,181
"50596",1050596,109,156,19,284
"50597",1050597,38,0,1,39
"50598",1050598,169,146,12,327
"50599",1050599,112,78,1,191
"50600",1050600,51,119,8,178
"50601",1050601,95,31,3,129
"50602",1050602,44,39,3,86
"50603",1050603,54,88,7,149
"50604",1050604,54,0,0,54
"50605",1050605,135,15,2,152
"50606",1050606,45,131,4,180
"50607",1050607,201,113,20,334
"50608",1050608,89,1,0,90
"50609",1050609,27,266,3,296
"50610",1050610,194,66,15,275
"50611",1050611,49,126,4,179
"50612",1050612,78,112,9,199
"50613",1050613,20,252,1,273
"50614",1050614,164,98,12,274
"50615",1050615,134,11,2,147
"50616",1050616,73,118,5,196
"50617",1050617,54,221,14,289
"50618",1050618,130,141,6,277
"50619",1050619,119,121,9,249
"50620",1050620,51,174,7,232
"50621",1050621,128,18,4,150
"50622",1050622,193,79,8,280
"50623",1050623,29,208,5,242
"50624",1050624,175,66,16,257
"50625",1050625,214,0,0,214
"50626",1050626,173,111,7,291
"50627",1050627,264,105,10,379
"50628",1050628,280,9,13,302
"50629",1050629,148,161,14,323
"50630",1050630,61,166,10,237
"50631",1050631,37,167,2,206
"50632",1050632,108,102,11,221
"50633",1050633,150,18,5,173
"50634",1050634,59,2,6,67
"50635",1050635,43,0,1,44
"50636",1050636,230,17,6,253
"50637",1050637,81,41,5,127
"50638",1050638,185,72,10,267
"50639",1050639,67,112,2,181
"50640",1050640,90,163,16,269
"50641",1050641,8,4,0,12
"50642",1050642,58,245,1,304
"50643",1050643,59,203,5,267
"50644",1050644,13,38,0,51
"50645",1050645,87,129,6,222
"50646",1050646,109,68,7,184
"50647",1050647,91,201,5,297
"50648",1050648,35,238,1,274
"50649",1050649,118,182,11,311
"50650",1050650,88,149,6,243
"50651",1050651,48,21,2,71
"50652",1050652,117,126,14,257
"50653",1050653,107,48,2,157
"50654",1050654,208,88,22,318
"50655",1050655,40,215,9,264
"50656",1050656,84,108,6,198
"50657",1050657,118,127,4,249
"50658",1050658,67,94,4,165
"50659",1050659,24,235,5,264
"50660",1050660,124,49,7,180
"50661",1050661,74,173,8,255
"50662",1050662,184,97,6,287
"50663",1050663,119,45,5,169
"50664",1050664,115,40,2,157
"50665",1050665,8,2,1,11
"50666",1050666,141,55,4,200
"50667",1050667,202,107,13,322
"50668",1050668,46,237,0,283
"50669",1050669,23,61,7,91
"50670",1050670,199,65,10,274
"50671",1050671,46,25,2,73
"50672",1050672,10,6,0,16
"50673",1050673,73,129,10,212
"50674",1050674,81,10,4,95
"50675",1050675,211,70,6,287
"50676",1050676,105,52,8,165
"50677",1050677,123,154,11,288
"50678",1050678,170,113,11,294
"50679",1050679,171,75,11,257
"50680",1050680,205,28,8,241
"50681",1050681,79,157,7,243
"50682",1050682,205,40,1,246
"50683",1050683,156,44,10,210
"50684",1050684,25,245,6,276
"50685",1050685,49,195,6,250
"50686",1050686,117,188,9,314
"50687",1050687,149,67,8,224
"50688",1050688,221,61,15,297
"50689",1050689,202,100,4,306
"50690",1050690,65,250,11,326
"50691",1050691,87,30,8,125
"50692",1050692,81,65,15,161
"50693",1050693,210,72,13,295
"50694",1050694,40,268,6,314
"50695",1050695,67,262,10,339
"50696",1050696,174,34,4,212
"50697",1050697,106,122,17,245
"50698",1050698,92,52,6,150
"50699",1050699,236,19,3,258
"50700",1050700,170,84,9,263
"50701",1050701,189,14,6,209
"50702",1050702,40,219,15,274
"50703",1050703,92,169,10,271
"50704",1050704,62,257,13,332
"50705",1050705,120,39,8,167
"50706",1050706,69,229,2,300
"50707",1050707,58,134,7,199
"50708",1050708,181,107,22,310
"50709",1050709,98,100,4,202
"50710",1050710,48,59,3,110
"50711",1050711,138,97,6,241
"50712",1050712,26,14,3,43
"50713",1050713,50,270,6,326
"50714",1050714,84,81,15,180
"50715",1050715,25,13,0,38
"50716",1050716,16,186,7,209
"50717",1050717,116,38,6,160
"50718",1050718,121,29,6,156
"50719",1050719,108,76,3,187
"50720",1050720,75,222,10,307
"50721",1050721,136,134,9,279
"50722",1050722,143,59,7,209
"50723",1050723,147,133,21,301
"50724",1050724,89,189,5,283
"50725",1050725,135,77,1,213
"50726",1050726,126,170,20,316
"50727",1050727,124,167,21,312
"50728",1050728,214,45,13,272
"50729",1050729,113,144,5,262
"50730",1050730,40,231,8,279
"50731",1050731,55,97,5,157
"50732",1050732,135,60,4,199
"50733",1050733,169,57,6,232
"50734",1050734,26,115,6,147
"50735",1050735,140,80,10,230
"50736",1050736,47,139,16,202
"50737",1050737,148,85,32,265
"50738",1050738,69,57,4,130
"50739",1050739,168,37,12,217
"50740",1050740,12,13,0,25
"50741",1050741,17,61,0,78
"50742",1050742,22,228,3,253
"50743",1050743,151,105,15,271
"50744",1050744,270,14,6,290
"50745",1050745,207,21,4,232
"50746",1050746,17,265,8,290
"50747",1050747,80,9,4,93
"50748",1050748,144,6,1,151
"50749",1050749,122,88,7,217
"50750",1050750,330,13,5,348
"50751",1050751,185,74,15,274
"50752",1050752,126,46,5,177
"50753",1050753,125,101,5,231
"50754",1050754,69,151,3,223
"50755",1050755,259,42,7,308
"50756",1050756,187,64,18,269
"50757",1050757,161,130,8,299
"50758",1050758,50,218,2,270
"50759",1050759,148,93,17,258
"50760",1050760,185,30,0,215
"50761",1050761,41,280,0,321
"50762",1050762,44,14,0,58
"50763",1050763,198,21,9,228
"50764",1050764,137,117,10,264
"50765",1050765,52,142,14,208
"50766",1050766,107,229,16,352
"50767",1050767,26,105,6,137
"50768",1050768,58,273,7,338
"50769",1050769,85,114,9,208
"50770",1050770,131,107,20,258
"50771",1050771,60,114,5,179
"50772",1050772,64,65,4,133
"50773",1050773,82,172,13,267
"50774",1050774,74,121,16,211
"50775",1050775,224,77,20,321
"50776",1050776,157,118,10,285
"50777",1050777,118,69,1,188
"50778",1050778,166,53,9,228
"50779",1050779,133,76,8,217
"50780",1050780,135,54,5,194
"50781",1050781,196,42,13,251
"50782",1050782,182,63,8,253
"50783",1050783,66,208,7,281
"50784",1050784,103,85,21,209
"50785",1050785,92,178,18,288
"50786",1050786,108,118,11,237
"50787",1050787,177,65,7,249
"50788",1050788,170,71,12,253
"50789",1050789,58,102,6,166
"50790",1050790,57,210,6,273
"50791",1050791,186,34,8,228
"50792",1050792,33,244,1,278
"50793",1050793,88,140,6,234
"50794",1050794,117,102,16,235
"50795",1050795,64,153,7,224
"50796",1050796,149,54,9,212
"50797",1050797,159,153,15,327
"50798",1050798,167,47,15,229
"50799",1050799,198,103,11,312
"50800",1050800,102,51,6,159
"50801",1050801,164,147,10,321
"50802",1050802,204,48,8,260
"50803",1050803,170,48,11,229
"50804",1050804,73,208,21,302
"50805",1050805,114,199,16,329
"50806",1050806,119,146,9,274
"50807",1050807,83,116,8,207
"50808",1050808,56,160,3,219
"50809",1050809,66,210,5,281
"50810",1050810,120,6,1,127
"50811",1050811,91,62,9,162
"50812",1050812,134,27,6,167
"50813",1050813,68,160,2,230
"50814",1050814,180,36,5,221
"50815",1050815,220,49,4,273
"50816",1050816,79,85,15,179
"50817",1050817,165,28,6,199
"50818",1050818,160,69,7,236
"50819",1050819,162,28,4,194
"50820",1050820,189,119,5,313
"50821",1050821,97,198,10,305
"50822",1050822,138,130,24,292
"50823",1050823,127,119,11,257
"50824",1050824,186,113,22,321
"50825",1050825,124,76,7,207
"50826",1050826,38,37,3,78
"50827",1050827,119,54,2,175
"50828",1050828,7,15,1,23
"50829",1050829,151,129,4,284
"50830",1050830,157,44,5,206
"50831",1050831,60,218,3,281
"50832",1050832,56,214,6,276
"50833",1050833,81,177,8,266
"50834",1050834,108,130,18,256
"50835",1050835,151,98,8,257
"50836",1050836,53,252,4,309
"50837",1050837,24,44,3,71
"50838",1050838,172,101,8,281
"50839",1050839,180,85,5,270
"50840",1050840,170,56,11,237
"50841",1050841,166,78,12,256
"50842",1050842,93,201,17,311
"50843",1050843,120,144,14,278
"50844",1050844,178,41,10,229
"50845",1050845,46,163,5,214
"50846",1050846,181,45,8,234
"50847",1050847,32,209,7,248
"50848",1050848,56,27,4,87
"50849",1050849,123,153,13,289
"50850",1050850,180,163,20,363
"50851",1050851,102,113,7,222
"50852",1050852,137,49,6,192
"50853",1050853,201,86,8,295
"50854",1050854,122,155,19,296
"50855",1050855,116,30,3,149
"50856",1050856,97,180,4,281
"50857",1050857,132,39,4,175
"50858",1050858,39,64,1,104
"50859",1050859,50,173,3,226
"50860",1050860,113,30,8,151
"50861",1050861,157,23,10,190
"50862",1050862,150,159,7,316
"50863",1050863,123,151,13,287
"50864",1050864,208,60,27,295
"50865",1050865,44,233,12,289
"50866",1050866,19,79,0,98
"50867",1050867,146,186,11,343
"50868",1050868,79,120,7,206
"50869",1050869,116,117,3,236
"50870",1050870,203,57,13,273
"50871",1050871,166,37,10,213
"50872",1050872,31,175,5,211
"50873",1050873,58,249,10,317
"50874",1050874,160,107,15,282
"50875",1050875,17,234,6,257
"50876",1050876,212,65,13,290
"50877",1050877,76,43,2,121
"50878",1050878,187,93,6,286
"50879",1050879,49,252,11,312
"50880",1050880,227,20,6,253
"50881",1050881,20,10,0,30
"50882",1050882,54,142,14,210
"50883",1050883,93,213,11,317
"50884",1050884,97,132,9,238
"50885",1050885,119,136,12,267
"50886",1050886,56,158,11,225
"50887",1050887,116,23,2,141
"50888",1050888,79,38,5,122
"50889",1050889,96,185,8,289
"50890",1050890,61,187,3,251
"50891",1050891,205,31,10,246
"50892",1050892,123,62,12,197
"50893",1050893,93,21,3,117
"50894",1050894,19,223,3,245
"50895",1050895,121,113,9,243
"50896",1050896,176,47,4,227
"50897",1050897,212,49,4,265
"50898",1050898,94,156,3,253
"50899",1050899,155,27,2,184
"50900",1050900,316,68,10,394
"50901",1050901,52,130,3,185
"50902",1050902,51,266,5,322
"50903",1050903,212,19,7,238
"50904",1050904,45,205,4,254
"50905",1050905,19,218,1,238
"50906",1050906,236,68,15,319
"50907",1050907,140,74,12,226
"50908",1050908,57,230,13,300
"50909",1050909,43,89,6,138
"50910",1050910,42,133,2,177
"50911",1050911,80,109,18,207
"50912",1050912,95,166,26,287
"50913",1050913,43,219,9,271
"50914",1050914,172,58,6,236
"50915",1050915,131,28,6,165
"50916",1050916,194,89,12,295
"50917",1050917,41,287,6,334
"50918",1050918,193,28,6,227
"50919",1050919,65,221,8,294
"50920",1050920,180,53,13,246
"50921",1050921,119,66,9,194
"50922",1050922,53,127,5,185
"50923",1050923,133,97,9,239
"50924",1050924,69,131,17,217
"50925",1050925,117,64,13,194
"50926",1050926,231,8,8,247
"50927",1050927,13,2,1,16
"50928",1050928,118,53,7,178
"50929",1050929,144,13,9,166
"50930",1050930,150,71,3,224
"50931",1050931,104,133,17,254
"50932",1050932,53,204,12,269
"50933",1050933,106,60,12,178
"50934",1050934,109,165,22,296
"50935",1050935,60,214,2,276
"50936",1050936,91,1,0,92
"50937",1050937,101,28,8,137
"50938",1050938,228,8,7,243
"50939",1050939,173,68,2,243
"50940",1050940,128,67,15,210
"50941",1050941,211,20,9,240
"50942",1050942,152,104,14,270
"50943",1050943,6,247,1,254
"50944",1050944,73,52,1,126
"50945",1050945,105,156,8,269
"50946",1050946,39,55,10,104
"50947",1050947,163,9,2,174
"50948",1050948,138,73,6,217
"50949",1050949,14,60,2,76
"50950",1050950,133,56,10,199
"50951",1050951,19,189,1,209
"50952",1050952,103,194,19,316
"50953",1050953,14,327,4,345
"50954",1050954,126,142,24,292
"50955",1050955,79,196,10,285
"50956",1050956,100,89,7,196
"50957",1050957,122,48,8,178
"50958",1050958,129,94,3,226
"50959",1050959,142,50,9,201
"50960",1050960,88,239,20,347
"50961",1050961,53,141,9,203
"50962",1050962,125,111,10,246
"50963",1050963,72,153,19,244
"50964",1050964,97,106,2,205
"50965",1050965,181,40,15,236
"50966",1050966,120,117,2,239
"50967",1050967,22,145,7,174
"50968",1050968,237,33,8,278
"50969",1050969,136,96,7,239
"50970",1050970,125,110,11,246
"50971",1050971,118,90,5,213
"50972",1050972,104,117,7,228
"50973",1050973,138,122,18,278
"50974",1050974,165,57,8,230
"50975",1050975,58,170,18,246
"50976",1050976,110,65,2,177
"50977",1050977,216,47,4,267
"50978",1050978,111,136,13,260
"50979",1050979,91,77,12,180
"50980",1050980,129,30,1,160
"50981",1050981,42,82,2,126
"50982",1050982,169,118,12,299
"50983",1050983,19,252,4,275
"50984",1050984,40,34,4,78
"50985",1050985,31,145,8,184
"50986",1050986,42,150,3,195
"50987",1050987,166,106,10,282
"50988",1050988,172,29,9,210
"50989",1050989,149,85,8,242
"50990",1050990,146,100,18,264
"50991",1050991,5,7,1,13
"50992",1050992,33,83,3,119
"50993",1050993,100,74,7,181
"50994",1050994,201,322,38,561
"50995",1050995,151,144,21,316
"50996",1050996,27,157,1,185
"50997",1050997,55,0,4,59
"50998",1050998,62,151,3,216
"50999",1050999,131,32,2,165
"51000",1051000,149,42,13,204
"51001",1051001,169,39,11,219
"51002",1051002,82,136,12,230
"51003",1051003,151,35,9,195
"51004",1051004,91,150,12,253
"51005",1051005,146,106,7,259
"51006",1051006,166,70,10,246
"51007",1051007,85,205,8,298
"51008",1051008,145,58,6,209
"51009",1051009,95,86,13,194
"51010",1051010,178,84,8,270
"51011",1051011,127,169,5,301
"51012",1051012,65,88,14,167
"51013",1051013,163,106,6,275
"51014",1051014,50,148,8,206
"51015",1051015,151,34,1,186
"51016",1051016,111,182,7,300
"51017",1051017,40,264,7,311
"51018",1051018,144,45,2,191
"51019",1051019,199,101,18,318
"51020",1051020,18,219,5,242
"51021",1051021,9,121,1,131
"51022",1051022,178,78,8,264
"51023",1051023,136,42,1,179
"51024",1051024,37,100,3,140
"51025",1051025,58,141,2,201
"51026",1051026,141,140,7,288
"51027",1051027,93,99,5,197
"51028",1051028,125,170,18,313
"51029",1051029,33,107,3,143
"51030",1051030,130,35,8,173
"51031",1051031,54,186,11,251
"51032",1051032,129,135,13,277
"51033",1051033,136,44,11,191
"51034",1051034,12,123,1,136
"51035",1051035,54,175,7,236
"51036",1051036,123,93,6,222
"51037",1051037,21,233,2,256
"51038",1051038,32,38,2,72
"51039",1051039,73,190,6,269
"51040",1051040,80,176,6,262
"51041",1051041,251,40,8,299
"51042",1051042,26,36,5,67
"51043",1051043,112,38,0,150
"51044",1051044,204,29,12,245
"51045",1051045,34,214,1,249
"51046",1051046,17,12,3,32
"51047",1051047,85,170,7,262
"51048",1051048,52,248,9,309
"51049",1051049,51,172,5,228
"51050",1051050,203,35,6,244
"51051",1051051,159,69,2,230
"51052",1051052,239,14,1,254
"51053",1051053,54,187,11,252
"51054",1051054,167,29,8,204
"51055",1051055,100,88,12,200
"51056",1051056,68,220,1,289
"51057",1051057,19,11,2,32
"51058",1051058,166,60,5,231
"51059",1051059,185,59,11,255
"51060",1051060,166,100,6,272
"51061",1051061,67,194,3,264
"51062",1051062,147,95,9,251
"51063",1051063,105,61,6,172
"51064",1051064,122,40,2,164
"51065",1051065,58,215,12,285
"51066",1051066,87,132,6,225
"51067",1051067,166,105,13,284
"51068",1051068,166,111,5,282
"51069",1051069,163,93,16,272
"51070",1051070,188,20,12,220
"51071",1051071,137,17,1,155
"51072",1051072,50,88,15,153
"51073",1051073,95,50,4,149
"51074",1051074,66,239,11,316
"51075",1051075,28,25,1,54
"51076",1051076,36,53,7,96
"51077",1051077,55,214,4,273
"51078",1051078,231,48,15,294
"51079",1051079,185,15,7,207
"51080",1051080,155,124,8,287
"51081",1051081,32,243,4,279
"51082",1051082,16,6,2,24
"51083",1051083,74,188,6,268
"51084",1051084,120,117,12,249
"51085",1051085,58,97,2,157
"51086",1051086,17,2,1,20
"51087",1051087,78,254,4,336
"51088",1051088,18,31,1,50
"51089",1051089,131,103,5,239
"51090",1051090,97,29,6,132
"51091",1051091,81,196,12,289
"51092",1051092,192,55,12,259
"51093",1051093,139,14,0,153
"51094",1051094,154,67,13,234
"51095",1051095,172,86,11,269
"51096",1051096,140,138,17,295
"51097",1051097,97,70,2,169
"51098",1051098,27,14,0,41
"51099",1051099,210,59,7,276
"51100",1051100,51,170,8,229
"51101",1051101,157,85,4,246
"51102",1051102,116,101,11,228
"51103",1051103,65,206,10,281
"51104",1051104,72,141,25,238
"51105",1051105,53,157,5,215
"51106",1051106,193,56,2,251
"51107",1051107,29,168,3,200
"51108",1051108,99,58,3,160
"51109",1051109,46,120,2,168
"51110",1051110,66,90,3,159
"51111",1051111,122,54,8,184
"51112",1051112,135,138,17,290
"51113",1051113,10,138,11,159
"51114",1051114,24,225,3,252
"51115",1051115,64,98,5,167
"51116",1051116,249,18,4,271
"51117",1051117,153,141,9,303
"51118",1051118,39,15,6,60
"51119",1051119,160,170,11,341
"51120",1051120,10,3,1,14
"51121",1051121,169,23,5,197
"51122",1051122,110,99,5,214
"51123",1051123,176,146,13,335
"51124",1051124,161,141,9,311
"51125",1051125,76,28,5,109
"51126",1051126,158,105,27,290
"51127",1051127,118,43,7,168
"51128",1051128,178,86,8,272
"51129",1051129,22,220,1,243
"51130",1051130,109,210,8,327
"51131",1051131,193,21,4,218
"51132",1051132,162,46,4,212
"51133",1051133,91,165,3,259
"51134",1051134,171,67,4,242
"51135",1051135,109,128,7,244
"51136",1051136,176,27,1,204
"51137",1051137,81,176,18,275
"51138",1051138,193,69,13,275
"51139",1051139,118,65,9,192
"51140",1051140,66,108,2,176
"51141",1051141,183,28,6,217
"51142",1051142,96,16,3,115
"51143",1051143,44,59,2,105
"51144",1051144,187,103,16,306
"51145",1051145,48,27,0,75
"51146",1051146,191,103,20,314
"51147",1051147,152,45,4,201
"51148",1051148,167,139,20,326
"51149",1051149,160,43,4,207
"51150",1051150,189,23,9,221
"51151",1051151,205,42,10,257
"51152",1051152,50,165,5,220
"51153",1051153,148,14,4,166
"51154",1051154,96,99,4,199
"51155",1051155,249,54,7,310
"51156",1051156,6,52,3,61
"51157",1051157,224,6,2,232
"51158",1051158,63,176,13,252
"51159",1051159,41,67,3,111
"51160",1051160,146,47,5,198
"51161",1051161,95,165,5,265
"51162",1051162,20,323,6,349
"51163",1051163,39,259,10,308
"51164",1051164,164,68,6,238
"51165",1051165,116,179,8,303
"51166",1051166,144,67,4,215
"51167",1051167,176,68,9,253
"51168",1051168,85,153,7,245
"51169",1051169,45,10,4,59
"51170",1051170,57,161,11,229
"51171",1051171,17,10,2,29
"51172",1051172,174,91,20,285
"51173",1051173,36,229,7,272
"51174",1051174,13,193,4,210
"51175",1051175,37,195,2,234
"51176",1051176,113,89,21,223
"51177",1051177,95,5,5,105
"51178",1051178,141,36,6,183
"51179",1051179,179,41,6,226
"51180",1051180,190,72,9,271
"51181",1051181,90,196,6,292
"51182",1051182,73,176,8,257
"51183",1051183,41,123,4,168
"51184",1051184,79,136,3,218
"51185",1051185,37,227,2,266
"51186",1051186,67,137,12,216
"51187",1051187,75,161,13,249
"51188",1051188,29,250,4,283
"51189",1051189,136,69,10,215
"51190",1051190,125,106,5,236
"51191",1051191,60,55,4,119
"51192",1051192,55,232,5,292
"51193",1051193,64,185,10,259
"51194",1051194,49,137,12,198
"51195",1051195,164,103,11,278
"51196",1051196,136,69,8,213
"51197",1051197,13,25,3,41
"51198",1051198,199,22,7,228
"51199",1051199,130,96,8,234
"51200",1051200,35,242,11,288
"51201",1051201,124,149,3,276
"51202",1051202,51,295,9,355
"51203",1051203,74,161,10,245
"51204",1051204,223,43,13,279
"51205",1051205,97,62,3,162
"51206",1051206,73,129,8,210
"51207",1051207,112,163,14,289
"51208",1051208,206,17,7,230
"51209",1051209,102,104,9,215
"51210",1051210,166,57,5,228
"51211",1051211,84,186,11,281
"51212",1051212,107,244,6,357
"51213",1051213,135,156,16,307
"51214",1051214,54,23,3,80
"51215",1051215,323,11,5,339
"51216",1051216,26,90,0,116
"51217",1051217,62,113,3,178
"51218",1051218,127,42,4,173
"51219",1051219,78,144,4,226
"51220",1051220,163,63,8,234
"51221",1051221,17,281,7,305
"51222",1051222,104,190,9,303
"51223",1051223,93,84,4,181
"51224",1051224,67,125,8,200
"51225",1051225,105,94,11,210
"51226",1051226,94,102,10,206
"51227",1051227,41,183,0,224
"51228",1051228,7,15,0,22
"51229",1051229,55,205,7,267
"51230",1051230,166,83,2,251
"51231",1051231,181,31,2,214
"51232",1051232,107,81,16,204
"51233",1051233,156,55,12,223
"51234",1051234,29,220,4,253
"51235",1051235,113,66,7,186
"51236",1051236,82,163,5,250
"51237",1051237,101,200,5,306
"51238",1051238,114,94,3,211
"51239",1051239,142,65,13,220
"51240",1051240,40,251,1,292
"51241",1051241,23,155,10,188
"51242",1051242,97,102,11,210
"51243",1051243,31,53,1,85
"51244",1051244,75,17,6,98
"51245",1051245,55,161,11,227
"51246",1051246,58,54,2,114
"51247",1051247,21,2,3,26
"51248",1051248,157,9,5,171
"51249",1051249,59,184,5,248
"51250",1051250,94,146,7,247
"51251",1051251,184,85,6,275
"51252",1051252,97,182,9,288
"51253",1051253,201,57,3,261
"51254",1051254,90,127,12,229
"51255",1051255,174,62,21,257
"51256",1051256,98,106,19,223
"51257",1051257,23,148,12,183
"51258",1051258,84,10,4,98
"51259",1051259,191,21,3,215
"51260",1051260,73,141,2,216
"51261",1051261,66,183,4,253
"51262",1051262,274,11,9,294
"51263",1051263,154,23,4,181
"51264",1051264,198,74,9,281
"51265",1051265,181,26,4,211
"51266",1051266,80,61,11,152
"51267",1051267,151,119,5,275
"51268",1051268,187,93,24,304
"51269",1051269,115,37,10,162
"51270",1051270,216,59,12,287
"51271",1051271,144,113,14,271
"51272",1051272,85,150,6,241
"51273",1051273,89,164,4,257
"51274",1051274,46,47,1,94
"51275",1051275,81,70,4,155
"51276",1051276,175,55,10,240
"51277",1051277,12,11,0,23
"51278",1051278,119,56,14,189
"51279",1051279,16,35,1,52
"51280",1051280,132,75,9,216
"51281",1051281,116,106,8,230
"51282",1051282,80,39,4,123
"51283",1051283,98,101,19,218
"51284",1051284,20,86,17,123
"51285",1051285,61,138,13,212
"51286",1051286,71,173,5,249
"51287",1051287,157,32,7,196
"51288",1051288,137,12,1,150
"51289",1051289,156,19,7,182
"51290",1051290,68,271,5,344
"51291",1051291,171,55,4,230
"51292",1051292,139,72,6,217
"51293",1051293,27,211,5,243
"51294",1051294,148,91,11,250
"51295",1051295,210,79,6,295
"51296",1051296,154,57,10,221
"51297",1051297,158,66,4,228
"51298",1051298,117,70,6,193
"51299",1051299,52,211,12,275
"51300",1051300,27,10,0,37
"51301",1051301,50,201,11,262
"51302",1051302,33,5,2,40
"51303",1051303,168,64,11,243
"51304",1051304,102,27,2,131
"51305",1051305,143,11,12,166
"51306",1051306,177,11,4,192
"51307",1051307,66,196,7,269
"51308",1051308,86,124,9,219
"51309",1051309,148,76,8,232
"51310",1051310,185,83,4,272
"51311",1051311,79,224,16,319
"51312",1051312,39,176,2,217
"51313",1051313,163,51,12,226
"51314",1051314,38,71,4,113
"51315",1051315,96,86,6,188
"51316",1051316,134,127,7,268
"51317",1051317,128,145,11,284
"51318",1051318,76,125,15,216
"51319",1051319,64,166,15,245
"51320",1051320,12,14,2,28
"51321",1051321,200,72,17,289
"51322",1051322,96,127,8,231
"51323",1051323,71,49,2,122
"51324",1051324,51,53,1,105
"51325",1051325,28,115,9,152
"51326",1051326,201,114,16,331
"51327",1051327,28,78,10,116
"51328",1051328,107,54,10,171
"51329",1051329,46,31,2,79
"51330",1051330,41,124,6,171
"51331",1051331,73,141,21,235
"51332",1051332,261,1,3,265
"51333",1051333,33,167,6,206
"51334",1051334,138,63,8,209
"51335",1051335,157,24,7,188
"51336",1051336,204,27,10,241
"51337",1051337,107,130,26,263
"51338",1051338,173,19,6,198
"51339",1051339,16,154,1,171
"51340",1051340,190,6,3,199
"51341",1051341,104,79,16,199
"51342",1051342,49,204,9,262
"51343",1051343,46,144,3,193
"51344",1051344,87,14,5,106
"51345",1051345,94,122,9,225
"51346",1051346,51,82,1,134
"51347",1051347,138,122,3,263
"51348",1051348,104,178,19,301
"51349",1051349,128,47,5,180
"51350",1051350,122,184,15,321
"51351",1051351,70,154,10,234
"51352",1051352,153,114,13,280
"51353",1051353,78,186,15,279
"51354",1051354,36,193,5,234
"51355",1051355,168,48,6,222
"51356",1051356,165,76,5,246
"51357",1051357,132,13,5,150
"51358",1051358,118,120,2,240
"51359",1051359,145,71,3,219
"51360",1051360,144,85,3,232
"51361",1051361,93,129,4,226
"51362",1051362,16,74,2,92
"51363",1051363,89,159,13,261
"51364",1051364,72,246,8,326
"51365",1051365,91,152,6,249
"51366",1051366,16,130,6,152
"51367",1051367,188,10,6,204
"51368",1051368,49,249,9,307
"51369",1051369,215,76,15,306
"51370",1051370,79,317,7,403
"51371",1051371,99,17,2,118
"51372",1051372,209,56,15,280
"51373",1051373,131,206,14,351
"51374",1051374,16,163,3,182
"51375",1051375,168,72,15,255
"51376",1051376,280,217,23,520
"51377",1051377,38,44,2,84
"51378",1051378,34,108,1,143
"51379",1051379,74,260,14,348
"51380",1051380,68,209,9,286
"51381",1051381,229,62,18,309
"51382",1051382,26,136,4,166
"51383",1051383,138,41,3,182
"51384",1051384,68,173,2,243
"51385",1051385,99,102,1,202
"51386",1051386,80,235,11,326
"51387",1051387,182,10,4,196
"51388",1051388,89,160,10,259
"51389",1051389,153,27,8,188
"51390",1051390,101,181,8,290
"51391",1051391,48,61,3,112
"51392",1051392,181,82,9,272
"51393",1051393,91,81,2,174
"51394",1051394,182,62,3,247
"51395",1051395,215,53,6,274
"51396",1051396,110,63,1,174
"51397",1051397,103,142,11,256
"51398",1051398,138,116,10,264
"51399",1051399,79,191,11,281
"51400",1051400,56,184,5,245
"51401",1051401,124,169,15,308
"51402",1051402,84,213,14,311
"51403",1051403,151,23,7,181
"51404",1051404,176,40,7,223
"51405",1051405,65,184,7,256
"51406",1051406,80,52,10,142
"51407",1051407,63,149,10,222
"51408",1051408,98,104,4,206
"51409",1051409,50,35,0,85
"51410",1051410,121,143,23,287
"51411",1051411,67,166,10,243
"51412",1051412,159,151,17,327
"51413",1051413,131,89,12,232
"51414",1051414,22,173,19,214
"51415",1051415,119,128,5,252
"51416",1051416,113,126,8,247
"51417",1051417,211,30,4,245
"51418",1051418,167,78,12,257
"51419",1051419,184,35,9,228
"51420",1051420,152,63,0,215
"51421",1051421,217,44,9,270
"51422",1051422,179,30,1,210
"51423",1051423,160,38,13,211
"51424",1051424,61,221,3,285
"51425",1051425,141,60,15,216
"51426",1051426,204,29,10,243
"51427",1051427,166,92,6,264
"51428",1051428,7,6,0,13
"51429",1051429,136,67,6,209
"51430",1051430,130,110,6,246
"51431",1051431,125,23,4,152
"51432",1051432,18,4,1,23
"51433",1051433,117,77,5,199
"51434",1051434,94,184,22,300
"51435",1051435,52,213,20,285
"51436",1051436,139,89,9,237
"51437",1051437,80,197,8,285
"51438",1051438,95,155,13,263
"51439",1051439,228,87,13,328
"51440",1051440,76,215,5,296
"51441",1051441,68,96,0,164
"51442",1051442,39,22,8,69
"51443",1051443,65,135,15,215
"51444",1051444,84,78,6,168
"51445",1051445,214,64,14,292
"51446",1051446,88,112,8,208
"51447",1051447,130,62,21,213
"51448",1051448,146,163,19,328
"51449",1051449,220,39,7,266
"51450",1051450,79,188,6,273
"51451",1051451,37,194,2,233
"51452",1051452,101,179,16,296
"51453",1051453,187,21,4,212
"51454",1051454,8,183,1,192
"51455",1051455,40,108,2,150
"51456",1051456,28,236,6,270
"51457",1051457,127,150,4,281
"51458",1051458,195,32,8,235
"51459",1051459,97,60,6,163
"51460",1051460,157,100,3,260
"51461",1051461,58,194,11,263
"51462",1051462,134,50,3,187
"51463",1051463,7,111,0,118
"51464",1051464,234,40,9,283
"51465",1051465,130,122,4,256
"51466",1051466,96,219,19,334
"51467",1051467,59,101,8,168
"51468",1051468,138,66,6,210
"51469",1051469,154,158,14,326
"51470",1051470,62,204,9,275
"51471",1051471,170,27,1,198
"51472",1051472,106,40,8,154
"51473",1051473,63,191,8,262
"51474",1051474,160,76,10,246
"51475",1051475,179,90,11,280
"51476",1051476,195,26,16,237
"51477",1051477,134,76,4,214
"51478",1051478,39,123,15,177
"51479",1051479,16,4,2,22
"51480",1051480,6,85,3,94
"51481",1051481,147,67,7,221
"51482",1051482,81,76,5,162
"51483",1051483,72,32,2,106
"51484",1051484,262,53,19,334
"51485",1051485,195,34,7,236
"51486",1051486,97,169,8,274
"51487",1051487,34,251,11,296
"51488",1051488,13,153,0,166
"51489",1051489,37,4,0,41
"51490",1051490,62,245,9,316
"51491",1051491,158,46,7,211
"51492",1051492,112,40,1,153
"51493",1051493,44,131,11,186
"51494",1051494,141,18,11,170
"51495",1051495,40,34,1,75
"51496",1051496,165,94,3,262
"51497",1051497,76,186,4,266
"51498",1051498,184,45,3,232
"51499",1051499,45,50,2,97
"51500",1051500,51,22,7,80
"51501",1051501,147,50,3,200
"51502",1051502,56,178,8,242
"51503",1051503,12,45,0,57
"51504",1051504,25,259,8,292
"51505",1051505,35,221,4,260
"51506",1051506,35,236,6,277
"51507",1051507,136,42,7,185
"51508",1051508,67,96,13,176
"51509",1051509,176,15,3,194
"51510",1051510,210,53,9,272
"51511",1051511,100,76,2,178
"51512",1051512,181,91,3,275
"51513",1051513,137,77,3,217
"51514",1051514,231,49,9,289
"51515",1051515,78,76,5,159
"51516",1051516,255,13,16,284
"51517",1051517,204,17,4,225
"51518",1051518,63,166,9,238
"51519",1051519,130,81,8,219
"51520",1051520,111,36,4,151
"51521",1051521,235,53,10,298
"51522",1051522,137,45,2,184
"51523",1051523,149,59,5,213
"51524",1051524,178,34,12,224
"51525",1051525,83,183,8,274
"51526",1051526,120,148,12,280
"51527",1051527,98,206,14,318
"51528",1051528,122,59,3,184
"51529",1051529,29,18,2,49
"51530",1051530,38,258,8,304
"51531",1051531,37,7,3,47
"51532",1051532,165,122,4,291
"51533",1051533,69,83,7,159
"51534",1051534,108,58,7,173
"51535",1051535,121,169,13,303
"51536",1051536,79,180,2,261
"51537",1051537,211,39,9,259
"51538",1051538,78,60,3,141
"51539",1051539,147,75,9,231
"51540",1051540,139,97,16,252
"51541",1051541,128,17,3,148
"51542",1051542,36,86,0,122
"51543",1051543,39,194,4,237
"51544",1051544,77,175,18,270
"51545",1051545,134,89,7,230
"51546",1051546,16,292,2,310
"51547",1051547,139,33,6,178
"51548",1051548,184,79,15,278
"51549",1051549,117,129,2,248
"51550",1051550,157,138,7,302
"51551",1051551,44,194,8,246
"51552",1051552,60,156,0,216
"51553",1051553,143,132,3,278
"51554",1051554,268,40,13,321
"51555",1051555,139,85,10,234
"51556",1051556,101,63,6,170
"51557",1051557,87,139,2,228
"51558",1051558,105,152,7,264
"51559",1051559,111,186,7,304
"51560",1051560,50,130,21,201
"51561",1051561,125,91,5,221
"51562",1051562,49,255,6,310
"51563",1051563,44,177,7,228
"51564",1051564,191,22,5,218
"51565",1051565,140,47,11,198
"51566",1051566,8,67,3,78
"51567",1051567,84,28,1,113
"51568",1051568,110,100,14,224
"51569",1051569,265,8,2,275
"51570",1051570,69,144,10,223
"51571",1051571,156,14,1,171
"51572",1051572,40,112,7,159
"51573",1051573,44,150,3,197
"51574",1051574,94,27,3,124
"51575",1051575,137,165,13,315
"51576",1051576,143,59,5,207
"51577",1051577,64,212,14,290
"51578",1051578,83,50,5,138
"51579",1051579,41,222,5,268
"51580",1051580,157,49,14,220
"51581",1051581,52,172,8,232
"51582",1051582,144,23,3,170
"51583",1051583,200,38,11,249
"51584",1051584,222,40,12,274
"51585",1051585,180,75,16,271
"51586",1051586,97,106,8,211
"51587",1051587,222,27,14,263
"51588",1051588,226,80,17,323
"51589",1051589,125,56,10,191
"51590",1051590,45,154,3,202
"51591",1051591,168,23,8,199
"51592",1051592,52,168,0,220
"51593",1051593,90,57,6,153
"51594",1051594,39,164,3,206
"51595",1051595,40,31,1,72
"51596",1051596,5,63,3,71
"51597",1051597,84,69,6,159
"51598",1051598,138,159,8,305
"51599",1051599,282,106,10,398
"51600",1051600,114,128,4,246
"51601",1051601,88,199,8,295
"51602",1051602,164,81,12,257
"51603",1051603,88,186,12,286
"51604",1051604,158,61,2,221
"51605",1051605,91,186,8,285
"51606",1051606,132,82,6,220
"51607",1051607,184,52,5,241
"51608",1051608,55,162,8,225
"51609",1051609,104,120,5,229
"51610",1051610,126,59,9,194
"51611",1051611,44,251,5,300
"51612",1051612,67,145,3,215
"51613",1051613,148,63,15,226
"51614",1051614,44,23,2,69
"51615",1051615,63,169,21,253
"51616",1051616,41,161,8,210
"51617",1051617,136,89,6,231
"51618",1051618,175,57,5,237
"51619",1051619,125,73,16,214
"51620",1051620,39,237,1,277
"51621",1051621,46,184,7,237
"51622",1051622,72,141,2,215
"51623",1051623,160,144,12,316
"51624",1051624,160,38,7,205
"51625",1051625,17,111,3,131
"51626",1051626,157,99,11,267
"51627",1051627,200,83,20,303
"51628",1051628,25,54,1,80
"51629",1051629,44,85,2,131
"51630",1051630,112,114,8,234
"51631",1051631,59,44,1,104
"51632",1051632,91,173,11,275
"51633",1051633,198,42,9,249
"51634",1051634,126,137,5,268
"51635",1051635,26,49,1,76
"51636",1051636,81,169,5,255
"51637",1051637,160,59,7,226
"51638",1051638,68,193,6,267
"51639",1051639,154,99,8,261
"51640",1051640,108,126,2,236
"51641",1051641,45,221,9,275
"51642",1051642,68,15,1,84
"51643",1051643,101,127,5,233
"51644",1051644,82,50,2,134
"51645",1051645,153,95,4,252
"51646",1051646,25,193,2,220
"51647",1051647,20,32,3,55
"51648",1051648,57,95,12,164
"51649",1051649,91,75,2,168
"51650",1051650,178,27,2,207
"51651",1051651,42,54,8,104
"51652",1051652,136,22,5,163
"51653",1051653,226,65,7,298
"51654",1051654,105,200,13,318
"51655",1051655,186,34,6,226
"51656",1051656,128,47,10,185
"51657",1051657,24,335,8,367
"51658",1051658,150,20,0,170
"51659",1051659,32,253,6,291
"51660",1051660,94,128,11,233
"51661",1051661,54,156,15,225
"51662",1051662,4,2,0,6
"51663",1051663,79,152,13,244
"51664",1051664,82,129,11,222
"51665",1051665,142,58,9,209
"51666",1051666,71,120,10,201
"51667",1051667,143,146,9,298
"51668",1051668,39,30,4,73
"51669",1051669,111,7,1,119
"51670",1051670,126,33,6,165
"51671",1051671,70,156,8,234
"51672",1051672,155,15,5,175
"51673",1051673,224,17,9,250
"51674",1051674,258,45,12,315
"51675",1051675,208,68,13,289
"51676",1051676,162,18,3,183
"51677",1051677,46,162,8,216
"51678",1051678,162,70,2,234
"51679",1051679,137,97,6,240
"51680",1051680,145,13,5,163
"51681",1051681,55,153,5,213
"51682",1051682,153,98,9,260
"51683",1051683,62,265,4,331
"51684",1051684,158,130,23,311
"51685",1051685,189,52,5,246
"51686",1051686,34,12,3,49
"51687",1051687,111,14,5,130
"51688",1051688,109,74,4,187
"51689",1051689,215,55,5,275
"51690",1051690,38,12,3,53
"51691",1051691,143,66,4,213
"51692",1051692,137,134,9,280
"51693",1051693,120,187,5,312
"51694",1051694,29,152,6,187
"51695",1051695,98,196,9,303
"51696",1051696,128,105,3,236
"51697",1051697,17,7,2,26
"51698",1051698,117,59,5,181
"51699",1051699,201,81,20,302
"51700",1051700,83,72,5,160
"51701",1051701,73,16,1,90
"51702",1051702,91,36,3,130
"51703",1051703,33,242,8,283
"51704",1051704,120,117,4,241
"51705",1051705,85,27,2,114
"51706",1051706,96,112,5,213
"51707",1051707,162,15,3,180
"51708",1051708,78,195,14,287
"51709",1051709,170,46,6,222
"51710",1051710,86,55,2,143
"51711",1051711,87,2,2,91
"51712",1051712,76,139,7,222
"51713",1051713,39,81,12,132
"51714",1051714,128,149,10,287
"51715",1051715,35,213,8,256
"51716",1051716,104,103,11,218
"51717",1051717,119,49,10,178
"51718",1051718,129,144,15,288
"51719",1051719,127,72,11,210
"51720",1051720,186,41,3,230
"51721",1051721,232,53,6,291
"51722",1051722,192,25,8,225
"51723",1051723,26,230,1,257
"51724",1051724,16,79,6,101
"51725",1051725,8,122,2,132
"51726",1051726,69,30,9,108
"51727",1051727,80,122,6,208
"51728",1051728,95,46,1,142
"51729",1051729,110,97,5,212
"51730",1051730,294,5,2,301
"51731",1051731,85,160,7,252
"51732",1051732,79,213,7,299
"51733",1051733,19,148,1,168
"51734",1051734,72,210,5,287
"51735",1051735,196,29,6,231
"51736",1051736,90,134,9,233
"51737",1051737,133,144,11,288
"51738",1051738,117,183,7,307
"51739",1051739,93,132,8,233
"51740",1051740,86,162,12,260
"51741",1051741,39,293,10,342
"51742",1051742,8,1,0,9
"51743",1051743,137,90,9,236
"51744",1051744,147,84,5,236
"51745",1051745,173,97,9,279
"51746",1051746,14,7,0,21
"51747",1051747,149,109,21,279
"51748",1051748,43,83,5,131
"51749",1051749,34,7,1,42
"51750",1051750,69,236,3,308
"51751",1051751,84,53,7,144
"51752",1051752,97,126,15,238
"51753",1051753,100,144,21,265
"51754",1051754,73,107,11,191
"51755",1051755,154,97,4,255
"51756",1051756,146,145,5,296
"51757",1051757,161,21,4,186
"51758",1051758,180,60,0,240
"51759",1051759,69,10,0,79
"51760",1051760,5,33,0,38
"51761",1051761,86,113,6,205
"51762",1051762,50,236,12,298
"51763",1051763,63,196,2,261
"51764",1051764,150,86,6,242
"51765",1051765,134,99,11,244
"51766",1051766,122,90,9,221
"51767",1051767,100,28,4,132
"51768",1051768,77,147,7,231
"51769",1051769,125,77,4,206
"51770",1051770,42,17,18,77
"51771",1051771,224,62,22,308
"51772",1051772,147,9,9,165
"51773",1051773,9,46,4,59
"51774",1051774,54,250,1,305
"51775",1051775,181,61,10,252
"51776",1051776,76,244,3,323
"51777",1051777,48,226,4,278
"51778",1051778,197,74,11,282
"51779",1051779,129,126,2,257
"51780",1051780,181,232,12,425
"51781",1051781,23,65,3,91
"51782",1051782,230,54,15,299
"51783",1051783,104,141,10,255
"51784",1051784,20,154,4,178
"51785",1051785,95,73,17,185
"51786",1051786,136,76,9,221
"51787",1051787,95,111,6,212
"51788",1051788,16,127,3,146
"51789",1051789,137,102,10,249
"51790",1051790,217,53,10,280
"51791",1051791,82,45,6,133
"51792",1051792,81,180,11,272
"51793",1051793,38,163,2,203
"51794",1051794,171,77,2,250
"51795",1051795,174,111,16,301
"51796",1051796,66,96,4,166
"51797",1051797,17,13,0,30
"51798",1051798,87,50,3,140
"51799",1051799,89,192,9,290
"51800",1051800,98,166,20,284
"51801",1051801,16,24,0,40
"51802",1051802,40,207,4,251
"51803",1051803,67,155,6,228
"51804",1051804,90,144,22,256
"51805",1051805,149,20,2,171
"51806",1051806,226,57,12,295
"51807",1051807,40,214,6,260
"51808",1051808,152,58,10,220
"51809",1051809,67,84,5,156
"51810",1051810,103,132,7,242
"51811",1051811,149,102,5,256
"51812",1051812,115,25,3,143
"51813",1051813,20,59,1,80
"51814",1051814,47,99,7,153
"51815",1051815,89,47,4,140
"51816",1051816,73,45,14,132
"51817",1051817,168,144,10,322
"51818",1051818,51,223,7,281
"51819",1051819,193,16,4,213
"51820",1051820,91,177,6,274
"51821",1051821,78,160,9,247
"51822",1051822,37,143,6,186
"51823",1051823,212,70,25,307
"51824",1051824,160,103,14,277
"51825",1051825,162,19,5,186
"51826",1051826,165,97,5,267
"51827",1051827,71,206,2,279
"51828",1051828,49,234,2,285
"51829",1051829,138,132,14,284
"51830",1051830,13,217,7,237
"51831",1051831,49,259,2,310
"51832",1051832,10,267,2,279
"51833",1051833,100,50,11,161
"51834",1051834,145,91,10,246
"51835",1051835,126,83,9,218
"51836",1051836,114,278,10,402
"51837",1051837,69,140,5,214
"51838",1051838,59,81,4,144
"51839",1051839,129,3,5,137
"51840",1051840,43,184,10,237
"51841",1051841,48,187,3,238
"51842",1051842,121,54,13,188
"51843",1051843,84,172,11,267
"51844",1051844,99,43,2,144
"51845",1051845,49,177,8,234
"51846",1051846,144,116,13,273
"51847",1051847,84,132,0,216
"51848",1051848,69,172,16,257
"51849",1051849,13,313,1,327
"51850",1051850,141,186,12,339
"51851",1051851,149,40,10,199
"51852",1051852,77,116,11,204
"51853",1051853,128,110,4,242
"51854",1051854,51,156,10,217
"51855",1051855,128,104,7,239
"51856",1051856,41,161,7,209
"51857",1051857,51,26,7,84
"51858",1051858,21,45,0,66
"51859",1051859,74,185,4,263
"51860",1051860,103,61,3,167
"51861",1051861,102,56,5,163
"51862",1051862,207,36,7,250
"51863",1051863,163,117,16,296
"51864",1051864,199,76,8,283
"51865",1051865,150,4,1,155
"51866",1051866,63,155,8,226
"51867",1051867,81,21,1,103
"51868",1051868,208,14,7,229
"51869",1051869,52,228,8,288
"51870",1051870,126,72,15,213
"51871",1051871,143,134,9,286
"51872",1051872,224,20,7,251
"51873",1051873,231,99,16,346
"51874",1051874,181,67,8,256
"51875",1051875,89,72,4,165
"51876",1051876,141,147,14,302
"51877",1051877,91,193,7,291
"51878",1051878,25,250,11,286
"51879",1051879,69,40,2,111
"51880",1051880,89,40,23,152
"51881",1051881,199,20,9,228
"51882",1051882,63,99,7,169
"51883",1051883,117,135,5,257
"51884",1051884,104,33,0,137
"51885",1051885,230,32,6,268
"51886",1051886,8,81,3,92
"51887",1051887,66,69,9,144
"51888",1051888,94,180,10,284
"51889",1051889,273,92,7,372
"51890",1051890,129,137,6,272
"51891",1051891,171,77,15,263
"51892",1051892,165,133,20,318
"51893",1051893,154,86,25,265
"51894",1051894,194,47,6,247
"51895",1051895,43,227,6,276
"51896",1051896,168,64,8,240
"51897",1051897,59,25,5,89
"51898",1051898,158,77,17,252
"51899",1051899,128,97,6,231
"51900",1051900,42,253,5,300
"51901",1051901,154,37,4,195
"51902",1051902,166,25,6,197
"51903",1051903,100,106,9,215
"51904",1051904,57,82,5,144
"51905",1051905,52,241,15,308
"51906",1051906,111,93,1,205
"51907",1051907,112,116,5,233
"51908",1051908,1,3,0,4
"51909",1051909,201,53,6,260
"51910",1051910,110,243,19,372
"51911",1051911,8,40,0,48
"51912",1051912,108,201,23,332
"51913",1051913,169,63,15,247
"51914",1051914,124,148,18,290
"51915",1051915,64,240,0,304
"51916",1051916,260,20,7,287
"51917",1051917,177,102,11,290
"51918",1051918,240,42,6,288
"51919",1051919,73,133,11,217
"51920",1051920,156,168,8,332
"51921",1051921,4,6,0,10
"51922",1051922,179,107,16,302
"51923",1051923,38,161,2,201
"51924",1051924,61,196,19,276
"51925",1051925,179,38,15,232
"51926",1051926,167,15,2,184
"51927",1051927,254,40,13,307
"51928",1051928,160,48,8,216
"51929",1051929,52,214,8,274
"51930",1051930,114,56,5,175
"51931",1051931,177,108,22,307
"51932",1051932,113,230,7,350
"51933",1051933,168,50,17,235
"51934",1051934,127,83,12,222
"51935",1051935,49,101,11,161
"51936",1051936,32,181,3,216
"51937",1051937,10,39,2,51
"51938",1051938,105,134,6,245
"51939",1051939,196,57,39,292
"51940",1051940,48,32,6,86
"51941",1051941,91,119,6,216
"51942",1051942,82,84,17,183
"51943",1051943,102,111,6,219
"51944",1051944,53,148,7,208
"51945",1051945,60,234,3,297
"51946",1051946,107,86,8,201
"51947",1051947,98,160,11,269
"51948",1051948,18,91,3,112
"51949",1051949,140,67,8,215
"51950",1051950,72,111,8,191
"51951",1051951,49,187,11,247
"51952",1051952,71,211,10,292
"51953",1051953,102,151,4,257
"51954",1051954,41,169,2,212
"51955",1051955,35,244,2,281
"51956",1051956,16,9,1,26
"51957",1051957,149,33,5,187
"51958",1051958,137,25,4,166
"51959",1051959,89,195,19,303
"51960",1051960,170,133,11,314
"51961",1051961,187,34,6,227
"51962",1051962,69,209,3,281
"51963",1051963,26,196,10,232
"51964",1051964,26,4,0,30
"51965",1051965,123,180,10,313
"51966",1051966,83,129,10,222
"51967",1051967,39,161,17,217
"51968",1051968,58,14,6,78
"51969",1051969,73,164,11,248
"51970",1051970,176,75,9,260
"51971",1051971,65,217,9,291
"51972",1051972,131,122,6,259
"51973",1051973,24,264,2,290
"51974",1051974,245,57,18,320
"51975",1051975,171,59,12,242
"51976",1051976,132,92,8,232
"51977",1051977,136,88,5,229
"51978",1051978,143,34,4,181
"51979",1051979,123,94,6,223
"51980",1051980,31,12,2,45
"51981",1051981,42,206,13,261
"51982",1051982,129,63,11,203
"51983",1051983,97,140,2,239
"51984",1051984,45,229,1,275
"51985",1051985,120,44,5,169
"51986",1051986,41,156,7,204
"51987",1051987,73,41,6,120
"51988",1051988,102,126,18,246
"51989",1051989,53,165,16,234
"51990",1051990,31,98,5,134
"51991",1051991,170,46,13,229
"51992",1051992,119,116,7,242
"51993",1051993,131,126,11,268
"51994",1051994,13,331,1,345
"51995",1051995,96,194,2,292
"51996",1051996,135,50,5,190
"51997",1051997,31,36,3,70
"51998",1051998,98,197,2,297
"51999",1051999,164,123,11,298
"52000",1052000,102,169,6,277
"52001",1052001,74,184,2,260
"52002",1052002,124,15,4,143
"52003",1052003,77,125,7,209
"52004",1052004,225,62,16,303
"52005",1052005,176,21,4,201
"52006",1052006,108,131,4,243
"52007",1052007,107,88,9,204
"52008",1052008,167,97,12,276
"52009",1052009,212,92,7,311
"52010",1052010,66,188,13,267
"52011",1052011,48,164,7,219
"52012",1052012,47,181,9,237
"52013",1052013,80,216,8,304
"52014",1052014,46,198,3,247
"52015",1052015,127,50,7,184
"52016",1052016,216,16,3,235
"52017",1052017,49,24,4,77
"52018",1052018,229,55,8,292
"52019",1052019,138,66,7,211
"52020",1052020,234,64,15,313
"52021",1052021,69,210,5,284
"52022",1052022,63,13,3,79
"52023",1052023,132,150,4,286
"52024",1052024,75,74,3,152
"52025",1052025,147,48,6,201
"52026",1052026,33,69,2,104
"52027",1052027,65,94,9,168
"52028",1052028,35,5,0,40
"52029",1052029,77,147,6,230
"52030",1052030,52,45,0,97
"52031",1052031,162,118,10,290
"52032",1052032,99,81,6,186
"52033",1052033,34,79,1,114
"52034",1052034,133,43,3,179
"52035",1052035,218,51,6,275
"52036",1052036,144,93,5,242
"52037",1052037,118,175,10,303
"52038",1052038,103,13,4,120
"52039",1052039,139,78,9,226
"52040",1052040,116,153,14,283
"52041",1052041,176,19,1,196
"52042",1052042,200,75,6,281
"52043",1052043,119,108,25,252
"52044",1052044,158,51,17,226
"52045",1052045,189,71,20,280
"52046",1052046,111,167,12,290
"52047",1052047,95,122,4,221
"52048",1052048,238,26,8,272
"52049",1052049,137,72,15,224
"52050",1052050,94,163,16,273
"52051",1052051,129,138,4,271
"52052",1052052,142,117,1,260
"52053",1052053,76,173,6,255
"52054",1052054,57,20,0,77
"52055",1052055,83,122,4,209
"52056",1052056,182,40,6,228
"52057",1052057,179,7,13,199
"52058",1052058,172,90,10,272
"52059",1052059,106,75,8,189
"52060",1052060,44,167,9,220
"52061",1052061,133,51,11,195
"52062",1052062,57,192,14,263
"52063",1052063,47,226,4,277
"52064",1052064,61,166,5,232
"52065",1052065,182,15,10,207
"52066",1052066,18,2,1,21
"52067",1052067,180,45,4,229
"52068",1052068,113,164,4,281
"52069",1052069,52,247,9,308
"52070",1052070,92,106,10,208
"52071",1052071,128,58,11,197
"52072",1052072,33,137,4,174
"52073",1052073,224,49,24,297
"52074",1052074,146,2,2,150
"52075",1052075,212,43,9,264
"52076",1052076,172,88,10,270
"52077",1052077,64,110,8,182
"52078",1052078,73,157,4,234
"52079",1052079,63,84,16,163
"52080",1052080,200,8,7,215
"52081",1052081,117,35,6,158
"52082",1052082,60,212,4,276
"52083",1052083,8,10,1,19
"52084",1052084,63,150,7,220
"52085",1052085,69,48,4,121
"52086",1052086,133,80,15,228
"52087",1052087,163,112,11,286
"52088",1052088,197,36,9,242
"52089",1052089,163,60,6,229
"52090",1052090,58,229,3,290
"52091",1052091,58,117,1,176
"52092",1052092,131,88,9,228
"52093",1052093,47,138,0,185
"52094",1052094,232,95,9,336
"52095",1052095,104,66,2,172
"52096",1052096,54,129,11,194
"52097",1052097,114,203,5,322
"52098",1052098,210,60,18,288
"52099",1052099,90,40,9,139
"52100",1052100,196,50,12,258
"52101",1052101,103,120,20,243
"52102",1052102,61,202,12,275
"52103",1052103,57,184,17,258
"52104",1052104,62,156,10,228
"52105",1052105,88,56,10,154
"52106",1052106,87,166,11,264
"52107",1052107,138,71,11,220
"52108",1052108,182,95,9,286
"52109",1052109,64,0,1,65
"52110",1052110,80,143,5,228
"52111",1052111,301,1,4,306
"52112",1052112,49,242,4,295
"52113",1052113,88,203,13,304
"52114",1052114,42,207,4,253
"52115",1052115,105,86,11,202
"52116",1052116,48,209,9,266
"52117",1052117,204,33,5,242
"52118",1052118,48,97,13,158
"52119",1052119,169,121,12,302
"52120",1052120,56,59,10,125
"52121",1052121,85,170,7,262
"52122",1052122,206,30,10,246
"52123",1052123,51,219,16,286
"52124",1052124,32,214,2,248
"52125",1052125,152,51,7,210
"52126",1052126,140,134,7,281
"52127",1052127,144,83,3,230
"52128",1052128,188,97,16,301
"52129",1052129,139,147,14,300
"52130",1052130,152,56,4,212
"52131",1052131,67,175,6,248
"52132",1052132,96,226,2,324
"52133",1052133,152,89,6,247
"52134",1052134,199,78,24,301
"52135",1052135,99,182,7,288
"52136",1052136,9,77,1,87
"52137",1052137,94,146,4,244
"52138",1052138,68,38,6,112
"52139",1052139,154,79,8,241
"52140",1052140,87,80,15,182
"52141",1052141,196,64,11,271
"52142",1052142,94,58,19,171
"52143",1052143,123,62,14,199
"52144",1052144,37,185,2,224
"52145",1052145,150,47,4,201
"52146",1052146,63,180,5,248
"52147",1052147,75,71,14,160
"52148",1052148,5,12,0,17
"52149",1052149,229,75,15,319
"52150",1052150,70,18,4,92
"52151",1052151,190,114,14,318
"52152",1052152,206,75,11,292
"52153",1052153,148,30,5,183
"52154",1052154,41,125,5,171
"52155",1052155,7,6,0,13
"52156",1052156,135,94,1,230
"52157",1052157,124,40,2,166
"52158",1052158,67,173,15,255
"52159",1052159,111,131,6,248
"52160",1052160,230,18,5,253
"52161",1052161,140,32,5,177
"52162",1052162,48,232,8,288
"52163",1052163,50,211,7,268
"52164",1052164,25,215,5,245
"52165",1052165,116,199,6,321
"52166",1052166,124,63,7,194
"52167",1052167,181,84,8,273
"52168",1052168,105,135,7,247
"52169",1052169,68,68,13,149
"52170",1052170,167,141,30,338
"52171",1052171,96,50,8,154
"52172",1052172,104,51,4,159
"52173",1052173,128,108,8,244
"52174",1052174,153,31,12,196
"52175",1052175,138,26,6,170
"52176",1052176,21,216,3,240
"52177",1052177,173,93,7,273
"52178",1052178,153,36,8,197
"52179",1052179,163,99,13,275
"52180",1052180,24,155,3,182
"52181",1052181,190,45,19,254
"52182",1052182,116,78,7,201
"52183",1052183,21,303,6,330
"52184",1052184,87,175,8,270
"52185",1052185,166,110,11,287
"52186",1052186,31,196,7,234
"52187",1052187,75,174,4,253
"52188",1052188,67,154,3,224
"52189",1052189,169,36,9,214
"52190",1052190,12,91,1,104
"52191",1052191,150,85,27,262
"52192",1052192,59,130,11,200
"52193",1052193,52,170,10,232
"52194",1052194,10,151,2,163
"52195",1052195,138,67,12,217
"52196",1052196,100,172,13,285
"52197",1052197,33,10,4,47
"52198",1052198,209,109,11,329
"52199",1052199,147,57,0,204
"52200",1052200,175,43,7,225
"52201",1052201,80,231,16,327
"52202",1052202,147,56,6,209
"52203",1052203,197,37,9,243
"52204",1052204,185,51,2,238
"52205",1052205,11,137,3,151
"52206",1052206,19,173,3,195
"52207",1052207,84,371,6,461
"52208",1052208,20,12,1,33
"52209",1052209,140,48,16,204
"52210",1052210,164,36,2,202
"52211",1052211,90,58,4,152
"52212",1052212,134,75,7,216
"52213",1052213,75,118,13,206
"52214",1052214,115,80,13,208
"52215",1052215,56,228,12,296
"52216",1052216,24,24,5,53
"52217",1052217,189,69,8,266
"52218",1052218,122,110,13,245
"52219",1052219,46,230,8,284
"52220",1052220,135,22,2,159
"52221",1052221,114,57,10,181
"52222",1052222,63,14,4,81
"52223",1052223,300,8,26,334
"52224",1052224,75,49,6,130
"52225",1052225,82,140,11,233
"52226",1052226,63,165,14,242
"52227",1052227,90,73,4,167
"52228",1052228,110,34,4,148
"52229",1052229,186,49,6,241
"52230",1052230,208,65,5,278
"52231",1052231,85,196,13,294
"52232",1052232,60,103,5,168
"52233",1052233,60,196,15,271
"52234",1052234,178,83,21,282
"52235",1052235,150,21,1,172
"52236",1052236,107,67,5,179
"52237",1052237,8,8,2,18
"52238",1052238,42,178,12,232
"52239",1052239,36,30,7,73
"52240",1052240,46,149,12,207
"52241",1052241,94,52,6,152
"52242",1052242,99,108,13,220
"52243",1052243,73,107,16,196
"52244",1052244,111,147,12,270
"52245",1052245,18,99,4,121
"52246",1052246,21,10,2,33
"52247",1052247,207,29,11,247
"52248",1052248,44,93,13,150
"52249",1052249,141,84,1,226
"52250",1052250,87,161,6,254
"52251",1052251,13,6,1,20
"52252",1052252,46,151,3,200
"52253",1052253,126,51,8,185
"52254",1052254,40,198,3,241
"52255",1052255,5,6,0,11
"52256",1052256,9,110,2,121
"52257",1052257,68,257,3,328
"52258",1052258,19,186,3,208
"52259",1052259,27,101,7,135
"52260",1052260,74,164,23,261
"52261",1052261,83,223,3,309
"52262",1052262,123,86,11,220
"52263",1052263,80,106,7,193
"52264",1052264,84,156,1,241
"52265",1052265,93,145,12,250
"52266",1052266,183,97,11,291
"52267",1052267,57,217,9,283
"52268",1052268,165,141,11,317
"52269",1052269,122,76,8,206
"52270",1052270,172,68,11,251
"52271",1052271,35,194,7,236
"52272",1052272,125,23,3,151
"52273",1052273,133,61,8,202
"52274",1052274,154,21,2,177
"52275",1052275,181,66,11,258
"52276",1052276,185,116,8,309
"52277",1052277,42,236,1,279
"52278",1052278,155,66,12,233
"52279",1052279,247,48,8,303
"52280",1052280,149,83,8,240
"52281",1052281,231,53,6,290
"52282",1052282,78,13,1,92
"52283",1052283,161,86,12,259
"52284",1052284,14,200,7,221
"52285",1052285,136,29,3,168
"52286",1052286,82,145,3,230
"52287",1052287,221,53,4,278
"52288",1052288,96,156,13,265
"52289",1052289,0,30,1,31
"52290",1052290,103,119,3,225
"52291",1052291,53,260,5,318
"52292",1052292,149,83,11,243
"52293",1052293,165,120,10,295
"52294",1052294,24,9,2,35
"52295",1052295,12,4,0,16
"52296",1052296,167,32,6,205
"52297",1052297,146,35,1,182
"52298",1052298,105,176,9,290
"52299",1052299,160,61,4,225
"52300",1052300,175,91,12,278
"52301",1052301,39,36,1,76
"52302",1052302,141,90,10,241
"52303",1052303,168,41,6,215
"52304",1052304,175,31,8,214
"52305",1052305,62,201,4,267
"52306",1052306,145,130,20,295
"52307",1052307,119,54,4,177
"52308",1052308,54,154,5,213
"52309",1052309,22,107,1,130
"52310",1052310,86,87,2,175
"52311",1052311,67,161,6,234
"52312",1052312,258,5,5,268
"52313",1052313,169,93,5,267
"52314",1052314,79,158,16,253
"52315",1052315,195,101,18,314
"52316",1052316,179,64,7,250
"52317",1052317,50,139,10,199
"52318",1052318,116,79,9,204
"52319",1052319,79,140,12,231
"52320",1052320,236,64,17,317
"52321",1052321,85,160,12,257
"52322",1052322,14,1,0,15
"52323",1052323,178,63,11,252
"52324",1052324,110,170,5,285
"52325",1052325,178,97,6,281
"52326",1052326,157,14,4,175
"52327",1052327,221,20,3,244
"52328",1052328,160,65,1,226
"52329",1052329,141,157,9,307
"52330",1052330,117,182,13,312
"52331",1052331,116,65,7,188
"52332",1052332,61,109,7,177
"52333",1052333,79,158,16,253
"52334",1052334,195,57,13,265
"52335",1052335,68,161,8,237
"52336",1052336,16,216,4,236
"52337",1052337,208,13,9,230
"52338",1052338,60,133,5,198
"52339",1052339,182,120,19,321
"52340",1052340,8,118,2,128
"52341",1052341,54,143,8,205
"52342",1052342,56,222,13,291
"52343",1052343,171,123,14,308
"52344",1052344,133,86,11,230
"52345",1052345,41,370,1,412
"52346",1052346,162,91,6,259
"52347",1052347,121,115,4,240
"52348",1052348,69,96,8,173
"52349",1052349,70,216,14,300
"52350",1052350,251,53,9,313
"52351",1052351,77,165,3,245
"52352",1052352,45,104,4,153
"52353",1052353,213,66,24,303
"52354",1052354,105,163,1,269
"52355",1052355,154,31,12,197
"52356",1052356,145,48,4,197
"52357",1052357,124,126,16,266
"52358",1052358,140,93,14,247
"52359",1052359,92,171,3,266
"52360",1052360,157,66,7,230
"52361",1052361,113,165,22,300
"52362",1052362,86,167,8,261
"52363",1052363,110,62,6,178
"52364",1052364,58,68,12,138
"52365",1052365,67,151,8,226
"52366",1052366,105,162,4,271
"52367",1052367,34,246,7,287
"52368",1052368,82,53,2,137
"52369",1052369,122,30,6,158
"52370",1052370,182,60,7,249
"52371",1052371,52,240,3,295
"52372",1052372,96,131,13,240
"52373",1052373,167,72,3,242
"52374",1052374,188,36,10,234
"52375",1052375,165,45,6,216
"52376",1052376,243,14,3,260
"52377",1052377,43,30,3,76
"52378",1052378,89,193,6,288
"52379",1052379,53,197,17,267
"52380",1052380,19,113,5,137
"52381",1052381,138,38,4,180
"52382",1052382,50,269,4,323
"52383",1052383,37,275,7,319
"52384",1052384,73,169,14,256
"52385",1052385,129,179,7,315
"52386",1052386,158,48,5,211
"52387",1052387,148,72,8,228
"52388",1052388,74,164,19,257
"52389",1052389,124,155,9,288
"52390",1052390,27,226,1,254
"52391",1052391,189,73,14,276
"52392",1052392,129,115,2,246
"52393",1052393,176,49,12,237
"52394",1052394,136,115,8,259
"52395",1052395,169,64,8,241
"52396",1052396,149,112,4,265
"52397",1052397,86,152,6,244
"52398",1052398,174,63,17,254
"52399",1052399,188,30,10,228
"52400",1052400,75,109,5,189
"52401",1052401,164,30,2,196
"52402",1052402,103,137,13,253
"52403",1052403,29,7,1,37
"52404",1052404,96,173,3,272
"52405",1052405,175,72,8,255
"52406",1052406,179,96,7,282
"52407",1052407,30,190,3,223
"52408",1052408,190,65,11,266
"52409",1052409,118,127,5,250
"52410",1052410,25,139,3,167
"52411",1052411,140,21,4,165
"52412",1052412,92,48,13,153
"52413",1052413,54,133,9,196
"52414",1052414,29,265,3,297
"52415",1052415,46,9,6,61
"52416",1052416,113,26,5,144
"52417",1052417,129,180,4,313
"52418",1052418,56,124,9,189
"52419",1052419,185,50,15,250
"52420",1052420,45,166,7,218
"52421",1052421,182,92,9,283
"52422",1052422,216,30,6,252
"52423",1052423,91,186,5,282
"52424",1052424,100,230,12,342
"52425",1052425,0,6,2,8
"52426",1052426,176,98,5,279
"52427",1052427,87,202,9,298
"52428",1052428,129,79,5,213
"52429",1052429,12,166,3,181
"52430",1052430,227,35,8,270
"52431",1052431,53,9,1,63
"52432",1052432,210,75,19,304
"52433",1052433,40,208,6,254
"52434",1052434,88,41,1,130
"52435",1052435,66,26,5,97
"52436",1052436,121,51,7,179
"52437",1052437,150,89,8,247
"52438",1052438,142,89,14,245
"52439",1052439,200,45,2,247
"52440",1052440,66,246,3,315
"52441",1052441,68,217,4,289
"52442",1052442,140,52,6,198
"52443",1052443,81,119,5,205
"52444",1052444,54,161,17,232
"52445",1052445,69,166,11,246
"52446",1052446,89,53,3,145
"52447",1052447,162,6,1,169
"52448",1052448,213,3,10,226
"52449",1052449,154,68,18,240
"52450",1052450,68,226,11,305
"52451",1052451,60,143,0,203
"52452",1052452,217,30,5,252
"52453",1052453,101,116,14,231
"52454",1052454,206,73,16,295
"52455",1052455,142,21,7,170
"52456",1052456,62,220,8,290
"52457",1052457,83,185,19,287
"52458",1052458,263,17,7,287
"52459",1052459,57,20,3,80
"52460",1052460,41,113,3,157
"52461",1052461,156,66,6,228
"52462",1052462,118,120,12,250
"52463",1052463,97,175,10,282
"52464",1052464,135,50,6,191
"52465",1052465,127,64,13,204
"52466",1052466,67,160,1,228
"52467",1052467,182,81,12,275
"52468",1052468,81,15,1,97
"52469",1052469,98,234,5,337
"52470",1052470,98,68,14,180
"52471",1052471,118,78,4,200
"52472",1052472,49,27,3,79
"52473",1052473,45,259,6,310
"52474",1052474,46,231,4,281
"52475",1052475,253,41,10,304
"52476",1052476,112,78,8,198
"52477",1052477,86,142,12,240
"52478",1052478,173,12,3,188
"52479",1052479,166,90,4,260
"52480",1052480,43,124,3,170
"52481",1052481,156,54,10,220
"52482",1052482,72,173,15,260
"52483",1052483,189,58,8,255
"52484",1052484,201,64,8,273
"52485",1052485,76,171,5,252
"52486",1052486,30,28,1,59
"52487",1052487,47,179,5,231
"52488",1052488,17,88,3,108
"52489",1052489,56,218,6,280
"52490",1052490,72,58,3,133
"52491",1052491,188,117,16,321
"52492",1052492,155,12,3,170
"52493",1052493,63,41,9,113
"52494",1052494,165,84,20,269
"52495",1052495,29,325,1,355
"52496",1052496,92,215,8,315
"52497",1052497,121,193,7,321
"52498",1052498,115,96,12,223
"52499",1052499,73,185,17,275
"52500",1052500,58,121,5,184
"52501",1052501,109,121,4,234
"52502",1052502,93,171,6,270
"52503",1052503,156,28,3,187
"52504",1052504,20,24,1,45
"52505",1052505,52,249,8,309
"52506",1052506,51,184,6,241
"52507",1052507,68,198,5,271
"52508",1052508,48,194,3,245
"52509",1052509,153,97,8,258
"52510",1052510,133,180,10,323
"52511",1052511,157,123,17,297
"52512",1052512,273,14,3,290
"52513",1052513,76,221,7,304
"52514",1052514,39,148,6,193
"52515",1052515,207,96,8,311
"52516",1052516,95,169,8,272
"52517",1052517,74,183,14,271
"52518",1052518,236,31,10,277
"52519",1052519,193,83,12,288
"52520",1052520,200,12,5,217
"52521",1052521,266,25,13,304
"52522",1052522,104,166,16,286
"52523",1052523,29,182,6,217
"52524",1052524,84,251,9,344
"52525",1052525,157,61,19,237
"52526",1052526,160,36,7,203
"52527",1052527,121,170,15,306
"52528",1052528,25,130,10,165
"52529",1052529,82,114,18,214
"52530",1052530,96,47,2,145
"52531",1052531,113,98,2,213
"52532",1052532,164,151,6,321
"52533",1052533,117,99,18,234
"52534",1052534,129,124,8,261
"52535",1052535,5,14,0,19
"52536",1052536,64,238,10,312
"52537",1052537,49,2,1,52
"52538",1052538,108,96,5,209
"52539",1052539,76,192,3,271
"52540",1052540,193,107,3,303
"52541",1052541,80,236,4,320
"52542",1052542,114,184,3,301
"52543",1052543,169,111,13,293
"52544",1052544,98,174,18,290
"52545",1052545,177,23,5,205
"52546",1052546,98,138,4,240
"52547",1052547,207,100,15,322
"52548",1052548,192,43,9,244
"52549",1052549,226,48,6,280
"52550",1052550,39,23,1,63
"52551",1052551,99,79,13,191
"52552",1052552,93,8,2,103
"52553",1052553,216,64,12,292
"52554",1052554,138,60,11,209
"52555",1052555,110,152,3,265
"52556",1052556,66,136,9,211
"52557",1052557,155,102,12,269
"52558",1052558,105,40,6,151
"52559",1052559,76,221,14,311
"52560",1052560,114,53,6,173
"52561",1052561,167,110,18,295
"52562",1052562,146,80,4,230
"52563",1052563,109,46,15,170
"52564",1052564,19,96,3,118
"52565",1052565,117,77,2,196
"52566",1052566,76,169,18,263
"52567",1052567,73,200,7,280
"52568",1052568,75,11,0,86
"52569",1052569,44,87,5,136
"52570",1052570,113,90,5,208
"52571",1052571,81,169,9,259
"52572",1052572,187,43,7,237
"52573",1052573,66,42,2,110
"52574",1052574,229,29,7,265
"52575",1052575,1,3,0,4
"52576",1052576,63,197,8,268
"52577",1052577,139,45,7,191
"52578",1052578,71,40,2,113
"52579",1052579,49,38,2,89
"52580",1052580,118,142,3,263
"52581",1052581,91,39,5,135
"52582",1052582,125,54,6,185
"52583",1052583,66,174,5,245
"52584",1052584,52,192,3,247
"52585",1052585,103,180,7,290
"52586",1052586,144,70,7,221
"52587",1052587,374,96,3,473
"52588",1052588,103,16,3,122
"52589",1052589,73,242,11,326
"52590",1052590,158,50,6,214
"52591",1052591,30,139,4,173
"52592",1052592,116,148,7,271
"52593",1052593,66,199,4,269
"52594",1052594,127,215,14,356
"52595",1052595,210,225,3,438
"52596",1052596,70,126,14,210
"52597",1052597,89,183,7,279
"52598",1052598,175,26,11,212
"52599",1052599,64,125,2,191
"52600",1052600,172,41,7,220
"52601",1052601,67,100,7,174
"52602",1052602,37,233,3,273
"52603",1052603,83,243,13,339
"52604",1052604,36,218,2,256
"52605",1052605,94,46,2,142
"52606",1052606,24,107,4,135
"52607",1052607,93,193,6,292
"52608",1052608,92,158,3,253
"52609",1052609,70,189,16,275
"52610",1052610,11,3,0,14
"52611",1052611,55,221,13,289
"52612",1052612,46,129,4,179
"52613",1052613,122,144,16,282
"52614",1052614,116,59,19,194
"52615",1052615,50,40,5,95
"52616",1052616,115,127,18,260
"52617",1052617,22,177,1,200
"52618",1052618,132,47,5,184
"52619",1052619,267,49,8,324
"52620",1052620,207,69,5,281
"52621",1052621,74,53,7,134
"52622",1052622,62,62,12,136
"52623",1052623,73,149,5,227
"52624",1052624,35,27,0,62
"52625",1052625,106,78,10,194
"52626",1052626,99,194,11,304
"52627",1052627,64,191,22,277
"52628",1052628,87,207,12,306
"52629",1052629,173,80,6,259
"52630",1052630,146,125,3,274
"52631",1052631,41,119,5,165
"52632",1052632,213,37,10,260
"52633",1052633,36,131,2,169
"52634",1052634,134,140,11,285
"52635",1052635,83,164,10,257
"52636",1052636,52,97,5,154
"52637",1052637,11,214,3,228
"52638",1052638,228,92,8,328
"52639",1052639,154,135,18,307
"52640",1052640,147,131,13,291
"52641",1052641,116,134,15,265
"52642",1052642,85,188,23,296
"52643",1052643,116,159,5,280
"52644",1052644,171,61,12,244
"52645",1052645,340,71,40,451
"52646",1052646,183,90,16,289
"52647",1052647,160,80,20,260
"52648",1052648,49,28,2,79
"52649",1052649,38,9,1,48
"52650",1052650,153,24,12,189
"52651",1052651,163,19,8,190
"52652",1052652,24,173,3,200
"52653",1052653,26,51,0,77
"52654",1052654,165,73,9,247
"52655",1052655,101,184,8,293
"52656",1052656,90,120,7,217
"52657",1052657,80,32,2,114
"52658",1052658,38,187,6,231
"52659",1052659,166,38,3,207
"52660",1052660,70,201,8,279
"52661",1052661,124,48,12,184
"52662",1052662,216,49,10,275
"52663",1052663,53,116,6,175
"52664",1052664,146,144,5,295
"52665",1052665,142,105,7,254
"52666",1052666,54,222,4,280
"52667",1052667,151,55,7,213
"52668",1052668,49,229,12,290
"52669",1052669,43,245,10,298
"52670",1052670,95,56,8,159
"52671",1052671,165,58,13,236
"52672",1052672,62,73,2,137
"52673",1052673,88,112,10,210
"52674",1052674,142,80,23,245
"52675",1052675,111,202,15,328
"52676",1052676,54,14,2,70
"52677",1052677,157,114,9,280
"52678",1052678,19,95,5,119
"52679",1052679,62,3,2,67
"52680",1052680,32,7,1,40
"52681",1052681,48,143,18,209
"52682",1052682,112,228,5,345
"52683",1052683,36,169,6,211
"52684",1052684,46,239,5,290
"52685",1052685,67,160,17,244
"52686",1052686,122,149,6,277
"52687",1052687,89,154,11,254
"52688",1052688,116,196,12,324
"52689",1052689,110,152,4,266
"52690",1052690,120,117,14,251
"52691",1052691,80,176,7,263
"52692",1052692,148,156,13,317
"52693",1052693,203,121,9,333
"52694",1052694,74,170,11,255
"52695",1052695,53,21,9,83
"52696",1052696,117,123,16,256
"52697",1052697,199,68,5,272
"52698",1052698,85,184,8,277
"52699",1052699,141,95,12,248
"52700",1052700,126,137,10,273
"52701",1052701,115,143,4,262
"52702",1052702,107,157,5,269
"52703",1052703,60,149,6,215
"52704",1052704,187,75,18,280
"52705",1052705,42,160,6,208
"52706",1052706,127,138,15,280
"52707",1052707,184,36,14,234
"52708",1052708,143,40,3,186
"52709",1052709,104,158,4,266
"52710",1052710,86,125,6,217
"52711",1052711,50,267,2,319
"52712",1052712,132,55,5,192
"52713",1052713,124,90,2,216
"52714",1052714,88,187,6,281
"52715",1052715,173,111,16,300
"52716",1052716,63,208,6,277
"52717",1052717,44,280,5,329
"52718",1052718,89,207,17,313
"52719",1052719,76,224,5,305
"52720",1052720,162,128,7,297
"52721",1052721,250,20,8,278
"52722",1052722,91,179,13,283
"52723",1052723,76,55,5,136
"52724",1052724,119,76,3,198
"52725",1052725,201,63,17,281
"52726",1052726,255,79,8,342
"52727",1052727,163,102,10,275
"52728",1052728,5,6,1,12
"52729",1052729,144,117,14,275
"52730",1052730,210,53,4,267
"52731",1052731,229,38,8,275
"52732",1052732,50,166,22,238
"52733",1052733,57,175,7,239
"52734",1052734,68,158,11,237
"52735",1052735,85,192,2,279
"52736",1052736,77,207,2,286
"52737",1052737,175,50,11,236
"52738",1052738,77,21,6,104
"52739",1052739,173,99,3,275
"52740",1052740,211,36,6,253
"52741",1052741,133,65,7,205
"52742",1052742,107,250,9,366
"52743",1052743,196,57,11,264
"52744",1052744,153,52,7,212
"52745",1052745,157,153,16,326
"52746",1052746,59,188,3,250
"52747",1052747,236,72,10,318
"52748",1052748,71,105,19,195
"52749",1052749,150,124,15,289
"52750",1052750,121,49,9,179
"52751",1052751,177,137,16,330
"52752",1052752,96,145,5,246
"52753",1052753,49,231,10,290
"52754",1052754,20,38,5,63
"52755",1052755,107,161,10,278
"52756",1052756,209,69,18,296
"52757",1052757,85,135,4,224
"52758",1052758,82,124,11,217
"52759",1052759,77,163,6,246
"52760",1052760,96,40,11,147
"52761",1052761,59,59,2,120
"52762",1052762,61,103,4,168
"52763",1052763,19,13,1,33
"52764",1052764,37,150,2,189
"52765",1052765,167,39,6,212
"52766",1052766,33,243,15,291
"52767",1052767,30,184,7,221
"52768",1052768,199,71,10,280
"52769",1052769,206,22,11,239
"52770",1052770,193,78,8,279
"52771",1052771,15,191,4,210
"52772",1052772,131,44,9,184
"52773",1052773,112,81,12,205
"52774",1052774,22,229,2,253
"52775",1052775,192,41,7,240
"52776",1052776,10,0,0,10
"52777",1052777,165,36,10,211
"52778",1052778,1,21,0,22
"52779",1052779,198,47,12,257
"52780",1052780,219,27,5,251
"52781",1052781,86,22,8,116
"52782",1052782,203,56,12,271
"52783",1052783,31,249,4,284
"52784",1052784,198,28,5,231
"52785",1052785,157,75,7,239
"52786",1052786,87,79,4,170
"52787",1052787,19,185,6,210
"52788",1052788,190,72,10,272
"52789",1052789,66,270,9,345
"52790",1052790,173,100,12,285
"52791",1052791,52,120,6,178
"52792",1052792,151,109,2,262
"52793",1052793,46,66,5,117
"52794",1052794,99,179,5,283
"52795",1052795,191,44,16,251
"52796",1052796,77,139,1,217
"52797",1052797,135,122,7,264
"52798",1052798,98,30,9,137
"52799",1052799,53,155,13,221
"52800",1052800,218,80,12,310
"52801",1052801,146,106,7,259
"52802",1052802,153,48,5,206
"52803",1052803,184,45,18,247
"52804",1052804,104,153,11,268
"52805",1052805,138,135,12,285
"52806",1052806,29,24,5,58
"52807",1052807,137,70,15,222
"52808",1052808,30,122,2,154
"52809",1052809,72,196,6,274
"52810",1052810,22,101,6,129
"52811",1052811,75,36,2,113
"52812",1052812,129,159,4,292
"52813",1052813,121,314,7,442
"52814",1052814,156,11,2,169
"52815",1052815,9,57,5,71
"52816",1052816,224,46,7,277
"52817",1052817,20,239,5,264
"52818",1052818,131,152,13,296
"52819",1052819,115,19,4,138
"52820",1052820,37,4,2,43
"52821",1052821,125,79,13,217
"52822",1052822,257,60,12,329
"52823",1052823,177,130,7,314
"52824",1052824,44,178,6,228
"52825",1052825,118,184,5,307
"52826",1052826,139,154,12,305
"52827",1052827,103,63,6,172
"52828",1052828,35,256,9,300
"52829",1052829,90,93,14,197
"52830",1052830,47,154,9,210
"52831",1052831,161,90,9,260
"52832",1052832,20,105,2,127
"52833",1052833,109,98,7,214
"52834",1052834,94,160,7,261
"52835",1052835,124,127,13,264
"52836",1052836,206,41,12,259
"52837",1052837,129,97,6,232
"52838",1052838,101,117,11,229
"52839",1052839,122,76,7,205
"52840",1052840,222,253,18,493
"52841",1052841,74,223,2,299
"52842",1052842,116,23,3,142
"52843",1052843,156,91,8,255
"52844",1052844,122,45,8,175
"52845",1052845,30,172,4,206
"52846",1052846,121,58,5,184
"52847",1052847,148,116,18,282
"52848",1052848,46,153,7,206
"52849",1052849,102,201,12,315
"52850",1052850,124,39,9,172
"52851",1052851,167,77,2,246
"52852",1052852,165,90,9,264
"52853",1052853,144,46,5,195
"52854",1052854,75,110,7,192
"52855",1052855,70,104,10,184
"52856",1052856,231,68,7,306
"52857",1052857,15,57,2,74
"52858",1052858,79,72,5,156
"52859",1052859,155,96,10,261
"52860",1052860,64,277,5,346
"52861",1052861,115,177,13,305
"52862",1052862,18,18,1,37
"52863",1052863,9,0,0,9
"52864",1052864,41,80,6,127
"52865",1052865,86,190,3,279
"52866",1052866,193,87,11,291
"52867",1052867,148,104,9,261
"52868",1052868,189,38,8,235
"52869",1052869,92,116,11,219
"52870",1052870,23,230,2,255
"52871",1052871,104,168,15,287
"52872",1052872,36,129,6,171
"52873",1052873,152,74,8,234
"52874",1052874,72,229,1,302
"52875",1052875,82,112,10,204
"52876",1052876,43,0,2,45
"52877",1052877,153,69,1,223
"52878",1052878,13,184,8,205
"52879",1052879,0,0,0,0
"52880",1052880,204,78,15,297
"52881",1052881,67,166,13,246
"52882",1052882,66,83,0,149
"52883",1052883,58,199,7,264
"52884",1052884,114,90,5,209
"52885",1052885,113,184,10,307
"52886",1052886,355,4,7,366
"52887",1052887,100,177,12,289
"52888",1052888,81,125,3,209
"52889",1052889,129,125,11,265
"52890",1052890,92,129,13,234
"52891",1052891,197,50,9,256
"52892",1052892,135,72,9,216
"52893",1052893,62,183,8,253
"52894",1052894,106,83,9,198
"52895",1052895,104,121,9,234
"52896",1052896,62,167,10,239
"52897",1052897,125,88,1,214
"52898",1052898,233,106,11,350
"52899",1052899,57,172,8,237
"52900",1052900,38,242,1,281
"52901",1052901,197,21,12,230
"52902",1052902,149,130,20,299
"52903",1052903,185,57,5,247
"52904",1052904,225,56,8,289
"52905",1052905,195,42,5,242
"52906",1052906,51,204,8,263
"52907",1052907,138,136,14,288
"52908",1052908,122,16,4,142
"52909",1052909,69,81,2,152
"52910",1052910,105,160,7,272
"52911",1052911,105,168,11,284
"52912",1052912,81,113,22,216
"52913",1052913,115,87,17,219
"52914",1052914,157,58,8,223
"52915",1052915,64,256,5,325
"52916",1052916,154,37,5,196
"52917",1052917,29,82,1,112
"52918",1052918,68,221,8,297
"52919",1052919,161,32,7,200
"52920",1052920,75,146,7,228
"52921",1052921,139,53,15,207
"52922",1052922,39,70,3,112
"52923",1052923,222,81,7,310
"52924",1052924,203,79,18,300
"52925",1052925,71,80,11,162
"52926",1052926,138,115,12,265
"52927",1052927,114,115,7,236
"52928",1052928,89,146,20,255
"52929",1052929,199,68,19,286
"52930",1052930,79,148,1,228
"52931",1052931,90,45,3,138
"52932",1052932,38,188,5,231
"52933",1052933,123,75,6,204
"52934",1052934,151,69,9,229
"52935",1052935,99,63,3,165
"52936",1052936,189,72,7,268
"52937",1052937,95,162,15,272
"52938",1052938,104,179,4,287
"52939",1052939,200,22,4,226
"52940",1052940,17,238,5,260
"52941",1052941,48,192,5,245
"52942",1052942,181,57,14,252
"52943",1052943,49,32,3,84
"52944",1052944,140,89,6,235
"52945",1052945,119,155,3,277
"52946",1052946,83,91,16,190
"52947",1052947,142,36,55,233
"52948",1052948,12,29,1,42
"52949",1052949,157,122,22,301
"52950",1052950,138,158,13,309
"52951",1052951,98,81,1,180
"52952",1052952,45,255,2,302
"52953",1052953,202,118,8,328
"52954",1052954,39,18,4,61
"52955",1052955,77,249,8,334
"52956",1052956,124,67,2,193
"52957",1052957,37,223,5,265
"52958",1052958,83,204,3,290
"52959",1052959,82,154,21,257
"52960",1052960,109,143,11,263
"52961",1052961,148,37,6,191
"52962",1052962,77,198,12,287
"52963",1052963,99,27,3,129
"52964",1052964,200,44,9,253
"52965",1052965,63,146,4,213
"52966",1052966,146,113,15,274
"52967",1052967,117,34,2,153
"52968",1052968,124,83,4,211
"52969",1052969,10,17,0,27
"52970",1052970,57,99,4,160
"52971",1052971,133,104,20,257
"52972",1052972,111,94,8,213
"52973",1052973,60,226,3,289
"52974",1052974,52,135,13,200
"52975",1052975,201,88,17,306
"52976",1052976,79,67,7,153
"52977",1052977,55,19,8,82
"52978",1052978,2,41,0,43
"52979",1052979,22,204,8,234
"52980",1052980,54,39,2,95
"52981",1052981,102,194,3,299
"52982",1052982,182,90,2,274
"52983",1052983,155,101,7,263
"52984",1052984,122,48,13,183
"52985",1052985,67,168,9,244
"52986",1052986,99,128,6,233
"52987",1052987,214,47,6,267
"52988",1052988,109,169,11,289
"52989",1052989,116,0,0,116
"52990",1052990,90,71,7,168
"52991",1052991,59,171,10,240
"52992",1052992,130,115,16,261
"52993",1052993,173,71,11,255
"52994",1052994,128,161,18,307
"52995",1052995,180,62,15,257
"52996",1052996,60,17,4,81
"52997",1052997,130,86,3,219
"52998",1052998,176,28,6,210
"52999",1052999,172,110,9,291
"53000",1053000,128,17,0,145
"53001",1053001,133,56,6,195
"53002",1053002,10,77,2,89
"53003",1053003,141,58,13,212
"53004",1053004,62,130,4,196
"53005",1053005,122,25,4,151
"53006",1053006,111,91,2,204
"53007",1053007,183,109,9,301
"53008",1053008,116,102,14,232
"53009",1053009,174,65,11,250
"53010",1053010,87,3,2,92
"53011",1053011,150,41,5,196
"53012",1053012,166,132,12,310
"53013",1053013,47,76,2,125
"53014",1053014,42,216,3,261
"53015",1053015,280,35,8,323
"53016",1053016,194,82,4,280
"53017",1053017,132,92,11,235
"53018",1053018,88,185,11,284
"53019",1053019,87,157,10,254
"53020",1053020,111,80,12,203
"53021",1053021,143,7,1,151
"53022",1053022,36,186,5,227
"53023",1053023,5,11,1,17
"53024",1053024,218,29,6,253
"53025",1053025,131,45,7,183
"53026",1053026,41,65,4,110
"53027",1053027,90,164,3,257
"53028",1053028,27,99,11,137
"53029",1053029,93,171,7,271
"53030",1053030,154,126,11,291
"53031",1053031,72,158,1,231
"53032",1053032,26,26,2,54
"53033",1053033,46,172,3,221
"53034",1053034,174,30,7,211
"53035",1053035,149,7,4,160
"53036",1053036,97,98,7,202
"53037",1053037,32,7,0,39
"53038",1053038,230,34,6,270
"53039",1053039,160,63,8,231
"53040",1053040,128,138,8,274
"53041",1053041,56,241,6,303
"53042",1053042,54,167,16,237
"53043",1053043,143,107,5,255
"53044",1053044,125,41,8,174
"53045",1053045,74,135,4,213
"53046",1053046,18,24,8,50
"53047",1053047,162,62,1,225
"53048",1053048,28,247,6,281
"53049",1053049,125,42,5,172
"53050",1053050,50,242,3,295
"53051",1053051,98,130,14,242
"53052",1053052,78,216,12,306
"53053",1053053,60,196,3,259
"53054",1053054,89,127,5,221
"53055",1053055,210,54,10,274
"53056",1053056,116,44,3,163
"53057",1053057,98,104,4,206
"53058",1053058,111,45,4,160
"53059",1053059,63,35,2,100
"53060",1053060,62,233,10,305
"53061",1053061,204,48,7,259
"53062",1053062,70,120,24,214
"53063",1053063,17,283,2,302
"53064",1053064,95,93,2,190
"53065",1053065,146,58,5,209
"53066",1053066,12,101,3,116
"53067",1053067,64,116,2,182
"53068",1053068,251,16,9,276
"53069",1053069,251,12,6,269
"53070",1053070,211,71,11,293
"53071",1053071,71,169,3,243
"53072",1053072,37,174,6,217
"53073",1053073,47,6,3,56
"53074",1053074,51,210,5,266
"53075",1053075,120,25,7,152
"53076",1053076,8,2,1,11
"53077",1053077,170,78,1,249
"53078",1053078,150,139,17,306
"53079",1053079,128,99,12,239
"53080",1053080,156,22,5,183
"53081",1053081,44,14,0,58
"53082",1053082,43,141,6,190
"53083",1053083,58,194,18,270
"53084",1053084,88,144,14,246
"53085",1053085,67,184,13,264
"53086",1053086,85,225,3,313
"53087",1053087,186,46,4,236
"53088",1053088,34,249,5,288
"53089",1053089,87,22,7,116
"53090",1053090,109,76,4,189
"53091",1053091,99,170,20,289
"53092",1053092,128,31,2,161
"53093",1053093,29,41,3,73
"53094",1053094,176,76,13,265
"53095",1053095,79,189,10,278
"53096",1053096,43,157,0,200
"53097",1053097,49,44,7,100
"53098",1053098,128,72,11,211
"53099",1053099,100,114,5,219
"53100",1053100,221,30,4,255
"53101",1053101,131,6,3,140
"53102",1053102,126,117,3,246
"53103",1053103,99,88,10,197
"53104",1053104,105,146,15,266
"53105",1053105,89,94,2,185
"53106",1053106,113,182,13,308
"53107",1053107,130,52,11,193
"53108",1053108,54,249,9,312
"53109",1053109,40,92,2,134
"53110",1053110,124,90,6,220
"53111",1053111,42,191,4,237
"53112",1053112,92,174,10,276
"53113",1053113,79,103,6,188
"53114",1053114,55,215,2,272
"53115",1053115,143,49,3,195
"53116",1053116,70,171,22,263
"53117",1053117,173,90,8,271
"53118",1053118,60,91,9,160
"53119",1053119,95,193,14,302
"53120",1053120,82,207,14,303
"53121",1053121,158,79,13,250
"53122",1053122,56,223,3,282
"53123",1053123,199,69,19,287
"53124",1053124,140,94,11,245
"53125",1053125,65,218,6,289
"53126",1053126,107,24,7,138
"53127",1053127,213,74,20,307
"53128",1053128,174,34,5,213
"53129",1053129,183,47,16,246
"53130",1053130,114,62,7,183
"53131",1053131,48,248,6,302
"53132",1053132,29,118,6,153
"53133",1053133,92,51,3,146
"53134",1053134,71,209,13,293
"53135",1053135,162,49,7,218
"53136",1053136,85,192,8,285
"53137",1053137,47,171,3,221
"53138",1053138,112,21,5,138
"53139",1053139,107,117,11,235
"53140",1053140,194,31,7,232
"53141",1053141,122,59,6,187
"53142",1053142,131,11,3,145
"53143",1053143,125,136,8,269
"53144",1053144,53,22,8,83
"53145",1053145,24,172,9,205
"53146",1053146,103,4,2,109
"53147",1053147,142,99,24,265
"53148",1053148,77,164,15,256
"53149",1053149,221,36,5,262
"53150",1053150,87,84,2,173
"53151",1053151,178,32,4,214
"53152",1053152,156,116,19,291
"53153",1053153,85,71,2,158
"53154",1053154,47,37,6,90
"53155",1053155,132,150,9,291
"53156",1053156,159,112,11,282
"53157",1053157,194,77,24,295
"53158",1053158,230,46,11,287
"53159",1053159,122,58,5,185
"53160",1053160,203,49,11,263
"53161",1053161,103,183,17,303
"53162",1053162,37,230,8,275
"53163",1053163,30,137,2,169
"53164",1053164,207,102,15,324
"53165",1053165,148,102,10,260
"53166",1053166,131,32,9,172
"53167",1053167,141,150,23,314
"53168",1053168,145,22,3,170
"53169",1053169,164,122,13,299
"53170",1053170,66,125,16,207
"53171",1053171,125,110,12,247
"53172",1053172,144,159,14,317
"53173",1053173,93,182,6,281
"53174",1053174,79,200,3,282
"53175",1053175,125,131,5,261
"53176",1053176,19,272,2,293
"53177",1053177,134,39,3,176
"53178",1053178,206,14,5,225
"53179",1053179,22,10,1,33
"53180",1053180,138,112,7,257
"53181",1053181,211,20,7,238
"53182",1053182,119,98,9,226
"53183",1053183,89,108,7,204
"53184",1053184,128,130,6,264
"53185",1053185,76,147,19,242
"53186",1053186,154,84,16,254
"53187",1053187,181,113,27,321
"53188",1053188,31,237,2,270
"53189",1053189,159,73,7,239
"53190",1053190,33,245,3,281
"53191",1053191,203,35,7,245
"53192",1053192,147,102,16,265
"53193",1053193,52,207,6,265
"53194",1053194,191,7,7,205
"53195",1053195,144,141,5,290
"53196",1053196,64,38,1,103
"53197",1053197,90,131,12,233
"53198",1053198,73,43,3,119
"53199",1053199,89,123,8,220
"53200",1053200,135,82,17,234
"53201",1053201,184,126,10,320
"53202",1053202,41,208,6,255
"53203",1053203,33,127,2,162
"53204",1053204,119,108,9,236
"53205",1053205,14,141,1,156
"53206",1053206,10,99,1,110
"53207",1053207,147,49,11,207
"53208",1053208,259,33,10,302
"53209",1053209,98,101,8,207
"53210",1053210,185,99,11,295
"53211",1053211,125,191,7,323
"53212",1053212,48,227,4,279
"53213",1053213,160,111,11,282
"53214",1053214,12,22,2,36
"53215",1053215,234,100,27,361
"53216",1053216,93,59,7,159
"53217",1053217,93,192,17,302
"53218",1053218,185,116,11,312
"53219",1053219,87,52,15,154
"53220",1053220,138,140,10,288
"53221",1053221,99,163,10,272
"53222",1053222,242,24,10,276
"53223",1053223,62,135,8,205
"53224",1053224,122,48,5,175
"53225",1053225,60,89,5,154
"53226",1053226,36,275,12,323
"53227",1053227,11,10,1,22
"53228",1053228,91,78,4,173
"53229",1053229,194,45,5,244
"53230",1053230,49,251,3,303
"53231",1053231,19,56,0,75
"53232",1053232,147,92,5,244
"53233",1053233,162,16,11,189
"53234",1053234,173,31,9,213
"53235",1053235,152,54,9,215
"53236",1053236,92,28,1,121
"53237",1053237,174,94,5,273
"53238",1053238,146,101,18,265
"53239",1053239,69,188,1,258
"53240",1053240,76,57,4,137
"53241",1053241,75,38,1,114
"53242",1053242,72,153,7,232
"53243",1053243,112,32,9,153
"53244",1053244,214,0,0,214
"53245",1053245,61,162,8,231
"53246",1053246,73,169,11,253
"53247",1053247,85,153,6,244
"53248",1053248,160,91,7,258
"53249",1053249,82,74,8,164
"53250",1053250,59,151,3,213
"53251",1053251,41,161,8,210
"53252",1053252,81,107,4,192
"53253",1053253,63,201,6,270
"53254",1053254,201,50,8,259
"53255",1053255,125,24,8,157
"53256",1053256,104,54,4,162
"53257",1053257,150,318,10,478
"53258",1053258,162,62,8,232
"53259",1053259,22,137,4,163
"53260",1053260,115,43,5,163
"53261",1053261,188,26,6,220
"53262",1053262,135,82,7,224
"53263",1053263,144,66,8,218
"53264",1053264,25,171,6,202
"53265",1053265,214,58,15,287
"53266",1053266,24,126,5,155
"53267",1053267,119,24,4,147
"53268",1053268,71,154,6,231
"53269",1053269,163,54,5,222
"53270",1053270,31,240,5,276
"53271",1053271,3,6,1,10
"53272",1053272,147,302,18,467
"53273",1053273,147,37,10,194
"53274",1053274,121,33,2,156
"53275",1053275,84,13,0,97
"53276",1053276,163,65,13,241
"53277",1053277,127,65,8,200
"53278",1053278,57,188,2,247
"53279",1053279,56,109,10,175
"53280",1053280,110,81,11,202
"53281",1053281,138,32,8,178
"53282",1053282,169,39,15,223
"53283",1053283,158,24,4,186
"53284",1053284,99,153,19,271
"53285",1053285,171,40,6,217
"53286",1053286,75,158,21,254
"53287",1053287,67,231,12,310
"53288",1053288,67,18,2,87
"53289",1053289,150,79,5,234
"53290",1053290,167,46,7,220
"53291",1053291,204,46,3,253
"53292",1053292,162,61,10,233
"53293",1053293,176,115,16,307
"53294",1053294,209,23,7,239
"53295",1053295,181,24,8,213
"53296",1053296,132,37,5,174
"53297",1053297,99,201,2,302
"53298",1053298,176,66,15,257
"53299",1053299,107,54,5,166
"53300",1053300,59,174,2,235
"53301",1053301,72,64,1,137
"53302",1053302,4,14,0,18
"53303",1053303,75,131,7,213
"53304",1053304,169,62,13,244
"53305",1053305,67,135,5,207
"53306",1053306,40,110,8,158
"53307",1053307,88,151,2,241
"53308",1053308,232,31,8,271
"53309",1053309,13,4,3,20
"53310",1053310,102,58,5,165
"53311",1053311,225,56,7,288
"53312",1053312,4,24,0,28
"53313",1053313,61,258,4,323
"53314",1053314,180,58,15,253
"53315",1053315,101,132,9,242
"53316",1053316,9,23,0,32
"53317",1053317,232,85,21,338
"53318",1053318,143,165,23,331
"53319",1053319,49,3,0,52
"53320",1053320,16,230,5,251
"53321",1053321,5,48,1,54
"53322",1053322,124,31,5,160
"53323",1053323,27,191,4,222
"53324",1053324,93,91,16,200
"53325",1053325,205,37,7,249
"53326",1053326,103,0,14,117
"53327",1053327,59,247,1,307
"53328",1053328,85,80,6,171
"53329",1053329,160,106,7,273
"53330",1053330,97,53,6,156
"53331",1053331,153,15,7,175
"53332",1053332,124,162,13,299
"53333",1053333,89,127,17,233
"53334",1053334,171,90,13,274
"53335",1053335,159,128,2,289
"53336",1053336,207,65,5,277
"53337",1053337,127,117,18,262
"53338",1053338,88,168,15,271
"53339",1053339,122,70,1,193
"53340",1053340,213,41,10,264
"53341",1053341,24,130,4,158
"53342",1053342,49,64,7,120
"53343",1053343,73,59,4,136
"53344",1053344,5,32,0,37
"53345",1053345,135,90,5,230
"53346",1053346,6,2,1,9
"53347",1053347,133,69,4,206
"53348",1053348,155,32,6,193
"53349",1053349,75,198,12,285
"53350",1053350,121,137,8,266
"53351",1053351,135,142,21,298
"53352",1053352,64,177,11,252
"53353",1053353,89,87,3,179
"53354",1053354,46,288,8,342
"53355",1053355,159,25,5,189
"53356",1053356,104,175,7,286
"53357",1053357,71,119,9,199
"53358",1053358,96,212,7,315
"53359",1053359,72,71,9,152
"53360",1053360,105,102,9,216
"53361",1053361,1,0,0,1
"53362",1053362,132,172,7,311
"53363",1053363,129,106,3,238
"53364",1053364,70,213,11,294
"53365",1053365,146,53,6,205
"53366",1053366,36,147,1,184
"53367",1053367,45,41,0,86
"53368",1053368,84,87,8,179
"53369",1053369,44,226,4,274
"53370",1053370,16,169,2,187
"53371",1053371,146,37,6,189
"53372",1053372,108,149,13,270
"53373",1053373,7,1,0,8
"53374",1053374,146,91,14,251
"53375",1053375,125,155,5,285
"53376",1053376,123,91,12,226
"53377",1053377,41,210,3,254
"53378",1053378,104,122,13,239
"53379",1053379,9,4,1,14
"53380",1053380,138,106,14,258
"53381",1053381,153,71,14,238
"53382",1053382,76,100,7,183
"53383",1053383,115,174,8,297
"53384",1053384,157,91,7,255
"53385",1053385,230,54,3,287
"53386",1053386,172,32,10,214
"53387",1053387,173,48,8,229
"53388",1053388,59,74,8,141
"53389",1053389,155,24,5,184
"53390",1053390,69,103,3,175
"53391",1053391,106,106,21,233
"53392",1053392,61,138,12,211
"53393",1053393,144,81,13,238
"53394",1053394,141,79,9,229
"53395",1053395,128,92,4,224
"53396",1053396,90,93,9,192
"53397",1053397,26,13,1,40
"53398",1053398,1,3,2,6
"53399",1053399,19,2,2,23
"53400",1053400,113,26,5,144
"53401",1053401,41,175,4,220
"53402",1053402,65,190,5,260
"53403",1053403,174,17,4,195
"53404",1053404,91,169,7,267
"53405",1053405,44,81,12,137
"53406",1053406,174,54,8,236
"53407",1053407,202,79,17,298
"53408",1053408,244,47,12,303
"53409",1053409,166,39,6,211
"53410",1053410,120,74,8,202
"53411",1053411,207,28,5,240
"53412",1053412,45,64,16,125
"53413",1053413,38,217,15,270
"53414",1053414,151,135,27,313
"53415",1053415,115,80,11,206
"53416",1053416,165,42,3,210
"53417",1053417,106,6,1,113
"53418",1053418,38,216,6,260
"53419",1053419,133,33,9,175
"53420",1053420,56,133,2,191
"53421",1053421,9,37,0,46
"53422",1053422,147,157,5,309
"53423",1053423,126,126,10,262
"53424",1053424,77,165,10,252
"53425",1053425,137,170,13,320
"53426",1053426,74,162,18,254
"53427",1053427,5,16,0,21
"53428",1053428,88,212,21,321
"53429",1053429,37,227,14,278
"53430",1053430,43,101,6,150
"53431",1053431,110,41,7,158
"53432",1053432,133,96,9,238
"53433",1053433,69,137,7,213
"53434",1053434,137,40,8,185
"53435",1053435,63,14,3,80
"53436",1053436,215,64,11,290
"53437",1053437,158,90,6,254
"53438",1053438,98,216,5,319
"53439",1053439,159,47,7,213
"53440",1053440,137,94,1,232
"53441",1053441,162,85,24,271
"53442",1053442,84,161,19,264
"53443",1053443,211,52,7,270
"53444",1053444,168,121,15,304
"53445",1053445,27,218,2,247
"53446",1053446,175,154,12,341
"53447",1053447,36,262,4,302
"53448",1053448,229,32,7,268
"53449",1053449,209,42,2,253
"53450",1053450,83,50,8,141
"53451",1053451,118,53,19,190
"53452",1053452,114,70,5,189
"53453",1053453,134,99,9,242
"53454",1053454,182,108,16,306
"53455",1053455,87,95,14,196
"53456",1053456,128,68,10,206
"53457",1053457,204,99,11,314
"53458",1053458,190,58,9,257
"53459",1053459,165,26,13,204
"53460",1053460,153,119,6,278
"53461",1053461,73,192,7,272
"53462",1053462,52,70,6,128
"53463",1053463,55,119,13,187
"53464",1053464,107,174,4,285
"53465",1053465,143,121,12,276
"53466",1053466,88,112,11,211
"53467",1053467,114,59,10,183
"53468",1053468,176,55,8,239
"53469",1053469,37,146,14,197
"53470",1053470,118,38,10,166
"53471",1053471,72,121,6,199
"53472",1053472,133,39,2,174
"53473",1053473,158,167,37,362
"53474",1053474,81,7,3,91
"53475",1053475,120,188,16,324
"53476",1053476,17,138,10,165
"53477",1053477,235,21,13,269
"53478",1053478,61,15,8,84
"53479",1053479,38,158,10,206
"53480",1053480,203,83,15,301
"53481",1053481,50,220,10,280
"53482",1053482,177,90,1,268
"53483",1053483,36,224,5,265
"53484",1053484,184,47,9,240
"53485",1053485,208,61,14,283
"53486",1053486,184,33,13,230
"53487",1053487,82,90,4,176
"53488",1053488,182,90,6,278
"53489",1053489,8,20,1,29
"53490",1053490,54,241,1,296
"53491",1053491,100,124,24,248
"53492",1053492,31,135,4,170
"53493",1053493,119,22,7,148
"53494",1053494,85,169,7,261
"53495",1053495,52,176,4,232
"53496",1053496,124,310,20,454
"53497",1053497,25,23,2,50
"53498",1053498,95,178,12,285
"53499",1053499,193,39,8,240
"53500",1053500,159,112,22,293
"53501",1053501,202,42,11,255
"53502",1053502,34,141,6,181
"53503",1053503,43,14,5,62
"53504",1053504,107,154,13,274
"53505",1053505,49,206,9,264
"53506",1053506,34,2,4,40
"53507",1053507,105,78,8,191
"53508",1053508,148,164,10,322
"53509",1053509,6,1,1,8
"53510",1053510,131,65,7,203
"53511",1053511,108,132,12,252
"53512",1053512,17,122,4,143
"53513",1053513,141,41,12,194
"53514",1053514,170,120,13,303
"53515",1053515,58,153,1,212
"53516",1053516,107,245,5,357
"53517",1053517,191,138,7,336
"53518",1053518,28,132,0,160
"53519",1053519,32,15,2,49
"53520",1053520,112,90,9,211
"53521",1053521,46,129,8,183
"53522",1053522,63,119,11,193
"53523",1053523,137,95,12,244
"53524",1053524,86,139,11,236
"53525",1053525,48,131,17,196
"53526",1053526,120,37,8,165
"53527",1053527,165,147,22,334
"53528",1053528,150,137,15,302
"53529",1053529,121,65,2,188
"53530",1053530,50,59,8,117
"53531",1053531,232,52,6,290
"53532",1053532,176,11,8,195
"53533",1053533,71,182,9,262
"53534",1053534,28,163,11,202
"53535",1053535,25,6,0,31
"53536",1053536,68,204,4,276
"53537",1053537,27,290,1,318
"53538",1053538,203,28,8,239
"53539",1053539,113,134,3,250
"53540",1053540,7,5,0,12
"53541",1053541,129,34,4,167
"53542",1053542,25,68,1,94
"53543",1053543,62,209,7,278
"53544",1053544,142,81,12,235
"53545",1053545,112,48,3,163
"53546",1053546,84,104,5,193
"53547",1053547,185,74,6,265
"53548",1053548,85,82,11,178
"53549",1053549,61,243,8,312
"53550",1053550,32,17,0,49
"53551",1053551,105,249,4,358
"53552",1053552,42,100,3,145
"53553",1053553,165,14,6,185
"53554",1053554,168,64,16,248
"53555",1053555,153,38,2,193
"53556",1053556,175,96,13,284
"53557",1053557,59,27,5,91
"53558",1053558,125,128,3,256
"53559",1053559,120,87,4,211
"53560",1053560,177,32,5,214
"53561",1053561,56,251,6,313
"53562",1053562,41,136,12,189
"53563",1053563,147,29,1,177
"53564",1053564,67,227,10,304
"53565",1053565,186,47,15,248
"53566",1053566,206,105,16,327
"53567",1053567,155,63,21,239
"53568",1053568,88,66,5,159
"53569",1053569,120,30,6,156
"53570",1053570,45,195,11,251
"53571",1053571,50,192,9,251
"53572",1053572,105,43,8,156
"53573",1053573,129,158,16,303
"53574",1053574,73,202,6,281
"53575",1053575,115,81,11,207
"53576",1053576,149,110,15,274
"53577",1053577,95,102,10,207
"53578",1053578,129,29,7,165
"53579",1053579,161,70,6,237
"53580",1053580,67,195,4,266
"53581",1053581,170,47,11,228
"53582",1053582,192,42,4,238
"53583",1053583,61,178,32,271
"53584",1053584,52,291,12,355
"53585",1053585,66,29,4,99
"53586",1053586,101,84,6,191
"53587",1053587,93,161,8,262
"53588",1053588,12,124,6,142
"53589",1053589,60,191,6,257
"53590",1053590,204,51,11,266
"53591",1053591,63,91,2,156
"53592",1053592,68,255,14,337
"53593",1053593,46,181,8,235
"53594",1053594,117,96,2,215
"53595",1053595,110,91,4,205
"53596",1053596,174,112,11,297
"53597",1053597,39,47,1,87
"53598",1053598,105,51,5,161
"53599",1053599,7,36,3,46
"53600",1053600,70,265,6,341
"53601",1053601,135,123,13,271
"53602",1053602,95,46,5,146
"53603",1053603,9,11,0,20
"53604",1053604,228,30,8,266
"53605",1053605,171,25,5,201
"53606",1053606,112,102,17,231
"53607",1053607,67,148,10,225
"53608",1053608,49,149,7,205
"53609",1053609,114,142,13,269
"53610",1053610,9,83,4,96
"53611",1053611,162,153,13,328
"53612",1053612,41,178,3,222
"53613",1053613,77,172,19,268
"53614",1053614,7,138,0,145
"53615",1053615,211,16,7,234
"53616",1053616,83,217,6,306
"53617",1053617,12,7,1,20
"53618",1053618,88,85,7,180
"53619",1053619,171,52,2,225
"53620",1053620,262,15,7,284
"53621",1053621,105,7,1,113
"53622",1053622,116,81,1,198
"53623",1053623,225,50,10,285
"53624",1053624,31,222,6,259
"53625",1053625,234,40,8,282
"53626",1053626,144,71,0,215
"53627",1053627,151,12,5,168
"53628",1053628,113,56,3,172
"53629",1053629,160,94,17,271
"53630",1053630,57,232,6,295
"53631",1053631,259,41,4,304
"53632",1053632,181,57,10,248
"53633",1053633,133,41,10,184
"53634",1053634,182,87,12,281
"53635",1053635,46,23,2,71
"53636",1053636,205,54,3,262
"53637",1053637,43,203,3,249
"53638",1053638,7,7,0,14
"53639",1053639,96,213,16,325
"53640",1053640,164,53,7,224
"53641",1053641,117,124,6,247
"53642",1053642,53,241,10,304
"53643",1053643,30,11,0,41
"53644",1053644,127,107,5,239
"53645",1053645,148,96,13,257
"53646",1053646,44,232,4,280
"53647",1053647,223,103,20,346
"53648",1053648,195,91,4,290
"53649",1053649,64,231,16,311
"53650",1053650,194,66,16,276
"53651",1053651,47,133,5,185
"53652",1053652,256,5,4,265
"53653",1053653,231,21,7,259
"53654",1053654,229,55,19,303
"53655",1053655,110,59,4,173
"53656",1053656,118,13,5,136
"53657",1053657,168,112,6,286
"53658",1053658,85,34,2,121
"53659",1053659,149,93,2,244
"53660",1053660,58,74,5,137
"53661",1053661,83,66,6,155
"53662",1053662,152,102,19,273
"53663",1053663,51,156,3,210
"53664",1053664,147,20,8,175
"53665",1053665,9,28,0,37
"53666",1053666,134,29,5,168
"53667",1053667,100,17,2,119
"53668",1053668,0,1,0,1
"53669",1053669,99,45,7,151
"53670",1053670,16,7,1,24
"53671",1053671,95,78,12,185
"53672",1053672,207,76,5,288
"53673",1053673,54,99,12,165
"53674",1053674,225,64,16,305
"53675",1053675,126,57,5,188
"53676",1053676,4,47,1,52
"53677",1053677,38,175,5,218
"53678",1053678,131,47,4,182
"53679",1053679,313,8,17,338
"53680",1053680,135,12,8,155
"53681",1053681,194,33,5,232
"53682",1053682,170,98,12,280
"53683",1053683,81,96,5,182
"53684",1053684,51,216,3,270
"53685",1053685,139,91,13,243
"53686",1053686,49,186,6,241
"53687",1053687,262,15,8,285
"53688",1053688,69,78,9,156
"53689",1053689,58,189,7,254
"53690",1053690,125,40,5,170
"53691",1053691,69,196,10,275
"53692",1053692,96,98,12,206
"53693",1053693,172,64,3,239
"53694",1053694,160,49,8,217
"53695",1053695,103,81,4,188
"53696",1053696,112,52,5,169
"53697",1053697,164,34,3,201
"53698",1053698,41,150,8,199
"53699",1053699,111,208,6,325
"53700",1053700,26,106,3,135
"53701",1053701,72,148,13,233
"53702",1053702,101,88,10,199
"53703",1053703,218,47,11,276
"53704",1053704,167,75,11,253
"53705",1053705,47,118,3,168
"53706",1053706,1,2,0,3
"53707",1053707,81,76,7,164
"53708",1053708,72,100,10,182
"53709",1053709,188,82,14,284
"53710",1053710,6,218,1,225
"53711",1053711,73,150,9,232
"53712",1053712,55,264,16,335
"53713",1053713,204,24,7,235
"53714",1053714,124,142,12,278
"53715",1053715,148,54,6,208
"53716",1053716,28,258,4,290
"53717",1053717,88,151,0,239
"53718",1053718,172,39,4,215
"53719",1053719,103,175,4,282
"53720",1053720,175,24,4,203
"53721",1053721,147,104,7,258
"53722",1053722,92,223,14,329
"53723",1053723,18,232,7,257
"53724",1053724,156,115,18,289
"53725",1053725,232,63,5,300
"53726",1053726,179,66,6,251
"53727",1053727,101,186,10,297
"53728",1053728,109,121,20,250
"53729",1053729,139,59,4,202
"53730",1053730,168,106,14,288
"53731",1053731,121,52,4,177
"53732",1053732,213,83,11,307
"53733",1053733,161,35,2,198
"53734",1053734,88,101,12,201
"53735",1053735,125,78,7,210
"53736",1053736,90,109,9,208
"53737",1053737,37,37,2,76
"53738",1053738,95,19,1,115
"53739",1053739,203,63,2,268
"53740",1053740,24,49,5,78
"53741",1053741,129,25,6,160
"53742",1053742,136,55,10,201
"53743",1053743,199,30,3,232
"53744",1053744,159,111,18,288
"53745",1053745,189,17,7,213
"53746",1053746,162,91,13,266
"53747",1053747,226,31,7,264
"53748",1053748,176,96,12,284
"53749",1053749,159,26,7,192
"53750",1053750,257,42,6,305
"53751",1053751,128,69,1,198
"53752",1053752,60,14,0,74
"53753",1053753,172,62,2,236
"53754",1053754,182,115,9,306
"53755",1053755,209,71,13,293
"53756",1053756,161,50,3,214
"53757",1053757,36,18,3,57
"53758",1053758,165,11,4,180
"53759",1053759,97,88,5,190
"53760",1053760,20,147,1,168
"53761",1053761,123,180,7,310
"53762",1053762,25,241,5,271
"53763",1053763,64,208,7,279
"53764",1053764,83,146,14,243
"53765",1053765,152,66,6,224
"53766",1053766,137,88,11,236
"53767",1053767,10,3,0,13
"53768",1053768,80,60,4,144
"53769",1053769,49,201,19,269
"53770",1053770,153,63,6,222
"53771",1053771,61,176,7,244
"53772",1053772,41,212,5,258
"53773",1053773,69,215,4,288
"53774",1053774,165,79,7,251
"53775",1053775,80,109,19,208
"53776",1053776,129,157,22,308
"53777",1053777,162,55,9,226
"53778",1053778,135,119,17,271
"53779",1053779,79,139,15,233
"53780",1053780,107,137,3,247
"53781",1053781,204,78,5,287
"53782",1053782,163,61,5,229
"53783",1053783,48,209,6,263
"53784",1053784,45,232,4,281
"53785",1053785,178,84,10,272
"53786",1053786,117,79,8,204
"53787",1053787,57,156,8,221
"53788",1053788,6,2,0,8
"53789",1053789,170,133,22,325
"53790",1053790,153,75,13,241
"53791",1053791,152,124,6,282
"53792",1053792,93,92,17,202
"53793",1053793,49,95,2,146
"53794",1053794,35,208,4,247
"53795",1053795,341,58,14,413
"53796",1053796,95,152,20,267
"53797",1053797,230,37,1,268
"53798",1053798,124,154,17,295
"53799",1053799,30,57,4,91
"53800",1053800,110,191,11,312
"53801",1053801,43,28,2,73
"53802",1053802,73,150,7,230
"53803",1053803,100,77,12,189
"53804",1053804,36,33,3,72
"53805",1053805,79,55,15,149
"53806",1053806,76,142,23,241
"53807",1053807,104,84,6,194
"53808",1053808,29,211,4,244
"53809",1053809,122,102,11,235
"53810",1053810,135,26,8,169
"53811",1053811,191,55,15,261
"53812",1053812,158,307,17,482
"53813",1053813,288,24,2,314
"53814",1053814,172,53,2,227
"53815",1053815,66,194,9,269
"53816",1053816,39,61,4,104
"53817",1053817,211,52,22,285
"53818",1053818,257,27,8,292
"53819",1053819,153,27,13,193
"53820",1053820,56,249,5,310
"53821",1053821,60,229,12,301
"53822",1053822,72,224,12,308
"53823",1053823,51,102,12,165
"53824",1053824,85,212,4,301
"53825",1053825,102,155,8,265
"53826",1053826,90,151,13,254
"53827",1053827,91,149,30,270
"53828",1053828,31,204,6,241
"53829",1053829,139,92,4,235
"53830",1053830,142,126,19,287
"53831",1053831,111,21,4,136
"53832",1053832,56,171,7,234
"53833",1053833,69,143,18,230
"53834",1053834,221,42,5,268
"53835",1053835,159,133,24,316
"53836",1053836,38,303,2,343
"53837",1053837,39,143,1,183
"53838",1053838,150,70,5,225
"53839",1053839,192,32,5,229
"53840",1053840,227,26,0,253
"53841",1053841,32,254,6,292
"53842",1053842,70,179,5,254
"53843",1053843,3,24,1,28
"53844",1053844,196,119,8,323
"53845",1053845,179,41,1,221
"53846",1053846,86,178,18,282
"53847",1053847,111,86,15,212
"53848",1053848,52,27,4,83
"53849",1053849,201,56,10,267
"53850",1053850,144,57,5,206
"53851",1053851,114,25,11,150
"53852",1053852,63,172,5,240
"53853",1053853,8,10,0,18
"53854",1053854,4,8,0,12
"53855",1053855,10,17,3,30
"53856",1053856,117,112,6,235
"53857",1053857,191,106,10,307
"53858",1053858,75,74,6,155
"53859",1053859,151,119,1,271
"53860",1053860,193,27,7,227
"53861",1053861,3,19,0,22
"53862",1053862,12,171,8,191
"53863",1053863,139,107,8,254
"53864",1053864,80,0,1,81
"53865",1053865,15,29,2,46
"53866",1053866,158,142,11,311
"53867",1053867,110,106,5,221
"53868",1053868,79,104,11,194
"53869",1053869,14,3,1,18
"53870",1053870,183,85,15,283
"53871",1053871,202,37,11,250
"53872",1053872,160,154,13,327
"53873",1053873,69,92,8,169
"53874",1053874,125,113,6,244
"53875",1053875,33,181,6,220
"53876",1053876,35,226,5,266
"53877",1053877,81,7,5,93
"53878",1053878,61,165,8,234
"53879",1053879,217,62,11,290
"53880",1053880,92,192,16,300
"53881",1053881,189,57,4,250
"53882",1053882,236,25,8,269
"53883",1053883,47,166,9,222
"53884",1053884,149,46,5,200
"53885",1053885,145,94,6,245
"53886",1053886,87,133,13,233
"53887",1053887,112,99,3,214
"53888",1053888,114,130,11,255
"53889",1053889,66,239,6,311
"53890",1053890,57,133,4,194
"53891",1053891,107,163,11,281
"53892",1053892,19,9,1,29
"53893",1053893,196,12,2,210
"53894",1053894,162,17,6,185
"53895",1053895,165,30,4,199
"53896",1053896,110,25,7,142
"53897",1053897,181,101,6,288
"53898",1053898,162,82,6,250
"53899",1053899,104,65,3,172
"53900",1053900,122,63,11,196
"53901",1053901,138,32,1,171
"53902",1053902,117,222,5,344
"53903",1053903,117,123,37,277
"53904",1053904,169,23,2,194
"53905",1053905,80,165,4,249
"53906",1053906,164,103,9,276
"53907",1053907,35,6,1,42
"53908",1053908,45,152,5,202
"53909",1053909,37,187,8,232
"53910",1053910,88,97,5,190
"53911",1053911,71,219,8,298
"53912",1053912,70,193,5,268
"53913",1053913,137,19,4,160
"53914",1053914,216,45,7,268
"53915",1053915,26,121,4,151
"53916",1053916,234,52,16,302
"53917",1053917,49,60,3,112
"53918",1053918,144,85,1,230
"53919",1053919,192,39,13,244
"53920",1053920,175,71,10,256
"53921",1053921,123,137,8,268
"53922",1053922,44,211,4,259
"53923",1053923,166,74,13,253
"53924",1053924,44,267,2,313
"53925",1053925,59,78,6,143
"53926",1053926,205,68,6,279
"53927",1053927,128,40,9,177
"53928",1053928,222,17,0,239
"53929",1053929,78,176,17,271
"53930",1053930,226,38,6,270
"53931",1053931,138,79,11,228
"53932",1053932,119,88,11,218
"53933",1053933,160,26,10,196
"53934",1053934,41,74,3,118
"53935",1053935,180,23,3,206
"53936",1053936,32,2,1,35
"53937",1053937,26,37,1,64
"53938",1053938,55,136,12,203
"53939",1053939,123,35,2,160
"53940",1053940,219,94,25,338
"53941",1053941,124,14,4,142
"53942",1053942,104,127,3,234
"53943",1053943,179,0,0,179
"53944",1053944,146,50,11,207
"53945",1053945,217,80,13,310
"53946",1053946,8,54,0,62
"53947",1053947,23,164,1,188
"53948",1053948,136,61,5,202
"53949",1053949,56,131,8,195
"53950",1053950,0,3,0,3
"53951",1053951,146,76,10,232
"53952",1053952,193,28,4,225
"53953",1053953,141,30,4,175
"53954",1053954,59,135,6,200
"53955",1053955,58,211,15,284
"53956",1053956,194,61,6,261
"53957",1053957,291,18,7,316
"53958",1053958,90,219,12,321
"53959",1053959,78,152,2,232
"53960",1053960,254,20,3,277
"53961",1053961,61,186,5,252
"53962",1053962,195,52,7,254
"53963",1053963,98,73,7,178
"53964",1053964,243,22,7,272
"53965",1053965,89,69,3,161
"53966",1053966,96,57,6,159
"53967",1053967,37,67,8,112
"53968",1053968,44,105,4,153
"53969",1053969,18,157,1,176
"53970",1053970,95,100,10,205
"53971",1053971,185,6,11,202
"53972",1053972,81,173,12,266
"53973",1053973,46,176,1,223
"53974",1053974,132,63,8,203
"53975",1053975,166,41,8,215
"53976",1053976,33,205,4,242
"53977",1053977,119,61,5,185
"53978",1053978,132,149,3,284
"53979",1053979,161,28,10,199
"53980",1053980,50,177,9,236
"53981",1053981,3,3,0,6
"53982",1053982,172,78,6,256
"53983",1053983,6,1,0,7
"53984",1053984,155,159,10,324
"53985",1053985,38,37,3,78
"53986",1053986,194,54,8,256
"53987",1053987,38,169,5,212
"53988",1053988,18,17,1,36
"53989",1053989,76,136,4,216
"53990",1053990,216,69,0,285
"53991",1053991,8,5,0,13
"53992",1053992,235,7,4,246
"53993",1053993,32,270,3,305
"53994",1053994,100,100,8,208
"53995",1053995,156,42,9,207
"53996",1053996,161,142,13,316
"53997",1053997,82,250,7,339
"53998",1053998,137,76,3,216
"53999",1053999,63,147,3,213
"54000",1054000,84,146,10,240
"54001",1054001,145,4,0,149
"54002",1054002,186,29,4,219
"54003",1054003,153,44,14,211
"54004",1054004,196,88,20,304
"54005",1054005,47,194,2,243
"54006",1054006,165,85,4,254
"54007",1054007,136,117,10,263
"54008",1054008,149,1,3,153
"54009",1054009,40,246,9,295
"54010",1054010,39,152,7,198
"54011",1054011,151,79,15,245
"54012",1054012,78,101,10,189
"54013",1054013,165,24,5,194
"54014",1054014,30,122,5,157
"54015",1054015,143,58,18,219
"54016",1054016,138,57,11,206
"54017",1054017,196,51,8,255
"54018",1054018,88,107,6,201
"54019",1054019,254,54,10,318
"54020",1054020,25,161,3,189
"54021",1054021,150,136,24,310
"54022",1054022,217,79,14,310
"54023",1054023,134,32,8,174
"54024",1054024,94,31,12,137
"54025",1054025,64,233,5,302
"54026",1054026,255,51,16,322
"54027",1054027,231,9,3,243
"54028",1054028,97,66,5,168
"54029",1054029,74,131,1,206
"54030",1054030,117,85,5,207
"54031",1054031,127,144,14,285
"54032",1054032,94,110,14,218
"54033",1054033,137,121,11,269
"54034",1054034,200,27,8,235
"54035",1054035,116,92,2,210
"54036",1054036,146,113,20,279
"54037",1054037,39,232,8,279
"54038",1054038,138,68,18,224
"54039",1054039,14,20,1,35
"54040",1054040,1,4,0,5
"54041",1054041,112,47,7,166
"54042",1054042,95,174,14,283
"54043",1054043,163,85,30,278
"54044",1054044,63,122,7,192
"54045",1054045,14,182,4,200
"54046",1054046,127,56,4,187
"54047",1054047,117,59,1,177
"54048",1054048,123,51,4,178
"54049",1054049,122,165,6,293
"54050",1054050,180,41,5,226
"54051",1054051,107,186,16,309
"54052",1054052,149,149,22,320
"54053",1054053,30,230,5,265
"54054",1054054,236,82,23,341
"54055",1054055,201,70,7,278
"54056",1054056,129,112,16,257
"54057",1054057,164,210,12,386
"54058",1054058,95,51,3,149
"54059",1054059,104,39,6,149
"54060",1054060,139,88,12,239
"54061",1054061,87,59,7,153
"54062",1054062,230,15,7,252
"54063",1054063,117,88,10,215
"54064",1054064,173,48,6,227
"54065",1054065,176,101,20,297
"54066",1054066,33,222,11,266
"54067",1054067,12,14,1,27
"54068",1054068,47,214,7,268
"54069",1054069,26,185,3,214
"54070",1054070,180,39,6,225
"54071",1054071,73,96,6,175
"54072",1054072,164,23,3,190
"54073",1054073,199,29,6,234
"54074",1054074,26,170,5,201
"54075",1054075,71,164,0,235
"54076",1054076,247,1,0,248
"54077",1054077,105,170,26,301
"54078",1054078,77,31,4,112
"54079",1054079,131,53,1,185
"54080",1054080,111,128,14,253
"54081",1054081,64,155,16,235
"54082",1054082,152,55,8,215
"54083",1054083,128,82,10,220
"54084",1054084,39,223,0,262
"54085",1054085,139,162,25,326
"54086",1054086,9,64,4,77
"54087",1054087,132,105,2,239
"54088",1054088,67,37,2,106
"54089",1054089,134,82,3,219
"54090",1054090,98,147,22,267
"54091",1054091,159,72,13,244
"54092",1054092,67,95,2,164
"54093",1054093,115,149,8,272
"54094",1054094,60,123,6,189
"54095",1054095,100,91,9,200
"54096",1054096,66,30,1,97
"54097",1054097,16,12,1,29
"54098",1054098,58,187,3,248
"54099",1054099,224,19,2,245
"54100",1054100,25,296,3,324
"54101",1054101,80,25,1,106
"54102",1054102,30,180,3,213
"54103",1054103,7,186,1,194
"54104",1054104,156,28,8,192
"54105",1054105,155,59,5,219
"54106",1054106,96,182,13,291
"54107",1054107,60,237,15,312
"54108",1054108,129,90,3,222
"54109",1054109,223,72,22,317
"54110",1054110,138,50,1,189
"54111",1054111,58,5,2,65
"54112",1054112,152,54,11,217
"54113",1054113,58,111,0,169
"54114",1054114,45,40,5,90
"54115",1054115,99,65,5,169
"54116",1054116,23,12,0,35
"54117",1054117,39,174,1,214
"54118",1054118,48,201,7,256
"54119",1054119,103,56,2,161
"54120",1054120,93,166,10,269
"54121",1054121,22,149,3,174
"54122",1054122,140,70,8,218
"54123",1054123,124,64,7,195
"54124",1054124,103,49,6,158
"54125",1054125,43,242,4,289
"54126",1054126,169,29,12,210
"54127",1054127,67,18,1,86
"54128",1054128,17,137,1,155
"54129",1054129,86,185,13,284
"54130",1054130,126,188,9,323
"54131",1054131,39,228,5,272
"54132",1054132,199,63,8,270
"54133",1054133,91,69,11,171
"54134",1054134,163,27,1,191
"54135",1054135,148,48,6,202
"54136",1054136,27,21,8,56
"54137",1054137,147,22,3,172
"54138",1054138,189,36,10,235
"54139",1054139,215,45,5,265
"54140",1054140,73,134,9,216
"54141",1054141,52,182,5,239
"54142",1054142,173,32,9,214
"54143",1054143,31,14,1,46
"54144",1054144,59,239,12,310
"54145",1054145,24,20,0,44
"54146",1054146,118,1,1,120
"54147",1054147,42,276,7,325
"54148",1054148,238,49,10,297
"54149",1054149,145,44,16,205
"54150",1054150,40,220,1,261
"54151",1054151,204,76,5,285
"54152",1054152,65,138,15,218
"54153",1054153,70,211,11,292
"54154",1054154,152,41,6,199
"54155",1054155,83,45,3,131
"54156",1054156,102,95,3,200
"54157",1054157,181,92,5,278
"54158",1054158,2,4,0,6
"54159",1054159,15,36,0,51
"54160",1054160,193,74,4,271
"54161",1054161,26,343,4,373
"54162",1054162,101,64,10,175
"54163",1054163,54,43,8,105
"54164",1054164,91,12,1,104
"54165",1054165,177,34,6,217
"54166",1054166,203,47,8,258
"54167",1054167,116,185,12,313
"54168",1054168,181,55,7,243
"54169",1054169,182,27,6,215
"54170",1054170,269,36,10,315
"54171",1054171,160,113,27,300
"54172",1054172,89,42,5,136
"54173",1054173,105,97,10,212
"54174",1054174,45,18,0,63
"54175",1054175,50,235,1,286
"54176",1054176,69,75,2,146
"54177",1054177,63,200,3,266
"54178",1054178,155,91,4,250
"54179",1054179,4,2,2,8
"54180",1054180,99,162,31,292
"54181",1054181,77,216,10,303
"54182",1054182,99,214,9,322
"54183",1054183,75,54,0,129
"54184",1054184,144,66,6,216
"54185",1054185,12,29,0,41
"54186",1054186,102,104,14,220
"54187",1054187,78,207,12,297
"54188",1054188,218,52,11,281
"54189",1054189,69,91,6,166
"54190",1054190,151,61,6,218
"54191",1054191,193,116,18,327
"54192",1054192,41,226,3,270
"54193",1054193,54,208,3,265
"54194",1054194,171,62,4,237
"54195",1054195,79,141,11,231
"54196",1054196,108,78,6,192
"54197",1054197,62,54,5,121
"54198",1054198,74,146,7,227
"54199",1054199,130,99,8,237
"54200",1054200,106,149,22,277
"54201",1054201,126,123,23,272
"54202",1054202,96,76,5,177
"54203",1054203,18,227,3,248
"54204",1054204,122,31,6,159
"54205",1054205,32,57,1,90
"54206",1054206,70,126,2,198
"54207",1054207,141,48,11,200
"54208",1054208,166,69,9,244
"54209",1054209,84,236,1,321
"54210",1054210,71,56,3,130
"54211",1054211,5,10,3,18
"54212",1054212,90,70,2,162
"54213",1054213,154,38,6,198
"54214",1054214,146,32,4,182
"54215",1054215,136,100,7,243
"54216",1054216,202,15,6,223
"54217",1054217,222,24,5,251
"54218",1054218,195,94,12,301
"54219",1054219,53,253,8,314
"54220",1054220,69,144,3,216
"54221",1054221,108,204,12,324
"54222",1054222,96,34,7,137
"54223",1054223,102,35,11,148
"54224",1054224,98,68,7,173
"54225",1054225,109,181,3,293
"54226",1054226,192,32,16,240
"54227",1054227,72,165,9,246
"54228",1054228,143,93,7,243
"54229",1054229,125,118,11,254
"54230",1054230,172,104,15,291
"54231",1054231,9,50,0,59
"54232",1054232,133,37,6,176
"54233",1054233,123,157,13,293
"54234",1054234,175,84,8,267
"54235",1054235,44,214,10,268
"54236",1054236,144,75,13,232
"54237",1054237,39,239,6,284
"54238",1054238,65,19,2,86
"54239",1054239,101,135,6,242
"54240",1054240,130,95,13,238
"54241",1054241,105,137,7,249
"54242",1054242,71,121,10,202
"54243",1054243,120,52,4,176
"54244",1054244,155,92,6,253
"54245",1054245,19,157,4,180
"54246",1054246,86,139,12,237
"54247",1054247,14,5,0,19
"54248",1054248,116,50,5,171
"54249",1054249,123,90,3,216
"54250",1054250,52,252,10,314
"54251",1054251,83,78,9,170
"54252",1054252,105,13,5,123
"54253",1054253,108,118,8,234
"54254",1054254,90,159,10,259
"54255",1054255,225,41,12,278
"54256",1054256,138,108,5,251
"54257",1054257,46,156,0,202
"54258",1054258,66,118,6,190
"54259",1054259,160,103,8,271
"54260",1054260,110,90,16,216
"54261",1054261,133,138,5,276
"54262",1054262,193,31,5,229
"54263",1054263,25,158,2,185
"54264",1054264,154,9,1,164
"54265",1054265,87,58,4,149
"54266",1054266,159,141,13,313
"54267",1054267,251,15,5,271
"54268",1054268,20,157,3,180
"54269",1054269,150,113,14,277
"54270",1054270,102,28,4,134
"54271",1054271,145,82,6,233
"54272",1054272,160,38,7,205
"54273",1054273,50,37,4,91
"54274",1054274,116,20,9,145
"54275",1054275,142,78,10,230
"54276",1054276,165,30,15,210
"54277",1054277,143,104,8,255
"54278",1054278,117,58,7,182
"54279",1054279,105,104,0,209
"54280",1054280,13,173,2,188
"54281",1054281,118,20,8,146
"54282",1054282,45,29,3,77
"54283",1054283,190,115,14,319
"54284",1054284,125,95,11,231
"54285",1054285,89,163,12,264
"54286",1054286,189,27,13,229
"54287",1054287,137,34,9,180
"54288",1054288,21,203,3,227
"54289",1054289,179,29,12,220
"54290",1054290,38,116,3,157
"54291",1054291,230,14,5,249
"54292",1054292,143,104,9,256
"54293",1054293,108,43,2,153
"54294",1054294,38,209,7,254
"54295",1054295,130,25,8,163
"54296",1054296,36,201,7,244
"54297",1054297,112,103,16,231
"54298",1054298,164,26,9,199
"54299",1054299,107,145,27,279
"54300",1054300,68,203,9,280
"54301",1054301,300,22,5,327
"54302",1054302,21,12,2,35
"54303",1054303,94,33,3,130
"54304",1054304,10,36,4,50
"54305",1054305,81,202,17,300
"54306",1054306,86,176,10,272
"54307",1054307,66,269,9,344
"54308",1054308,78,62,3,143
"54309",1054309,169,71,8,248
"54310",1054310,117,9,0,126
"54311",1054311,148,72,4,224
"54312",1054312,97,20,3,120
"54313",1054313,67,202,7,276
"54314",1054314,24,218,4,246
"54315",1054315,168,57,8,233
"54316",1054316,214,63,19,296
"54317",1054317,111,216,8,335
"54318",1054318,190,34,15,239
"54319",1054319,124,119,2,245
"54320",1054320,98,54,3,155
"54321",1054321,59,193,12,264
"54322",1054322,144,89,4,237
"54323",1054323,96,96,7,199
"54324",1054324,95,138,3,236
"54325",1054325,129,138,13,280
"54326",1054326,299,9,7,315
"54327",1054327,161,77,7,245
"54328",1054328,177,69,13,259
"54329",1054329,136,16,1,153
"54330",1054330,174,98,7,279
"54331",1054331,178,113,16,307
"54332",1054332,135,23,2,160
"54333",1054333,244,15,6,265
"54334",1054334,93,163,5,261
"54335",1054335,146,42,7,195
"54336",1054336,68,101,8,177
"54337",1054337,107,222,21,350
"54338",1054338,105,9,2,116
"54339",1054339,25,33,2,60
"54340",1054340,43,256,4,303
"54341",1054341,79,112,22,213
"54342",1054342,31,136,6,173
"54343",1054343,113,69,3,185
"54344",1054344,92,180,15,287
"54345",1054345,83,104,14,201
"54346",1054346,147,118,12,277
"54347",1054347,34,148,2,184
"54348",1054348,60,138,13,211
"54349",1054349,92,178,16,286
"54350",1054350,157,28,5,190
"54351",1054351,182,33,3,218
"54352",1054352,105,8,10,123
"54353",1054353,27,198,2,227
"54354",1054354,138,142,22,302
"54355",1054355,129,142,7,278
"54356",1054356,37,233,2,272
"54357",1054357,12,138,2,152
"54358",1054358,90,131,15,236
"54359",1054359,112,8,6,126
"54360",1054360,100,40,6,146
"54361",1054361,126,112,5,243
"54362",1054362,22,207,16,245
"54363",1054363,167,110,6,283
"54364",1054364,154,36,9,199
"54365",1054365,37,199,9,245
"54366",1054366,31,26,2,59
"54367",1054367,36,276,1,313
"54368",1054368,209,106,8,323
"54369",1054369,209,39,11,259
"54370",1054370,150,107,11,268
"54371",1054371,160,72,19,251
"54372",1054372,123,26,1,150
"54373",1054373,130,100,8,238
"54374",1054374,151,57,4,212
"54375",1054375,47,148,1,196
"54376",1054376,66,171,12,249
"54377",1054377,76,146,12,234
"54378",1054378,144,95,6,245
"54379",1054379,112,97,9,218
"54380",1054380,51,22,3,76
"54381",1054381,97,77,8,182
"54382",1054382,10,260,4,274
"54383",1054383,88,138,10,236
"54384",1054384,30,8,3,41
"54385",1054385,64,175,6,245
"54386",1054386,124,5,1,130
"54387",1054387,42,13,8,63
"54388",1054388,81,127,17,225
"54389",1054389,36,17,3,56
"54390",1054390,17,167,1,185
"54391",1054391,92,158,10,260
"54392",1054392,46,206,10,262
"54393",1054393,11,221,5,237
"54394",1054394,56,241,15,312
"54395",1054395,16,4,0,20
"54396",1054396,30,184,7,221
"54397",1054397,97,185,5,287
"54398",1054398,99,45,0,144
"54399",1054399,152,51,8,211
"54400",1054400,142,108,6,256
"54401",1054401,75,122,6,203
"54402",1054402,163,62,8,233
"54403",1054403,203,24,10,237
"54404",1054404,133,61,4,198
"54405",1054405,128,15,3,146
"54406",1054406,81,129,4,214
"54407",1054407,102,13,3,118
"54408",1054408,153,80,9,242
"54409",1054409,160,57,3,220
"54410",1054410,139,22,7,168
"54411",1054411,44,117,1,162
"54412",1054412,54,171,7,232
"54413",1054413,148,2,2,152
"54414",1054414,144,128,19,291
"54415",1054415,159,93,4,256
"54416",1054416,105,190,22,317
"54417",1054417,38,240,11,289
"54418",1054418,200,67,7,274
"54419",1054419,81,214,9,304
"54420",1054420,43,250,8,301
"54421",1054421,117,130,21,268
"54422",1054422,52,92,15,159
"54423",1054423,36,216,4,256
"54424",1054424,153,162,15,330
"54425",1054425,104,149,17,270
"54426",1054426,69,17,4,90
"54427",1054427,98,98,4,200
"54428",1054428,3,1,0,4
"54429",1054429,92,148,14,254
"54430",1054430,156,4,1,161
"54431",1054431,124,118,11,253
"54432",1054432,158,15,6,179
"54433",1054433,187,46,5,238
"54434",1054434,100,25,3,128
"54435",1054435,76,90,16,182
"54436",1054436,119,148,10,277
"54437",1054437,73,191,9,273
"54438",1054438,98,199,16,313
"54439",1054439,120,87,8,215
"54440",1054440,20,50,3,73
"54441",1054441,34,13,4,51
"54442",1054442,179,38,16,233
"54443",1054443,105,156,5,266
"54444",1054444,23,208,4,235
"54445",1054445,81,178,5,264
"54446",1054446,98,198,7,303
"54447",1054447,141,124,20,285
"54448",1054448,85,135,3,223
"54449",1054449,72,192,3,267
"54450",1054450,40,135,3,178
"54451",1054451,71,131,5,207
"54452",1054452,56,130,4,190
"54453",1054453,191,54,8,253
"54454",1054454,241,104,9,354
"54455",1054455,150,6,8,164
"54456",1054456,92,121,13,226
"54457",1054457,143,41,8,192
"54458",1054458,0,94,1,95
"54459",1054459,12,7,1,20
"54460",1054460,177,87,10,274
"54461",1054461,160,82,3,245
"54462",1054462,160,13,0,173
"54463",1054463,66,125,14,205
"54464",1054464,161,126,8,295
"54465",1054465,8,14,3,25
"54466",1054466,200,38,4,242
"54467",1054467,76,75,6,157
"54468",1054468,32,257,2,291
"54469",1054469,117,63,6,186
"54470",1054470,170,18,4,192
"54471",1054471,130,97,5,232
"54472",1054472,197,40,11,248
"54473",1054473,3,3,0,6
"54474",1054474,126,95,12,233
"54475",1054475,47,228,10,285
"54476",1054476,106,96,5,207
"54477",1054477,99,222,17,338
"54478",1054478,56,188,4,248
"54479",1054479,135,91,9,235
"54480",1054480,144,96,3,243
"54481",1054481,150,29,6,185
"54482",1054482,132,35,6,173
"54483",1054483,90,89,4,183
"54484",1054484,221,36,13,270
"54485",1054485,96,67,10,173
"54486",1054486,49,35,5,89
"54487",1054487,167,78,7,252
"54488",1054488,86,164,6,256
"54489",1054489,101,111,14,226
"54490",1054490,77,204,8,289
"54491",1054491,119,47,5,171
"54492",1054492,73,59,2,134
"54493",1054493,111,65,6,182
"54494",1054494,163,10,7,180
"54495",1054495,136,96,10,242
"54496",1054496,64,31,2,97
"54497",1054497,133,57,8,198
"54498",1054498,126,88,5,219
"54499",1054499,45,20,2,67
"54500",1054500,71,216,7,294
"54501",1054501,123,38,5,166
"54502",1054502,156,79,3,238
"54503",1054503,54,192,13,259
"54504",1054504,116,156,20,292
"54505",1054505,128,48,5,181
"54506",1054506,135,144,20,299
"54507",1054507,78,186,15,279
"54508",1054508,178,85,6,269
"54509",1054509,99,168,16,283
"54510",1054510,176,76,5,257
"54511",1054511,25,36,5,66
"54512",1054512,81,17,2,100
"54513",1054513,107,26,1,134
"54514",1054514,80,169,10,259
"54515",1054515,205,69,21,295
"54516",1054516,129,76,6,211
"54517",1054517,135,139,5,279
"54518",1054518,108,92,19,219
"54519",1054519,144,52,4,200
"54520",1054520,94,182,15,291
"54521",1054521,89,170,6,265
"54522",1054522,81,199,5,285
"54523",1054523,143,28,4,175
"54524",1054524,121,82,7,210
"54525",1054525,214,40,13,267
"54526",1054526,50,150,2,202
"54527",1054527,101,62,2,165
"54528",1054528,27,124,3,154
"54529",1054529,92,198,3,293
"54530",1054530,41,136,4,181
"54531",1054531,13,4,0,17
"54532",1054532,174,30,10,214
"54533",1054533,66,227,7,300
"54534",1054534,272,40,8,320
"54535",1054535,159,43,7,209
"54536",1054536,144,44,7,195
"54537",1054537,211,33,18,262
"54538",1054538,85,217,11,313
"54539",1054539,37,232,6,275
"54540",1054540,148,16,5,169
"54541",1054541,81,162,24,267
"54542",1054542,23,9,4,36
"54543",1054543,101,60,12,173
"54544",1054544,109,82,9,200
"54545",1054545,53,89,3,145
"54546",1054546,191,41,11,243
"54547",1054547,167,46,12,225
"54548",1054548,215,19,5,239
"54549",1054549,60,110,25,195
"54550",1054550,39,222,4,265
"54551",1054551,46,270,14,330
"54552",1054552,116,61,1,178
"54553",1054553,43,118,3,164
"54554",1054554,23,143,20,186
"54555",1054555,48,241,20,309
"54556",1054556,271,40,12,323
"54557",1054557,74,242,12,328
"54558",1054558,45,140,11,196
"54559",1054559,115,201,3,319
"54560",1054560,64,25,8,97
"54561",1054561,168,154,13,335
"54562",1054562,44,78,10,132
"54563",1054563,204,17,3,224
"54564",1054564,134,89,15,238
"54565",1054565,104,130,8,242
"54566",1054566,187,51,7,245
"54567",1054567,76,98,8,182
"54568",1054568,6,2,0,8
"54569",1054569,118,62,17,197
"54570",1054570,110,25,9,144
"54571",1054571,14,57,2,73
"54572",1054572,140,76,21,237
"54573",1054573,155,141,8,304
"54574",1054574,160,27,8,195
"54575",1054575,103,201,9,313
"54576",1054576,161,76,13,250
"54577",1054577,80,176,11,267
"54578",1054578,110,184,5,299
"54579",1054579,70,101,1,172
"54580",1054580,20,223,2,245
"54581",1054581,191,76,14,281
"54582",1054582,112,27,6,145
"54583",1054583,42,167,5,214
"54584",1054584,138,176,11,325
"54585",1054585,161,152,10,323
"54586",1054586,97,68,10,175
"54587",1054587,143,70,9,222
"54588",1054588,133,99,5,237
"54589",1054589,120,197,15,332
"54590",1054590,100,160,5,265
"54591",1054591,148,59,11,218
"54592",1054592,66,125,10,201
"54593",1054593,136,32,9,177
"54594",1054594,145,110,5,260
"54595",1054595,60,243,4,307
"54596",1054596,157,36,5,198
"54597",1054597,268,12,3,283
"54598",1054598,56,257,2,315
"54599",1054599,92,87,16,195
"54600",1054600,74,160,3,237
"54601",1054601,136,20,6,162
"54602",1054602,235,53,7,295
"54603",1054603,219,18,5,242
"54604",1054604,82,174,13,269
"54605",1054605,156,121,21,298
"54606",1054606,76,227,11,314
"54607",1054607,146,20,4,170
"54608",1054608,139,44,6,189
"54609",1054609,43,101,6,150
"54610",1054610,18,79,9,106
"54611",1054611,39,263,1,303
"54612",1054612,155,129,7,291
"54613",1054613,86,98,11,195
"54614",1054614,122,98,9,229
"54615",1054615,253,44,4,301
"54616",1054616,20,296,5,321
"54617",1054617,103,200,16,319
"54618",1054618,58,138,9,205
"54619",1054619,68,1,0,69
"54620",1054620,29,215,2,246
"54621",1054621,130,141,17,288
"54622",1054622,139,130,5,274
"54623",1054623,51,283,7,341
"54624",1054624,171,132,12,315
"54625",1054625,53,251,5,309
"54626",1054626,167,106,2,275
"54627",1054627,10,24,0,34
"54628",1054628,210,27,5,242
"54629",1054629,202,21,8,231
"54630",1054630,78,43,6,127
"54631",1054631,48,254,5,307
"54632",1054632,231,32,7,270
"54633",1054633,79,97,20,196
"54634",1054634,136,175,3,314
"54635",1054635,161,78,13,252
"54636",1054636,148,134,9,291
"54637",1054637,141,31,7,179
"54638",1054638,28,68,2,98
"54639",1054639,141,197,7,345
"54640",1054640,134,166,4,304
"54641",1054641,145,45,6,196
"54642",1054642,107,39,12,158
"54643",1054643,149,65,4,218
"54644",1054644,114,92,9,215
"54645",1054645,64,171,6,241
"54646",1054646,47,265,5,317
"54647",1054647,150,134,18,302
"54648",1054648,189,36,4,229
"54649",1054649,10,17,0,27
"54650",1054650,122,88,5,215
"54651",1054651,64,111,5,180
"54652",1054652,100,44,6,150
"54653",1054653,61,87,10,158
"54654",1054654,94,59,7,160
"54655",1054655,124,46,4,174
"54656",1054656,49,189,20,258
"54657",1054657,72,101,7,180
"54658",1054658,149,19,11,179
"54659",1054659,113,38,5,156
"54660",1054660,146,139,13,298
"54661",1054661,161,18,3,182
"54662",1054662,210,106,8,324
"54663",1054663,175,114,13,302
"54664",1054664,63,47,5,115
"54665",1054665,145,134,12,291
"54666",1054666,96,134,5,235
"54667",1054667,164,40,12,216
"54668",1054668,33,257,1,291
"54669",1054669,111,126,24,261
"54670",1054670,97,151,9,257
"54671",1054671,125,60,9,194
"54672",1054672,52,226,6,284
"54673",1054673,138,41,11,190
"54674",1054674,9,4,0,13
"54675",1054675,95,119,24,238
"54676",1054676,47,222,1,270
"54677",1054677,107,12,3,122
"54678",1054678,175,78,9,262
"54679",1054679,158,93,6,257
"54680",1054680,89,165,18,272
"54681",1054681,118,138,6,262
"54682",1054682,102,45,5,152
"54683",1054683,71,109,11,191
"54684",1054684,189,39,3,231
"54685",1054685,132,149,32,313
"54686",1054686,16,211,15,242
"54687",1054687,65,249,5,319
"54688",1054688,185,52,8,245
"54689",1054689,96,46,9,151
"54690",1054690,120,50,13,183
"54691",1054691,81,176,4,261
"54692",1054692,57,153,11,221
"54693",1054693,133,178,15,326
"54694",1054694,96,132,10,238
"54695",1054695,38,218,6,262
"54696",1054696,113,160,16,289
"54697",1054697,77,194,5,276
"54698",1054698,167,100,6,273
"54699",1054699,23,15,1,39
"54700",1054700,79,103,4,186
"54701",1054701,15,287,6,308
"54702",1054702,7,1,1,9
"54703",1054703,130,126,4,260
"54704",1054704,146,113,12,271
"54705",1054705,25,8,0,33
"54706",1054706,195,85,7,287
"54707",1054707,126,77,8,211
"54708",1054708,201,83,10,294
"54709",1054709,30,178,4,212
"54710",1054710,165,47,2,214
"54711",1054711,135,38,9,182
"54712",1054712,132,134,12,278
"54713",1054713,173,99,11,283
"54714",1054714,215,25,4,244
"54715",1054715,22,40,0,62
"54716",1054716,217,60,14,291
"54717",1054717,158,21,3,182
"54718",1054718,175,102,16,293
"54719",1054719,112,127,8,247
"54720",1054720,127,71,16,214
"54721",1054721,69,64,8,141
"54722",1054722,163,121,4,288
"54723",1054723,86,119,17,222
"54724",1054724,121,63,15,199
"54725",1054725,136,107,25,268
"54726",1054726,138,65,8,211
"54727",1054727,178,14,4,196
"54728",1054728,125,44,10,179
"54729",1054729,206,75,9,290
"54730",1054730,164,95,13,272
"54731",1054731,235,62,6,303
"54732",1054732,96,157,4,257
"54733",1054733,63,143,8,214
"54734",1054734,119,32,5,156
"54735",1054735,64,169,7,240
"54736",1054736,222,68,5,295
"54737",1054737,141,44,6,191
"54738",1054738,63,87,10,160
"54739",1054739,101,165,9,275
"54740",1054740,174,38,16,228
"54741",1054741,17,121,4,142
"54742",1054742,157,103,11,271
"54743",1054743,154,55,6,215
"54744",1054744,73,114,13,200
"54745",1054745,77,161,4,242
"54746",1054746,154,71,3,228
"54747",1054747,18,7,1,26
"54748",1054748,25,270,5,300
"54749",1054749,187,43,12,242
"54750",1054750,20,301,0,321
"54751",1054751,146,156,10,312
"54752",1054752,162,93,4,259
"54753",1054753,249,53,8,310
"54754",1054754,127,124,14,265
"54755",1054755,85,38,4,127
"54756",1054756,163,58,6,227
"54757",1054757,19,96,4,119
"54758",1054758,203,71,23,297
"54759",1054759,168,77,6,251
"54760",1054760,37,126,7,170
"54761",1054761,28,23,3,54
"54762",1054762,71,202,19,292
"54763",1054763,112,70,3,185
"54764",1054764,51,200,2,253
"54765",1054765,196,70,6,272
"54766",1054766,187,75,9,271
"54767",1054767,36,196,3,235
"54768",1054768,115,180,16,311
"54769",1054769,130,162,12,304
"54770",1054770,66,126,1,193
"54771",1054771,67,203,5,275
"54772",1054772,128,54,7,189
"54773",1054773,69,117,14,200
"54774",1054774,260,35,7,302
"54775",1054775,211,0,0,211
"54776",1054776,144,93,17,254
"54777",1054777,42,224,8,274
"54778",1054778,188,98,10,296
"54779",1054779,183,42,10,235
"54780",1054780,172,63,9,244
"54781",1054781,78,84,12,174
"54782",1054782,89,110,7,206
"54783",1054783,140,53,2,195
"54784",1054784,99,123,15,237
"54785",1054785,65,122,6,193
"54786",1054786,218,34,24,276
"54787",1054787,60,26,3,89
"54788",1054788,171,60,1,232
"54789",1054789,41,230,3,274
"54790",1054790,107,53,12,172
"54791",1054791,148,79,5,232
"54792",1054792,96,188,9,293
"54793",1054793,44,223,7,274
"54794",1054794,112,160,9,281
"54795",1054795,139,62,8,209
"54796",1054796,18,52,2,72
"54797",1054797,70,26,4,100
"54798",1054798,221,109,8,338
"54799",1054799,87,102,2,191
"54800",1054800,87,96,5,188
"54801",1054801,14,68,1,83
"54802",1054802,64,56,3,123
"54803",1054803,126,90,15,231
"54804",1054804,222,18,10,250
"54805",1054805,182,37,1,220
"54806",1054806,96,118,6,220
"54807",1054807,100,77,1,178
"54808",1054808,125,69,4,198
"54809",1054809,34,145,4,183
"54810",1054810,66,247,4,317
"54811",1054811,98,210,11,319
"54812",1054812,82,107,9,198
"54813",1054813,128,83,7,218
"54814",1054814,155,37,10,202
"54815",1054815,167,117,10,294
"54816",1054816,77,173,6,256
"54817",1054817,71,161,18,250
"54818",1054818,49,212,4,265
"54819",1054819,88,123,2,213
"54820",1054820,165,70,4,239
"54821",1054821,149,36,10,195
"54822",1054822,23,194,4,221
"54823",1054823,248,13,10,271
"54824",1054824,117,58,6,181
"54825",1054825,157,74,3,234
"54826",1054826,169,90,5,264
"54827",1054827,226,76,4,306
"54828",1054828,150,70,10,230
"54829",1054829,37,61,3,101
"54830",1054830,116,55,12,183
"54831",1054831,99,185,11,295
"54832",1054832,33,252,8,293
"54833",1054833,107,80,4,191
"54834",1054834,28,117,4,149
"54835",1054835,179,16,9,204
"54836",1054836,17,100,3,120
"54837",1054837,149,131,2,282
"54838",1054838,102,152,5,259
"54839",1054839,82,95,1,178
"54840",1054840,129,94,9,232
"54841",1054841,28,14,5,47
"54842",1054842,107,11,2,120
"54843",1054843,47,233,4,284
"54844",1054844,141,20,6,167
"54845",1054845,136,23,2,161
"54846",1054846,35,224,3,262
"54847",1054847,140,41,9,190
"54848",1054848,206,40,10,256
"54849",1054849,137,141,16,294
"54850",1054850,108,60,15,183
"54851",1054851,175,68,7,250
"54852",1054852,44,111,13,168
"54853",1054853,125,49,5,179
"54854",1054854,150,27,7,184
"54855",1054855,7,7,0,14
"54856",1054856,90,55,4,149
"54857",1054857,100,85,1,186
"54858",1054858,142,119,12,273
"54859",1054859,124,116,3,243
"54860",1054860,28,15,6,49
"54861",1054861,94,49,5,148
"54862",1054862,37,261,2,300
"54863",1054863,26,68,3,97
"54864",1054864,43,70,7,120
"54865",1054865,117,61,7,185
"54866",1054866,26,51,2,79
"54867",1054867,177,59,12,248
"54868",1054868,47,178,7,232
"54869",1054869,169,40,10,219
"54870",1054870,213,98,14,325
"54871",1054871,75,148,11,234
"54872",1054872,150,103,8,261
"54873",1054873,103,36,10,149
"54874",1054874,105,12,3,120
"54875",1054875,97,105,0,202
"54876",1054876,189,53,5,247
"54877",1054877,127,117,17,261
"54878",1054878,43,200,0,243
"54879",1054879,85,133,17,235
"54880",1054880,83,93,6,182
"54881",1054881,163,92,8,263
"54882",1054882,52,181,3,236
"54883",1054883,46,278,3,327
"54884",1054884,119,32,4,155
"54885",1054885,67,59,0,126
"54886",1054886,60,33,4,97
"54887",1054887,46,59,4,109
"54888",1054888,90,91,17,198
"54889",1054889,169,102,9,280
"54890",1054890,53,195,10,258
"54891",1054891,148,96,13,257
"54892",1054892,159,89,12,260
"54893",1054893,26,50,2,78
"54894",1054894,119,57,8,184
"54895",1054895,208,34,6,248
"54896",1054896,213,39,14,266
"54897",1054897,76,157,30,263
"54898",1054898,120,54,14,188
"54899",1054899,111,63,7,181
"54900",1054900,134,91,11,236
"54901",1054901,72,200,7,279
"54902",1054902,62,164,13,239
"54903",1054903,176,19,3,198
"54904",1054904,137,101,10,248
"54905",1054905,142,7,0,149
"54906",1054906,122,155,22,299
"54907",1054907,29,118,6,153
"54908",1054908,153,38,6,197
"54909",1054909,35,203,3,241
"54910",1054910,18,245,8,271
"54911",1054911,62,192,11,265
"54912",1054912,72,104,9,185
"54913",1054913,26,280,2,308
"54914",1054914,121,70,6,197
"54915",1054915,75,119,6,200
"54916",1054916,84,132,26,242
"54917",1054917,35,116,8,159
"54918",1054918,144,74,4,222
"54919",1054919,97,61,9,167
"54920",1054920,28,229,4,261
"54921",1054921,77,117,7,201
"54922",1054922,137,110,10,257
"54923",1054923,136,61,12,209
"54924",1054924,82,80,4,166
"54925",1054925,159,112,9,280
"54926",1054926,202,87,17,306
"54927",1054927,124,109,2,235
"54928",1054928,84,148,11,243
"54929",1054929,61,244,4,309
"54930",1054930,105,55,13,173
"54931",1054931,42,66,1,109
"54932",1054932,143,82,23,248
"54933",1054933,68,180,11,259
"54934",1054934,214,90,16,320
"54935",1054935,172,37,5,214
"54936",1054936,164,131,9,304
"54937",1054937,68,124,7,199
"54938",1054938,155,32,0,187
"54939",1054939,28,89,2,119
"54940",1054940,154,56,7,217
"54941",1054941,202,55,13,270
"54942",1054942,44,228,7,279
"54943",1054943,231,29,7,267
"54944",1054944,85,150,2,237
"54945",1054945,77,140,0,217
"54946",1054946,137,64,3,204
"54947",1054947,141,66,12,219
"54948",1054948,82,122,12,216
"54949",1054949,87,221,8,316
"54950",1054950,94,134,9,237
"54951",1054951,100,69,6,175
"54952",1054952,87,200,16,303
"54953",1054953,2,9,0,11
"54954",1054954,116,136,21,273
"54955",1054955,79,186,9,274
"54956",1054956,43,82,2,127
"54957",1054957,135,64,8,207
"54958",1054958,161,95,22,278
"54959",1054959,50,27,1,78
"54960",1054960,235,40,3,278
"54961",1054961,92,67,15,174
"54962",1054962,81,6,0,87
"54963",1054963,130,55,7,192
"54964",1054964,64,76,12,152
"54965",1054965,131,97,12,240
"54966",1054966,214,58,12,284
"54967",1054967,30,136,6,172
"54968",1054968,177,62,2,241
"54969",1054969,142,77,10,229
"54970",1054970,90,37,5,132
"54971",1054971,75,170,11,256
"54972",1054972,199,120,4,323
"54973",1054973,233,57,12,302
"54974",1054974,33,233,4,270
"54975",1054975,92,214,11,317
"54976",1054976,35,137,3,175
"54977",1054977,123,91,6,220
"54978",1054978,156,70,7,233
"54979",1054979,88,20,2,110
"54980",1054980,56,174,6,236
"54981",1054981,47,211,11,269
"54982",1054982,143,86,2,231
"54983",1054983,101,105,8,214
"54984",1054984,4,67,2,73
"54985",1054985,133,136,4,273
"54986",1054986,182,106,7,295
"54987",1054987,158,88,11,257
"54988",1054988,131,113,5,249
"54989",1054989,169,24,10,203
"54990",1054990,205,78,23,306
"54991",1054991,166,87,20,273
"54992",1054992,62,179,10,251
"54993",1054993,71,189,11,271
"54994",1054994,48,116,9,173
"54995",1054995,29,9,1,39
"54996",1054996,42,253,5,300
"54997",1054997,138,80,12,230
"54998",1054998,26,232,6,264
"54999",1054999,293,10,12,315
"55000",1055000,84,148,9,241
"55001",1055001,144,123,18,285
"55002",1055002,25,9,3,37
"55003",1055003,110,79,5,194
"55004",1055004,97,51,3,151
"55005",1055005,29,226,8,263
"55006",1055006,9,5,2,16
"55007",1055007,92,172,1,265
"55008",1055008,161,17,2,180
"55009",1055009,73,133,1,207
"55010",1055010,192,102,21,315
"55011",1055011,123,18,9,150
"55012",1055012,57,207,2,266
"55013",1055013,149,98,19,266
"55014",1055014,96,168,9,273
"55015",1055015,206,6,2,214
"55016",1055016,107,122,6,235
"55017",1055017,7,54,0,61
"55018",1055018,54,185,6,245
"55019",1055019,30,50,2,82
"55020",1055020,99,30,6,135
"55021",1055021,136,127,12,275
"55022",1055022,170,105,6,281
"55023",1055023,134,37,5,176
"55024",1055024,126,60,2,188
"55025",1055025,216,33,11,260
"55026",1055026,229,32,7,268
"55027",1055027,84,157,4,245
"55028",1055028,88,154,10,252
"55029",1055029,150,53,2,205
"55030",1055030,188,55,3,246
"55031",1055031,156,97,6,259
"55032",1055032,128,98,6,232
"55033",1055033,55,244,13,312
"55034",1055034,34,239,6,279
"55035",1055035,53,211,8,272
"55036",1055036,85,145,19,249
"55037",1055037,190,39,5,234
"55038",1055038,65,132,3,200
"55039",1055039,117,117,10,244
"55040",1055040,48,138,6,192
"55041",1055041,115,123,23,261
"55042",1055042,185,40,1,226
"55043",1055043,197,16,3,216
"55044",1055044,211,32,13,256
"55045",1055045,90,130,26,246
"55046",1055046,22,224,2,248
"55047",1055047,193,35,6,234
"55048",1055048,66,129,2,197
"55049",1055049,142,143,11,296
"55050",1055050,115,155,19,289
"55051",1055051,142,48,8,198
"55052",1055052,129,82,4,215
"55053",1055053,100,117,10,227
"55054",1055054,107,78,18,203
"55055",1055055,89,140,10,239
"55056",1055056,232,45,9,286
"55057",1055057,127,103,6,236
"55058",1055058,84,52,5,141
"55059",1055059,93,42,6,141
"55060",1055060,101,218,9,328
"55061",1055061,69,194,8,271
"55062",1055062,34,103,2,139
"55063",1055063,207,42,8,257
"55064",1055064,47,104,7,158
"55065",1055065,207,40,9,256
"55066",1055066,147,145,33,325
"55067",1055067,58,143,9,210
"55068",1055068,74,116,3,193
"55069",1055069,6,55,1,62
"55070",1055070,168,82,5,255
"55071",1055071,37,226,4,267
"55072",1055072,21,75,0,96
"55073",1055073,26,226,3,255
"55074",1055074,197,107,9,313
"55075",1055075,71,172,3,246
"55076",1055076,68,23,3,94
"55077",1055077,152,20,9,181
"55078",1055078,265,30,9,304
"55079",1055079,133,87,6,226
"55080",1055080,88,128,16,232
"55081",1055081,190,76,2,268
"55082",1055082,172,85,10,267
"55083",1055083,61,159,9,229
"55084",1055084,117,166,27,310
"55085",1055085,98,68,0,166
"55086",1055086,94,145,16,255
"55087",1055087,87,103,4,194
"55088",1055088,140,92,8,240
"55089",1055089,34,238,6,278
"55090",1055090,32,210,1,243
"55091",1055091,22,190,6,218
"55092",1055092,111,145,7,263
"55093",1055093,89,191,29,309
"55094",1055094,175,85,6,266
"55095",1055095,116,97,12,225
"55096",1055096,21,192,7,220
"55097",1055097,67,185,5,257
"55098",1055098,8,5,0,13
"55099",1055099,110,57,0,167
"55100",1055100,145,71,20,236
"55101",1055101,64,225,9,298
"55102",1055102,110,184,15,309
"55103",1055103,146,48,9,203
"55104",1055104,61,170,1,232
"55105",1055105,54,226,5,285
"55106",1055106,168,60,12,240
"55107",1055107,22,30,1,53
"55108",1055108,94,226,12,332
"55109",1055109,128,33,4,165
"55110",1055110,180,50,4,234
"55111",1055111,42,271,8,321
"55112",1055112,41,214,2,257
"55113",1055113,103,20,7,130
"55114",1055114,200,68,12,280
"55115",1055115,65,44,5,114
"55116",1055116,12,58,1,71
"55117",1055117,102,40,1,143
"55118",1055118,219,82,21,322
"55119",1055119,120,40,2,162
"55120",1055120,144,83,5,232
"55121",1055121,57,37,3,97
"55122",1055122,13,130,7,150
"55123",1055123,81,176,5,262
"55124",1055124,131,65,5,201
"55125",1055125,76,15,6,97
"55126",1055126,187,36,5,228
"55127",1055127,135,106,7,248
"55128",1055128,189,39,5,233
"55129",1055129,171,96,9,276
"55130",1055130,107,128,15,250
"55131",1055131,64,194,11,269
"55132",1055132,71,105,8,184
"55133",1055133,174,129,21,324
"55134",1055134,162,37,3,202
"55135",1055135,62,138,6,206
"55136",1055136,101,161,18,280
"55137",1055137,132,128,20,280
"55138",1055138,53,8,1,62
"55139",1055139,87,111,7,205
"55140",1055140,54,113,7,174
"55141",1055141,39,210,7,256
"55142",1055142,200,66,7,273
"55143",1055143,25,232,6,263
"55144",1055144,114,100,14,228
"55145",1055145,183,62,2,247
"55146",1055146,24,1,1,26
"55147",1055147,89,241,2,332
"55148",1055148,136,80,0,216
"55149",1055149,101,171,7,279
"55150",1055150,42,130,7,179
"55151",1055151,82,233,6,321
"55152",1055152,109,18,4,131
"55153",1055153,190,102,9,301
"55154",1055154,65,54,2,121
"55155",1055155,53,217,12,282
"55156",1055156,140,55,10,205
"55157",1055157,131,42,4,177
"55158",1055158,88,151,6,245
"55159",1055159,123,71,13,207
"55160",1055160,19,12,3,34
"55161",1055161,202,13,11,226
"55162",1055162,85,205,9,299
"55163",1055163,139,48,5,192
"55164",1055164,91,157,6,254
"55165",1055165,87,41,6,134
"55166",1055166,140,95,7,242
"55167",1055167,181,61,9,251
"55168",1055168,169,36,3,208
"55169",1055169,12,11,2,25
"55170",1055170,119,22,4,145
"55171",1055171,123,87,6,216
"55172",1055172,105,45,4,154
"55173",1055173,151,61,13,225
"55174",1055174,144,74,5,223
"55175",1055175,231,22,7,260
"55176",1055176,120,62,3,185
"55177",1055177,63,136,6,205
"55178",1055178,240,16,5,261
"55179",1055179,111,30,13,154
"55180",1055180,124,52,6,182
"55181",1055181,63,20,2,85
"55182",1055182,207,52,7,266
"55183",1055183,159,89,10,258
"55184",1055184,147,50,9,206
"55185",1055185,80,85,7,172
"55186",1055186,101,140,4,245
"55187",1055187,93,76,3,172
"55188",1055188,28,159,3,190
"55189",1055189,74,335,0,409
"55190",1055190,49,74,2,125
"55191",1055191,257,219,21,497
"55192",1055192,162,95,12,269
"55193",1055193,144,118,7,269
"55194",1055194,63,153,6,222
"55195",1055195,63,187,11,261
"55196",1055196,79,241,12,332
"55197",1055197,125,51,14,190
"55198",1055198,144,174,11,329
"55199",1055199,54,86,7,147
"55200",1055200,136,116,2,254
"55201",1055201,81,183,16,280
"55202",1055202,79,207,11,297
"55203",1055203,214,96,14,324
"55204",1055204,76,133,3,212
"55205",1055205,151,21,6,178
"55206",1055206,34,116,8,158
"55207",1055207,102,148,8,258
"55208",1055208,224,29,9,262
"55209",1055209,49,148,8,205
"55210",1055210,122,79,10,211
"55211",1055211,121,127,13,261
"55212",1055212,19,226,8,253
"55213",1055213,40,177,1,218
"55214",1055214,99,8,4,111
"55215",1055215,34,251,5,290
"55216",1055216,151,41,2,194
"55217",1055217,45,242,5,292
"55218",1055218,173,49,9,231
"55219",1055219,62,165,13,240
"55220",1055220,159,55,4,218
"55221",1055221,121,112,6,239
"55222",1055222,65,242,3,310
"55223",1055223,138,72,5,215
"55224",1055224,52,167,6,225
"55225",1055225,159,81,13,253
"55226",1055226,163,103,17,283
"55227",1055227,138,88,2,228
"55228",1055228,52,9,3,64
"55229",1055229,156,21,7,184
"55230",1055230,132,91,13,236
"55231",1055231,260,19,5,284
"55232",1055232,66,90,16,172
"55233",1055233,181,29,6,216
"55234",1055234,95,150,18,263
"55235",1055235,114,167,13,294
"55236",1055236,166,108,12,286
"55237",1055237,7,43,0,50
"55238",1055238,174,34,6,214
"55239",1055239,137,109,15,261
"55240",1055240,101,31,7,139
"55241",1055241,77,2,0,79
"55242",1055242,26,238,9,273
"55243",1055243,78,192,7,277
"55244",1055244,105,67,4,176
"55245",1055245,101,87,19,207
"55246",1055246,50,201,7,258
"55247",1055247,8,336,3,347
"55248",1055248,78,190,7,275
"55249",1055249,64,111,8,183
"55250",1055250,157,85,10,252
"55251",1055251,113,91,13,217
"55252",1055252,73,135,5,213
"55253",1055253,27,47,3,77
"55254",1055254,13,213,4,230
"55255",1055255,165,34,10,209
"55256",1055256,106,53,4,163
"55257",1055257,187,18,4,209
"55258",1055258,207,85,15,307
"55259",1055259,26,62,0,88
"55260",1055260,74,163,22,259
"55261",1055261,118,24,5,147
"55262",1055262,233,41,13,287
"55263",1055263,37,278,3,318
"55264",1055264,212,16,8,236
"55265",1055265,331,119,29,479
"55266",1055266,148,12,5,165
"55267",1055267,247,13,5,265
"55268",1055268,170,109,17,296
"55269",1055269,138,47,3,188
"55270",1055270,151,48,3,202
"55271",1055271,176,76,6,258
"55272",1055272,62,194,13,269
"55273",1055273,141,169,5,315
"55274",1055274,143,157,20,320
"55275",1055275,130,116,9,255
"55276",1055276,172,8,5,185
"55277",1055277,193,67,1,261
"55278",1055278,97,63,8,168
"55279",1055279,58,54,0,112
"55280",1055280,17,12,0,29
"55281",1055281,76,15,2,93
"55282",1055282,109,36,3,148
"55283",1055283,26,33,2,61
"55284",1055284,54,259,17,330
"55285",1055285,149,54,5,208
"55286",1055286,178,111,2,291
"55287",1055287,129,15,1,145
"55288",1055288,87,160,15,262
"55289",1055289,75,169,8,252
"55290",1055290,190,35,8,233
"55291",1055291,68,106,2,176
"55292",1055292,78,214,4,296
"55293",1055293,140,48,3,191
"55294",1055294,14,213,4,231
"55295",1055295,17,199,3,219
"55296",1055296,73,144,1,218
"55297",1055297,75,52,1,128
"55298",1055298,76,83,2,161
"55299",1055299,104,30,9,143
"55300",1055300,60,9,7,76
"55301",1055301,62,202,12,276
"55302",1055302,25,118,4,147
"55303",1055303,128,54,1,183
"55304",1055304,147,75,26,248
"55305",1055305,17,12,2,31
"55306",1055306,147,69,7,223
"55307",1055307,179,23,6,208
"55308",1055308,84,177,5,266
"55309",1055309,51,20,2,73
"55310",1055310,170,122,5,297
"55311",1055311,151,66,5,222
"55312",1055312,52,132,3,187
"55313",1055313,176,129,22,327
"55314",1055314,94,184,9,287
"55315",1055315,81,174,18,273
"55316",1055316,136,144,2,282
"55317",1055317,153,109,6,268
"55318",1055318,154,66,7,227
"55319",1055319,152,121,18,291
"55320",1055320,122,136,13,271
"55321",1055321,198,32,13,243
"55322",1055322,194,37,10,241
"55323",1055323,64,225,16,305
"55324",1055324,68,239,9,316
"55325",1055325,58,80,7,145
"55326",1055326,103,100,6,209
"55327",1055327,191,15,11,217
"55328",1055328,42,98,6,146
"55329",1055329,179,65,6,250
"55330",1055330,137,46,7,190
"55331",1055331,112,155,10,277
"55332",1055332,65,117,20,202
"55333",1055333,77,31,9,117
"55334",1055334,181,40,8,229
"55335",1055335,171,80,1,252
"55336",1055336,69,83,11,163
"55337",1055337,125,41,3,169
"55338",1055338,18,34,0,52
"55339",1055339,80,65,1,146
"55340",1055340,130,100,2,232
"55341",1055341,124,98,7,229
"55342",1055342,191,70,4,265
"55343",1055343,124,191,12,327
"55344",1055344,84,211,9,304
"55345",1055345,143,5,3,151
"55346",1055346,39,25,3,67
"55347",1055347,167,39,5,211
"55348",1055348,92,119,6,217
"55349",1055349,34,132,3,169
"55350",1055350,103,180,4,287
"55351",1055351,90,203,11,304
"55352",1055352,45,52,2,99
"55353",1055353,180,34,8,222
"55354",1055354,196,36,12,244
"55355",1055355,25,330,2,357
"55356",1055356,30,103,7,140
"55357",1055357,6,0,0,6
"55358",1055358,140,124,7,271
"55359",1055359,81,42,8,131
"55360",1055360,52,240,16,308
"55361",1055361,90,131,10,231
"55362",1055362,64,56,3,123
"55363",1055363,143,117,10,270
"55364",1055364,66,220,21,307
"55365",1055365,55,193,5,253
"55366",1055366,137,113,6,256
"55367",1055367,76,220,7,303
"55368",1055368,80,67,16,163
"55369",1055369,209,64,5,278
"55370",1055370,200,44,9,253
"55371",1055371,129,121,6,256
"55372",1055372,133,105,11,249
"55373",1055373,82,95,16,193
"55374",1055374,185,24,8,217
"55375",1055375,62,107,2,171
"55376",1055376,148,92,7,247
"55377",1055377,139,63,5,207
"55378",1055378,66,146,10,222
"55379",1055379,123,108,13,244
"55380",1055380,163,29,1,193
"55381",1055381,26,151,2,179
"55382",1055382,237,36,10,283
"55383",1055383,118,120,10,248
"55384",1055384,203,77,10,290
"55385",1055385,185,93,12,290
"55386",1055386,134,23,12,169
"55387",1055387,79,141,1,221
"55388",1055388,193,70,2,265
"55389",1055389,60,233,12,305
"55390",1055390,177,54,4,235
"55391",1055391,29,26,3,58
"55392",1055392,2,13,1,16
"55393",1055393,120,70,5,195
"55394",1055394,43,72,1,116
"55395",1055395,188,89,16,293
"55396",1055396,135,52,7,194
"55397",1055397,68,146,1,215
"55398",1055398,135,152,29,316
"55399",1055399,6,9,0,15
"55400",1055400,127,23,0,150
"55401",1055401,15,4,0,19
"55402",1055402,215,65,6,286
"55403",1055403,90,36,3,129
"55404",1055404,225,17,9,251
"55405",1055405,222,13,6,241
"55406",1055406,35,132,2,169
"55407",1055407,177,25,3,205
"55408",1055408,122,103,16,241
"55409",1055409,92,181,6,279
"55410",1055410,76,68,5,149
"55411",1055411,15,258,2,275
"55412",1055412,17,6,1,24
"55413",1055413,204,19,18,241
"55414",1055414,52,164,10,226
"55415",1055415,164,75,16,255
"55416",1055416,62,165,18,245
"55417",1055417,107,93,10,210
"55418",1055418,206,67,9,282
"55419",1055419,164,40,5,209
"55420",1055420,141,43,7,191
"55421",1055421,95,88,5,188
"55422",1055422,124,149,6,279
"55423",1055423,87,189,2,278
"55424",1055424,141,100,11,252
"55425",1055425,203,67,4,274
"55426",1055426,158,51,8,217
"55427",1055427,20,199,3,222
"55428",1055428,99,144,6,249
"55429",1055429,30,214,8,252
"55430",1055430,159,66,7,232
"55431",1055431,47,87,5,139
"55432",1055432,21,134,4,159
"55433",1055433,163,40,10,213
"55434",1055434,48,161,4,213
"55435",1055435,14,8,0,22
"55436",1055436,19,3,5,27
"55437",1055437,122,99,4,225
"55438",1055438,5,21,0,26
"55439",1055439,38,1,2,41
"55440",1055440,71,53,8,132
"55441",1055441,37,232,2,271
"55442",1055442,160,110,17,287
"55443",1055443,176,129,15,320
"55444",1055444,50,8,0,58
"55445",1055445,111,69,4,184
"55446",1055446,150,79,3,232
"55447",1055447,36,198,4,238
"55448",1055448,112,162,11,285
"55449",1055449,31,17,1,49
"55450",1055450,190,88,6,284
"55451",1055451,200,86,16,302
"55452",1055452,289,11,2,302
"55453",1055453,56,198,8,262
"55454",1055454,219,48,22,289
"55455",1055455,110,210,10,330
"55456",1055456,54,123,10,187
"55457",1055457,105,118,0,223
"55458",1055458,177,33,5,215
"55459",1055459,179,117,15,311
"55460",1055460,153,101,11,265
"55461",1055461,121,72,13,206
"55462",1055462,109,119,14,242
"55463",1055463,156,55,9,220
"55464",1055464,75,152,1,228
"55465",1055465,75,195,7,277
"55466",1055466,31,170,10,211
"55467",1055467,212,31,5,248
"55468",1055468,31,239,3,273
"55469",1055469,162,32,3,197
"55470",1055470,175,86,5,266
"55471",1055471,55,117,1,173
"55472",1055472,75,96,6,177
"55473",1055473,96,225,5,326
"55474",1055474,44,122,5,171
"55475",1055475,83,83,4,170
"55476",1055476,136,107,23,266
"55477",1055477,136,62,9,207
"55478",1055478,31,177,7,215
"55479",1055479,141,145,16,302
"55480",1055480,231,87,15,333
"55481",1055481,150,160,10,320
"55482",1055482,151,146,3,300
"55483",1055483,222,57,17,296
"55484",1055484,64,181,11,256
"55485",1055485,56,83,2,141
"55486",1055486,143,142,11,296
"55487",1055487,176,93,7,276
"55488",1055488,159,75,8,242
"55489",1055489,72,164,14,250
"55490",1055490,74,156,14,244
"55491",1055491,69,187,7,263
"55492",1055492,174,77,9,260
"55493",1055493,82,125,6,213
"55494",1055494,31,224,4,259
"55495",1055495,98,33,2,133
"55496",1055496,73,194,5,272
"55497",1055497,108,77,11,196
"55498",1055498,76,106,5,187
"55499",1055499,102,70,6,178
"55500",1055500,86,230,20,336
"55501",1055501,28,28,3,59
"55502",1055502,86,107,6,199
"55503",1055503,157,75,8,240
"55504",1055504,95,36,0,131
"55505",1055505,212,20,5,237
"55506",1055506,49,7,1,57
"55507",1055507,83,74,1,158
"55508",1055508,199,16,3,218
"55509",1055509,61,96,5,162
"55510",1055510,111,162,13,286
"55511",1055511,109,230,13,352
"55512",1055512,128,140,5,273
"55513",1055513,74,113,7,194
"55514",1055514,120,67,7,194
"55515",1055515,63,209,17,289
"55516",1055516,53,205,6,264
"55517",1055517,3,0,0,3
"55518",1055518,163,9,5,177
"55519",1055519,113,151,12,276
"55520",1055520,41,37,5,83
"55521",1055521,63,149,9,221
"55522",1055522,32,14,2,48
"55523",1055523,95,54,2,151
"55524",1055524,116,194,27,337
"55525",1055525,136,112,10,258
"55526",1055526,89,14,4,107
"55527",1055527,194,86,9,289
"55528",1055528,31,28,2,61
"55529",1055529,71,115,13,199
"55530",1055530,100,153,9,262
"55531",1055531,61,180,3,244
"55532",1055532,14,2,2,18
"55533",1055533,113,17,5,135
"55534",1055534,131,21,4,156
"55535",1055535,124,72,2,198
"55536",1055536,122,36,5,163
"55537",1055537,170,77,5,252
"55538",1055538,63,96,5,164
"55539",1055539,95,180,6,281
"55540",1055540,136,95,4,235
"55541",1055541,81,59,15,155
"55542",1055542,152,123,13,288
"55543",1055543,122,145,6,273
"55544",1055544,145,89,10,244
"55545",1055545,112,141,9,262
"55546",1055546,152,113,3,268
"55547",1055547,111,111,10,232
"55548",1055548,84,32,1,117
"55549",1055549,219,8,8,235
"55550",1055550,131,34,3,168
"55551",1055551,198,102,8,308
"55552",1055552,68,187,10,265
"55553",1055553,159,162,5,326
"55554",1055554,126,22,5,153
"55555",1055555,264,19,6,289
"55556",1055556,205,63,20,288
"55557",1055557,125,200,7,332
"55558",1055558,161,7,6,174
"55559",1055559,34,185,4,223
"55560",1055560,162,88,7,257
"55561",1055561,104,41,5,150
"55562",1055562,113,115,7,235
"55563",1055563,87,143,2,232
"55564",1055564,77,182,7,266
"55565",1055565,90,221,10,321
"55566",1055566,127,146,3,276
"55567",1055567,124,36,3,163
"55568",1055568,67,164,10,241
"55569",1055569,109,48,5,162
"55570",1055570,69,196,13,278
"55571",1055571,208,52,5,265
"55572",1055572,138,61,6,205
"55573",1055573,138,65,7,210
"55574",1055574,49,46,4,99
"55575",1055575,154,79,3,236
"55576",1055576,215,43,8,266
"55577",1055577,140,53,7,200
"55578",1055578,37,83,4,124
"55579",1055579,95,100,5,200
"55580",1055580,129,51,4,184
"55581",1055581,49,104,2,155
"55582",1055582,196,38,8,242
"55583",1055583,274,17,12,303
"55584",1055584,59,68,0,127
"55585",1055585,20,15,1,36
"55586",1055586,180,49,15,244
"55587",1055587,223,45,5,273
"55588",1055588,12,36,2,50
"55589",1055589,46,137,9,192
"55590",1055590,114,209,3,326
"55591",1055591,47,249,6,302
"55592",1055592,143,61,21,225
"55593",1055593,204,72,9,285
"55594",1055594,208,33,5,246
"55595",1055595,37,51,1,89
"55596",1055596,49,0,0,49
"55597",1055597,33,269,3,305
"55598",1055598,46,269,6,321
"55599",1055599,143,50,3,196
"55600",1055600,169,80,3,252
"55601",1055601,62,59,7,128
"55602",1055602,107,55,10,172
"55603",1055603,64,143,6,213
"55604",1055604,211,43,11,265
"55605",1055605,35,13,1,49
"55606",1055606,64,259,13,336
"55607",1055607,136,65,6,207
"55608",1055608,245,45,10,300
"55609",1055609,145,68,7,220
"55610",1055610,157,105,11,273
"55611",1055611,60,106,8,174
"55612",1055612,107,148,15,270
"55613",1055613,37,175,2,214
"55614",1055614,145,22,6,173
"55615",1055615,57,199,20,276
"55616",1055616,98,115,5,218
"55617",1055617,286,19,3,308
"55618",1055618,155,68,5,228
"55619",1055619,148,4,3,155
"55620",1055620,63,204,22,289
"55621",1055621,165,56,2,223
"55622",1055622,64,156,11,231
"55623",1055623,82,157,6,245
"55624",1055624,82,22,4,108
"55625",1055625,10,8,2,20
"55626",1055626,52,49,2,103
"55627",1055627,89,141,5,235
"55628",1055628,76,91,9,176
"55629",1055629,29,89,6,124
"55630",1055630,64,179,5,248
"55631",1055631,101,122,5,228
"55632",1055632,44,189,6,239
"55633",1055633,180,111,14,305
"55634",1055634,49,215,5,269
"55635",1055635,152,113,19,284
"55636",1055636,164,99,2,265
"55637",1055637,120,157,17,294
"55638",1055638,149,61,22,232
"55639",1055639,135,24,2,161
"55640",1055640,173,30,11,214
"55641",1055641,24,215,3,242
"55642",1055642,84,69,13,166
"55643",1055643,128,104,12,244
"55644",1055644,73,143,6,222
"55645",1055645,150,118,18,286
"55646",1055646,16,19,1,36
"55647",1055647,92,135,5,232
"55648",1055648,58,40,4,102
"55649",1055649,43,241,6,290
"55650",1055650,23,62,3,88
"55651",1055651,147,118,2,267
"55652",1055652,71,215,15,301
"55653",1055653,80,125,9,214
"55654",1055654,53,42,3,98
"55655",1055655,128,131,6,265
"55656",1055656,203,9,2,214
"55657",1055657,237,72,4,313
"55658",1055658,164,24,3,191
"55659",1055659,107,203,4,314
"55660",1055660,104,196,11,311
"55661",1055661,36,158,3,197
"55662",1055662,227,45,12,284
"55663",1055663,38,254,8,300
"55664",1055664,192,12,8,212
"55665",1055665,104,163,7,274
"55666",1055666,101,132,10,243
"55667",1055667,125,42,3,170
"55668",1055668,52,133,5,190
"55669",1055669,213,15,7,235
"55670",1055670,195,63,14,272
"55671",1055671,186,43,8,237
"55672",1055672,116,147,26,289
"55673",1055673,185,113,7,305
"55674",1055674,68,228,9,305
"55675",1055675,93,149,21,263
"55676",1055676,17,67,1,85
"55677",1055677,156,87,10,253
"55678",1055678,78,37,6,121
"55679",1055679,104,181,4,289
"55680",1055680,68,99,10,177
"55681",1055681,45,54,4,103
"55682",1055682,177,50,10,237
"55683",1055683,41,16,6,63
"55684",1055684,90,146,7,243
"55685",1055685,39,184,11,234
"55686",1055686,104,27,1,132
"55687",1055687,154,27,10,191
"55688",1055688,112,175,4,291
"55689",1055689,10,157,4,171
"55690",1055690,45,69,7,121
"55691",1055691,136,102,7,245
"55692",1055692,147,25,1,173
"55693",1055693,23,254,3,280
"55694",1055694,8,9,2,19
"55695",1055695,47,20,3,70
"55696",1055696,40,183,5,228
"55697",1055697,126,67,5,198
"55698",1055698,110,128,8,246
"55699",1055699,199,23,9,231
"55700",1055700,105,151,13,269
"55701",1055701,149,49,3,201
"55702",1055702,151,83,7,241
"55703",1055703,42,172,8,222
"55704",1055704,160,64,7,231
"55705",1055705,99,57,3,159
"55706",1055706,109,65,7,181
"55707",1055707,141,81,14,236
"55708",1055708,38,234,20,292
"55709",1055709,129,82,6,217
"55710",1055710,138,73,3,214
"55711",1055711,189,30,6,225
"55712",1055712,75,183,19,277
"55713",1055713,42,86,4,132
"55714",1055714,319,6,8,333
"55715",1055715,122,98,5,225
"55716",1055716,66,49,2,117
"55717",1055717,114,52,10,176
"55718",1055718,40,156,6,202
"55719",1055719,185,105,4,294
"55720",1055720,128,129,10,267
"55721",1055721,73,63,4,140
"55722",1055722,98,181,4,283
"55723",1055723,91,181,7,279
"55724",1055724,165,52,6,223
"55725",1055725,272,57,17,346
"55726",1055726,50,64,6,120
"55727",1055727,96,179,9,284
"55728",1055728,192,28,0,220
"55729",1055729,148,101,1,250
"55730",1055730,134,96,7,237
"55731",1055731,56,232,11,299
"55732",1055732,148,121,13,282
"55733",1055733,44,46,7,97
"55734",1055734,103,91,7,201
"55735",1055735,13,40,3,56
"55736",1055736,70,201,8,279
"55737",1055737,147,85,10,242
"55738",1055738,111,164,13,288
"55739",1055739,60,226,7,293
"55740",1055740,182,32,12,226
"55741",1055741,189,114,8,311
"55742",1055742,143,133,11,287
"55743",1055743,262,56,13,331
"55744",1055744,31,18,2,51
"55745",1055745,111,35,3,149
"55746",1055746,140,86,13,239
"55747",1055747,17,212,11,240
"55748",1055748,92,160,7,259
"55749",1055749,114,29,4,147
"55750",1055750,20,84,1,105
"55751",1055751,34,263,5,302
"55752",1055752,55,233,6,294
"55753",1055753,184,0,1,185
"55754",1055754,218,18,5,241
"55755",1055755,45,156,6,207
"55756",1055756,12,112,3,127
"55757",1055757,42,233,8,283
"55758",1055758,93,132,5,230
"55759",1055759,58,136,6,200
"55760",1055760,60,215,3,278
"55761",1055761,67,137,4,208
"55762",1055762,211,72,7,290
"55763",1055763,131,56,9,196
"55764",1055764,58,55,5,118
"55765",1055765,93,161,6,260
"55766",1055766,36,230,8,274
"55767",1055767,44,181,4,229
"55768",1055768,196,126,9,331
"55769",1055769,84,102,7,193
"55770",1055770,74,112,46,232
"55771",1055771,39,215,1,255
"55772",1055772,149,30,9,188
"55773",1055773,38,162,4,204
"55774",1055774,212,52,19,283
"55775",1055775,47,63,7,117
"55776",1055776,101,216,3,320
"55777",1055777,62,206,5,273
"55778",1055778,44,186,2,232
"55779",1055779,111,90,2,203
"55780",1055780,88,148,20,256
"55781",1055781,1,4,1,6
"55782",1055782,198,72,8,278
"55783",1055783,158,36,7,201
"55784",1055784,104,138,6,248
"55785",1055785,136,131,18,285
"55786",1055786,39,53,3,95
"55787",1055787,42,213,5,260
"55788",1055788,94,113,20,227
"55789",1055789,160,85,3,248
"55790",1055790,71,46,10,127
"55791",1055791,79,189,7,275
"55792",1055792,233,10,5,248
"55793",1055793,79,81,9,169
"55794",1055794,148,45,4,197
"55795",1055795,124,70,15,209
"55796",1055796,117,38,7,162
"55797",1055797,141,94,20,255
"55798",1055798,25,221,5,251
"55799",1055799,82,63,5,150
"55800",1055800,75,85,11,171
"55801",1055801,178,51,10,239
"55802",1055802,54,175,7,236
"55803",1055803,129,162,5,296
"55804",1055804,33,223,3,259
"55805",1055805,232,66,13,311
"55806",1055806,11,24,1,36
"55807",1055807,33,165,5,203
"55808",1055808,139,84,5,228
"55809",1055809,82,15,4,101
"55810",1055810,151,67,5,223
"55811",1055811,7,87,8,102
"55812",1055812,8,32,3,43
"55813",1055813,141,37,11,189
"55814",1055814,155,59,10,224
"55815",1055815,55,218,4,277
"55816",1055816,61,187,7,255
"55817",1055817,194,14,10,218
"55818",1055818,63,180,3,246
"55819",1055819,131,142,9,282
"55820",1055820,34,135,7,176
"55821",1055821,122,55,6,183
"55822",1055822,115,131,11,257
"55823",1055823,16,21,1,38
"55824",1055824,23,133,5,161
"55825",1055825,198,20,8,226
"55826",1055826,284,10,9,303
"55827",1055827,125,129,4,258
"55828",1055828,76,94,11,181
"55829",1055829,30,237,11,278
"55830",1055830,137,38,3,178
"55831",1055831,48,29,1,78
"55832",1055832,36,14,4,54
"55833",1055833,27,201,1,229
"55834",1055834,147,69,19,235
"55835",1055835,102,2,2,106
"55836",1055836,92,132,11,235
"55837",1055837,92,177,9,278
"55838",1055838,140,40,14,194
"55839",1055839,83,67,3,153
"55840",1055840,85,104,5,194
"55841",1055841,74,188,8,270
"55842",1055842,110,139,10,259
"55843",1055843,110,100,1,211
"55844",1055844,53,111,7,171
"55845",1055845,35,133,10,178
"55846",1055846,148,86,10,244
"55847",1055847,67,143,11,221
"55848",1055848,72,31,8,111
"55849",1055849,62,85,6,153
"55850",1055850,2,0,0,2
"55851",1055851,124,21,7,152
"55852",1055852,61,137,9,207
"55853",1055853,49,96,2,147
"55854",1055854,21,9,1,31
"55855",1055855,65,189,20,274
"55856",1055856,186,54,4,244
"55857",1055857,170,92,13,275
"55858",1055858,181,34,9,224
"55859",1055859,17,10,1,28
"55860",1055860,13,127,4,144
"55861",1055861,133,43,2,178
"55862",1055862,27,275,10,312
"55863",1055863,34,197,5,236
"55864",1055864,44,68,2,114
"55865",1055865,98,151,19,268
"55866",1055866,143,29,6,178
"55867",1055867,137,98,19,254
"55868",1055868,212,24,2,238
"55869",1055869,38,211,5,254
"55870",1055870,67,165,0,232
"55871",1055871,7,4,0,11
"55872",1055872,181,72,11,264
"55873",1055873,124,103,12,239
"55874",1055874,155,141,7,303
"55875",1055875,134,67,5,206
"55876",1055876,140,156,10,306
"55877",1055877,173,56,3,232
"55878",1055878,23,13,0,36
"55879",1055879,6,44,2,52
"55880",1055880,33,63,0,96
"55881",1055881,173,113,9,295
"55882",1055882,136,77,7,220
"55883",1055883,43,92,8,143
"55884",1055884,280,9,11,300
"55885",1055885,50,14,3,67
"55886",1055886,32,8,1,41
"55887",1055887,102,124,11,237
"55888",1055888,100,25,8,133
"55889",1055889,122,146,11,279
"55890",1055890,53,225,12,290
"55891",1055891,66,66,6,138
"55892",1055892,138,51,4,193
"55893",1055893,15,21,1,37
"55894",1055894,120,93,13,226
"55895",1055895,223,10,3,236
"55896",1055896,74,84,6,164
"55897",1055897,62,77,6,145
"55898",1055898,132,97,8,237
"55899",1055899,74,138,6,218
"55900",1055900,99,139,5,243
"55901",1055901,160,112,17,289
"55902",1055902,145,84,4,233
"55903",1055903,166,56,10,232
"55904",1055904,142,102,14,258
"55905",1055905,227,71,14,312
"55906",1055906,40,231,7,278
"55907",1055907,113,168,15,296
"55908",1055908,53,34,2,89
"55909",1055909,64,228,3,295
"55910",1055910,83,17,1,101
"55911",1055911,178,49,4,231
"55912",1055912,149,103,17,269
"55913",1055913,171,84,15,270
"55914",1055914,34,35,4,73
"55915",1055915,85,95,9,189
"55916",1055916,84,75,5,164
"55917",1055917,163,45,6,214
"55918",1055918,93,113,2,208
"55919",1055919,144,54,16,214
"55920",1055920,223,62,4,289
"55921",1055921,67,224,8,299
"55922",1055922,25,26,0,51
"55923",1055923,168,75,11,254
"55924",1055924,114,154,12,280
"55925",1055925,39,104,4,147
"55926",1055926,141,70,17,228
"55927",1055927,122,67,6,195
"55928",1055928,208,35,7,250
"55929",1055929,88,188,5,281
"55930",1055930,213,66,16,295
"55931",1055931,97,146,10,253
"55932",1055932,93,121,15,229
"55933",1055933,107,134,9,250
"55934",1055934,104,147,4,255
"55935",1055935,54,113,5,172
"55936",1055936,65,82,7,154
"55937",1055937,181,75,4,260
"55938",1055938,129,162,40,331
"55939",1055939,139,92,13,244
"55940",1055940,152,108,11,271
"55941",1055941,155,53,11,219
"55942",1055942,100,202,13,315
"55943",1055943,42,159,2,203
"55944",1055944,63,11,3,77
"55945",1055945,34,111,7,152
"55946",1055946,200,71,16,287
"55947",1055947,167,135,15,317
"55948",1055948,96,48,6,150
"55949",1055949,176,47,8,231
"55950",1055950,185,80,0,265
"55951",1055951,136,81,6,223
"55952",1055952,154,163,14,331
"55953",1055953,191,21,8,220
"55954",1055954,17,129,4,150
"55955",1055955,115,63,10,188
"55956",1055956,251,47,6,304
"55957",1055957,107,12,1,120
"55958",1055958,43,151,4,198
"55959",1055959,63,117,4,184
"55960",1055960,32,254,4,290
"55961",1055961,67,197,11,275
"55962",1055962,76,197,17,290
"55963",1055963,80,90,1,171
"55964",1055964,96,192,9,297
"55965",1055965,76,33,6,115
"55966",1055966,204,61,12,277
"55967",1055967,170,65,12,247
"55968",1055968,33,204,4,241
"55969",1055969,53,136,16,205
"55970",1055970,106,80,8,194
"55971",1055971,50,188,0,238
"55972",1055972,89,120,15,224
"55973",1055973,65,176,14,255
"55974",1055974,70,121,6,197
"55975",1055975,119,55,10,184
"55976",1055976,290,36,3,329
"55977",1055977,142,47,6,195
"55978",1055978,152,64,11,227
"55979",1055979,137,0,0,137
"55980",1055980,132,114,11,257
"55981",1055981,32,84,4,120
"55982",1055982,87,204,8,299
"55983",1055983,148,54,2,204
"55984",1055984,26,11,0,37
"55985",1055985,137,7,2,146
"55986",1055986,242,46,15,303
"55987",1055987,90,40,15,145
"55988",1055988,120,184,18,322
"55989",1055989,24,308,6,338
"55990",1055990,62,177,9,248
"55991",1055991,209,24,8,241
"55992",1055992,38,157,10,205
"55993",1055993,141,50,6,197
"55994",1055994,81,111,5,197
"55995",1055995,37,19,0,56
"55996",1055996,186,114,13,313
"55997",1055997,66,15,2,83
"55998",1055998,164,32,11,207
"55999",1055999,146,111,9,266
"56000",1056000,69,158,4,231
"56001",1056001,45,207,4,256
"56002",1056002,35,46,4,85
"56003",1056003,110,31,8,149
"56004",1056004,188,86,3,277
"56005",1056005,260,60,8,328
"56006",1056006,162,152,9,323
"56007",1056007,200,128,16,344
"56008",1056008,150,130,27,307
"56009",1056009,140,103,10,253
"56010",1056010,90,121,5,216
"56011",1056011,15,60,1,76
"56012",1056012,192,68,9,269
"56013",1056013,6,58,2,66
"56014",1056014,90,51,2,143
"56015",1056015,151,28,11,190
"56016",1056016,213,70,8,291
"56017",1056017,54,6,3,63
"56018",1056018,253,1,3,257
"56019",1056019,28,165,10,203
"56020",1056020,212,21,7,240
"56021",1056021,97,115,9,221
"56022",1056022,149,70,9,228
"56023",1056023,97,147,11,255
"56024",1056024,86,167,12,265
"56025",1056025,160,65,8,233
"56026",1056026,65,160,3,228
"56027",1056027,109,64,8,181
"56028",1056028,50,275,3,328
"56029",1056029,125,68,12,205
"56030",1056030,66,160,24,250
"56031",1056031,47,230,2,279
"56032",1056032,129,72,12,213
"56033",1056033,143,97,14,254
"56034",1056034,56,199,7,262
"56035",1056035,158,23,6,187
"56036",1056036,174,106,13,293
"56037",1056037,80,40,7,127
"56038",1056038,101,151,9,261
"56039",1056039,26,73,3,102
"56040",1056040,193,46,4,243
"56041",1056041,61,121,9,191
"56042",1056042,43,23,2,68
"56043",1056043,40,235,7,282
"56044",1056044,121,17,4,142
"56045",1056045,198,23,9,230
"56046",1056046,124,109,13,246
"56047",1056047,90,129,3,222
"56048",1056048,61,17,6,84
"56049",1056049,230,30,14,274
"56050",1056050,46,29,0,75
"56051",1056051,8,6,0,14
"56052",1056052,124,106,9,239
"56053",1056053,98,13,7,118
"56054",1056054,192,323,15,530
"56055",1056055,155,31,10,196
"56056",1056056,38,5,1,44
"56057",1056057,147,135,18,300
"56058",1056058,23,19,4,46
"56059",1056059,176,59,6,241
"56060",1056060,38,223,12,273
"56061",1056061,149,96,7,252
"56062",1056062,135,98,12,245
"56063",1056063,96,194,13,303
"56064",1056064,51,30,9,90
"56065",1056065,69,14,4,87
"56066",1056066,60,24,7,91
"56067",1056067,196,22,10,228
"56068",1056068,15,75,4,94
"56069",1056069,47,239,7,293
"56070",1056070,130,74,3,207
"56071",1056071,168,96,8,272
"56072",1056072,184,81,8,273
"56073",1056073,58,220,10,288
"56074",1056074,118,176,22,316
"56075",1056075,175,66,4,245
"56076",1056076,134,111,7,252
"56077",1056077,180,29,6,215
"56078",1056078,51,186,0,237
"56079",1056079,111,47,4,162
"56080",1056080,87,100,9,196
"56081",1056081,37,21,5,63
"56082",1056082,37,216,3,256
"56083",1056083,92,197,7,296
"56084",1056084,117,110,21,248
"56085",1056085,49,45,1,95
"56086",1056086,54,159,6,219
"56087",1056087,80,185,8,273
"56088",1056088,49,175,1,225
"56089",1056089,69,193,13,275
"56090",1056090,44,33,2,79
"56091",1056091,120,146,10,276
"56092",1056092,124,19,5,148
"56093",1056093,6,52,1,59
"56094",1056094,77,194,8,279
"56095",1056095,53,153,0,206
"56096",1056096,71,264,2,337
"56097",1056097,106,43,3,152
"56098",1056098,185,22,6,213
"56099",1056099,220,26,25,271
"56100",1056100,27,0,0,27
"56101",1056101,221,45,11,277
"56102",1056102,86,140,9,235
"56103",1056103,17,55,0,72
"56104",1056104,90,124,7,221
"56105",1056105,115,133,3,251
"56106",1056106,85,148,7,240
"56107",1056107,7,3,0,10
"56108",1056108,105,158,16,279
"56109",1056109,102,107,7,216
"56110",1056110,68,110,10,188
"56111",1056111,16,24,1,41
"56112",1056112,85,70,4,159
"56113",1056113,106,103,8,217
"56114",1056114,109,93,8,210
"56115",1056115,145,59,6,210
"56116",1056116,68,76,4,148
"56117",1056117,224,20,10,254
"56118",1056118,72,88,1,161
"56119",1056119,68,33,2,103
"56120",1056120,160,47,5,212
"56121",1056121,186,28,10,224
"56122",1056122,160,47,9,216
"56123",1056123,60,103,6,169
"56124",1056124,113,48,7,168
"56125",1056125,31,6,3,40
"56126",1056126,45,260,12,317
"56127",1056127,67,86,1,154
"56128",1056128,22,42,0,64
"56129",1056129,188,111,18,317
"56130",1056130,111,86,9,206
"56131",1056131,175,61,4,240
"56132",1056132,114,38,1,153
"56133",1056133,55,191,6,252
"56134",1056134,77,190,19,286
"56135",1056135,128,1,0,129
"56136",1056136,251,27,9,287
"56137",1056137,89,97,12,198
"56138",1056138,125,125,7,257
"56139",1056139,37,27,2,66
"56140",1056140,41,221,3,265
"56141",1056141,103,15,3,121
"56142",1056142,142,97,10,249
"56143",1056143,180,78,9,267
"56144",1056144,54,101,2,157
"56145",1056145,184,51,12,247
"56146",1056146,117,77,8,202
"56147",1056147,32,249,4,285
"56148",1056148,115,11,4,130
"56149",1056149,51,270,2,323
"56150",1056150,5,3,1,9
"56151",1056151,98,89,3,190
"56152",1056152,60,129,8,197
"56153",1056153,27,137,8,172
"56154",1056154,127,60,13,200
"56155",1056155,133,108,9,250
"56156",1056156,157,123,15,295
"56157",1056157,59,155,6,220
"56158",1056158,28,8,2,38
"56159",1056159,201,63,9,273
"56160",1056160,101,17,2,120
"56161",1056161,105,103,6,214
"56162",1056162,184,52,7,243
"56163",1056163,224,41,8,273
"56164",1056164,38,0,1,39
"56165",1056165,180,2,17,199
"56166",1056166,28,184,6,218
"56167",1056167,18,51,2,71
"56168",1056168,198,23,6,227
"56169",1056169,67,177,10,254
"56170",1056170,158,63,1,222
"56171",1056171,50,46,2,98
"56172",1056172,124,2,2,128
"56173",1056173,156,95,5,256
"56174",1056174,35,25,0,60
"56175",1056175,269,133,9,411
"56176",1056176,45,187,2,234
"56177",1056177,21,168,8,197
"56178",1056178,21,7,0,28
"56179",1056179,95,133,3,231
"56180",1056180,17,68,3,88
"56181",1056181,219,42,12,273
"56182",1056182,18,213,7,238
"56183",1056183,50,148,4,202
"56184",1056184,187,10,3,200
"56185",1056185,144,59,4,207
"56186",1056186,199,59,16,274
"56187",1056187,45,150,1,196
"56188",1056188,95,118,7,220
"56189",1056189,207,108,17,332
"56190",1056190,52,202,4,258
"56191",1056191,44,31,7,82
"56192",1056192,56,165,9,230
"56193",1056193,216,33,9,258
"56194",1056194,38,135,4,177
"56195",1056195,132,63,6,201
"56196",1056196,93,102,6,201
"56197",1056197,82,134,16,232
"56198",1056198,110,124,4,238
"56199",1056199,120,136,4,260
"56200",1056200,164,45,4,213
"56201",1056201,181,45,1,227
"56202",1056202,110,49,2,161
"56203",1056203,145,47,8,200
"56204",1056204,119,41,8,168
"56205",1056205,81,136,4,221
"56206",1056206,163,99,12,274
"56207",1056207,38,11,3,52
"56208",1056208,31,52,1,84
"56209",1056209,24,210,1,235
"56210",1056210,143,148,9,300
"56211",1056211,22,247,6,275
"56212",1056212,24,94,14,132
"56213",1056213,51,178,5,234
"56214",1056214,66,59,3,128
"56215",1056215,11,17,2,30
"56216",1056216,56,15,1,72
"56217",1056217,134,24,7,165
"56218",1056218,133,50,13,196
"56219",1056219,195,46,16,257
"56220",1056220,164,136,25,325
"56221",1056221,163,32,6,201
"56222",1056222,230,144,3,377
"56223",1056223,170,31,9,210
"56224",1056224,114,75,6,195
"56225",1056225,148,39,14,201
"56226",1056226,116,187,2,305
"56227",1056227,104,161,10,275
"56228",1056228,46,26,4,76
"56229",1056229,133,70,9,212
"56230",1056230,165,28,2,195
"56231",1056231,144,61,6,211
"56232",1056232,42,156,8,206
"56233",1056233,23,41,3,67
"56234",1056234,179,76,17,272
"56235",1056235,142,49,7,198
"56236",1056236,53,110,10,173
"56237",1056237,88,201,5,294
"56238",1056238,23,174,3,200
"56239",1056239,135,141,11,287
"56240",1056240,164,46,9,219
"56241",1056241,44,1,0,45
"56242",1056242,224,93,17,334
"56243",1056243,70,239,5,314
"56244",1056244,117,130,19,266
"56245",1056245,63,254,2,319
"56246",1056246,146,89,4,239
"56247",1056247,63,164,10,237
"56248",1056248,145,62,12,219
"56249",1056249,135,57,4,196
"56250",1056250,130,33,3,166
"56251",1056251,103,134,7,244
"56252",1056252,214,13,4,231
"56253",1056253,184,109,16,309
"56254",1056254,197,101,23,321
"56255",1056255,31,168,5,204
"56256",1056256,77,216,8,301
"56257",1056257,66,111,11,188
"56258",1056258,113,101,7,221
"56259",1056259,165,17,4,186
"56260",1056260,300,6,5,311
"56261",1056261,364,33,18,415
"56262",1056262,39,276,9,324
"56263",1056263,252,92,15,359
"56264",1056264,55,143,4,202
"56265",1056265,135,133,10,278
"56266",1056266,126,64,2,192
"56267",1056267,155,135,6,296
"56268",1056268,162,50,7,219
"56269",1056269,78,183,2,263
"56270",1056270,105,93,5,203
"56271",1056271,112,120,11,243
"56272",1056272,27,192,5,224
"56273",1056273,95,112,8,215
"56274",1056274,84,106,3,193
"56275",1056275,45,15,0,60
"56276",1056276,80,33,4,117
"56277",1056277,66,12,2,80
"56278",1056278,82,104,3,189
"56279",1056279,81,174,14,269
"56280",1056280,163,52,2,217
"56281",1056281,236,41,12,289
"56282",1056282,149,77,11,237
"56283",1056283,160,68,9,237
"56284",1056284,145,82,8,235
"56285",1056285,51,84,2,137
"56286",1056286,183,75,7,265
"56287",1056287,123,60,7,190
"56288",1056288,7,29,2,38
"56289",1056289,45,5,1,51
"56290",1056290,96,157,2,255
"56291",1056291,33,229,3,265
"56292",1056292,167,68,5,240
"56293",1056293,40,216,1,257
"56294",1056294,154,102,13,269
"56295",1056295,138,118,7,263
"56296",1056296,61,178,25,264
"56297",1056297,101,83,3,187
"56298",1056298,78,236,12,326
"56299",1056299,35,199,3,237
"56300",1056300,108,102,8,218
"56301",1056301,186,55,20,261
"56302",1056302,120,90,15,225
"56303",1056303,225,27,6,258
"56304",1056304,117,139,6,262
"56305",1056305,122,135,3,260
"56306",1056306,66,25,6,97
"56307",1056307,29,226,4,259
"56308",1056308,22,38,1,61
"56309",1056309,117,45,8,170
"56310",1056310,145,69,9,223
"56311",1056311,46,224,2,272
"56312",1056312,50,174,4,228
"56313",1056313,79,166,16,261
"56314",1056314,144,94,12,250
"56315",1056315,176,57,5,238
"56316",1056316,127,0,0,127
"56317",1056317,51,225,2,278
"56318",1056318,39,30,6,75
"56319",1056319,67,88,3,158
"56320",1056320,93,138,15,246
"56321",1056321,80,60,4,144
"56322",1056322,182,53,8,243
"56323",1056323,61,206,5,272
"56324",1056324,82,242,3,327
"56325",1056325,159,17,9,185
"56326",1056326,105,219,8,332
"56327",1056327,101,121,6,228
"56328",1056328,167,57,11,235
"56329",1056329,69,2,0,71
"56330",1056330,48,220,9,277
"56331",1056331,166,115,10,291
"56332",1056332,84,153,1,238
"56333",1056333,121,34,14,169
"56334",1056334,105,212,15,332
"56335",1056335,72,213,8,293
"56336",1056336,159,77,18,254
"56337",1056337,145,26,8,179
"56338",1056338,272,14,10,296
"56339",1056339,122,46,5,173
"56340",1056340,93,180,9,282
"56341",1056341,82,156,10,248
"56342",1056342,128,146,13,287
"56343",1056343,45,127,14,186
"56344",1056344,114,129,7,250
"56345",1056345,147,64,4,215
"56346",1056346,45,189,2,236
"56347",1056347,51,245,7,303
"56348",1056348,44,87,8,139
"56349",1056349,120,85,6,211
"56350",1056350,74,111,5,190
"56351",1056351,44,250,5,299
"56352",1056352,55,145,13,213
"56353",1056353,113,156,12,281
"56354",1056354,224,18,3,245
"56355",1056355,158,63,9,230
"56356",1056356,115,14,0,129
"56357",1056357,52,161,7,220
"56358",1056358,91,160,17,268
"56359",1056359,42,171,5,218
"56360",1056360,60,216,7,283
"56361",1056361,18,9,0,27
"56362",1056362,142,110,4,256
"56363",1056363,39,242,5,286
"56364",1056364,252,27,8,287
"56365",1056365,51,243,16,310
"56366",1056366,103,100,5,208
"56367",1056367,146,79,5,230
"56368",1056368,104,105,7,216
"56369",1056369,200,27,6,233
"56370",1056370,113,86,15,214
"56371",1056371,123,124,4,251
"56372",1056372,132,86,9,227
"56373",1056373,33,17,4,54
"56374",1056374,18,1,1,20
"56375",1056375,166,83,3,252
"56376",1056376,29,238,2,269
"56377",1056377,124,85,9,218
"56378",1056378,54,88,6,148
"56379",1056379,69,171,5,245
"56380",1056380,127,61,4,192
"56381",1056381,54,210,8,272
"56382",1056382,111,178,10,299
"56383",1056383,184,104,16,304
"56384",1056384,87,68,16,171
"56385",1056385,121,135,17,273
"56386",1056386,65,203,4,272
"56387",1056387,45,218,4,267
"56388",1056388,85,5,4,94
"56389",1056389,179,62,9,250
"56390",1056390,87,143,10,240
"56391",1056391,201,21,3,225
"56392",1056392,53,136,24,213
"56393",1056393,87,37,2,126
"56394",1056394,113,188,11,312
"56395",1056395,177,56,13,246
"56396",1056396,20,218,5,243
"56397",1056397,109,13,3,125
"56398",1056398,151,102,21,274
"56399",1056399,66,152,11,229
"56400",1056400,44,207,6,257
"56401",1056401,133,13,5,151
"56402",1056402,41,171,4,216
"56403",1056403,138,24,2,164
"56404",1056404,189,51,14,254
"56405",1056405,212,58,7,277
"56406",1056406,132,103,9,244
"56407",1056407,214,24,6,244
"56408",1056408,49,175,12,236
"56409",1056409,21,213,3,237
"56410",1056410,109,52,7,168
"56411",1056411,132,179,15,326
"56412",1056412,99,149,21,269
"56413",1056413,39,165,20,224
"56414",1056414,10,4,2,16
"56415",1056415,138,13,16,167
"56416",1056416,99,73,7,179
"56417",1056417,121,97,26,244
"56418",1056418,225,20,3,248
"56419",1056419,82,92,13,187
"56420",1056420,194,23,11,228
"56421",1056421,84,125,15,224
"56422",1056422,155,74,3,232
"56423",1056423,158,55,6,219
"56424",1056424,58,142,13,213
"56425",1056425,116,10,6,132
"56426",1056426,27,23,1,51
"56427",1056427,255,97,10,362
"56428",1056428,31,251,8,290
"56429",1056429,75,180,13,268
"56430",1056430,70,149,14,233
"56431",1056431,58,96,7,161
"56432",1056432,77,246,8,331
"56433",1056433,148,98,14,260
"56434",1056434,170,52,12,234
"56435",1056435,217,70,6,293
"56436",1056436,29,68,8,105
"56437",1056437,9,3,4,16
"56438",1056438,38,9,0,47
"56439",1056439,138,130,13,281
"56440",1056440,2,2,1,5
"56441",1056441,207,53,11,271
"56442",1056442,127,102,5,234
"56443",1056443,236,76,10,322
"56444",1056444,43,219,9,271
"56445",1056445,35,174,8,217
"56446",1056446,23,243,8,274
"56447",1056447,193,97,20,310
"56448",1056448,122,96,9,227
"56449",1056449,248,44,7,299
"56450",1056450,89,196,16,301
"56451",1056451,260,34,7,301
"56452",1056452,63,11,2,76
"56453",1056453,23,17,1,41
"56454",1056454,108,89,9,206
"56455",1056455,111,95,18,224
"56456",1056456,187,79,15,281
"56457",1056457,199,18,8,225
"56458",1056458,73,204,5,282
"56459",1056459,200,25,4,229
"56460",1056460,38,226,4,268
"56461",1056461,81,180,5,266
"56462",1056462,44,128,12,184
"56463",1056463,162,48,6,216
"56464",1056464,92,60,4,156
"56465",1056465,139,110,7,256
"56466",1056466,46,203,11,260
"56467",1056467,196,43,19,258
"56468",1056468,122,5,0,127
"56469",1056469,54,53,14,121
"56470",1056470,116,143,11,270
"56471",1056471,32,104,4,140
"56472",1056472,196,34,7,237
"56473",1056473,193,69,5,267
"56474",1056474,147,116,11,274
"56475",1056475,53,20,4,77
"56476",1056476,46,238,6,290
"56477",1056477,108,58,10,176
"56478",1056478,108,166,11,285
"56479",1056479,134,118,5,257
"56480",1056480,15,229,4,248
"56481",1056481,16,21,1,38
"56482",1056482,141,52,10,203
"56483",1056483,127,26,3,156
"56484",1056484,157,42,7,206
"56485",1056485,117,181,16,314
"56486",1056486,120,26,8,154
"56487",1056487,98,51,3,152
"56488",1056488,183,16,1,200
"56489",1056489,14,16,0,30
"56490",1056490,125,23,7,155
"56491",1056491,118,190,4,312
"56492",1056492,3,5,0,8
"56493",1056493,101,59,10,170
"56494",1056494,123,145,19,287
"56495",1056495,117,135,5,257
"56496",1056496,124,108,13,245
"56497",1056497,166,109,7,282
"56498",1056498,88,203,14,305
"56499",1056499,168,63,4,235
"56500",1056500,41,153,1,195
"56501",1056501,211,19,5,235
"56502",1056502,61,240,11,312
"56503",1056503,209,87,5,301
"56504",1056504,58,197,8,263
"56505",1056505,93,57,11,161
"56506",1056506,76,205,9,290
"56507",1056507,254,51,18,323
"56508",1056508,250,49,14,313
"56509",1056509,161,32,5,198
"56510",1056510,172,40,4,216
"56511",1056511,174,149,15,338
"56512",1056512,83,118,8,209
"56513",1056513,76,205,7,288
"56514",1056514,74,213,6,293
"56515",1056515,161,66,7,234
"56516",1056516,54,168,10,232
"56517",1056517,288,51,5,344
"56518",1056518,22,217,1,240
"56519",1056519,110,103,4,217
"56520",1056520,200,51,9,260
"56521",1056521,156,34,4,194
"56522",1056522,192,16,3,211
"56523",1056523,27,171,2,200
"56524",1056524,46,3,1,50
"56525",1056525,39,199,8,246
"56526",1056526,112,179,3,294
"56527",1056527,71,245,14,330
"56528",1056528,149,38,5,192
"56529",1056529,48,173,5,226
"56530",1056530,124,136,7,267
"56531",1056531,21,16,1,38
"56532",1056532,70,172,9,251
"56533",1056533,79,129,6,214
"56534",1056534,148,46,5,199
"56535",1056535,159,55,5,219
"56536",1056536,92,68,8,168
"56537",1056537,161,13,20,194
"56538",1056538,37,106,3,146
"56539",1056539,207,46,5,258
"56540",1056540,189,87,26,302
"56541",1056541,143,88,5,236
"56542",1056542,154,92,6,252
"56543",1056543,80,70,10,160
"56544",1056544,227,61,9,297
"56545",1056545,55,229,6,290
"56546",1056546,76,81,3,160
"56547",1056547,41,45,3,89
"56548",1056548,67,89,6,162
"56549",1056549,198,27,11,236
"56550",1056550,152,45,14,211
"56551",1056551,270,206,45,521
"56552",1056552,73,172,4,249
"56553",1056553,27,242,6,275
"56554",1056554,131,53,4,188
"56555",1056555,121,28,8,157
"56556",1056556,70,168,6,244
"56557",1056557,170,86,9,265
"56558",1056558,244,39,12,295
"56559",1056559,121,27,1,149
"56560",1056560,39,162,1,202
"56561",1056561,165,44,12,221
"56562",1056562,187,53,16,256
"56563",1056563,175,85,21,281
"56564",1056564,155,53,9,217
"56565",1056565,97,44,11,152
"56566",1056566,58,164,6,228
"56567",1056567,17,3,1,21
"56568",1056568,139,45,11,195
"56569",1056569,180,82,11,273
"56570",1056570,79,42,9,130
"56571",1056571,90,211,8,309
"56572",1056572,90,173,24,287
"56573",1056573,25,6,2,33
"56574",1056574,165,73,4,242
"56575",1056575,57,147,8,212
"56576",1056576,129,125,11,265
"56577",1056577,64,235,9,308
"56578",1056578,93,47,4,144
"56579",1056579,173,86,12,271
"56580",1056580,186,12,7,205
"56581",1056581,184,97,8,289
"56582",1056582,98,23,3,124
"56583",1056583,33,99,9,141
"56584",1056584,161,155,16,332
"56585",1056585,95,99,11,205
"56586",1056586,108,37,3,148
"56587",1056587,54,141,7,202
"56588",1056588,125,94,11,230
"56589",1056589,116,81,12,209
"56590",1056590,39,33,1,73
"56591",1056591,109,41,6,156
"56592",1056592,122,90,8,220
"56593",1056593,100,119,4,223
"56594",1056594,79,214,10,303
"56595",1056595,200,81,2,283
"56596",1056596,102,157,10,269
"56597",1056597,84,23,2,109
"56598",1056598,142,59,4,205
"56599",1056599,24,134,6,164
"56600",1056600,166,95,7,268
"56601",1056601,152,67,19,238
"56602",1056602,118,18,0,136
"56603",1056603,113,78,5,196
"56604",1056604,89,157,10,256
"56605",1056605,31,219,2,252
"56606",1056606,141,84,3,228
"56607",1056607,2,3,0,5
"56608",1056608,95,390,29,514
"56609",1056609,182,79,9,270
"56610",1056610,125,11,8,144
"56611",1056611,106,20,6,132
"56612",1056612,137,137,5,279
"56613",1056613,133,163,3,299
"56614",1056614,244,35,3,282
"56615",1056615,151,75,3,229
"56616",1056616,193,62,6,261
"56617",1056617,92,44,2,138
"56618",1056618,125,107,8,240
"56619",1056619,40,228,5,273
"56620",1056620,85,117,4,206
"56621",1056621,198,80,10,288
"56622",1056622,213,57,7,277
"56623",1056623,216,28,13,257
"56624",1056624,112,161,7,280
"56625",1056625,145,103,7,255
"56626",1056626,43,246,4,293
"56627",1056627,30,1,1,32
"56628",1056628,89,127,9,225
"56629",1056629,93,194,11,298
"56630",1056630,140,16,6,162
"56631",1056631,129,8,3,140
"56632",1056632,99,94,7,200
"56633",1056633,99,5,1,105
"56634",1056634,171,75,2,248
"56635",1056635,41,259,9,309
"56636",1056636,159,48,6,213
"56637",1056637,106,148,24,278
"56638",1056638,111,123,5,239
"56639",1056639,95,202,20,317
"56640",1056640,165,101,8,274
"56641",1056641,182,53,3,238
"56642",1056642,234,31,9,274
"56643",1056643,115,57,9,181
"56644",1056644,114,45,9,168
"56645",1056645,163,87,24,274
"56646",1056646,5,37,1,43
"56647",1056647,209,68,8,285
"56648",1056648,111,112,13,236
"56649",1056649,123,78,5,206
"56650",1056650,170,107,2,279
"56651",1056651,162,57,6,225
"56652",1056652,92,152,3,247
"56653",1056653,132,45,5,182
"56654",1056654,87,6,1,94
"56655",1056655,134,88,18,240
"56656",1056656,155,28,3,186
"56657",1056657,44,176,1,221
"56658",1056658,232,83,4,319
"56659",1056659,271,14,8,293
"56660",1056660,166,65,10,241
"56661",1056661,139,71,4,214
"56662",1056662,62,201,25,288
"56663",1056663,1,1,3,5
"56664",1056664,127,178,9,314
"56665",1056665,139,45,3,187
"56666",1056666,100,121,22,243
"56667",1056667,217,95,8,320
"56668",1056668,182,24,9,215
"56669",1056669,66,88,5,159
"56670",1056670,134,131,2,267
"56671",1056671,144,159,10,313
"56672",1056672,141,102,8,251
"56673",1056673,224,60,13,297
"56674",1056674,52,57,2,111
"56675",1056675,192,25,3,220
"56676",1056676,28,208,5,241
"56677",1056677,135,29,1,165
"56678",1056678,91,53,8,152
"56679",1056679,26,8,6,40
"56680",1056680,27,284,5,316
"56681",1056681,40,224,4,268
"56682",1056682,227,26,12,265
"56683",1056683,140,112,14,266
"56684",1056684,184,31,7,222
"56685",1056685,29,61,0,90
"56686",1056686,114,159,8,281
"56687",1056687,10,159,6,175
"56688",1056688,220,96,9,325
"56689",1056689,68,203,1,272
"56690",1056690,184,62,6,252
"56691",1056691,58,148,7,213
"56692",1056692,81,216,12,309
"56693",1056693,60,175,3,238
"56694",1056694,78,111,3,192
"56695",1056695,148,24,10,182
"56696",1056696,25,154,4,183
"56697",1056697,51,34,6,91
"56698",1056698,105,89,10,204
"56699",1056699,217,66,11,294
"56700",1056700,181,47,12,240
"56701",1056701,169,117,8,294
"56702",1056702,81,28,7,116
"56703",1056703,107,31,3,141
"56704",1056704,49,229,5,283
"56705",1056705,45,150,9,204
"56706",1056706,131,126,14,271
"56707",1056707,83,11,3,97
"56708",1056708,54,232,5,291
"56709",1056709,67,131,7,205
"56710",1056710,101,101,5,207
"56711",1056711,106,73,9,188
"56712",1056712,61,22,3,86
"56713",1056713,105,168,4,277
"56714",1056714,91,153,4,248
"56715",1056715,105,198,13,316
"56716",1056716,101,196,15,312
"56717",1056717,132,19,9,160
"56718",1056718,119,170,13,302
"56719",1056719,24,93,4,121
"56720",1056720,81,67,2,150
"56721",1056721,154,60,6,220
"56722",1056722,115,120,7,242
"56723",1056723,60,206,9,275
"56724",1056724,56,188,20,264
"56725",1056725,54,150,10,214
"56726",1056726,197,41,8,246
"56727",1056727,161,86,9,256
"56728",1056728,157,115,20,292
"56729",1056729,44,105,9,158
"56730",1056730,135,54,5,194
"56731",1056731,176,56,8,240
"56732",1056732,127,42,7,176
"56733",1056733,86,179,11,276
"56734",1056734,20,17,2,39
"56735",1056735,125,16,8,149
"56736",1056736,155,33,6,194
"56737",1056737,90,149,4,243
"56738",1056738,56,111,11,178
"56739",1056739,42,166,12,220
"56740",1056740,152,94,10,256
"56741",1056741,65,184,3,252
"56742",1056742,89,0,0,89
"56743",1056743,128,146,12,286
"56744",1056744,137,78,9,224
"56745",1056745,202,37,10,249
"56746",1056746,161,80,7,248
"56747",1056747,136,27,5,168
"56748",1056748,154,44,7,205
"56749",1056749,188,59,9,256
"56750",1056750,133,135,6,274
"56751",1056751,28,3,1,32
"56752",1056752,95,17,1,113
"56753",1056753,135,42,10,187
"56754",1056754,90,137,1,228
"56755",1056755,42,179,6,227
"56756",1056756,110,39,3,152
"56757",1056757,32,201,6,239
"56758",1056758,25,231,2,258
"56759",1056759,34,231,4,269
"56760",1056760,64,235,12,311
"56761",1056761,127,43,3,173
"56762",1056762,46,85,7,138
"56763",1056763,82,151,16,249
"56764",1056764,164,65,9,238
"56765",1056765,92,65,4,161
"56766",1056766,59,0,1,60
"56767",1056767,173,86,5,264
"56768",1056768,43,143,6,192
"56769",1056769,104,112,13,229
"56770",1056770,85,164,14,263
"56771",1056771,180,43,8,231
"56772",1056772,16,24,1,41
"56773",1056773,64,214,6,284
"56774",1056774,11,7,0,18
"56775",1056775,39,156,5,200
"56776",1056776,86,134,11,231
"56777",1056777,151,116,18,285
"56778",1056778,143,51,8,202
"56779",1056779,130,147,16,293
"56780",1056780,101,183,6,290
"56781",1056781,35,174,3,212
"56782",1056782,43,12,2,57
"56783",1056783,84,110,1,195
"56784",1056784,104,130,9,243
"56785",1056785,251,73,11,335
"56786",1056786,104,20,3,127
"56787",1056787,62,119,2,183
"56788",1056788,114,124,9,247
"56789",1056789,101,88,13,202
"56790",1056790,241,26,6,273
"56791",1056791,149,73,18,240
"56792",1056792,44,28,8,80
"56793",1056793,131,82,9,222
"56794",1056794,148,66,7,221
"56795",1056795,186,45,4,235
"56796",1056796,236,64,11,311
"56797",1056797,20,222,4,246
"56798",1056798,111,185,6,302
"56799",1056799,121,105,13,239
"56800",1056800,17,256,4,277
"56801",1056801,97,35,3,135
"56802",1056802,186,12,2,200
"56803",1056803,86,130,5,221
"56804",1056804,147,122,12,281
"56805",1056805,197,83,24,304
"56806",1056806,57,198,6,261
"56807",1056807,201,43,4,248
"56808",1056808,180,3,3,186
"56809",1056809,4,16,0,20
"56810",1056810,92,50,9,151
"56811",1056811,146,102,16,264
"56812",1056812,83,111,5,199
"56813",1056813,78,178,10,266
"56814",1056814,53,160,18,231
"56815",1056815,97,14,3,114
"56816",1056816,55,224,1,280
"56817",1056817,63,28,1,92
"56818",1056818,123,136,6,265
"56819",1056819,98,114,11,223
"56820",1056820,245,29,5,279
"56821",1056821,164,124,12,300
"56822",1056822,35,191,13,239
"56823",1056823,215,43,8,266
"56824",1056824,101,47,1,149
"56825",1056825,145,93,8,246
"56826",1056826,198,148,11,357
"56827",1056827,108,144,3,255
"56828",1056828,64,207,20,291
"56829",1056829,83,184,7,274
"56830",1056830,56,163,2,221
"56831",1056831,83,185,9,277
"56832",1056832,174,54,6,234
"56833",1056833,115,96,11,222
"56834",1056834,232,15,4,251
"56835",1056835,178,40,3,221
"56836",1056836,42,175,4,221
"56837",1056837,120,153,19,292
"56838",1056838,2,6,0,8
"56839",1056839,154,98,9,261
"56840",1056840,9,107,3,119
"56841",1056841,102,109,13,224
"56842",1056842,76,57,3,136
"56843",1056843,174,54,6,234
"56844",1056844,82,142,8,232
"56845",1056845,70,61,5,136
"56846",1056846,96,150,3,249
"56847",1056847,51,288,4,343
"56848",1056848,85,183,9,277
"56849",1056849,7,46,1,54
"56850",1056850,44,261,6,311
"56851",1056851,91,180,12,283
"56852",1056852,146,58,15,219
"56853",1056853,170,93,7,270
"56854",1056854,54,149,3,206
"56855",1056855,116,122,7,245
"56856",1056856,196,51,10,257
"56857",1056857,33,202,4,239
"56858",1056858,234,36,5,275
"56859",1056859,136,17,5,158
"56860",1056860,130,19,5,154
"56861",1056861,162,60,3,225
"56862",1056862,151,74,11,236
"56863",1056863,48,213,3,264
"56864",1056864,182,40,6,228
"56865",1056865,82,64,5,151
"56866",1056866,25,174,3,202
"56867",1056867,80,43,6,129
"56868",1056868,183,25,7,215
"56869",1056869,78,47,3,128
"56870",1056870,142,123,5,270
"56871",1056871,141,93,10,244
"56872",1056872,88,61,6,155
"56873",1056873,127,33,8,168
"56874",1056874,88,79,3,170
"56875",1056875,147,82,4,233
"56876",1056876,10,137,1,148
"56877",1056877,47,191,12,250
"56878",1056878,119,97,11,227
"56879",1056879,44,250,7,301
"56880",1056880,34,266,4,304
"56881",1056881,163,18,4,185
"56882",1056882,216,119,14,349
"56883",1056883,60,141,2,203
"56884",1056884,72,150,12,234
"56885",1056885,91,64,9,164
"56886",1056886,104,190,9,303
"56887",1056887,209,27,11,247
"56888",1056888,68,188,16,272
"56889",1056889,12,208,2,222
"56890",1056890,57,251,3,311
"56891",1056891,148,27,1,176
"56892",1056892,211,72,3,286
"56893",1056893,77,9,8,94
"56894",1056894,242,13,9,264
"56895",1056895,203,77,10,290
"56896",1056896,169,31,14,214
"56897",1056897,175,118,5,298
"56898",1056898,56,126,14,196
"56899",1056899,219,35,6,260
"56900",1056900,16,76,2,94
"56901",1056901,138,99,17,254
"56902",1056902,90,169,9,268
"56903",1056903,70,14,1,85
"56904",1056904,11,14,3,28
"56905",1056905,90,72,18,180
"56906",1056906,64,237,16,317
"56907",1056907,197,82,28,307
"56908",1056908,101,200,10,311
"56909",1056909,166,72,9,247
"56910",1056910,79,150,7,236
"56911",1056911,133,77,9,219
"56912",1056912,168,54,12,234
"56913",1056913,11,4,0,15
"56914",1056914,185,51,4,240
"56915",1056915,186,85,2,273
"56916",1056916,14,11,0,25
"56917",1056917,45,79,4,128
"56918",1056918,69,116,16,201
"56919",1056919,231,47,22,300
"56920",1056920,76,16,1,93
"56921",1056921,144,99,7,250
"56922",1056922,84,122,10,216
"56923",1056923,37,206,2,245
"56924",1056924,185,92,7,284
"56925",1056925,138,144,7,289
"56926",1056926,134,137,7,278
"56927",1056927,109,16,3,128
"56928",1056928,187,32,9,228
"56929",1056929,90,78,5,173
"56930",1056930,98,213,11,322
"56931",1056931,43,182,2,227
"56932",1056932,41,206,4,251
"56933",1056933,204,23,3,230
"56934",1056934,186,78,10,274
"56935",1056935,94,145,16,255
"56936",1056936,120,162,10,292
"56937",1056937,187,52,7,246
"56938",1056938,19,220,3,242
"56939",1056939,82,178,5,265
"56940",1056940,223,37,12,272
"56941",1056941,33,13,3,49
"56942",1056942,148,115,8,271
"56943",1056943,77,206,1,284
"56944",1056944,68,48,3,119
"56945",1056945,126,84,5,215
"56946",1056946,106,34,8,148
"56947",1056947,106,201,9,316
"56948",1056948,87,74,6,167
"56949",1056949,164,126,13,303
"56950",1056950,159,84,23,266
"56951",1056951,5,39,0,44
"56952",1056952,91,71,9,171
"56953",1056953,96,95,5,196
"56954",1056954,111,14,5,130
"56955",1056955,249,15,1,265
"56956",1056956,162,5,7,174
"56957",1056957,31,135,5,171
"56958",1056958,52,201,11,264
"56959",1056959,114,216,14,344
"56960",1056960,48,169,6,223
"56961",1056961,125,129,9,263
"56962",1056962,112,114,6,232
"56963",1056963,129,46,4,179
"56964",1056964,161,109,8,278
"56965",1056965,126,118,5,249
"56966",1056966,160,69,7,236
"56967",1056967,120,146,13,279
"56968",1056968,91,64,1,156
"56969",1056969,38,226,10,274
"56970",1056970,169,83,9,261
"56971",1056971,187,92,10,289
"56972",1056972,115,51,3,169
"56973",1056973,290,7,10,307
"56974",1056974,17,11,0,28
"56975",1056975,75,126,11,212
"56976",1056976,213,51,13,277
"56977",1056977,139,94,3,236
"56978",1056978,91,148,5,244
"56979",1056979,160,76,15,251
"56980",1056980,61,100,8,169
"56981",1056981,24,88,2,114
"56982",1056982,148,55,11,214
"56983",1056983,112,143,6,261
"56984",1056984,29,165,6,200
"56985",1056985,239,18,5,262
"56986",1056986,35,125,2,162
"56987",1056987,48,248,6,302
"56988",1056988,0,0,0,0
"56989",1056989,17,261,2,280
"56990",1056990,131,151,3,285
"56991",1056991,198,83,10,291
"56992",1056992,189,76,19,284
"56993",1056993,202,64,12,278
"56994",1056994,95,279,12,386
"56995",1056995,208,109,14,331
"56996",1056996,101,214,3,318
"56997",1056997,30,200,8,238
"56998",1056998,10,55,1,66
"56999",1056999,131,59,8,198
"57000",1057000,135,83,10,228
"57001",1057001,72,62,5,139
"57002",1057002,131,106,13,250
"57003",1057003,141,71,3,215
"57004",1057004,53,7,2,62
"57005",1057005,164,54,5,223
"57006",1057006,152,105,19,276
"57007",1057007,110,146,17,273
"57008",1057008,149,28,8,185
"57009",1057009,66,248,1,315
"57010",1057010,111,70,3,184
"57011",1057011,64,207,10,281
"57012",1057012,123,88,13,224
"57013",1057013,212,21,8,241
"57014",1057014,149,54,10,213
"57015",1057015,57,244,7,308
"57016",1057016,153,71,4,228
"57017",1057017,96,144,0,240
"57018",1057018,65,171,24,260
"57019",1057019,84,144,3,231
"57020",1057020,89,20,6,115
"57021",1057021,29,16,2,47
"57022",1057022,67,200,15,282
"57023",1057023,70,209,11,290
"57024",1057024,190,25,10,225
"57025",1057025,6,3,0,9
"57026",1057026,130,94,5,229
"57027",1057027,122,146,10,278
"57028",1057028,269,225,36,530
"57029",1057029,149,158,21,328
"57030",1057030,73,177,5,255
"57031",1057031,178,104,4,286
"57032",1057032,150,147,7,304
"57033",1057033,106,196,13,315
"57034",1057034,38,222,5,265
"57035",1057035,104,51,15,170
"57036",1057036,101,183,1,285
"57037",1057037,155,110,12,277
"57038",1057038,223,38,8,269
"57039",1057039,171,104,13,288
"57040",1057040,189,82,5,276
"57041",1057041,118,72,8,198
"57042",1057042,104,131,14,249
"57043",1057043,246,17,18,281
"57044",1057044,207,36,4,247
"57045",1057045,111,102,12,225
"57046",1057046,59,132,8,199
"57047",1057047,234,50,13,297
"57048",1057048,32,222,4,258
"57049",1057049,100,107,7,214
"57050",1057050,51,96,2,149
"57051",1057051,76,23,1,100
"57052",1057052,8,226,3,237
"57053",1057053,12,18,2,32
"57054",1057054,147,40,7,194
"57055",1057055,122,57,3,182
"57056",1057056,48,157,7,212
"57057",1057057,68,173,6,247
"57058",1057058,75,90,6,171
"57059",1057059,76,63,11,150
"57060",1057060,230,49,17,296
"57061",1057061,106,162,21,289
"57062",1057062,17,126,2,145
"57063",1057063,31,277,2,310
"57064",1057064,78,263,4,345
"57065",1057065,35,50,0,85
"57066",1057066,120,132,6,258
"57067",1057067,51,15,1,67
"57068",1057068,197,81,11,289
"57069",1057069,60,161,5,226
"57070",1057070,21,211,3,235
"57071",1057071,39,78,2,119
"57072",1057072,139,95,9,243
"57073",1057073,63,138,4,205
"57074",1057074,103,143,4,250
"57075",1057075,97,131,3,231
"57076",1057076,37,125,3,165
"57077",1057077,133,50,4,187
"57078",1057078,174,76,4,254
"57079",1057079,12,19,0,31
"57080",1057080,58,202,8,268
"57081",1057081,156,39,9,204
"57082",1057082,89,111,3,203
"57083",1057083,88,170,13,271
"57084",1057084,166,51,12,229
"57085",1057085,122,81,6,209
"57086",1057086,141,54,6,201
"57087",1057087,98,73,8,179
"57088",1057088,49,235,10,294
"57089",1057089,90,170,2,262
"57090",1057090,185,89,1,275
"57091",1057091,146,102,14,262
"57092",1057092,89,171,8,268
"57093",1057093,35,61,5,101
"57094",1057094,106,92,8,206
"57095",1057095,30,223,5,258
"57096",1057096,137,17,3,157
"57097",1057097,64,191,3,258
"57098",1057098,174,20,8,202
"57099",1057099,175,86,6,267
"57100",1057100,54,107,9,170
"57101",1057101,55,0,0,55
"57102",1057102,172,94,12,278
"57103",1057103,169,114,9,292
"57104",1057104,32,196,2,230
"57105",1057105,143,194,7,344
"57106",1057106,94,178,11,283
"57107",1057107,56,166,9,231
"57108",1057108,40,208,3,251
"57109",1057109,163,68,11,242
"57110",1057110,18,133,3,154
"57111",1057111,209,24,6,239
"57112",1057112,68,211,3,282
"57113",1057113,127,35,1,163
"57114",1057114,26,136,3,165
"57115",1057115,162,62,6,230
"57116",1057116,115,42,6,163
"57117",1057117,20,122,7,149
"57118",1057118,141,132,13,286
"57119",1057119,114,31,14,159
"57120",1057120,135,114,6,255
"57121",1057121,185,61,8,254
"57122",1057122,105,142,11,258
"57123",1057123,23,277,5,305
"57124",1057124,80,195,7,282
"57125",1057125,59,56,2,117
"57126",1057126,143,118,3,264
"57127",1057127,72,179,14,265
"57128",1057128,82,133,19,234
"57129",1057129,41,114,3,158
"57130",1057130,10,18,1,29
"57131",1057131,90,77,7,174
"57132",1057132,215,4,18,237
"57133",1057133,63,81,1,145
"57134",1057134,76,193,12,281
"57135",1057135,134,84,15,233
"57136",1057136,56,243,1,300
"57137",1057137,114,104,16,234
"57138",1057138,114,36,4,154
"57139",1057139,91,175,9,275
"57140",1057140,37,28,2,67
"57141",1057141,109,175,6,290
"57142",1057142,173,94,13,280
"57143",1057143,98,133,8,239
"57144",1057144,19,213,3,235
"57145",1057145,162,10,8,180
"57146",1057146,98,98,9,205
"57147",1057147,138,43,6,187
"57148",1057148,120,104,5,229
"57149",1057149,191,21,1,213
"57150",1057150,122,148,1,271
"57151",1057151,88,130,8,226
"57152",1057152,37,244,1,282
"57153",1057153,105,125,6,236
"57154",1057154,76,165,8,249
"57155",1057155,78,34,6,118
"57156",1057156,56,195,9,260
"57157",1057157,120,143,9,272
"57158",1057158,30,88,5,123
"57159",1057159,127,45,13,185
"57160",1057160,105,46,5,156
"57161",1057161,44,60,3,107
"57162",1057162,179,44,5,228
"57163",1057163,41,112,6,159
"57164",1057164,143,86,9,238
"57165",1057165,21,194,1,216
"57166",1057166,94,143,16,253
"57167",1057167,278,30,4,312
"57168",1057168,130,114,9,253
"57169",1057169,58,178,21,257
"57170",1057170,197,96,17,310
"57171",1057171,227,78,24,329
"57172",1057172,138,126,19,283
"57173",1057173,58,182,19,259
"57174",1057174,175,39,9,223
"57175",1057175,191,31,13,235
"57176",1057176,54,235,3,292
"57177",1057177,53,104,7,164
"57178",1057178,117,76,12,205
"57179",1057179,165,26,8,199
"57180",1057180,10,142,3,155
"57181",1057181,233,21,4,258
"57182",1057182,157,97,10,264
"57183",1057183,212,49,11,272
"57184",1057184,41,6,1,48
"57185",1057185,198,42,13,253
"57186",1057186,63,193,10,266
"57187",1057187,203,81,20,304
"57188",1057188,82,104,5,191
"57189",1057189,96,122,7,225
"57190",1057190,71,131,8,210
"57191",1057191,27,144,7,178
"57192",1057192,66,210,4,280
"57193",1057193,96,120,10,226
"57194",1057194,44,252,8,304
"57195",1057195,44,225,8,277
"57196",1057196,206,53,10,269
"57197",1057197,107,139,25,271
"57198",1057198,64,183,6,253
"57199",1057199,181,95,2,278
"57200",1057200,74,126,6,206
"57201",1057201,151,125,20,296
"57202",1057202,78,175,3,256
"57203",1057203,71,86,8,165
"57204",1057204,89,146,21,256
"57205",1057205,140,91,3,234
"57206",1057206,32,143,2,177
"57207",1057207,154,73,12,239
"57208",1057208,69,190,2,261
"57209",1057209,97,102,8,207
"57210",1057210,203,27,6,236
"57211",1057211,31,65,4,100
"57212",1057212,109,68,14,191
"57213",1057213,142,156,5,303
"57214",1057214,94,46,7,147
"57215",1057215,81,183,7,271
"57216",1057216,51,142,9,202
"57217",1057217,102,145,4,251
"57218",1057218,74,184,4,262
"57219",1057219,181,20,6,207
"57220",1057220,126,75,9,210
"57221",1057221,92,178,18,288
"57222",1057222,131,66,13,210
"57223",1057223,129,105,16,250
"57224",1057224,52,205,14,271
"57225",1057225,32,65,7,104
"57226",1057226,230,46,5,281
"57227",1057227,45,3,6,54
"57228",1057228,80,174,16,270
"57229",1057229,81,106,9,196
"57230",1057230,89,83,4,176
"57231",1057231,198,24,6,228
"57232",1057232,75,121,8,204
"57233",1057233,130,28,4,162
"57234",1057234,26,16,0,42
"57235",1057235,88,137,18,243
"57236",1057236,31,167,6,204
"57237",1057237,59,208,16,283
"57238",1057238,106,121,13,240
"57239",1057239,117,133,8,258
"57240",1057240,29,266,3,298
"57241",1057241,77,18,5,100
"57242",1057242,70,71,6,147
"57243",1057243,120,155,3,278
"57244",1057244,61,129,11,201
"57245",1057245,86,184,1,271
"57246",1057246,189,33,5,227
"57247",1057247,122,79,13,214
"57248",1057248,109,73,7,189
"57249",1057249,203,2,2,207
"57250",1057250,106,87,14,207
"57251",1057251,143,157,18,318
"57252",1057252,73,115,5,193
"57253",1057253,68,182,13,263
"57254",1057254,149,33,2,184
"57255",1057255,99,128,7,234
"57256",1057256,134,35,3,172
"57257",1057257,131,53,8,192
"57258",1057258,31,99,1,131
"57259",1057259,95,56,9,160
"57260",1057260,127,29,3,159
"57261",1057261,48,83,2,133
"57262",1057262,146,80,4,230
"57263",1057263,55,230,4,289
"57264",1057264,118,63,10,191
"57265",1057265,266,18,10,294
"57266",1057266,110,111,8,229
"57267",1057267,48,229,4,281
"57268",1057268,164,137,17,318
"57269",1057269,90,51,6,147
"57270",1057270,157,22,2,181
"57271",1057271,85,215,11,311
"57272",1057272,168,110,8,286
"57273",1057273,149,98,10,257
"57274",1057274,206,45,7,258
"57275",1057275,120,196,8,324
"57276",1057276,181,141,17,339
"57277",1057277,188,127,15,330
"57278",1057278,66,188,10,264
"57279",1057279,26,75,4,105
"57280",1057280,118,18,6,142
"57281",1057281,133,25,2,160
"57282",1057282,61,220,12,293
"57283",1057283,38,139,1,178
"57284",1057284,18,19,3,40
"57285",1057285,119,139,12,270
"57286",1057286,83,80,9,172
"57287",1057287,79,181,14,274
"57288",1057288,21,151,1,173
"57289",1057289,144,36,4,184
"57290",1057290,90,164,10,264
"57291",1057291,125,38,7,170
"57292",1057292,155,106,9,270
"57293",1057293,80,78,10,168
"57294",1057294,14,160,2,176
"57295",1057295,128,88,11,227
"57296",1057296,126,0,0,126
"57297",1057297,200,55,5,260
"57298",1057298,171,35,4,210
"57299",1057299,149,31,2,182
"57300",1057300,179,62,11,252
"57301",1057301,208,42,15,265
"57302",1057302,87,128,19,234
"57303",1057303,72,182,13,267
"57304",1057304,134,29,3,166
"57305",1057305,171,147,13,331
"57306",1057306,144,277,27,448
"57307",1057307,197,84,5,286
"57308",1057308,176,49,11,236
"57309",1057309,114,124,5,243
"57310",1057310,16,22,2,40
"57311",1057311,164,40,3,207
"57312",1057312,168,4,0,172
"57313",1057313,41,240,8,289
"57314",1057314,110,170,18,298
"57315",1057315,149,63,7,219
"57316",1057316,71,2,5,78
"57317",1057317,188,119,11,318
"57318",1057318,165,60,9,234
"57319",1057319,37,195,6,238
"57320",1057320,151,23,3,177
"57321",1057321,140,76,14,230
"57322",1057322,199,51,7,257
"57323",1057323,174,92,9,275
"57324",1057324,55,139,3,197
"57325",1057325,99,104,15,218
"57326",1057326,131,149,17,297
"57327",1057327,53,1,1,55
"57328",1057328,167,110,9,286
"57329",1057329,55,157,3,215
"57330",1057330,95,72,12,179
"57331",1057331,172,24,3,199
"57332",1057332,127,130,19,276
"57333",1057333,134,47,6,187
"57334",1057334,148,0,0,148
"57335",1057335,52,180,6,238
"57336",1057336,204,17,3,224
"57337",1057337,176,85,13,274
"57338",1057338,167,100,6,273
"57339",1057339,122,154,11,287
"57340",1057340,224,26,6,256
"57341",1057341,68,47,10,125
"57342",1057342,129,74,20,223
"57343",1057343,143,87,19,249
"57344",1057344,212,26,7,245
"57345",1057345,160,89,5,254
"57346",1057346,52,237,9,298
"57347",1057347,182,86,11,279
"57348",1057348,135,100,1,236
"57349",1057349,184,61,6,251
"57350",1057350,116,118,10,244
"57351",1057351,200,30,10,240
"57352",1057352,99,70,7,176
"57353",1057353,213,9,4,226
"57354",1057354,144,23,7,174
"57355",1057355,77,190,8,275
"57356",1057356,37,190,6,233
"57357",1057357,58,68,5,131
"57358",1057358,236,18,3,257
"57359",1057359,60,150,8,218
"57360",1057360,68,218,10,296
"57361",1057361,103,201,7,311
"57362",1057362,103,180,16,299
"57363",1057363,43,106,2,151
"57364",1057364,153,0,0,153
"57365",1057365,61,233,6,300
"57366",1057366,72,181,8,261
"57367",1057367,75,206,11,292
"57368",1057368,174,28,7,209
"57369",1057369,159,13,5,177
"57370",1057370,95,212,10,317
"57371",1057371,126,52,5,183
"57372",1057372,70,201,3,274
"57373",1057373,67,32,10,109
"57374",1057374,217,94,10,321
"57375",1057375,105,103,20,228
"57376",1057376,97,174,14,285
"57377",1057377,6,14,0,20
"57378",1057378,125,87,14,226
"57379",1057379,0,34,1,35
"57380",1057380,87,184,12,283
"57381",1057381,49,191,7,247
"57382",1057382,52,105,12,169
"57383",1057383,63,195,15,273
"57384",1057384,174,59,15,248
"57385",1057385,148,15,8,171
"57386",1057386,62,136,5,203
"57387",1057387,126,96,11,233
"57388",1057388,37,132,4,173
"57389",1057389,27,223,4,254
"57390",1057390,137,133,11,281
"57391",1057391,160,36,1,197
"57392",1057392,67,182,7,256
"57393",1057393,166,37,3,206
"57394",1057394,150,110,1,261
"57395",1057395,118,100,21,239
"57396",1057396,164,56,11,231
"57397",1057397,61,8,0,69
"57398",1057398,170,20,2,192
"57399",1057399,180,136,27,343
"57400",1057400,125,85,8,218
"57401",1057401,138,51,9,198
"57402",1057402,194,67,3,264
"57403",1057403,25,217,6,248
"57404",1057404,123,140,6,269
"57405",1057405,177,96,13,286
"57406",1057406,124,133,9,266
"57407",1057407,133,78,4,215
"57408",1057408,130,30,14,174
"57409",1057409,23,161,9,193
"57410",1057410,209,25,9,243
"57411",1057411,159,59,13,231
"57412",1057412,159,65,9,233
"57413",1057413,98,53,4,155
"57414",1057414,15,9,1,25
"57415",1057415,113,97,14,224
"57416",1057416,96,3,0,99
"57417",1057417,232,21,9,262
"57418",1057418,132,38,5,175
"57419",1057419,244,19,3,266
"57420",1057420,82,116,7,205
"57421",1057421,321,14,8,343
"57422",1057422,200,99,6,305
"57423",1057423,31,227,1,259
"57424",1057424,181,89,17,287
"57425",1057425,151,140,16,307
"57426",1057426,39,209,13,261
"57427",1057427,57,238,3,298
"57428",1057428,63,239,1,303
"57429",1057429,143,88,10,241
"57430",1057430,78,157,9,244
"57431",1057431,9,0,0,9
"57432",1057432,73,219,12,304
"57433",1057433,166,24,7,197
"57434",1057434,194,76,10,280
"57435",1057435,112,53,15,180
"57436",1057436,76,137,17,230
"57437",1057437,68,99,5,172
"57438",1057438,73,30,4,107
"57439",1057439,37,145,2,184
"57440",1057440,32,267,5,304
"57441",1057441,125,160,13,298
"57442",1057442,174,117,16,307
"57443",1057443,51,181,4,236
"57444",1057444,86,182,2,270
"57445",1057445,119,121,2,242
"57446",1057446,152,36,8,196
"57447",1057447,110,72,19,201
"57448",1057448,45,186,0,231
"57449",1057449,106,182,3,291
"57450",1057450,120,95,12,227
"57451",1057451,132,13,1,146
"57452",1057452,189,85,9,283
"57453",1057453,162,18,6,186
"57454",1057454,77,204,8,289
"57455",1057455,120,154,15,289
"57456",1057456,109,182,22,313
"57457",1057457,112,77,12,201
"57458",1057458,120,138,1,259
"57459",1057459,206,35,8,249
"57460",1057460,15,25,1,41
"57461",1057461,42,32,1,75
"57462",1057462,73,163,7,243
"57463",1057463,96,126,13,235
"57464",1057464,282,101,4,387
"57465",1057465,133,89,12,234
"57466",1057466,151,92,8,251
"57467",1057467,120,17,2,139
"57468",1057468,216,63,14,293
"57469",1057469,190,54,5,249
"57470",1057470,155,37,5,197
"57471",1057471,39,227,17,283
"57472",1057472,93,209,19,321
"57473",1057473,90,211,19,320
"57474",1057474,216,45,13,274
"57475",1057475,124,176,11,311
"57476",1057476,177,94,12,283
"57477",1057477,61,197,11,269
"57478",1057478,94,202,5,301
"57479",1057479,22,259,2,283
"57480",1057480,13,66,2,81
"57481",1057481,156,73,9,238
"57482",1057482,20,155,2,177
"57483",1057483,127,43,6,176
"57484",1057484,64,254,12,330
"57485",1057485,138,110,9,257
"57486",1057486,78,225,10,313
"57487",1057487,36,260,2,298
"57488",1057488,130,103,3,236
"57489",1057489,149,60,13,222
"57490",1057490,64,143,5,212
"57491",1057491,48,94,1,143
"57492",1057492,60,35,4,99
"57493",1057493,168,76,14,258
"57494",1057494,54,201,24,279
"57495",1057495,92,76,8,176
"57496",1057496,75,121,16,212
"57497",1057497,15,28,1,44
"57498",1057498,187,71,7,265
"57499",1057499,91,218,9,318
"57500",1057500,90,208,17,315
"57501",1057501,130,46,8,184
"57502",1057502,157,55,11,223
"57503",1057503,172,63,5,240
"57504",1057504,236,32,12,280
"57505",1057505,143,56,9,208
"57506",1057506,64,254,7,325
"57507",1057507,42,229,5,276
"57508",1057508,215,29,12,256
"57509",1057509,141,126,7,274
"57510",1057510,56,234,6,296
"57511",1057511,33,191,8,232
"57512",1057512,146,126,13,285
"57513",1057513,99,188,16,303
"57514",1057514,56,161,2,219
"57515",1057515,89,145,9,243
"57516",1057516,127,100,12,239
"57517",1057517,122,64,7,193
"57518",1057518,135,100,8,243
"57519",1057519,179,46,10,235
"57520",1057520,208,45,14,267
"57521",1057521,158,75,6,239
"57522",1057522,74,90,6,170
"57523",1057523,88,107,3,198
"57524",1057524,183,117,15,315
"57525",1057525,21,180,1,202
"57526",1057526,6,6,0,12
"57527",1057527,111,90,14,215
"57528",1057528,149,70,10,229
"57529",1057529,38,171,2,211
"57530",1057530,7,4,1,12
"57531",1057531,28,268,4,300
"57532",1057532,95,56,10,161
"57533",1057533,122,94,3,219
"57534",1057534,68,147,18,233
"57535",1057535,95,127,14,236
"57536",1057536,74,192,3,269
"57537",1057537,93,112,2,207
"57538",1057538,203,10,2,215
"57539",1057539,128,29,2,159
"57540",1057540,82,195,7,284
"57541",1057541,101,119,12,232
"57542",1057542,195,92,15,302
"57543",1057543,96,67,3,166
"57544",1057544,89,109,0,198
"57545",1057545,78,219,5,302
"57546",1057546,67,162,5,234
"57547",1057547,52,147,16,215
"57548",1057548,12,23,0,35
"57549",1057549,81,145,14,240
"57550",1057550,80,127,10,217
"57551",1057551,116,130,3,249
"57552",1057552,123,62,14,199
"57553",1057553,67,256,7,330
"57554",1057554,111,118,5,234
"57555",1057555,118,211,9,338
"57556",1057556,167,132,8,307
"57557",1057557,69,43,5,117
"57558",1057558,214,66,3,283
"57559",1057559,195,29,1,225
"57560",1057560,47,186,1,234
"57561",1057561,200,141,12,353
"57562",1057562,114,93,10,217
"57563",1057563,79,187,9,275
"57564",1057564,177,83,10,270
"57565",1057565,57,217,4,278
"57566",1057566,49,155,6,210
"57567",1057567,137,130,9,276
"57568",1057568,21,264,8,293
"57569",1057569,6,4,0,10
"57570",1057570,82,129,6,217
"57571",1057571,60,216,17,293
"57572",1057572,146,70,12,228
"57573",1057573,182,36,9,227
"57574",1057574,220,42,6,268
"57575",1057575,194,43,9,246
"57576",1057576,235,26,4,265
"57577",1057577,12,67,2,81
"57578",1057578,103,122,7,232
"57579",1057579,158,39,11,208
"57580",1057580,54,214,12,280
"57581",1057581,64,28,2,94
"57582",1057582,193,80,15,288
"57583",1057583,72,233,3,308
"57584",1057584,41,250,6,297
"57585",1057585,66,249,7,322
"57586",1057586,58,201,0,259
"57587",1057587,28,126,8,162
"57588",1057588,16,16,0,32
"57589",1057589,29,139,3,171
"57590",1057590,42,209,4,255
"57591",1057591,126,112,9,247
"57592",1057592,97,147,7,251
"57593",1057593,155,74,14,243
"57594",1057594,204,114,10,328
"57595",1057595,82,196,12,290
"57596",1057596,141,145,20,306
"57597",1057597,155,115,14,284
"57598",1057598,194,16,8,218
"57599",1057599,44,181,5,230
"57600",1057600,55,201,3,259
"57601",1057601,36,126,3,165
"57602",1057602,162,39,5,206
"57603",1057603,153,96,15,264
"57604",1057604,181,110,19,310
"57605",1057605,65,135,5,205
"57606",1057606,86,1,0,87
"57607",1057607,83,107,2,192
"57608",1057608,184,66,4,254
"57609",1057609,118,87,16,221
"57610",1057610,196,86,13,295
"57611",1057611,178,52,14,244
"57612",1057612,139,62,12,213
"57613",1057613,56,60,2,118
"57614",1057614,60,96,10,166
"57615",1057615,84,156,5,245
"57616",1057616,139,2,1,142
"57617",1057617,132,59,6,197
"57618",1057618,150,36,7,193
"57619",1057619,191,57,8,256
"57620",1057620,81,245,12,338
"57621",1057621,120,70,4,194
"57622",1057622,31,53,3,87
"57623",1057623,103,102,7,212
"57624",1057624,119,165,11,295
"57625",1057625,133,53,10,196
"57626",1057626,223,67,19,309
"57627",1057627,42,199,5,246
"57628",1057628,91,194,4,289
"57629",1057629,23,211,4,238
"57630",1057630,134,26,2,162
"57631",1057631,66,159,7,232
"57632",1057632,61,157,4,222
"57633",1057633,123,151,10,284
"57634",1057634,176,44,16,236
"57635",1057635,62,31,0,93
"57636",1057636,31,184,7,222
"57637",1057637,41,163,4,208
"57638",1057638,34,28,2,64
"57639",1057639,155,26,8,189
"57640",1057640,207,27,5,239
"57641",1057641,75,176,25,276
"57642",1057642,108,152,8,268
"57643",1057643,37,130,1,168
"57644",1057644,67,51,2,120
"57645",1057645,208,85,8,301
"57646",1057646,69,191,12,272
"57647",1057647,135,16,1,152
"57648",1057648,50,168,4,222
"57649",1057649,142,67,1,210
"57650",1057650,89,21,5,115
"57651",1057651,142,159,11,312
"57652",1057652,109,172,13,294
"57653",1057653,39,14,5,58
"57654",1057654,40,18,1,59
"57655",1057655,202,31,9,242
"57656",1057656,115,58,8,181
"57657",1057657,86,127,4,217
"57658",1057658,105,48,8,161
"57659",1057659,17,84,3,104
"57660",1057660,127,21,3,151
"57661",1057661,83,72,8,163
"57662",1057662,191,40,5,236
"57663",1057663,167,87,12,266
"57664",1057664,132,46,7,185
"57665",1057665,113,128,8,249
"57666",1057666,156,74,10,240
"57667",1057667,201,49,14,264
"57668",1057668,118,105,3,226
"57669",1057669,152,71,10,233
"57670",1057670,53,233,6,292
"57671",1057671,25,24,2,51
"57672",1057672,28,162,5,195
"57673",1057673,51,137,11,199
"57674",1057674,103,119,5,227
"57675",1057675,210,76,7,293
"57676",1057676,238,17,6,261
"57677",1057677,150,147,6,303
"57678",1057678,192,47,9,248
"57679",1057679,167,116,16,299
"57680",1057680,96,123,8,227
"57681",1057681,147,119,19,285
"57682",1057682,145,45,11,201
"57683",1057683,227,35,13,275
"57684",1057684,2,27,0,29
"57685",1057685,149,24,3,176
"57686",1057686,23,25,4,52
"57687",1057687,116,68,16,200
"57688",1057688,84,142,6,232
"57689",1057689,107,67,6,180
"57690",1057690,156,150,7,313
"57691",1057691,13,248,7,268
"57692",1057692,122,127,2,251
"57693",1057693,60,54,8,122
"57694",1057694,53,200,18,271
"57695",1057695,33,75,1,109
"57696",1057696,43,29,1,73
"57697",1057697,8,9,2,19
"57698",1057698,80,152,3,235
"57699",1057699,100,174,7,281
"57700",1057700,50,12,2,64
"57701",1057701,179,43,5,227
"57702",1057702,99,153,4,256
"57703",1057703,29,14,2,45
"57704",1057704,137,83,13,233
"57705",1057705,54,237,10,301
"57706",1057706,226,25,13,264
"57707",1057707,126,46,9,181
"57708",1057708,128,65,3,196
"57709",1057709,156,110,16,282
"57710",1057710,60,105,13,178
"57711",1057711,115,49,5,169
"57712",1057712,145,83,2,230
"57713",1057713,184,30,4,218
"57714",1057714,110,201,9,320
"57715",1057715,145,122,8,275
"57716",1057716,186,83,7,276
"57717",1057717,67,231,12,310
"57718",1057718,115,92,7,214
"57719",1057719,62,243,8,313
"57720",1057720,10,5,0,15
"57721",1057721,123,160,18,301
"57722",1057722,46,213,27,286
"57723",1057723,5,40,1,46
"57724",1057724,192,36,7,235
"57725",1057725,136,23,4,163
"57726",1057726,93,160,6,259
"57727",1057727,73,195,7,275
"57728",1057728,21,242,1,264
"57729",1057729,32,54,5,91
"57730",1057730,100,151,13,264
"57731",1057731,15,295,11,321
"57732",1057732,129,65,11,205
"57733",1057733,138,81,11,230
"57734",1057734,101,34,4,139
"57735",1057735,28,194,7,229
"57736",1057736,136,71,9,216
"57737",1057737,110,62,8,180
"57738",1057738,115,74,3,192
"57739",1057739,75,134,9,218
"57740",1057740,53,256,8,317
"57741",1057741,142,52,13,207
"57742",1057742,129,13,3,145
"57743",1057743,104,130,10,244
"57744",1057744,134,149,4,287
"57745",1057745,162,66,2,230
"57746",1057746,64,189,6,259
"57747",1057747,87,68,3,158
"57748",1057748,62,186,11,259
"57749",1057749,158,126,15,299
"57750",1057750,53,41,6,100
"57751",1057751,183,114,12,309
"57752",1057752,116,51,5,172
"57753",1057753,131,83,11,225
"57754",1057754,34,69,0,103
"57755",1057755,107,161,18,286
"57756",1057756,83,140,2,225
"57757",1057757,214,40,8,262
"57758",1057758,49,207,8,264
"57759",1057759,55,124,4,183
"57760",1057760,117,139,16,272
"57761",1057761,75,143,0,218
"57762",1057762,53,188,7,248
"57763",1057763,31,239,1,271
"57764",1057764,114,126,15,255
"57765",1057765,66,153,13,232
"57766",1057766,170,70,3,243
"57767",1057767,199,45,5,249
"57768",1057768,130,87,18,235
"57769",1057769,154,20,6,180
"57770",1057770,121,66,0,187
"57771",1057771,74,128,11,213
"57772",1057772,130,62,19,211
"57773",1057773,108,130,5,243
"57774",1057774,41,179,10,230
"57775",1057775,142,75,5,222
"57776",1057776,240,69,9,318
"57777",1057777,10,26,1,37
"57778",1057778,203,104,12,319
"57779",1057779,192,52,8,252
"57780",1057780,73,195,5,273
"57781",1057781,68,208,3,279
"57782",1057782,187,71,7,265
"57783",1057783,118,73,3,194
"57784",1057784,62,19,2,83
"57785",1057785,191,140,17,348
"57786",1057786,149,96,8,253
"57787",1057787,113,78,12,203
"57788",1057788,113,154,17,284
"57789",1057789,54,210,5,269
"57790",1057790,42,229,6,277
"57791",1057791,130,32,6,168
"57792",1057792,130,54,10,194
"57793",1057793,7,42,0,49
"57794",1057794,173,133,7,313
"57795",1057795,204,51,12,267
"57796",1057796,127,36,4,167
"57797",1057797,25,41,0,66
"57798",1057798,205,19,6,230
"57799",1057799,52,224,11,287
"57800",1057800,260,25,5,290
"57801",1057801,166,30,7,203
"57802",1057802,136,37,8,181
"57803",1057803,193,8,8,209
"57804",1057804,90,146,8,244
"57805",1057805,107,22,5,134
"57806",1057806,94,10,4,108
"57807",1057807,106,154,8,268
"57808",1057808,145,41,10,196
"57809",1057809,110,114,8,232
"57810",1057810,138,121,12,271
"57811",1057811,162,79,9,250
"57812",1057812,49,158,12,219
"57813",1057813,22,219,4,245
"57814",1057814,162,46,3,211
"57815",1057815,78,202,5,285
"57816",1057816,99,165,3,267
"57817",1057817,67,125,21,213
"57818",1057818,232,51,7,290
"57819",1057819,123,48,8,179
"57820",1057820,97,36,4,137
"57821",1057821,41,23,2,66
"57822",1057822,47,205,10,262
"57823",1057823,29,40,0,69
"57824",1057824,186,22,7,215
"57825",1057825,39,197,7,243
"57826",1057826,25,80,9,114
"57827",1057827,47,115,10,172
"57828",1057828,42,28,0,70
"57829",1057829,162,13,5,180
"57830",1057830,118,70,3,191
"57831",1057831,40,105,4,149
"57832",1057832,73,126,7,206
"57833",1057833,94,117,9,220
"57834",1057834,73,9,4,86
"57835",1057835,62,154,5,221
"57836",1057836,27,57,3,87
"57837",1057837,130,100,11,241
"57838",1057838,170,79,5,254
"57839",1057839,150,10,2,162
"57840",1057840,141,63,12,216
"57841",1057841,107,47,1,155
"57842",1057842,174,45,10,229
"57843",1057843,112,188,6,306
"57844",1057844,124,57,5,186
"57845",1057845,137,73,5,215
"57846",1057846,81,151,18,250
"57847",1057847,27,283,11,321
"57848",1057848,15,138,6,159
"57849",1057849,54,91,15,160
"57850",1057850,113,55,4,172
"57851",1057851,137,82,5,224
"57852",1057852,0,8,0,8
"57853",1057853,14,57,0,71
"57854",1057854,193,70,10,273
"57855",1057855,82,113,10,205
"57856",1057856,130,44,6,180
"57857",1057857,134,81,8,223
"57858",1057858,100,218,3,321
"57859",1057859,80,77,3,160
"57860",1057860,92,149,5,246
"57861",1057861,36,175,4,215
"57862",1057862,116,61,2,179
"57863",1057863,212,68,22,302
"57864",1057864,40,4,0,44
"57865",1057865,125,44,20,189
"57866",1057866,41,247,2,290
"57867",1057867,259,28,15,302
"57868",1057868,4,260,1,265
"57869",1057869,128,26,5,159
"57870",1057870,117,120,10,247
"57871",1057871,159,15,9,183
"57872",1057872,116,88,18,222
"57873",1057873,103,91,15,209
"57874",1057874,156,19,4,179
"57875",1057875,133,67,1,201
"57876",1057876,231,18,6,255
"57877",1057877,100,157,19,276
"57878",1057878,185,17,4,206
"57879",1057879,56,202,8,266
"57880",1057880,81,159,7,247
"57881",1057881,151,78,6,235
"57882",1057882,204,24,5,233
"57883",1057883,25,10,0,35
"57884",1057884,109,125,11,245
"57885",1057885,252,34,4,290
"57886",1057886,44,114,7,165
"57887",1057887,73,76,6,155
"57888",1057888,66,140,6,212
"57889",1057889,119,101,3,223
"57890",1057890,11,268,4,283
"57891",1057891,1,26,0,27
"57892",1057892,78,135,6,219
"57893",1057893,133,91,11,235
"57894",1057894,158,83,14,255
"57895",1057895,160,109,7,276
"57896",1057896,112,87,8,207
"57897",1057897,104,166,25,295
"57898",1057898,21,217,1,239
"57899",1057899,59,100,0,159
"57900",1057900,265,243,35,543
"57901",1057901,58,171,10,239
"57902",1057902,173,66,10,249
"57903",1057903,66,130,4,200
"57904",1057904,99,160,11,270
"57905",1057905,96,51,7,154
"57906",1057906,176,121,25,322
"57907",1057907,103,78,4,185
"57908",1057908,10,74,0,84
"57909",1057909,71,242,10,323
"57910",1057910,184,20,6,210
"57911",1057911,122,146,11,279
"57912",1057912,127,172,16,315
"57913",1057913,87,204,8,299
"57914",1057914,76,126,5,207
"57915",1057915,117,51,7,175
"57916",1057916,52,90,6,148
"57917",1057917,113,155,9,277
"57918",1057918,168,56,9,233
"57919",1057919,192,30,18,240
"57920",1057920,156,44,1,201
"57921",1057921,188,36,12,236
"57922",1057922,191,78,21,290
"57923",1057923,86,60,4,150
"57924",1057924,21,27,1,49
"57925",1057925,161,79,13,253
"57926",1057926,116,75,15,206
"57927",1057927,164,108,13,285
"57928",1057928,220,40,5,265
"57929",1057929,186,26,12,224
"57930",1057930,226,26,7,259
"57931",1057931,8,3,1,12
"57932",1057932,76,158,1,235
"57933",1057933,43,262,1,306
"57934",1057934,96,145,1,242
"57935",1057935,103,48,16,167
"57936",1057936,76,29,1,106
"57937",1057937,144,109,8,261
"57938",1057938,260,25,9,294
"57939",1057939,89,118,5,212
"57940",1057940,156,207,16,379
"57941",1057941,207,53,8,268
"57942",1057942,42,45,1,88
"57943",1057943,156,47,5,208
"57944",1057944,97,123,7,227
"57945",1057945,177,58,18,253
"57946",1057946,43,238,7,288
"57947",1057947,80,47,2,129
"57948",1057948,84,137,9,230
"57949",1057949,44,156,6,206
"57950",1057950,72,60,6,138
"57951",1057951,114,177,24,315
"57952",1057952,80,192,11,283
"57953",1057953,197,48,11,256
"57954",1057954,15,214,3,232
"57955",1057955,193,38,7,238
"57956",1057956,48,212,17,277
"57957",1057957,31,5,0,36
"57958",1057958,141,146,7,294
"57959",1057959,95,92,10,197
"57960",1057960,146,64,11,221
"57961",1057961,44,252,3,299
"57962",1057962,58,10,5,73
"57963",1057963,41,28,3,72
"57964",1057964,28,15,3,46
"57965",1057965,18,237,1,256
"57966",1057966,98,61,5,164
"57967",1057967,185,33,7,225
"57968",1057968,179,148,16,343
"57969",1057969,181,28,7,216
"57970",1057970,121,55,7,183
"57971",1057971,102,248,3,353
"57972",1057972,108,47,5,160
"57973",1057973,15,42,1,58
"57974",1057974,127,180,21,328
"57975",1057975,91,108,15,214
"57976",1057976,99,135,6,240
"57977",1057977,96,58,0,154
"57978",1057978,55,82,1,138
"57979",1057979,89,112,10,211
"57980",1057980,156,24,1,181
"57981",1057981,139,123,2,264
"57982",1057982,152,29,1,182
"57983",1057983,96,45,5,146
"57984",1057984,176,60,1,237
"57985",1057985,94,62,2,158
"57986",1057986,130,90,22,242
"57987",1057987,110,44,8,162
"57988",1057988,75,184,9,268
"57989",1057989,23,37,0,60
"57990",1057990,61,213,8,282
"57991",1057991,170,121,12,303
"57992",1057992,154,60,15,229
"57993",1057993,3,11,0,14
"57994",1057994,93,182,6,281
"57995",1057995,196,32,8,236
"57996",1057996,63,204,16,283
"57997",1057997,81,256,9,346
"57998",1057998,182,18,5,205
"57999",1057999,22,267,7,296
"58000",1058000,22,222,3,247
"58001",1058001,62,71,7,140
"58002",1058002,140,139,8,287
"58003",1058003,164,31,15,210
"58004",1058004,132,103,4,239
"58005",1058005,177,102,5,284
"58006",1058006,205,107,16,328
"58007",1058007,89,123,12,224
"58008",1058008,75,188,4,267
"58009",1058009,195,45,12,252
"58010",1058010,70,93,8,171
"58011",1058011,75,103,16,194
"58012",1058012,203,27,16,246
"58013",1058013,19,172,2,193
"58014",1058014,204,76,18,298
"58015",1058015,139,146,26,311
"58016",1058016,65,102,7,174
"58017",1058017,23,188,2,213
"58018",1058018,94,62,3,159
"58019",1058019,114,99,4,217
"58020",1058020,228,26,17,271
"58021",1058021,114,28,2,144
"58022",1058022,130,37,7,174
"58023",1058023,214,15,5,234
"58024",1058024,56,91,4,151
"58025",1058025,129,116,9,254
"58026",1058026,60,244,10,314
"58027",1058027,223,70,9,302
"58028",1058028,78,170,7,255
"58029",1058029,76,32,4,112
"58030",1058030,236,27,3,266
"58031",1058031,97,148,4,249
"58032",1058032,100,89,5,194
"58033",1058033,145,54,12,211
"58034",1058034,4,82,1,87
"58035",1058035,171,92,14,277
"58036",1058036,129,30,13,172
"58037",1058037,87,233,15,335
"58038",1058038,52,146,7,205
"58039",1058039,67,174,6,247
"58040",1058040,155,57,15,227
"58041",1058041,149,21,6,176
"58042",1058042,53,67,10,130
"58043",1058043,133,151,5,289
"58044",1058044,37,19,1,57
"58045",1058045,62,185,3,250
"58046",1058046,51,225,2,278
"58047",1058047,141,100,6,247
"58048",1058048,101,180,8,289
"58049",1058049,246,65,11,322
"58050",1058050,159,98,2,259
"58051",1058051,62,178,19,259
"58052",1058052,163,68,11,242
"58053",1058053,119,92,6,217
"58054",1058054,152,62,4,218
"58055",1058055,67,196,29,292
"58056",1058056,144,59,6,209
"58057",1058057,153,43,11,207
"58058",1058058,88,197,15,300
"58059",1058059,166,140,26,332
"58060",1058060,135,103,20,258
"58061",1058061,151,88,12,251
"58062",1058062,8,94,1,103
"58063",1058063,75,118,0,193
"58064",1058064,134,49,13,196
"58065",1058065,179,30,13,222
"58066",1058066,162,81,2,245
"58067",1058067,68,225,7,300
"58068",1058068,150,134,15,299
"58069",1058069,32,219,12,263
"58070",1058070,113,124,1,238
"58071",1058071,178,22,16,216
"58072",1058072,84,152,11,247
"58073",1058073,97,82,4,183
"58074",1058074,122,58,7,187
"58075",1058075,202,15,2,219
"58076",1058076,51,121,10,182
"58077",1058077,140,68,4,212
"58078",1058078,5,0,1,6
"58079",1058079,90,145,8,243
"58080",1058080,53,144,4,201
"58081",1058081,37,141,17,195
"58082",1058082,107,18,4,129
"58083",1058083,108,113,14,235
"58084",1058084,95,174,17,286
"58085",1058085,23,138,3,164
"58086",1058086,69,212,12,293
"58087",1058087,42,305,8,355
"58088",1058088,213,40,15,268
"58089",1058089,23,62,5,90
"58090",1058090,8,5,1,14
"58091",1058091,195,41,8,244
"58092",1058092,109,185,11,305
"58093",1058093,138,55,9,202
"58094",1058094,165,8,1,174
"58095",1058095,92,69,4,165
"58096",1058096,47,145,7,199
"58097",1058097,11,114,3,128
"58098",1058098,43,261,10,314
"58099",1058099,150,115,10,275
"58100",1058100,137,127,9,273
"58101",1058101,17,65,4,86
"58102",1058102,70,202,16,288
"58103",1058103,13,3,0,16
"58104",1058104,46,6,1,53
"58105",1058105,115,96,8,219
"58106",1058106,196,74,12,282
"58107",1058107,184,13,4,201
"58108",1058108,41,147,13,201
"58109",1058109,107,45,3,155
"58110",1058110,165,82,2,249
"58111",1058111,21,204,6,231
"58112",1058112,236,25,10,271
"58113",1058113,193,60,3,256
"58114",1058114,69,197,7,273
"58115",1058115,75,222,3,300
"58116",1058116,52,187,17,256
"58117",1058117,125,99,12,236
"58118",1058118,101,176,12,289
"58119",1058119,156,70,7,233
"58120",1058120,123,70,7,200
"58121",1058121,124,117,17,258
"58122",1058122,109,149,11,269
"58123",1058123,55,95,10,160
"58124",1058124,82,177,8,267
"58125",1058125,206,15,12,233
"58126",1058126,160,59,15,234
"58127",1058127,91,59,9,159
"58128",1058128,179,55,6,240
"58129",1058129,154,0,0,154
"58130",1058130,58,226,11,295
"58131",1058131,30,257,2,289
"58132",1058132,95,101,13,209
"58133",1058133,99,172,4,275
"58134",1058134,44,219,1,264
"58135",1058135,71,29,9,109
"58136",1058136,113,92,3,208
"58137",1058137,74,174,11,259
"58138",1058138,114,59,4,177
"58139",1058139,28,221,10,259
"58140",1058140,8,159,0,167
"58141",1058141,100,128,19,247
"58142",1058142,18,245,3,266
"58143",1058143,133,139,9,281
"58144",1058144,53,111,11,175
"58145",1058145,119,46,12,177
"58146",1058146,158,0,1,159
"58147",1058147,85,181,13,279
"58148",1058148,184,104,19,307
"58149",1058149,30,250,3,283
"58150",1058150,145,64,11,220
"58151",1058151,112,156,4,272
"58152",1058152,44,182,7,233
"58153",1058153,156,25,3,184
"58154",1058154,5,1,0,6
"58155",1058155,83,185,10,278
"58156",1058156,166,102,9,277
"58157",1058157,70,113,7,190
"58158",1058158,146,140,5,291
"58159",1058159,137,96,8,241
"58160",1058160,21,224,2,247
"58161",1058161,36,110,5,151
"58162",1058162,18,324,0,342
"58163",1058163,123,133,14,270
"58164",1058164,68,241,6,315
"58165",1058165,59,242,15,316
"58166",1058166,202,60,6,268
"58167",1058167,47,159,9,215
"58168",1058168,235,53,8,296
"58169",1058169,163,51,5,219
"58170",1058170,117,117,9,243
"58171",1058171,112,179,12,303
"58172",1058172,123,37,9,169
"58173",1058173,242,52,8,302
"58174",1058174,69,115,6,190
"58175",1058175,185,88,6,279
"58176",1058176,92,183,8,283
"58177",1058177,120,119,11,250
"58178",1058178,36,122,6,164
"58179",1058179,163,162,0,325
"58180",1058180,93,117,13,223
"58181",1058181,150,78,10,238
"58182",1058182,26,0,0,26
"58183",1058183,201,14,5,220
"58184",1058184,144,127,22,293
"58185",1058185,22,271,4,297
"58186",1058186,165,25,4,194
"58187",1058187,127,121,2,250
"58188",1058188,107,102,10,219
"58189",1058189,200,66,6,272
"58190",1058190,134,98,5,237
"58191",1058191,169,65,13,247
"58192",1058192,135,57,2,194
"58193",1058193,35,44,2,81
"58194",1058194,17,54,0,71
"58195",1058195,155,82,15,252
"58196",1058196,25,17,2,44
"58197",1058197,181,102,10,293
"58198",1058198,105,181,21,307
"58199",1058199,108,104,15,227
"58200",1058200,121,146,5,272
"58201",1058201,50,211,16,277
"58202",1058202,179,74,10,263
"58203",1058203,205,86,23,314
"58204",1058204,49,180,4,233
"58205",1058205,150,49,11,210
"58206",1058206,193,40,19,252
"58207",1058207,66,189,6,261
"58208",1058208,122,132,6,260
"58209",1058209,29,0,2,31
"58210",1058210,123,73,6,202
"58211",1058211,112,135,1,248
"58212",1058212,180,56,5,241
"58213",1058213,73,164,25,262
"58214",1058214,77,208,11,296
"58215",1058215,124,105,6,235
"58216",1058216,132,158,4,294
"58217",1058217,96,57,11,164
"58218",1058218,126,9,1,136
"58219",1058219,190,85,13,288
"58220",1058220,35,229,3,267
"58221",1058221,134,111,8,253
"58222",1058222,181,77,4,262
"58223",1058223,102,77,13,192
"58224",1058224,61,151,6,218
"58225",1058225,62,253,4,319
"58226",1058226,281,14,4,299
"58227",1058227,62,155,14,231
"58228",1058228,33,314,1,348
"58229",1058229,75,166,8,249
"58230",1058230,168,181,12,361
"58231",1058231,110,155,14,279
"58232",1058232,125,53,16,194
"58233",1058233,142,77,5,224
"58234",1058234,48,135,4,187
"58235",1058235,64,86,11,161
"58236",1058236,38,6,0,44
"58237",1058237,128,109,11,248
"58238",1058238,155,147,18,320
"58239",1058239,188,56,13,257
"58240",1058240,54,165,17,236
"58241",1058241,9,58,0,67
"58242",1058242,204,17,3,224
"58243",1058243,148,72,13,233
"58244",1058244,5,41,0,46
"58245",1058245,177,41,19,237
"58246",1058246,84,181,18,283
"58247",1058247,92,181,10,283
"58248",1058248,65,225,3,293
"58249",1058249,72,43,1,116
"58250",1058250,148,116,12,276
"58251",1058251,100,189,9,298
"58252",1058252,78,110,9,197
"58253",1058253,82,35,2,119
"58254",1058254,193,70,8,271
"58255",1058255,157,102,9,268
"58256",1058256,37,206,5,248
"58257",1058257,3,50,1,54
"58258",1058258,172,60,13,245
"58259",1058259,157,98,3,258
"58260",1058260,44,159,5,208
"58261",1058261,157,51,3,211
"58262",1058262,69,212,8,289
"58263",1058263,69,7,4,80
"58264",1058264,5,36,1,42
"58265",1058265,141,121,15,277
"58266",1058266,91,95,14,200
"58267",1058267,36,193,5,234
"58268",1058268,60,5,1,66
"58269",1058269,111,40,5,156
"58270",1058270,47,68,11,126
"58271",1058271,16,91,2,109
"58272",1058272,137,118,6,261
"58273",1058273,156,34,2,192
"58274",1058274,48,190,22,260
"58275",1058275,186,92,12,290
"58276",1058276,72,34,1,107
"58277",1058277,155,114,3,272
"58278",1058278,181,81,1,263
"58279",1058279,188,34,9,231
"58280",1058280,25,228,2,255
"58281",1058281,173,17,6,196
"58282",1058282,142,131,7,280
"58283",1058283,164,39,7,210
"58284",1058284,69,157,8,234
"58285",1058285,189,37,4,230
"58286",1058286,185,64,5,254
"58287",1058287,80,104,8,192
"58288",1058288,50,29,2,81
"58289",1058289,39,13,1,53
"58290",1058290,107,84,6,197
"58291",1058291,90,237,11,338
"58292",1058292,190,35,4,229
"58293",1058293,160,28,5,193
"58294",1058294,100,17,1,118
"58295",1058295,186,69,13,268
"58296",1058296,37,235,3,275
"58297",1058297,88,115,8,211
"58298",1058298,56,154,0,210
"58299",1058299,226,76,8,310
"58300",1058300,60,207,14,281
"58301",1058301,150,77,16,243
"58302",1058302,13,54,2,69
"58303",1058303,50,145,11,206
"58304",1058304,209,52,13,274
"58305",1058305,256,38,11,305
"58306",1058306,191,24,3,218
"58307",1058307,86,158,3,247
"58308",1058308,114,120,13,247
"58309",1058309,175,19,14,208
"58310",1058310,90,89,7,186
"58311",1058311,80,167,17,264
"58312",1058312,169,97,9,275
"58313",1058313,126,31,6,163
"58314",1058314,45,160,12,217
"58315",1058315,171,9,3,183
"58316",1058316,86,43,4,133
"58317",1058317,157,104,12,273
"58318",1058318,153,135,11,299
"58319",1058319,73,77,5,155
"58320",1058320,146,131,10,287
"58321",1058321,99,154,9,262
"58322",1058322,63,180,6,249
"58323",1058323,113,37,9,159
"58324",1058324,60,46,4,110
"58325",1058325,259,7,10,276
"58326",1058326,43,39,2,84
"58327",1058327,23,216,5,244
"58328",1058328,140,178,7,325
"58329",1058329,149,52,7,208
"58330",1058330,4,0,0,4
"58331",1058331,40,73,4,117
"58332",1058332,186,25,7,218
"58333",1058333,39,62,1,102
"58334",1058334,43,136,3,182
"58335",1058335,170,104,21,295
"58336",1058336,73,146,5,224
"58337",1058337,54,9,2,65
"58338",1058338,205,55,11,271
"58339",1058339,52,180,19,251
"58340",1058340,100,153,12,265
"58341",1058341,257,13,9,279
"58342",1058342,70,252,7,329
"58343",1058343,208,4,4,216
"58344",1058344,152,140,6,298
"58345",1058345,214,71,12,297
"58346",1058346,145,58,6,209
"58347",1058347,115,54,11,180
"58348",1058348,39,192,10,241
"58349",1058349,82,201,17,300
"58350",1058350,5,1,0,6
"58351",1058351,160,70,2,232
"58352",1058352,9,143,4,156
"58353",1058353,210,68,20,298
"58354",1058354,17,223,7,247
"58355",1058355,94,41,5,140
"58356",1058356,26,151,5,182
"58357",1058357,102,197,22,321
"58358",1058358,39,63,4,106
"58359",1058359,261,71,6,338
"58360",1058360,71,177,8,256
"58361",1058361,102,183,8,293
"58362",1058362,81,114,11,206
"58363",1058363,71,233,9,313
"58364",1058364,84,114,4,202
"58365",1058365,116,16,2,134
"58366",1058366,214,26,11,251
"58367",1058367,169,59,9,237
"58368",1058368,56,76,2,134
"58369",1058369,115,59,5,179
"58370",1058370,87,113,8,208
"58371",1058371,147,158,12,317
"58372",1058372,128,95,12,235
"58373",1058373,87,180,17,284
"58374",1058374,38,189,4,231
"58375",1058375,151,107,10,268
"58376",1058376,122,74,12,208
"58377",1058377,174,101,10,285
"58378",1058378,97,93,15,205
"58379",1058379,111,169,17,297
"58380",1058380,73,16,0,89
"58381",1058381,170,89,20,279
"58382",1058382,58,185,2,245
"58383",1058383,64,223,6,293
"58384",1058384,20,255,1,276
"58385",1058385,30,243,4,277
"58386",1058386,70,165,9,244
"58387",1058387,12,132,0,144
"58388",1058388,219,24,6,249
"58389",1058389,147,20,8,175
"58390",1058390,59,103,8,170
"58391",1058391,242,38,11,291
"58392",1058392,24,204,3,231
"58393",1058393,126,67,13,206
"58394",1058394,80,10,2,92
"58395",1058395,121,137,9,267
"58396",1058396,136,135,19,290
"58397",1058397,64,41,1,106
"58398",1058398,135,159,8,302
"58399",1058399,75,7,1,83
"58400",1058400,104,82,16,202
"58401",1058401,45,25,3,73
"58402",1058402,66,146,4,216
"58403",1058403,131,54,11,196
"58404",1058404,128,64,8,200
"58405",1058405,136,63,2,201
"58406",1058406,70,191,21,282
"58407",1058407,208,56,12,276
"58408",1058408,174,114,10,298
"58409",1058409,164,121,10,295
"58410",1058410,52,88,5,145
"58411",1058411,203,113,10,326
"58412",1058412,53,199,5,257
"58413",1058413,133,73,11,217
"58414",1058414,38,41,2,81
"58415",1058415,227,45,12,284
"58416",1058416,124,141,4,269
"58417",1058417,146,113,14,273
"58418",1058418,36,227,2,265
"58419",1058419,163,43,1,207
"58420",1058420,98,30,5,133
"58421",1058421,235,39,15,289
"58422",1058422,137,71,11,219
"58423",1058423,100,161,16,277
"58424",1058424,222,31,2,255
"58425",1058425,138,135,12,285
"58426",1058426,43,209,8,260
"58427",1058427,165,102,20,287
"58428",1058428,72,207,6,285
"58429",1058429,153,116,10,279
"58430",1058430,146,178,7,331
"58431",1058431,76,155,19,250
"58432",1058432,116,66,10,192
"58433",1058433,100,185,11,296
"58434",1058434,184,70,4,258
"58435",1058435,96,173,16,285
"58436",1058436,96,196,13,305
"58437",1058437,119,71,8,198
"58438",1058438,99,135,10,244
"58439",1058439,33,251,7,291
"58440",1058440,97,69,3,169
"58441",1058441,255,14,5,274
"58442",1058442,91,108,4,203
"58443",1058443,32,59,4,95
"58444",1058444,133,170,25,328
"58445",1058445,23,147,7,177
"58446",1058446,147,108,5,260
"58447",1058447,124,128,13,265
"58448",1058448,62,86,6,154
"58449",1058449,146,81,9,236
"58450",1058450,247,15,3,265
"58451",1058451,42,52,7,101
"58452",1058452,101,70,2,173
"58453",1058453,147,50,7,204
"58454",1058454,112,80,6,198
"58455",1058455,227,38,5,270
"58456",1058456,125,30,4,159
"58457",1058457,50,13,2,65
"58458",1058458,309,97,5,411
"58459",1058459,122,146,14,282
"58460",1058460,178,92,8,278
"58461",1058461,24,102,1,127
"58462",1058462,138,98,7,243
"58463",1058463,126,150,12,288
"58464",1058464,79,90,13,182
"58465",1058465,206,7,4,217
"58466",1058466,211,68,18,297
"58467",1058467,56,92,8,156
"58468",1058468,74,155,8,237
"58469",1058469,235,4,3,242
"58470",1058470,123,69,19,211
"58471",1058471,47,179,0,226
"58472",1058472,54,146,4,204
"58473",1058473,170,112,6,288
"58474",1058474,120,30,5,155
"58475",1058475,93,141,16,250
"58476",1058476,62,28,4,94
"58477",1058477,43,69,0,112
"58478",1058478,37,96,4,137
"58479",1058479,64,261,4,329
"58480",1058480,198,58,11,267
"58481",1058481,51,18,2,71
"58482",1058482,98,111,3,212
"58483",1058483,9,41,3,53
"58484",1058484,25,272,2,299
"58485",1058485,151,120,12,283
"58486",1058486,165,92,15,272
"58487",1058487,101,119,1,221
"58488",1058488,44,210,10,264
"58489",1058489,102,235,6,343
"58490",1058490,52,177,10,239
"58491",1058491,94,88,10,192
"58492",1058492,63,32,2,97
"58493",1058493,100,92,15,207
"58494",1058494,71,202,3,276
"58495",1058495,160,113,12,285
"58496",1058496,33,53,0,86
"58497",1058497,45,185,4,234
"58498",1058498,91,165,0,256
"58499",1058499,159,86,8,253
"58500",1058500,65,199,5,269
"58501",1058501,128,102,7,237
"58502",1058502,116,157,8,281
"58503",1058503,13,303,1,317
"58504",1058504,78,152,6,236
"58505",1058505,211,55,15,281
"58506",1058506,34,27,0,61
"58507",1058507,20,69,1,90
"58508",1058508,152,103,1,256
"58509",1058509,88,145,13,246
"58510",1058510,189,90,1,280
"58511",1058511,128,80,9,217
"58512",1058512,139,28,7,174
"58513",1058513,83,19,3,105
"58514",1058514,160,35,12,207
"58515",1058515,149,51,11,211
"58516",1058516,206,28,8,242
"58517",1058517,144,148,14,306
"58518",1058518,55,104,7,166
"58519",1058519,162,20,9,191
"58520",1058520,14,202,3,219
"58521",1058521,112,188,3,303
"58522",1058522,52,248,5,305
"58523",1058523,118,123,6,247
"58524",1058524,198,21,12,231
"58525",1058525,125,170,10,305
"58526",1058526,91,241,12,344
"58527",1058527,47,26,4,77
"58528",1058528,50,248,15,313
"58529",1058529,228,62,11,301
"58530",1058530,75,202,31,308
"58531",1058531,78,45,3,126
"58532",1058532,41,254,18,313
"58533",1058533,177,55,12,244
"58534",1058534,104,26,2,132
"58535",1058535,105,19,5,129
"58536",1058536,51,213,16,280
"58537",1058537,151,74,11,236
"58538",1058538,65,139,2,206
"58539",1058539,72,164,6,242
"58540",1058540,120,199,10,329
"58541",1058541,66,45,3,114
"58542",1058542,98,107,7,212
"58543",1058543,232,48,5,285
"58544",1058544,111,25,10,146
"58545",1058545,143,82,6,231
"58546",1058546,70,236,7,313
"58547",1058547,92,166,7,265
"58548",1058548,139,81,12,232
"58549",1058549,63,194,6,263
"58550",1058550,9,1,0,10
"58551",1058551,69,88,6,163
"58552",1058552,60,91,6,157
"58553",1058553,121,91,8,220
"58554",1058554,18,299,14,331
"58555",1058555,113,92,9,214
"58556",1058556,191,26,8,225
"58557",1058557,139,70,13,222
"58558",1058558,30,220,6,256
"58559",1058559,58,171,11,240
"58560",1058560,116,25,4,145
"58561",1058561,60,199,9,268
"58562",1058562,160,11,1,172
"58563",1058563,125,129,39,293
"58564",1058564,181,57,7,245
"58565",1058565,41,241,6,288
"58566",1058566,76,203,10,289
"58567",1058567,45,16,2,63
"58568",1058568,134,61,19,214
"58569",1058569,60,234,10,304
"58570",1058570,138,50,9,197
"58571",1058571,219,61,10,290
"58572",1058572,130,137,22,289
"58573",1058573,35,122,2,159
"58574",1058574,48,206,1,255
"58575",1058575,65,116,0,181
"58576",1058576,110,167,7,284
"58577",1058577,115,44,10,169
"58578",1058578,150,74,3,227
"58579",1058579,178,57,9,244
"58580",1058580,126,49,5,180
"58581",1058581,128,143,14,285
"58582",1058582,111,108,5,224
"58583",1058583,180,42,11,233
"58584",1058584,103,94,7,204
"58585",1058585,231,11,5,247
"58586",1058586,184,133,16,333
"58587",1058587,26,259,9,294
"58588",1058588,56,175,2,233
"58589",1058589,13,20,0,33
"58590",1058590,120,135,14,269
"58591",1058591,108,42,7,157
"58592",1058592,177,68,2,247
"58593",1058593,45,155,17,217
"58594",1058594,139,70,8,217
"58595",1058595,138,81,5,224
"58596",1058596,110,90,6,206
"58597",1058597,70,102,3,175
"58598",1058598,115,65,4,184
"58599",1058599,235,34,6,275
"58600",1058600,97,52,4,153
"58601",1058601,179,37,8,224
"58602",1058602,124,156,8,288
"58603",1058603,47,46,3,96
"58604",1058604,189,37,5,231
"58605",1058605,57,72,15,144
"58606",1058606,149,86,5,240
"58607",1058607,127,60,7,194
"58608",1058608,221,62,4,287
"58609",1058609,125,140,4,269
"58610",1058610,28,118,6,152
"58611",1058611,89,112,14,215
"58612",1058612,44,254,2,300
"58613",1058613,8,34,0,42
"58614",1058614,125,62,6,193
"58615",1058615,134,147,24,305
"58616",1058616,97,41,11,149
"58617",1058617,194,53,4,251
"58618",1058618,71,77,4,152
"58619",1058619,71,138,18,227
"58620",1058620,120,180,3,303
"58621",1058621,136,22,4,162
"58622",1058622,13,5,0,18
"58623",1058623,185,92,23,300
"58624",1058624,26,31,3,60
"58625",1058625,93,107,6,206
"58626",1058626,49,135,6,190
"58627",1058627,179,26,6,211
"58628",1058628,60,161,4,225
"58629",1058629,101,130,7,238
"58630",1058630,118,143,13,274
"58631",1058631,148,147,6,301
"58632",1058632,58,42,10,110
"58633",1058633,35,124,4,163
"58634",1058634,64,211,15,290
"58635",1058635,48,1,1,50
"58636",1058636,46,43,0,89
"58637",1058637,209,65,29,303
"58638",1058638,177,76,8,261
"58639",1058639,133,25,7,165
"58640",1058640,81,216,10,307
"58641",1058641,154,31,7,192
"58642",1058642,99,156,13,268
"58643",1058643,21,128,2,151
"58644",1058644,17,188,3,208
"58645",1058645,87,110,6,203
"58646",1058646,54,25,0,79
"58647",1058647,107,19,1,127
"58648",1058648,14,205,2,221
"58649",1058649,155,104,13,272
"58650",1058650,180,71,14,265
"58651",1058651,54,103,4,161
"58652",1058652,131,176,9,316
"58653",1058653,124,66,17,207
"58654",1058654,137,139,7,283
"58655",1058655,119,70,10,199
"58656",1058656,9,0,0,9
"58657",1058657,31,179,7,217
"58658",1058658,170,87,20,277
"58659",1058659,127,151,8,286
"58660",1058660,64,209,21,294
"58661",1058661,143,108,10,261
"58662",1058662,110,142,9,261
"58663",1058663,160,20,2,182
"58664",1058664,139,128,8,275
"58665",1058665,172,44,13,229
"58666",1058666,18,14,1,33
"58667",1058667,7,1,1,9
"58668",1058668,101,145,4,250
"58669",1058669,316,82,16,414
"58670",1058670,30,126,1,157
"58671",1058671,143,57,10,210
"58672",1058672,49,155,3,207
"58673",1058673,106,162,8,276
"58674",1058674,272,30,2,304
"58675",1058675,179,60,4,243
"58676",1058676,180,105,16,301
"58677",1058677,167,51,10,228
"58678",1058678,152,81,15,248
"58679",1058679,44,241,3,288
"58680",1058680,26,206,7,239
"58681",1058681,193,70,3,266
"58682",1058682,109,59,13,181
"58683",1058683,47,94,11,152
"58684",1058684,61,142,9,212
"58685",1058685,100,77,0,177
"58686",1058686,117,132,16,265
"58687",1058687,114,60,18,192
"58688",1058688,108,154,9,271
"58689",1058689,147,20,7,174
"58690",1058690,144,19,3,166
"58691",1058691,221,29,8,258
"58692",1058692,40,268,8,316
"58693",1058693,152,145,7,304
"58694",1058694,66,5,0,71
"58695",1058695,44,16,2,62
"58696",1058696,140,134,13,287
"58697",1058697,24,178,4,206
"58698",1058698,60,107,4,171
"58699",1058699,55,246,8,309
"58700",1058700,155,105,3,263
"58701",1058701,52,80,16,148
"58702",1058702,170,29,6,205
"58703",1058703,71,184,15,270
"58704",1058704,74,162,13,249
"58705",1058705,140,66,2,208
"58706",1058706,155,55,6,216
"58707",1058707,193,65,4,262
"58708",1058708,45,229,3,277
"58709",1058709,147,133,5,285
"58710",1058710,105,58,2,165
"58711",1058711,123,134,11,268
"58712",1058712,147,162,13,322
"58713",1058713,103,108,10,221
"58714",1058714,14,308,1,323
"58715",1058715,68,198,8,274
"58716",1058716,103,75,11,189
"58717",1058717,19,140,0,159
"58718",1058718,181,202,9,392
"58719",1058719,62,121,6,189
"58720",1058720,127,82,14,223
"58721",1058721,232,21,14,267
"58722",1058722,56,152,5,213
"58723",1058723,206,80,12,298
"58724",1058724,41,133,9,183
"58725",1058725,202,21,6,229
"58726",1058726,138,1,0,139
"58727",1058727,102,179,6,287
"58728",1058728,95,121,20,236
"58729",1058729,42,177,9,228
"58730",1058730,85,118,13,216
"58731",1058731,124,75,19,218
"58732",1058732,169,101,7,277
"58733",1058733,216,72,13,301
"58734",1058734,28,5,0,33
"58735",1058735,37,153,1,191
"58736",1058736,161,100,3,264
"58737",1058737,158,32,6,196
"58738",1058738,19,37,1,57
"58739",1058739,116,131,18,265
"58740",1058740,141,74,5,220
"58741",1058741,46,218,13,277
"58742",1058742,117,86,14,217
"58743",1058743,121,38,4,163
"58744",1058744,37,271,9,317
"58745",1058745,179,62,11,252
"58746",1058746,191,50,11,252
"58747",1058747,132,88,28,248
"58748",1058748,107,61,3,171
"58749",1058749,175,39,15,229
"58750",1058750,244,16,4,264
"58751",1058751,121,111,14,246
"58752",1058752,33,186,12,231
"58753",1058753,99,199,16,314
"58754",1058754,150,92,14,256
"58755",1058755,92,129,4,225
"58756",1058756,131,114,11,256
"58757",1058757,8,9,1,18
"58758",1058758,166,36,6,208
"58759",1058759,81,97,15,193
"58760",1058760,125,92,1,218
"58761",1058761,148,64,16,228
"58762",1058762,187,43,8,238
"58763",1058763,221,91,14,326
"58764",1058764,152,64,12,228
"58765",1058765,111,186,9,306
"58766",1058766,114,160,12,286
"58767",1058767,24,6,0,30
"58768",1058768,139,51,4,194
"58769",1058769,88,177,12,277
"58770",1058770,175,35,12,222
"58771",1058771,221,71,16,308
"58772",1058772,147,50,10,207
"58773",1058773,193,75,10,278
"58774",1058774,77,61,7,145
"58775",1058775,101,94,4,199
"58776",1058776,238,20,13,271
"58777",1058777,64,107,2,173
"58778",1058778,191,55,11,257
"58779",1058779,143,118,14,275
"58780",1058780,46,272,10,328
"58781",1058781,55,250,3,308
"58782",1058782,173,37,8,218
"58783",1058783,154,139,23,316
"58784",1058784,217,25,9,251
"58785",1058785,45,190,10,245
"58786",1058786,41,17,1,59
"58787",1058787,135,24,6,165
"58788",1058788,228,71,13,312
"58789",1058789,120,46,8,174
"58790",1058790,154,72,5,231
"58791",1058791,72,117,3,192
"58792",1058792,139,45,5,189
"58793",1058793,46,0,1,47
"58794",1058794,176,63,14,253
"58795",1058795,101,49,9,159
"58796",1058796,148,82,6,236
"58797",1058797,52,113,14,179
"58798",1058798,73,166,10,249
"58799",1058799,48,179,11,238
"58800",1058800,69,138,12,219
"58801",1058801,13,184,1,198
"58802",1058802,62,221,6,289
"58803",1058803,104,199,10,313
"58804",1058804,74,210,8,292
"58805",1058805,203,88,18,309
"58806",1058806,102,11,5,118
"58807",1058807,165,79,6,250
"58808",1058808,51,118,15,184
"58809",1058809,105,87,10,202
"58810",1058810,154,60,9,223
"58811",1058811,33,231,4,268
"58812",1058812,10,8,1,19
"58813",1058813,10,103,7,120
"58814",1058814,129,195,7,331
"58815",1058815,32,21,3,56
"58816",1058816,64,77,8,149
"58817",1058817,26,203,9,238
"58818",1058818,148,102,14,264
"58819",1058819,114,132,4,250
"58820",1058820,210,59,12,281
"58821",1058821,114,84,16,214
"58822",1058822,114,125,1,240
"58823",1058823,216,49,13,278
"58824",1058824,145,90,6,241
"58825",1058825,124,115,3,242
"58826",1058826,40,19,4,63
"58827",1058827,52,161,6,219
"58828",1058828,235,8,7,250
"58829",1058829,126,41,1,168
"58830",1058830,200,37,15,252
"58831",1058831,55,19,3,77
"58832",1058832,89,245,13,347
"58833",1058833,170,17,9,196
"58834",1058834,169,90,6,265
"58835",1058835,135,107,5,247
"58836",1058836,187,82,8,277
"58837",1058837,133,114,13,260
"58838",1058838,10,123,1,134
"58839",1058839,102,91,6,199
"58840",1058840,252,55,12,319
"58841",1058841,164,43,6,213
"58842",1058842,207,50,9,266
"58843",1058843,166,227,22,415
"58844",1058844,152,67,2,221
"58845",1058845,81,37,3,121
"58846",1058846,48,17,2,67
"58847",1058847,139,35,9,183
"58848",1058848,147,130,12,289
"58849",1058849,131,58,8,197
"58850",1058850,133,66,2,201
"58851",1058851,28,12,0,40
"58852",1058852,16,243,2,261
"58853",1058853,132,101,16,249
"58854",1058854,113,160,12,285
"58855",1058855,125,35,8,168
"58856",1058856,154,135,14,303
"58857",1058857,133,183,13,329
"58858",1058858,21,134,4,159
"58859",1058859,50,197,10,257
"58860",1058860,122,135,2,259
"58861",1058861,136,125,9,270
"58862",1058862,110,85,6,201
"58863",1058863,26,264,2,292
"58864",1058864,173,133,11,317
"58865",1058865,98,47,6,151
"58866",1058866,21,263,8,292
"58867",1058867,5,173,2,180
"58868",1058868,57,0,1,58
"58869",1058869,81,130,5,216
"58870",1058870,17,233,5,255
"58871",1058871,51,115,13,179
"58872",1058872,56,182,4,242
"58873",1058873,135,72,9,216
"58874",1058874,33,81,1,115
"58875",1058875,216,53,13,282
"58876",1058876,47,116,7,170
"58877",1058877,177,24,6,207
"58878",1058878,151,147,28,326
"58879",1058879,154,61,14,229
"58880",1058880,113,148,8,269
"58881",1058881,151,18,5,174
"58882",1058882,121,110,8,239
"58883",1058883,154,281,24,459
"58884",1058884,123,215,17,355
"58885",1058885,144,56,4,204
"58886",1058886,89,180,20,289
"58887",1058887,24,55,2,81
"58888",1058888,67,163,1,231
"58889",1058889,99,115,4,218
"58890",1058890,76,183,4,263
"58891",1058891,115,163,25,303
"58892",1058892,41,106,2,149
"58893",1058893,128,37,13,178
"58894",1058894,192,18,9,219
"58895",1058895,142,135,11,288
"58896",1058896,211,62,14,287
"58897",1058897,53,155,4,212
"58898",1058898,0,16,0,16
"58899",1058899,144,126,13,283
"58900",1058900,88,141,3,232
"58901",1058901,148,26,4,178
"58902",1058902,130,120,29,279
"58903",1058903,119,28,6,153
"58904",1058904,54,180,17,251
"58905",1058905,46,187,17,250
"58906",1058906,186,66,4,256
"58907",1058907,100,65,7,172
"58908",1058908,172,81,3,256
"58909",1058909,158,26,9,193
"58910",1058910,9,274,2,285
"58911",1058911,69,110,2,181
"58912",1058912,54,217,10,281
"58913",1058913,182,78,14,274
"58914",1058914,89,160,17,266
"58915",1058915,55,133,7,195
"58916",1058916,111,146,4,261
"58917",1058917,168,48,11,227
"58918",1058918,50,422,7,479
"58919",1058919,202,43,9,254
"58920",1058920,133,149,19,301
"58921",1058921,163,97,4,264
"58922",1058922,24,5,0,29
"58923",1058923,197,31,6,234
"58924",1058924,90,125,3,218
"58925",1058925,69,233,8,310
"58926",1058926,84,164,5,253
"58927",1058927,100,58,13,171
"58928",1058928,92,82,8,182
"58929",1058929,219,0,2,221
"58930",1058930,91,22,3,116
"58931",1058931,116,89,2,207
"58932",1058932,197,18,12,227
"58933",1058933,55,59,6,120
"58934",1058934,137,113,11,261
"58935",1058935,34,19,1,54
"58936",1058936,132,73,11,216
"58937",1058937,89,95,3,187
"58938",1058938,29,232,5,266
"58939",1058939,104,108,9,221
"58940",1058940,164,26,5,195
"58941",1058941,22,12,0,34
"58942",1058942,180,56,4,240
"58943",1058943,151,16,14,181
"58944",1058944,97,111,13,221
"58945",1058945,167,151,10,328
"58946",1058946,158,18,10,186
"58947",1058947,245,63,10,318
"58948",1058948,78,162,11,251
"58949",1058949,184,74,7,265
"58950",1058950,30,23,2,55
"58951",1058951,29,203,7,239
"58952",1058952,216,37,8,261
"58953",1058953,121,109,9,239
"58954",1058954,137,72,11,220
"58955",1058955,82,175,4,261
"58956",1058956,159,158,7,324
"58957",1058957,74,144,8,226
"58958",1058958,51,198,8,257
"58959",1058959,184,61,14,259
"58960",1058960,185,64,18,267
"58961",1058961,49,221,3,273
"58962",1058962,150,78,13,241
"58963",1058963,139,31,7,177
"58964",1058964,59,42,4,105
"58965",1058965,94,181,6,281
"58966",1058966,44,176,2,222
"58967",1058967,121,38,3,162
"58968",1058968,203,18,6,227
"58969",1058969,191,59,14,264
"58970",1058970,129,42,9,180
"58971",1058971,42,72,2,116
"58972",1058972,92,251,4,347
"58973",1058973,45,58,6,109
"58974",1058974,34,25,1,60
"58975",1058975,208,47,12,267
"58976",1058976,88,175,21,284
"58977",1058977,88,147,28,263
"58978",1058978,159,48,9,216
"58979",1058979,126,44,17,187
"58980",1058980,155,98,10,263
"58981",1058981,67,217,6,290
"58982",1058982,176,91,15,282
"58983",1058983,93,163,5,261
"58984",1058984,22,43,2,67
"58985",1058985,64,59,4,127
"58986",1058986,35,105,3,143
"58987",1058987,182,75,25,282
"58988",1058988,49,72,1,122
"58989",1058989,53,151,5,209
"58990",1058990,50,6,0,56
"58991",1058991,49,94,7,150
"58992",1058992,60,79,6,145
"58993",1058993,114,103,8,225
"58994",1058994,114,81,8,203
"58995",1058995,94,187,18,299
"58996",1058996,197,117,17,331
"58997",1058997,94,105,5,204
"58998",1058998,44,144,1,189
"58999",1058999,308,7,3,318
"59000",1059000,67,162,15,244
"59001",1059001,78,90,2,170
"59002",1059002,185,5,2,192
"59003",1059003,106,68,7,181
"59004",1059004,77,180,11,268
"59005",1059005,189,80,15,284
"59006",1059006,103,131,4,238
"59007",1059007,192,20,6,218
"59008",1059008,142,33,6,181
"59009",1059009,174,104,4,282
"59010",1059010,145,65,5,215
"59011",1059011,164,122,14,300
"59012",1059012,39,160,7,206
"59013",1059013,74,165,11,250
"59014",1059014,154,132,12,298
"59015",1059015,34,162,15,211
"59016",1059016,210,83,11,304
"59017",1059017,180,94,6,280
"59018",1059018,161,95,12,268
"59019",1059019,1,0,0,1
"59020",1059020,135,46,4,185
"59021",1059021,50,82,6,138
"59022",1059022,88,140,9,237
"59023",1059023,223,32,5,260
"59024",1059024,99,134,3,236
"59025",1059025,97,9,0,106
"59026",1059026,146,77,1,224
"59027",1059027,203,31,6,240
"59028",1059028,50,148,2,200
"59029",1059029,118,79,4,201
"59030",1059030,168,105,4,277
"59031",1059031,154,42,13,209
"59032",1059032,77,151,13,241
"59033",1059033,73,149,3,225
"59034",1059034,210,28,11,249
"59035",1059035,135,94,7,236
"59036",1059036,43,254,1,298
"59037",1059037,167,56,3,226
"59038",1059038,170,44,4,218
"59039",1059039,77,181,12,270
"59040",1059040,42,131,8,181
"59041",1059041,96,178,24,298
"59042",1059042,87,181,6,274
"59043",1059043,125,49,9,183
"59044",1059044,109,162,19,290
"59045",1059045,3,11,1,15
"59046",1059046,137,62,3,202
"59047",1059047,71,162,18,251
"59048",1059048,55,285,11,351
"59049",1059049,134,66,18,218
"59050",1059050,233,61,13,307
"59051",1059051,152,76,8,236
"59052",1059052,95,108,1,204
"59053",1059053,18,6,0,24
"59054",1059054,35,216,10,261
"59055",1059055,189,78,8,275
"59056",1059056,27,140,7,174
"59057",1059057,31,134,6,171
"59058",1059058,50,236,6,292
"59059",1059059,73,191,8,272
"59060",1059060,175,96,11,282
"59061",1059061,185,49,5,239
"59062",1059062,111,25,8,144
"59063",1059063,268,43,8,319
"59064",1059064,93,91,10,194
"59065",1059065,109,67,2,178
"59066",1059066,2,97,0,99
"59067",1059067,186,67,8,261
"59068",1059068,77,236,11,324
"59069",1059069,140,49,6,195
"59070",1059070,42,144,6,192
"59071",1059071,162,33,6,201
"59072",1059072,79,161,9,249
"59073",1059073,54,188,17,259
"59074",1059074,98,40,2,140
"59075",1059075,81,162,7,250
"59076",1059076,223,16,8,247
"59077",1059077,72,52,4,128
"59078",1059078,219,68,20,307
"59079",1059079,44,40,2,86
"59080",1059080,31,203,3,237
"59081",1059081,165,18,4,187
"59082",1059082,24,18,6,48
"59083",1059083,8,1,0,9
"59084",1059084,139,93,4,236
"59085",1059085,106,52,5,163
"59086",1059086,203,65,8,276
"59087",1059087,153,52,8,213
"59088",1059088,5,59,1,65
"59089",1059089,175,80,9,264
"59090",1059090,36,50,2,88
"59091",1059091,195,20,11,226
"59092",1059092,90,186,9,285
"59093",1059093,115,39,9,163
"59094",1059094,183,38,9,230
"59095",1059095,20,251,6,277
"59096",1059096,2,53,2,57
"59097",1059097,163,61,4,228
"59098",1059098,146,140,12,298
"59099",1059099,163,79,5,247
"59100",1059100,213,10,7,230
"59101",1059101,59,72,3,134
"59102",1059102,54,136,3,193
"59103",1059103,148,124,12,284
"59104",1059104,103,176,10,289
"59105",1059105,149,48,4,201
"59106",1059106,156,41,7,204
"59107",1059107,43,290,3,336
"59108",1059108,69,28,4,101
"59109",1059109,51,238,11,300
"59110",1059110,116,119,12,247
"59111",1059111,14,2,0,16
"59112",1059112,38,152,4,194
"59113",1059113,81,166,5,252
"59114",1059114,163,38,12,213
"59115",1059115,102,126,12,240
"59116",1059116,128,48,14,190
"59117",1059117,159,64,4,227
"59118",1059118,85,242,3,330
"59119",1059119,152,37,6,195
"59120",1059120,118,148,14,280
"59121",1059121,122,143,7,272
"59122",1059122,12,0,0,12
"59123",1059123,209,75,4,288
"59124",1059124,182,16,5,203
"59125",1059125,159,36,2,197
"59126",1059126,56,232,10,298
"59127",1059127,68,178,5,251
"59128",1059128,52,187,13,252
"59129",1059129,218,128,17,363
"59130",1059130,200,28,1,229
"59131",1059131,111,136,12,259
"59132",1059132,231,85,14,330
"59133",1059133,203,83,31,317
"59134",1059134,74,184,12,270
"59135",1059135,124,65,8,197
"59136",1059136,62,135,6,203
"59137",1059137,123,209,4,336
"59138",1059138,168,138,10,316
"59139",1059139,57,147,12,216
"59140",1059140,40,227,7,274
"59141",1059141,143,13,3,159
"59142",1059142,43,9,4,56
"59143",1059143,311,114,8,433
"59144",1059144,32,171,4,207
"59145",1059145,66,246,3,315
"59146",1059146,110,83,4,197
"59147",1059147,147,74,14,235
"59148",1059148,91,171,8,270
"59149",1059149,135,49,6,190
"59150",1059150,20,17,1,38
"59151",1059151,108,92,2,202
"59152",1059152,90,156,14,260
"59153",1059153,108,75,4,187
"59154",1059154,101,110,10,221
"59155",1059155,68,199,11,278
"59156",1059156,119,91,16,226
"59157",1059157,137,57,16,210
"59158",1059158,93,39,0,132
"59159",1059159,127,159,6,292
"59160",1059160,193,115,0,308
"59161",1059161,61,213,12,286
"59162",1059162,90,62,7,159
"59163",1059163,132,67,9,208
"59164",1059164,14,9,1,24
"59165",1059165,108,101,7,216
"59166",1059166,109,211,11,331
"59167",1059167,4,12,0,16
"59168",1059168,164,16,9,189
"59169",1059169,151,41,13,205
"59170",1059170,92,181,13,286
"59171",1059171,168,96,11,275
"59172",1059172,125,127,8,260
"59173",1059173,7,6,0,13
"59174",1059174,117,58,18,193
"59175",1059175,59,163,8,230
"59176",1059176,117,98,15,230
"59177",1059177,102,81,17,200
"59178",1059178,80,121,7,208
"59179",1059179,80,43,1,124
"59180",1059180,79,175,8,262
"59181",1059181,98,62,2,162
"59182",1059182,181,27,3,211
"59183",1059183,258,63,3,324
"59184",1059184,173,30,5,208
"59185",1059185,69,51,2,122
"59186",1059186,40,217,2,259
"59187",1059187,39,159,9,207
"59188",1059188,183,107,15,305
"59189",1059189,141,85,5,231
"59190",1059190,145,110,6,261
"59191",1059191,149,50,6,205
"59192",1059192,98,33,5,136
"59193",1059193,25,259,11,295
"59194",1059194,7,262,2,271
"59195",1059195,62,32,4,98
"59196",1059196,83,117,4,204
"59197",1059197,36,203,7,246
"59198",1059198,31,25,7,63
"59199",1059199,24,68,3,95
"59200",1059200,39,105,4,148
"59201",1059201,40,186,2,228
"59202",1059202,146,48,7,201
"59203",1059203,93,10,5,108
"59204",1059204,93,75,10,178
"59205",1059205,107,77,9,193
"59206",1059206,39,231,6,276
"59207",1059207,79,203,5,287
"59208",1059208,80,193,5,278
"59209",1059209,182,54,3,239
"59210",1059210,139,52,11,202
"59211",1059211,70,108,12,190
"59212",1059212,175,69,9,253
"59213",1059213,92,44,6,142
"59214",1059214,102,43,5,150
"59215",1059215,152,5,4,161
"59216",1059216,160,114,19,293
"59217",1059217,113,15,2,130
"59218",1059218,67,39,9,115
"59219",1059219,65,204,11,280
"59220",1059220,136,120,11,267
"59221",1059221,172,84,3,259
"59222",1059222,257,50,8,315
"59223",1059223,121,58,15,194
"59224",1059224,30,136,5,171
"59225",1059225,67,96,20,183
"59226",1059226,186,47,7,240
"59227",1059227,169,66,6,241
"59228",1059228,193,124,4,321
"59229",1059229,215,73,10,298
"59230",1059230,242,42,11,295
"59231",1059231,136,135,3,274
"59232",1059232,93,147,14,254
"59233",1059233,113,76,7,196
"59234",1059234,11,46,1,58
"59235",1059235,7,4,0,11
"59236",1059236,45,32,4,81
"59237",1059237,49,39,3,91
"59238",1059238,112,30,9,151
"59239",1059239,91,14,7,112
"59240",1059240,304,0,4,308
"59241",1059241,104,197,20,321
"59242",1059242,153,44,6,203
"59243",1059243,124,51,7,182
"59244",1059244,106,176,14,296
"59245",1059245,44,167,10,221
"59246",1059246,168,116,17,301
"59247",1059247,97,117,14,228
"59248",1059248,98,112,3,213
"59249",1059249,148,62,8,218
"59250",1059250,124,101,15,240
"59251",1059251,74,24,5,103
"59252",1059252,121,58,10,189
"59253",1059253,110,74,4,188
"59254",1059254,188,21,5,214
"59255",1059255,150,138,8,296
"59256",1059256,208,15,8,231
"59257",1059257,202,86,19,307
"59258",1059258,67,90,17,174
"59259",1059259,8,12,0,20
"59260",1059260,10,2,0,12
"59261",1059261,128,169,8,305
"59262",1059262,19,171,4,194
"59263",1059263,83,17,3,103
"59264",1059264,104,103,19,226
"59265",1059265,95,84,6,185
"59266",1059266,65,92,17,174
"59267",1059267,50,181,2,233
"59268",1059268,196,126,9,331
"59269",1059269,84,44,1,129
"59270",1059270,126,20,2,148
"59271",1059271,138,115,16,269
"59272",1059272,117,45,14,176
"59273",1059273,145,6,5,156
"59274",1059274,101,68,5,174
"59275",1059275,182,54,9,245
"59276",1059276,91,112,5,208
"59277",1059277,8,162,0,170
"59278",1059278,103,84,13,200
"59279",1059279,209,11,4,224
"59280",1059280,147,81,16,244
"59281",1059281,54,96,6,156
"59282",1059282,220,54,12,286
"59283",1059283,137,78,14,229
"59284",1059284,56,243,7,306
"59285",1059285,90,197,10,297
"59286",1059286,70,131,2,203
"59287",1059287,39,112,1,152
"59288",1059288,153,134,17,304
"59289",1059289,102,89,13,204
"59290",1059290,134,85,4,223
"59291",1059291,64,213,17,294
"59292",1059292,44,6,1,51
"59293",1059293,107,32,3,142
"59294",1059294,230,52,14,296
"59295",1059295,56,196,8,260
"59296",1059296,226,75,13,314
"59297",1059297,205,75,5,285
"59298",1059298,77,190,15,282
"59299",1059299,159,24,6,189
"59300",1059300,48,92,4,144
"59301",1059301,157,117,6,280
"59302",1059302,130,105,20,255
"59303",1059303,85,43,2,130
"59304",1059304,34,10,3,47
"59305",1059305,182,14,1,197
"59306",1059306,148,57,6,211
"59307",1059307,141,146,8,295
"59308",1059308,37,189,6,232
"59309",1059309,125,104,8,237
"59310",1059310,122,31,2,155
"59311",1059311,73,196,16,285
"59312",1059312,86,195,15,296
"59313",1059313,24,209,7,240
"59314",1059314,71,104,7,182
"59315",1059315,68,197,5,270
"59316",1059316,67,217,14,298
"59317",1059317,24,165,4,193
"59318",1059318,131,84,13,228
"59319",1059319,44,151,1,196
"59320",1059320,70,210,12,292
"59321",1059321,49,221,14,284
"59322",1059322,21,7,1,29
"59323",1059323,126,155,6,287
"59324",1059324,82,145,8,235
"59325",1059325,133,152,7,292
"59326",1059326,13,12,0,25
"59327",1059327,180,30,13,223
"59328",1059328,80,172,4,256
"59329",1059329,42,88,2,132
"59330",1059330,113,120,6,239
"59331",1059331,131,38,5,174
"59332",1059332,194,57,6,257
"59333",1059333,110,172,2,284
"59334",1059334,44,204,4,252
"59335",1059335,64,5,1,70
"59336",1059336,98,188,9,295
"59337",1059337,55,215,4,274
"59338",1059338,23,131,1,155
"59339",1059339,74,106,13,193
"59340",1059340,130,17,3,150
"59341",1059341,128,36,9,173
"59342",1059342,96,118,5,219
"59343",1059343,149,137,8,294
"59344",1059344,91,214,9,314
"59345",1059345,121,164,9,294
"59346",1059346,77,8,3,88
"59347",1059347,83,96,8,187
"59348",1059348,73,230,3,306
"59349",1059349,105,77,6,188
"59350",1059350,92,193,26,311
"59351",1059351,91,50,19,160
"59352",1059352,49,34,1,84
"59353",1059353,68,151,5,224
"59354",1059354,67,41,5,113
"59355",1059355,141,67,15,223
"59356",1059356,164,70,4,238
"59357",1059357,194,32,4,230
"59358",1059358,99,134,9,242
"59359",1059359,227,115,18,360
"59360",1059360,77,87,4,168
"59361",1059361,221,7,3,231
"59362",1059362,87,148,12,247
"59363",1059363,202,43,8,253
"59364",1059364,34,92,13,139
"59365",1059365,107,165,11,283
"59366",1059366,121,35,8,164
"59367",1059367,182,78,1,261
"59368",1059368,150,40,3,193
"59369",1059369,76,180,7,263
"59370",1059370,132,123,8,263
"59371",1059371,192,85,6,283
"59372",1059372,101,112,7,220
"59373",1059373,144,118,13,275
"59374",1059374,92,199,7,298
"59375",1059375,140,61,10,211
"59376",1059376,40,204,9,253
"59377",1059377,44,28,2,74
"59378",1059378,125,17,4,146
"59379",1059379,41,157,6,204
"59380",1059380,35,247,12,294
"59381",1059381,49,195,14,258
"59382",1059382,150,52,5,207
"59383",1059383,198,69,3,270
"59384",1059384,42,128,10,180
"59385",1059385,75,258,7,340
"59386",1059386,2,5,0,7
"59387",1059387,104,114,11,229
"59388",1059388,74,78,0,152
"59389",1059389,122,62,4,188
"59390",1059390,39,122,9,170
"59391",1059391,75,109,7,191
"59392",1059392,34,182,4,220
"59393",1059393,80,151,10,241
"59394",1059394,11,32,0,43
"59395",1059395,40,273,12,325
"59396",1059396,122,193,19,334
"59397",1059397,54,170,19,243
"59398",1059398,90,39,3,132
"59399",1059399,116,65,12,193
"59400",1059400,86,188,4,278
"59401",1059401,105,63,7,175
"59402",1059402,122,134,13,269
"59403",1059403,49,125,6,180
"59404",1059404,73,8,2,83
"59405",1059405,35,214,4,253
"59406",1059406,95,59,4,158
"59407",1059407,75,14,4,93
"59408",1059408,66,195,3,264
"59409",1059409,164,77,14,255
"59410",1059410,142,142,23,307
"59411",1059411,106,25,5,136
"59412",1059412,231,18,8,257
"59413",1059413,156,5,3,164
"59414",1059414,87,185,6,278
"59415",1059415,105,94,4,203
"59416",1059416,192,59,9,260
"59417",1059417,184,104,12,300
"59418",1059418,46,184,7,237
"59419",1059419,189,45,10,244
"59420",1059420,110,34,4,148
"59421",1059421,89,218,3,310
"59422",1059422,48,174,10,232
"59423",1059423,145,90,12,247
"59424",1059424,161,126,7,294
"59425",1059425,136,93,13,242
"59426",1059426,53,171,1,225
"59427",1059427,270,29,6,305
"59428",1059428,95,198,7,300
"59429",1059429,99,141,3,243
"59430",1059430,131,75,12,218
"59431",1059431,62,208,10,280
"59432",1059432,48,275,2,325
"59433",1059433,113,168,22,303
"59434",1059434,133,57,10,200
"59435",1059435,171,69,12,252
"59436",1059436,29,6,3,38
"59437",1059437,71,118,5,194
"59438",1059438,124,39,4,167
"59439",1059439,113,57,5,175
"59440",1059440,45,106,11,162
"59441",1059441,119,92,10,221
"59442",1059442,111,69,5,185
"59443",1059443,109,134,12,255
"59444",1059444,217,41,12,270
"59445",1059445,198,65,11,274
"59446",1059446,53,256,2,311
"59447",1059447,10,98,3,111
"59448",1059448,96,45,8,149
"59449",1059449,115,30,4,149
"59450",1059450,49,266,3,318
"59451",1059451,44,236,8,288
"59452",1059452,97,178,22,297
"59453",1059453,165,39,3,207
"59454",1059454,44,247,8,299
"59455",1059455,132,70,4,206
"59456",1059456,169,41,3,213
"59457",1059457,158,57,11,226
"59458",1059458,145,14,3,162
"59459",1059459,74,150,6,230
"59460",1059460,134,162,9,305
"59461",1059461,65,144,10,219
"59462",1059462,57,207,11,275
"59463",1059463,67,87,6,160
"59464",1059464,71,172,9,252
"59465",1059465,94,65,9,168
"59466",1059466,120,70,4,194
"59467",1059467,143,61,3,207
"59468",1059468,36,164,9,209
"59469",1059469,75,64,3,142
"59470",1059470,116,86,13,215
"59471",1059471,204,22,10,236
"59472",1059472,168,27,10,205
"59473",1059473,25,96,6,127
"59474",1059474,123,139,7,269
"59475",1059475,191,30,8,229
"59476",1059476,45,20,0,65
"59477",1059477,44,27,5,76
"59478",1059478,119,85,13,217
"59479",1059479,154,31,8,193
"59480",1059480,59,193,7,259
"59481",1059481,100,115,11,226
"59482",1059482,93,77,2,172
"59483",1059483,146,73,0,219
"59484",1059484,70,86,12,168
"59485",1059485,9,171,1,181
"59486",1059486,94,112,12,218
"59487",1059487,71,130,7,208
"59488",1059488,111,121,15,247
"59489",1059489,21,173,2,196
"59490",1059490,47,156,16,219
"59491",1059491,43,187,10,240
"59492",1059492,63,184,3,250
"59493",1059493,47,27,1,75
"59494",1059494,118,95,5,218
"59495",1059495,25,229,6,260
"59496",1059496,136,71,7,214
"59497",1059497,116,134,3,253
"59498",1059498,70,1,2,73
"59499",1059499,50,1,1,52
"59500",1059500,213,84,9,306
"59501",1059501,103,144,13,260
"59502",1059502,84,195,7,286
"59503",1059503,116,133,7,256
"59504",1059504,171,59,5,235
"59505",1059505,32,232,8,272
"59506",1059506,158,71,5,234
"59507",1059507,234,17,7,258
"59508",1059508,177,37,6,220
"59509",1059509,107,190,10,307
"59510",1059510,74,197,4,275
"59511",1059511,152,57,9,218
"59512",1059512,91,128,25,244
"59513",1059513,185,23,10,218
"59514",1059514,164,136,5,305
"59515",1059515,13,8,1,22
"59516",1059516,30,176,5,211
"59517",1059517,88,212,16,316
"59518",1059518,80,226,3,309
"59519",1059519,224,88,8,320
"59520",1059520,78,147,11,236
"59521",1059521,91,66,3,160
"59522",1059522,87,178,7,272
"59523",1059523,52,132,3,187
"59524",1059524,73,157,15,245
"59525",1059525,77,103,3,183
"59526",1059526,79,214,6,299
"59527",1059527,89,44,5,138
"59528",1059528,177,67,4,248
"59529",1059529,1,1,0,2
"59530",1059530,83,85,8,176
"59531",1059531,129,125,15,269
"59532",1059532,179,70,13,262
"59533",1059533,106,69,5,180
"59534",1059534,140,72,8,220
"59535",1059535,96,128,3,227
"59536",1059536,213,23,13,249
"59537",1059537,194,130,8,332
"59538",1059538,59,72,0,131
"59539",1059539,101,75,2,178
"59540",1059540,111,116,10,237
"59541",1059541,30,175,13,218
"59542",1059542,91,89,2,182
"59543",1059543,106,26,7,139
"59544",1059544,140,106,14,260
"59545",1059545,106,179,6,291
"59546",1059546,137,66,4,207
"59547",1059547,181,74,21,276
"59548",1059548,131,203,14,348
"59549",1059549,44,193,12,249
"59550",1059550,113,115,2,230
"59551",1059551,171,139,9,319
"59552",1059552,86,101,10,197
"59553",1059553,27,248,5,280
"59554",1059554,153,41,5,199
"59555",1059555,170,155,31,356
"59556",1059556,198,59,10,267
"59557",1059557,113,31,3,147
"59558",1059558,116,149,9,274
"59559",1059559,221,23,10,254
"59560",1059560,34,178,10,222
"59561",1059561,92,64,6,162
"59562",1059562,131,73,8,212
"59563",1059563,22,240,6,268
"59564",1059564,204,124,12,340
"59565",1059565,210,73,18,301
"59566",1059566,41,54,3,98
"59567",1059567,133,71,2,206
"59568",1059568,169,111,11,291
"59569",1059569,15,2,2,19
"59570",1059570,78,122,9,209
"59571",1059571,239,53,13,305
"59572",1059572,104,81,3,188
"59573",1059573,128,17,1,146
"59574",1059574,90,187,9,286
"59575",1059575,74,49,3,126
"59576",1059576,26,167,5,198
"59577",1059577,220,21,8,249
"59578",1059578,57,155,8,220
"59579",1059579,87,102,5,194
"59580",1059580,103,144,11,258
"59581",1059581,42,114,3,159
"59582",1059582,128,46,1,175
"59583",1059583,63,178,8,249
"59584",1059584,166,18,4,188
"59585",1059585,79,153,7,239
"59586",1059586,41,148,7,196
"59587",1059587,201,39,7,247
"59588",1059588,45,220,2,267
"59589",1059589,40,244,9,293
"59590",1059590,258,45,11,314
"59591",1059591,98,155,9,262
"59592",1059592,118,147,9,274
"59593",1059593,33,186,7,226
"59594",1059594,185,18,12,215
"59595",1059595,140,45,12,197
"59596",1059596,162,60,7,229
"59597",1059597,81,175,9,265
"59598",1059598,97,67,9,173
"59599",1059599,101,193,12,306
"59600",1059600,233,26,18,277
"59601",1059601,31,86,5,122
"59602",1059602,139,89,12,240
"59603",1059603,113,158,4,275
"59604",1059604,69,202,15,286
"59605",1059605,166,59,2,227
"59606",1059606,54,187,7,248
"59607",1059607,56,239,8,303
"59608",1059608,122,56,3,181
"59609",1059609,89,143,6,238
"59610",1059610,162,78,11,251
"59611",1059611,89,40,10,139
"59612",1059612,183,103,9,295
"59613",1059613,157,95,1,253
"59614",1059614,183,98,3,284
"59615",1059615,17,70,2,89
"59616",1059616,127,28,8,163
"59617",1059617,180,135,3,318
"59618",1059618,61,87,3,151
"59619",1059619,5,5,2,12
"59620",1059620,198,39,6,243
"59621",1059621,96,115,10,221
"59622",1059622,235,30,9,274
"59623",1059623,59,108,3,170
"59624",1059624,196,27,11,234
"59625",1059625,73,0,0,73
"59626",1059626,110,110,8,228
"59627",1059627,177,107,15,299
"59628",1059628,203,66,11,280
"59629",1059629,121,90,6,217
"59630",1059630,44,210,7,261
"59631",1059631,61,28,3,92
"59632",1059632,203,70,24,297
"59633",1059633,140,112,13,265
"59634",1059634,86,108,13,207
"59635",1059635,98,73,5,176
"59636",1059636,180,35,5,220
"59637",1059637,171,28,6,205
"59638",1059638,106,69,5,180
"59639",1059639,101,47,1,149
"59640",1059640,138,76,9,223
"59641",1059641,98,23,3,124
"59642",1059642,17,6,0,23
"59643",1059643,88,230,18,336
"59644",1059644,143,43,4,190
"59645",1059645,249,23,2,274
"59646",1059646,212,17,5,234
"59647",1059647,139,87,11,237
"59648",1059648,68,216,11,295
"59649",1059649,54,11,1,66
"59650",1059650,61,222,8,291
"59651",1059651,68,229,9,306
"59652",1059652,92,170,2,264
"59653",1059653,145,92,11,248
"59654",1059654,113,186,7,306
"59655",1059655,71,203,8,282
"59656",1059656,98,129,12,239
"59657",1059657,147,38,11,196
"59658",1059658,207,53,8,268
"59659",1059659,85,139,4,228
"59660",1059660,82,112,4,198
"59661",1059661,191,127,13,331
"59662",1059662,159,66,11,236
"59663",1059663,65,130,3,198
"59664",1059664,80,224,23,327
"59665",1059665,28,237,4,269
"59666",1059666,97,143,12,252
"59667",1059667,171,124,5,300
"59668",1059668,154,50,13,217
"59669",1059669,76,40,5,121
"59670",1059670,63,183,13,259
"59671",1059671,165,116,2,283
"59672",1059672,237,25,4,266
"59673",1059673,145,9,4,158
"59674",1059674,37,243,3,283
"59675",1059675,50,140,2,192
"59676",1059676,130,87,5,222
"59677",1059677,7,15,2,24
"59678",1059678,141,133,2,276
"59679",1059679,166,72,11,249
"59680",1059680,155,21,2,178
"59681",1059681,12,307,2,321
"59682",1059682,124,11,9,144
"59683",1059683,60,182,7,249
"59684",1059684,143,75,8,226
"59685",1059685,13,265,2,280
"59686",1059686,43,188,3,234
"59687",1059687,87,148,5,240
"59688",1059688,138,125,4,267
"59689",1059689,149,126,12,287
"59690",1059690,165,77,5,247
"59691",1059691,35,15,2,52
"59692",1059692,191,25,9,225
"59693",1059693,141,47,8,196
"59694",1059694,50,222,6,278
"59695",1059695,69,100,21,190
"59696",1059696,60,89,7,156
"59697",1059697,135,54,6,195
"59698",1059698,141,92,4,237
"59699",1059699,118,195,4,317
"59700",1059700,131,115,5,251
"59701",1059701,210,28,4,242
"59702",1059702,169,124,19,312
"59703",1059703,174,89,7,270
"59704",1059704,170,87,16,273
"59705",1059705,104,154,9,267
"59706",1059706,193,121,20,334
"59707",1059707,42,20,1,63
"59708",1059708,163,70,8,241
"59709",1059709,174,36,7,217
"59710",1059710,104,104,21,229
"59711",1059711,34,178,11,223
"59712",1059712,69,75,9,153
"59713",1059713,189,92,17,298
"59714",1059714,150,81,6,237
"59715",1059715,12,88,5,105
"59716",1059716,112,123,6,241
"59717",1059717,101,143,20,264
"59718",1059718,167,111,20,298
"59719",1059719,173,69,16,258
"59720",1059720,18,124,5,147
"59721",1059721,278,164,17,459
"59722",1059722,178,50,8,236
"59723",1059723,179,109,6,294
"59724",1059724,124,127,5,256
"59725",1059725,127,46,8,181
"59726",1059726,86,59,1,146
"59727",1059727,162,111,4,277
"59728",1059728,233,3,2,238
"59729",1059729,165,66,5,236
"59730",1059730,100,42,1,143
"59731",1059731,68,155,14,237
"59732",1059732,149,146,11,306
"59733",1059733,99,115,7,221
"59734",1059734,103,93,2,198
"59735",1059735,56,87,8,151
"59736",1059736,158,111,20,289
"59737",1059737,103,67,6,176
"59738",1059738,119,92,6,217
"59739",1059739,136,82,5,223
"59740",1059740,187,121,7,315
"59741",1059741,200,52,7,259
"59742",1059742,100,132,17,249
"59743",1059743,213,23,5,241
"59744",1059744,54,109,10,173
"59745",1059745,143,50,6,199
"59746",1059746,48,201,6,255
"59747",1059747,103,144,5,252
"59748",1059748,42,61,2,105
"59749",1059749,84,232,6,322
"59750",1059750,47,165,6,218
"59751",1059751,117,110,13,240
"59752",1059752,48,180,10,238
"59753",1059753,12,4,1,17
"59754",1059754,56,207,6,269
"59755",1059755,44,41,3,88
"59756",1059756,174,19,5,198
"59757",1059757,76,6,4,86
"59758",1059758,66,130,12,208
"59759",1059759,117,173,20,310
"59760",1059760,166,66,8,240
"59761",1059761,106,19,6,131
"59762",1059762,122,133,11,266
"59763",1059763,125,96,14,235
"59764",1059764,69,81,12,162
"59765",1059765,69,159,5,233
"59766",1059766,104,86,16,206
"59767",1059767,58,176,16,250
"59768",1059768,124,87,3,214
"59769",1059769,88,37,6,131
"59770",1059770,20,183,4,207
"59771",1059771,106,36,5,147
"59772",1059772,54,204,5,263
"59773",1059773,149,114,13,276
"59774",1059774,8,52,1,61
"59775",1059775,151,76,13,240
"59776",1059776,188,68,13,269
"59777",1059777,32,187,3,222
"59778",1059778,83,68,8,159
"59779",1059779,132,115,10,257
"59780",1059780,194,9,4,207
"59781",1059781,147,120,14,281
"59782",1059782,176,36,11,223
"59783",1059783,27,251,7,285
"59784",1059784,118,30,4,152
"59785",1059785,43,187,2,232
"59786",1059786,31,250,2,283
"59787",1059787,175,57,9,241
"59788",1059788,200,40,6,246
"59789",1059789,211,23,1,235
"59790",1059790,110,132,20,262
"59791",1059791,202,30,6,238
"59792",1059792,124,26,4,154
"59793",1059793,124,171,8,303
"59794",1059794,64,165,24,253
"59795",1059795,111,106,6,223
"59796",1059796,108,177,15,300
"59797",1059797,97,125,14,236
"59798",1059798,136,97,12,245
"59799",1059799,51,211,3,265
"59800",1059800,106,95,7,208
"59801",1059801,138,85,8,231
"59802",1059802,84,100,7,191
"59803",1059803,57,184,3,244
"59804",1059804,139,64,3,206
"59805",1059805,215,33,15,263
"59806",1059806,136,42,9,187
"59807",1059807,158,25,12,195
"59808",1059808,107,162,13,282
"59809",1059809,134,84,15,233
"59810",1059810,116,146,12,274
"59811",1059811,87,8,1,96
"59812",1059812,113,122,4,239
"59813",1059813,71,34,3,108
"59814",1059814,151,24,0,175
"59815",1059815,143,33,12,188
"59816",1059816,11,7,0,18
"59817",1059817,151,0,0,151
"59818",1059818,58,247,8,313
"59819",1059819,93,209,7,309
"59820",1059820,196,19,9,224
"59821",1059821,118,209,6,333
"59822",1059822,203,39,6,248
"59823",1059823,134,50,11,195
"59824",1059824,112,160,3,275
"59825",1059825,139,77,9,225
"59826",1059826,92,79,4,175
"59827",1059827,2,65,2,69
"59828",1059828,205,74,10,289
"59829",1059829,166,145,18,329
"59830",1059830,151,76,15,242
"59831",1059831,151,49,11,211
"59832",1059832,116,227,11,354
"59833",1059833,199,34,6,239
"59834",1059834,97,215,5,317
"59835",1059835,102,153,4,259
"59836",1059836,97,3,3,103
"59837",1059837,10,22,4,36
"59838",1059838,29,225,0,254
"59839",1059839,37,185,1,223
"59840",1059840,9,7,0,16
"59841",1059841,34,30,2,66
"59842",1059842,168,144,8,320
"59843",1059843,13,236,2,251
"59844",1059844,86,102,5,193
"59845",1059845,125,76,9,210
"59846",1059846,187,44,8,239
"59847",1059847,1,3,0,4
"59848",1059848,67,207,9,283
"59849",1059849,125,43,6,174
"59850",1059850,35,28,1,64
"59851",1059851,47,261,8,316
"59852",1059852,142,67,8,217
"59853",1059853,22,137,1,160
"59854",1059854,61,161,8,230
"59855",1059855,82,171,23,276
"59856",1059856,238,51,4,293
"59857",1059857,47,257,4,308
"59858",1059858,86,138,7,231
"59859",1059859,32,201,9,242
"59860",1059860,131,30,5,166
"59861",1059861,207,83,20,310
"59862",1059862,71,81,11,163
"59863",1059863,173,143,5,321
"59864",1059864,96,126,4,226
"59865",1059865,50,162,6,218
"59866",1059866,134,150,16,300
"59867",1059867,210,88,11,309
"59868",1059868,150,29,4,183
"59869",1059869,15,211,3,229
"59870",1059870,48,168,3,219
"59871",1059871,86,186,9,281
"59872",1059872,109,127,15,251
"59873",1059873,96,102,4,202
"59874",1059874,144,55,9,208
"59875",1059875,6,0,0,6
"59876",1059876,41,188,7,236
"59877",1059877,61,193,3,257
"59878",1059878,46,236,11,293
"59879",1059879,100,52,1,153
"59880",1059880,151,130,18,299
"59881",1059881,45,225,4,274
"59882",1059882,153,88,21,262
"59883",1059883,27,171,12,210
"59884",1059884,157,64,16,237
"59885",1059885,28,219,13,260
"59886",1059886,40,242,7,289
"59887",1059887,34,178,4,216
"59888",1059888,151,93,6,250
"59889",1059889,80,90,5,175
"59890",1059890,85,167,4,256
"59891",1059891,142,127,10,279
"59892",1059892,150,26,1,177
"59893",1059893,29,183,5,217
"59894",1059894,36,187,6,229
"59895",1059895,271,35,15,321
"59896",1059896,2,10,0,12
"59897",1059897,254,26,7,287
"59898",1059898,58,107,13,178
"59899",1059899,78,109,7,194
"59900",1059900,48,207,16,271
"59901",1059901,150,48,3,201
"59902",1059902,91,149,9,249
"59903",1059903,98,67,15,180
"59904",1059904,35,136,6,177
"59905",1059905,169,24,5,198
"59906",1059906,85,67,6,158
"59907",1059907,44,220,4,268
"59908",1059908,133,174,5,312
"59909",1059909,132,55,2,189
"59910",1059910,173,11,2,186
"59911",1059911,137,63,19,219
"59912",1059912,41,169,4,214
"59913",1059913,126,125,39,290
"59914",1059914,227,55,9,291
"59915",1059915,144,84,11,239
"59916",1059916,83,34,6,123
"59917",1059917,123,69,21,213
"59918",1059918,104,58,4,166
"59919",1059919,109,125,10,244
"59920",1059920,151,87,8,246
"59921",1059921,98,93,9,200
"59922",1059922,56,123,2,181
"59923",1059923,160,130,9,299
"59924",1059924,51,177,11,239
"59925",1059925,173,21,3,197
"59926",1059926,137,33,8,178
"59927",1059927,86,50,8,144
"59928",1059928,136,45,4,185
"59929",1059929,119,157,17,293
"59930",1059930,85,24,6,115
"59931",1059931,109,170,14,293
"59932",1059932,175,129,9,313
"59933",1059933,94,121,4,219
"59934",1059934,33,197,7,237
"59935",1059935,138,98,6,242
"59936",1059936,113,2,0,115
"59937",1059937,70,176,26,272
"59938",1059938,24,262,3,289
"59939",1059939,54,37,4,95
"59940",1059940,136,167,10,313
"59941",1059941,43,40,8,91
"59942",1059942,225,35,5,265
"59943",1059943,104,18,3,125
"59944",1059944,154,39,7,200
"59945",1059945,94,83,2,179
"59946",1059946,51,241,3,295
"59947",1059947,134,86,3,223
"59948",1059948,82,25,5,112
"59949",1059949,0,0,0,0
"59950",1059950,103,63,3,169
"59951",1059951,25,14,0,39
"59952",1059952,63,208,2,273
"59953",1059953,36,293,5,334
"59954",1059954,173,75,10,258
"59955",1059955,68,108,11,187
"59956",1059956,42,84,6,132
"59957",1059957,243,32,6,281
"59958",1059958,251,10,2,263
"59959",1059959,144,47,6,197
"59960",1059960,120,61,19,200
"59961",1059961,148,25,8,181
"59962",1059962,203,125,8,336
"59963",1059963,122,211,19,352
"59964",1059964,124,12,4,140
"59965",1059965,71,65,8,144
"59966",1059966,148,11,4,163
"59967",1059967,152,25,6,183
"59968",1059968,24,23,0,47
"59969",1059969,27,231,2,260
"59970",1059970,66,14,1,81
"59971",1059971,96,12,2,110
"59972",1059972,152,61,9,222
"59973",1059973,258,10,8,276
"59974",1059974,38,252,9,299
"59975",1059975,10,6,0,16
"59976",1059976,42,45,4,91
"59977",1059977,1,6,0,7
"59978",1059978,51,113,3,167
"59979",1059979,161,79,14,254
"59980",1059980,168,118,19,305
"59981",1059981,118,176,8,302
"59982",1059982,127,58,4,189
"59983",1059983,74,86,7,167
"59984",1059984,103,57,14,174
"59985",1059985,179,27,2,208
"59986",1059986,126,151,9,286
"59987",1059987,75,197,8,280
"59988",1059988,80,159,4,243
"59989",1059989,81,69,11,161
"59990",1059990,114,83,8,205
"59991",1059991,198,50,2,250
"59992",1059992,117,136,3,256
"59993",1059993,22,42,2,66
"59994",1059994,22,100,1,123
"59995",1059995,162,70,8,240
"59996",1059996,69,154,14,237
"59997",1059997,238,27,6,271
"59998",1059998,102,78,5,185
"59999",1059999,110,45,3,158
"60000",1060000,56,31,0,87
"60001",1060001,58,121,5,184
"60002",1060002,50,185,6,241
"60003",1060003,201,50,7,258
"60004",1060004,64,234,3,301
"60005",1060005,175,36,9,220
"60006",1060006,59,212,4,275
"60007",1060007,53,293,1,347
"60008",1060008,56,136,5,197
"60009",1060009,62,220,7,289
"60010",1060010,99,115,14,228
"60011",1060011,108,16,7,131
"60012",1060012,58,151,14,223
"60013",1060013,124,43,5,172
"60014",1060014,57,240,6,303
"60015",1060015,124,63,6,193
"60016",1060016,97,7,6,110
"60017",1060017,96,65,2,163
"60018",1060018,75,152,10,237
"60019",1060019,145,69,9,223
"60020",1060020,146,27,4,177
"60021",1060021,129,153,11,293
"60022",1060022,90,143,10,243
"60023",1060023,114,57,4,175
"60024",1060024,71,191,15,277
"60025",1060025,106,105,11,222
"60026",1060026,186,37,7,230
"60027",1060027,6,1,0,7
"60028",1060028,183,96,20,299
"60029",1060029,32,246,8,286
"60030",1060030,139,55,9,203
"60031",1060031,61,168,5,234
"60032",1060032,144,114,13,271
"60033",1060033,134,120,7,261
"60034",1060034,151,65,10,226
"60035",1060035,112,95,4,211
"60036",1060036,74,171,3,248
"60037",1060037,209,39,13,261
"60038",1060038,138,18,4,160
"60039",1060039,2,52,1,55
"60040",1060040,159,140,19,318
"60041",1060041,146,99,2,247
"60042",1060042,6,13,1,20
"60043",1060043,180,107,3,290
"60044",1060044,132,195,12,339
"60045",1060045,230,42,10,282
"60046",1060046,57,201,6,264
"60047",1060047,25,29,1,55
"60048",1060048,249,30,6,285
"60049",1060049,113,84,10,207
"60050",1060050,59,143,11,213
"60051",1060051,132,88,11,231
"60052",1060052,8,3,5,16
"60053",1060053,61,260,0,321
"60054",1060054,94,118,10,222
"60055",1060055,22,160,1,183
"60056",1060056,84,31,6,121
"60057",1060057,53,184,9,246
"60058",1060058,137,78,6,221
"60059",1060059,139,131,24,294
"60060",1060060,97,24,3,124
"60061",1060061,171,44,9,224
"60062",1060062,186,80,15,281
"60063",1060063,17,166,3,186
"60064",1060064,101,78,12,191
"60065",1060065,133,56,22,211
"60066",1060066,186,70,2,258
"60067",1060067,158,77,11,246
"60068",1060068,178,119,10,307
"60069",1060069,221,15,2,238
"60070",1060070,96,229,15,340
"60071",1060071,108,62,5,175
"60072",1060072,155,94,9,258
"60073",1060073,24,100,6,130
"60074",1060074,85,71,13,169
"60075",1060075,25,175,3,203
"60076",1060076,41,12,3,56
"60077",1060077,133,0,0,133
"60078",1060078,140,117,7,264
"60079",1060079,145,36,4,185
"60080",1060080,51,179,6,236
"60081",1060081,183,100,10,293
"60082",1060082,206,0,0,206
"60083",1060083,209,25,7,241
"60084",1060084,132,114,5,251
"60085",1060085,174,24,4,202
"60086",1060086,153,113,18,284
"60087",1060087,109,13,10,132
"60088",1060088,17,183,9,209
"60089",1060089,18,68,2,88
"60090",1060090,123,138,8,269
"60091",1060091,72,40,6,118
"60092",1060092,33,175,7,215
"60093",1060093,44,19,12,75
"60094",1060094,142,66,1,209
"60095",1060095,91,143,8,242
"60096",1060096,69,201,5,275
"60097",1060097,65,195,14,274
"60098",1060098,226,26,9,261
"60099",1060099,110,111,15,236
"60100",1060100,144,80,7,231
"60101",1060101,20,21,4,45
"60102",1060102,68,203,4,275
"60103",1060103,127,102,10,239
"60104",1060104,55,100,1,156
"60105",1060105,145,41,6,192
"60106",1060106,95,58,6,159
"60107",1060107,104,20,1,125
"60108",1060108,198,93,9,300
"60109",1060109,159,20,7,186
"60110",1060110,121,88,4,213
"60111",1060111,145,77,13,235
"60112",1060112,60,162,20,242
"60113",1060113,102,228,11,341
"60114",1060114,119,74,7,200
"60115",1060115,56,246,10,312
"60116",1060116,59,210,15,284
"60117",1060117,37,254,4,295
"60118",1060118,150,77,5,232
"60119",1060119,121,168,7,296
"60120",1060120,32,210,6,248
"60121",1060121,9,15,2,26
"60122",1060122,137,11,6,154
"60123",1060123,40,187,6,233
"60124",1060124,123,146,10,279
"60125",1060125,33,138,3,174
"60126",1060126,68,188,3,259
"60127",1060127,30,88,2,120
"60128",1060128,129,52,4,185
"60129",1060129,221,79,12,312
"60130",1060130,99,91,2,192
"60131",1060131,202,57,12,271
"60132",1060132,218,50,0,268
"60133",1060133,146,69,7,222
"60134",1060134,279,38,7,324
"60135",1060135,59,131,11,201
"60136",1060136,79,157,8,244
"60137",1060137,59,167,12,238
"60138",1060138,153,252,21,426
"60139",1060139,98,161,10,269
"60140",1060140,229,75,16,320
"60141",1060141,180,58,16,254
"60142",1060142,41,280,4,325
"60143",1060143,201,37,6,244
"60144",1060144,158,25,9,192
"60145",1060145,105,44,2,151
"60146",1060146,197,85,7,289
"60147",1060147,115,109,5,229
"60148",1060148,78,135,13,226
"60149",1060149,194,68,2,264
"60150",1060150,53,174,8,235
"60151",1060151,76,197,13,286
"60152",1060152,98,85,4,187
"60153",1060153,206,28,15,249
"60154",1060154,190,33,12,235
"60155",1060155,32,193,6,231
"60156",1060156,148,28,5,181
"60157",1060157,182,72,13,267
"60158",1060158,167,65,10,242
"60159",1060159,84,98,16,198
"60160",1060160,154,51,5,210
"60161",1060161,154,42,15,211
"60162",1060162,39,147,15,201
"60163",1060163,101,38,5,144
"60164",1060164,42,260,10,312
"60165",1060165,177,82,18,277
"60166",1060166,153,101,12,266
"60167",1060167,121,117,3,241
"60168",1060168,148,69,1,218
"60169",1060169,42,24,2,68
"60170",1060170,172,71,7,250
"60171",1060171,20,14,1,35
"60172",1060172,145,36,8,189
"60173",1060173,50,150,14,214
"60174",1060174,169,8,1,178
"60175",1060175,28,43,3,74
"60176",1060176,63,172,4,239
"60177",1060177,51,207,1,259
"60178",1060178,61,82,4,147
"60179",1060179,97,164,10,271
"60180",1060180,109,54,7,170
"60181",1060181,160,51,10,221
"60182",1060182,0,66,0,66
"60183",1060183,112,143,6,261
"60184",1060184,144,43,10,197
"60185",1060185,122,117,12,251
"60186",1060186,73,205,6,284
"60187",1060187,153,80,5,238
"60188",1060188,226,41,13,280
"60189",1060189,91,13,3,107
"60190",1060190,184,69,11,264
"60191",1060191,58,160,6,224
"60192",1060192,108,104,7,219
"60193",1060193,44,238,1,283
"60194",1060194,102,182,15,299
"60195",1060195,33,139,5,177
"60196",1060196,155,102,7,264
"60197",1060197,179,23,9,211
"60198",1060198,86,164,6,256
"60199",1060199,125,48,9,182
"60200",1060200,133,60,10,203
"60201",1060201,80,196,7,283
"60202",1060202,90,87,21,198
"60203",1060203,78,138,3,219
"60204",1060204,165,115,8,288
"60205",1060205,133,70,4,207
"60206",1060206,139,38,3,180
"60207",1060207,57,168,7,232
"60208",1060208,28,238,3,269
"60209",1060209,47,168,6,221
"60210",1060210,147,71,7,225
"60211",1060211,157,83,7,247
"60212",1060212,210,63,14,287
"60213",1060213,74,183,4,261
"60214",1060214,111,22,4,137
"60215",1060215,62,253,9,324
"60216",1060216,62,20,6,88
"60217",1060217,32,8,0,40
"60218",1060218,53,36,5,94
"60219",1060219,29,73,2,104
"60220",1060220,18,31,7,56
"60221",1060221,56,190,9,255
"60222",1060222,179,107,10,296
"60223",1060223,76,227,4,307
"60224",1060224,125,139,15,279
"60225",1060225,6,4,1,11
"60226",1060226,242,123,12,377
"60227",1060227,134,164,15,313
"60228",1060228,202,35,8,245
"60229",1060229,29,150,4,183
"60230",1060230,202,112,16,330
"60231",1060231,144,70,8,222
"60232",1060232,8,28,0,36
"60233",1060233,81,180,6,267
"60234",1060234,77,66,6,149
"60235",1060235,82,189,6,277
"60236",1060236,150,15,4,169
"60237",1060237,159,46,5,210
"60238",1060238,75,94,4,173
"60239",1060239,44,79,7,130
"60240",1060240,143,83,6,232
"60241",1060241,128,143,0,271
"60242",1060242,151,81,12,244
"60243",1060243,78,27,2,107
"60244",1060244,89,37,15,141
"60245",1060245,7,7,1,15
"60246",1060246,130,31,10,171
"60247",1060247,69,110,0,179
"60248",1060248,163,84,5,252
"60249",1060249,82,17,1,100
"60250",1060250,147,114,18,279
"60251",1060251,85,191,5,281
"60252",1060252,87,172,4,263
"60253",1060253,17,153,1,171
"60254",1060254,52,41,7,100
"60255",1060255,68,71,6,145
"60256",1060256,230,17,6,253
"60257",1060257,154,82,4,240
"60258",1060258,51,245,3,299
"60259",1060259,59,147,2,208
"60260",1060260,2,3,1,6
"60261",1060261,171,66,5,242
"60262",1060262,119,17,1,137
"60263",1060263,107,199,8,314
"60264",1060264,127,56,4,187
"60265",1060265,60,185,4,249
"60266",1060266,168,47,6,221
"60267",1060267,37,275,2,314
"60268",1060268,115,132,14,261
"60269",1060269,129,111,15,255
"60270",1060270,169,92,3,264
"60271",1060271,117,169,12,298
"60272",1060272,106,171,19,296
"60273",1060273,29,11,0,40
"60274",1060274,19,250,1,270
"60275",1060275,84,30,3,117
"60276",1060276,95,171,9,275
"60277",1060277,8,8,0,16
"60278",1060278,115,183,15,313
"60279",1060279,166,90,8,264
"60280",1060280,71,189,5,265
"60281",1060281,125,52,6,183
"60282",1060282,200,139,6,345
"60283",1060283,181,139,26,346
"60284",1060284,194,79,9,282
"60285",1060285,168,69,8,245
"60286",1060286,162,38,10,210
"60287",1060287,154,64,11,229
"60288",1060288,82,150,9,241
"60289",1060289,7,2,0,9
"60290",1060290,211,77,3,291
"60291",1060291,51,213,1,265
"60292",1060292,107,5,2,114
"60293",1060293,173,116,8,297
"60294",1060294,124,126,23,273
"60295",1060295,216,70,5,291
"60296",1060296,25,2,0,27
"60297",1060297,85,157,11,253
"60298",1060298,84,216,9,309
"60299",1060299,49,150,4,203
"60300",1060300,5,11,3,19
"60301",1060301,165,61,3,229
"60302",1060302,16,188,2,206
"60303",1060303,232,57,22,311
"60304",1060304,101,62,5,168
"60305",1060305,177,51,10,238
"60306",1060306,31,22,3,56
"60307",1060307,34,166,15,215
"60308",1060308,85,39,10,134
"60309",1060309,29,12,2,43
"60310",1060310,16,6,0,22
"60311",1060311,237,26,11,274
"60312",1060312,30,215,1,246
"60313",1060313,100,70,15,185
"60314",1060314,150,42,6,198
"60315",1060315,192,28,9,229
"60316",1060316,99,74,2,175
"60317",1060317,117,91,0,208
"60318",1060318,7,31,1,39
"60319",1060319,72,31,3,106
"60320",1060320,37,100,0,137
"60321",1060321,125,47,5,177
"60322",1060322,51,273,12,336
"60323",1060323,169,72,7,248
"60324",1060324,185,35,15,235
"60325",1060325,32,175,5,212
"60326",1060326,110,161,19,290
"60327",1060327,4,58,1,63
"60328",1060328,58,222,3,283
"60329",1060329,165,30,9,204
"60330",1060330,109,138,3,250
"60331",1060331,131,66,7,204
"60332",1060332,99,177,5,281
"60333",1060333,55,153,3,211
"60334",1060334,80,257,6,343
"60335",1060335,52,229,10,291
"60336",1060336,171,67,5,243
"60337",1060337,176,31,6,213
"60338",1060338,159,91,7,257
"60339",1060339,303,18,9,330
"60340",1060340,55,142,10,207
"60341",1060341,160,54,7,221
"60342",1060342,170,26,8,204
"60343",1060343,73,89,8,170
"60344",1060344,199,56,8,263
"60345",1060345,75,217,10,302
"60346",1060346,96,78,10,184
"60347",1060347,6,31,2,39
"60348",1060348,160,105,10,275
"60349",1060349,101,216,21,338
"60350",1060350,129,23,7,159
"60351",1060351,11,47,2,60
"60352",1060352,129,43,2,174
"60353",1060353,70,253,7,330
"60354",1060354,135,164,18,317
"60355",1060355,66,183,6,255
"60356",1060356,80,102,2,184
"60357",1060357,129,65,16,210
"60358",1060358,106,65,11,182
"60359",1060359,189,85,16,290
"60360",1060360,88,58,4,150
"60361",1060361,202,13,7,222
"60362",1060362,76,136,8,220
"60363",1060363,125,80,7,212
"60364",1060364,171,17,6,194
"60365",1060365,16,29,0,45
"60366",1060366,80,86,2,168
"60367",1060367,134,162,9,305
"60368",1060368,147,50,2,199
"60369",1060369,148,66,9,223
"60370",1060370,65,154,12,231
"60371",1060371,151,26,6,183
"60372",1060372,82,141,23,246
"60373",1060373,60,82,5,147
"60374",1060374,4,27,0,31
"60375",1060375,8,6,1,15
"60376",1060376,91,108,14,213
"60377",1060377,129,44,6,179
"60378",1060378,189,90,8,287
"60379",1060379,94,88,7,189
"60380",1060380,36,75,2,113
"60381",1060381,48,216,13,277
"60382",1060382,63,172,8,243
"60383",1060383,53,245,1,299
"60384",1060384,142,47,4,193
"60385",1060385,4,5,1,10
"60386",1060386,180,22,14,216
"60387",1060387,88,78,3,169
"60388",1060388,44,249,0,293
"60389",1060389,251,10,5,266
"60390",1060390,126,137,28,291
"60391",1060391,90,114,7,211
"60392",1060392,174,76,11,261
"60393",1060393,95,147,8,250
"60394",1060394,149,106,13,268
"60395",1060395,154,55,3,212
"60396",1060396,144,66,1,211
"60397",1060397,86,135,5,226
"60398",1060398,79,147,9,235
"60399",1060399,31,243,4,278
"60400",1060400,83,63,5,151
"60401",1060401,50,115,7,172
"60402",1060402,101,70,8,179
"60403",1060403,5,4,0,9
"60404",1060404,111,98,4,213
"60405",1060405,130,17,3,150
"60406",1060406,142,71,4,217
"60407",1060407,111,115,9,235
"60408",1060408,135,151,20,306
"60409",1060409,206,81,22,309
"60410",1060410,43,84,2,129
"60411",1060411,127,108,9,244
"60412",1060412,172,81,19,272
"60413",1060413,11,28,1,40
"60414",1060414,59,134,8,201
"60415",1060415,122,43,6,171
"60416",1060416,6,2,0,8
"60417",1060417,167,42,8,217
"60418",1060418,230,4,3,237
"60419",1060419,13,9,1,23
"60420",1060420,184,103,22,309
"60421",1060421,1,7,0,8
"60422",1060422,154,80,11,245
"60423",1060423,134,91,3,228
"60424",1060424,23,199,3,225
"60425",1060425,92,37,4,133
"60426",1060426,100,31,2,133
"60427",1060427,80,45,19,144
"60428",1060428,225,74,12,311
"60429",1060429,172,65,6,243
"60430",1060430,140,119,14,273
"60431",1060431,152,100,5,257
"60432",1060432,147,55,6,208
"60433",1060433,128,115,5,248
"60434",1060434,184,83,20,287
"60435",1060435,17,166,3,186
"60436",1060436,137,167,15,319
"60437",1060437,74,177,7,258
"60438",1060438,62,205,6,273
"60439",1060439,203,38,14,255
"60440",1060440,26,76,2,104
"60441",1060441,125,111,6,242
"60442",1060442,68,38,7,113
"60443",1060443,63,153,7,223
"60444",1060444,45,199,5,249
"60445",1060445,39,9,4,52
"60446",1060446,128,90,9,227
"60447",1060447,8,147,3,158
"60448",1060448,132,101,9,242
"60449",1060449,48,184,4,236
"60450",1060450,117,37,2,156
"60451",1060451,215,19,5,239
"60452",1060452,89,126,7,222
"60453",1060453,142,106,6,254
"60454",1060454,98,28,4,130
"60455",1060455,100,228,17,345
"60456",1060456,70,200,6,276
"60457",1060457,59,4,1,64
"60458",1060458,164,65,15,244
"60459",1060459,100,189,13,302
"60460",1060460,151,20,3,174
"60461",1060461,144,68,7,219
"60462",1060462,218,75,21,314
"60463",1060463,64,49,5,118
"60464",1060464,126,63,7,196
"60465",1060465,92,81,13,186
"60466",1060466,132,129,6,267
"60467",1060467,191,43,6,240
"60468",1060468,37,21,0,58
"60469",1060469,88,87,10,185
"60470",1060470,19,123,6,148
"60471",1060471,124,78,3,205
"60472",1060472,60,246,1,307
"60473",1060473,40,161,1,202
"60474",1060474,221,72,2,295
"60475",1060475,119,122,12,253
"60476",1060476,52,164,4,220
"60477",1060477,16,9,1,26
"60478",1060478,124,166,15,305
"60479",1060479,142,59,3,204
"60480",1060480,65,176,10,251
"60481",1060481,69,230,1,300
"60482",1060482,56,174,7,237
"60483",1060483,187,118,13,318
"60484",1060484,19,91,0,110
"60485",1060485,117,169,11,297
"60486",1060486,174,116,3,293
"60487",1060487,125,62,13,200
"60488",1060488,21,195,3,219
"60489",1060489,131,108,4,243
"60490",1060490,91,68,3,162
"60491",1060491,16,16,2,34
"60492",1060492,45,42,4,91
"60493",1060493,74,3,0,77
"60494",1060494,59,118,2,179
"60495",1060495,70,185,10,265
"60496",1060496,61,168,15,244
"60497",1060497,197,56,9,262
"60498",1060498,129,78,16,223
"60499",1060499,70,156,3,229
"60500",1060500,155,82,8,245
"60501",1060501,73,114,5,192
"60502",1060502,20,2,0,22
"60503",1060503,239,9,8,256
"60504",1060504,50,128,7,185
"60505",1060505,107,143,12,262
"60506",1060506,61,217,17,295
"60507",1060507,83,175,8,266
"60508",1060508,201,32,8,241
"60509",1060509,75,43,6,124
"60510",1060510,142,125,1,268
"60511",1060511,187,19,7,213
"60512",1060512,79,142,6,227
"60513",1060513,44,200,8,252
"60514",1060514,84,173,8,265
"60515",1060515,37,246,4,287
"60516",1060516,109,72,8,189
"60517",1060517,139,139,7,285
"60518",1060518,179,73,17,269
"60519",1060519,121,135,11,267
"60520",1060520,185,36,6,227
"60521",1060521,79,248,5,332
"60522",1060522,57,108,8,173
"60523",1060523,100,215,11,326
"60524",1060524,10,31,2,43
"60525",1060525,41,273,7,321
"60526",1060526,152,31,6,189
"60527",1060527,139,58,7,204
"60528",1060528,108,124,5,237
"60529",1060529,61,211,9,281
"60530",1060530,37,250,6,293
"60531",1060531,175,65,8,248
"60532",1060532,65,174,11,250
"60533",1060533,52,186,12,250
"60534",1060534,112,95,10,217
"60535",1060535,127,89,5,221
"60536",1060536,18,187,7,212
"60537",1060537,42,21,1,64
"60538",1060538,160,101,6,267
"60539",1060539,44,81,6,131
"60540",1060540,127,67,6,200
"60541",1060541,165,127,14,306
"60542",1060542,34,124,0,158
"60543",1060543,160,45,9,214
"60544",1060544,137,143,8,288
"60545",1060545,59,189,4,252
"60546",1060546,143,130,12,285
"60547",1060547,188,79,7,274
"60548",1060548,35,7,1,43
"60549",1060549,98,68,11,177
"60550",1060550,129,30,6,165
"60551",1060551,161,161,26,348
"60552",1060552,190,36,10,236
"60553",1060553,198,37,11,246
"60554",1060554,1,83,3,87
"60555",1060555,40,218,4,262
"60556",1060556,79,202,4,285
"60557",1060557,26,153,3,182
"60558",1060558,82,104,17,203
"60559",1060559,31,166,4,201
"60560",1060560,48,79,1,128
"60561",1060561,129,35,6,170
"60562",1060562,36,229,7,272
"60563",1060563,94,66,14,174
"60564",1060564,49,253,11,313
"60565",1060565,35,30,2,67
"60566",1060566,58,128,10,196
"60567",1060567,49,175,11,235
"60568",1060568,69,69,3,141
"60569",1060569,109,23,2,134
"60570",1060570,51,240,12,303
"60571",1060571,200,126,15,341
"60572",1060572,175,31,5,211
"60573",1060573,21,230,2,253
"60574",1060574,172,43,3,218
"60575",1060575,61,153,5,219
"60576",1060576,135,39,3,177
"60577",1060577,37,241,1,279
"60578",1060578,148,46,10,204
"60579",1060579,26,5,1,32
"60580",1060580,74,129,13,216
"60581",1060581,98,105,24,227
"60582",1060582,154,85,2,241
"60583",1060583,14,76,4,94
"60584",1060584,127,28,3,158
"60585",1060585,29,244,1,274
"60586",1060586,72,134,9,215
"60587",1060587,118,83,8,209
"60588",1060588,149,114,19,282
"60589",1060589,101,143,6,250
"60590",1060590,142,36,5,183
"60591",1060591,180,93,6,279
"60592",1060592,132,102,8,242
"60593",1060593,24,84,2,110
"60594",1060594,220,70,11,301
"60595",1060595,56,110,7,173
"60596",1060596,13,5,3,21
"60597",1060597,183,29,12,224
"60598",1060598,107,172,6,285
"60599",1060599,144,80,5,229
"60600",1060600,197,53,4,254
"60601",1060601,143,73,8,224
"60602",1060602,68,51,20,139
"60603",1060603,108,105,5,218
"60604",1060604,51,120,10,181
"60605",1060605,154,62,11,227
"60606",1060606,115,128,15,258
"60607",1060607,188,38,10,236
"60608",1060608,69,262,3,334
"60609",1060609,184,67,16,267
"60610",1060610,96,40,8,144
"60611",1060611,59,209,18,286
"60612",1060612,33,172,6,211
"60613",1060613,101,118,17,236
"60614",1060614,104,34,6,144
"60615",1060615,128,91,2,221
"60616",1060616,52,277,3,332
"60617",1060617,134,84,16,234
"60618",1060618,174,92,11,277
"60619",1060619,288,5,6,299
"60620",1060620,38,241,5,284
"60621",1060621,157,98,10,265
"60622",1060622,190,82,15,287
"60623",1060623,161,47,6,214
"60624",1060624,54,177,6,237
"60625",1060625,129,196,6,331
"60626",1060626,46,66,10,122
"60627",1060627,64,245,18,327
"60628",1060628,99,128,4,231
"60629",1060629,45,99,4,148
"60630",1060630,92,232,21,345
"60631",1060631,28,110,1,139
"60632",1060632,193,46,6,245
"60633",1060633,235,20,6,261
"60634",1060634,77,142,10,229
"60635",1060635,187,79,16,282
"60636",1060636,241,57,4,302
"60637",1060637,120,157,17,294
"60638",1060638,25,150,9,184
"60639",1060639,155,79,22,256
"60640",1060640,105,11,1,117
"60641",1060641,139,145,9,293
"60642",1060642,28,161,6,195
"60643",1060643,212,77,2,291
"60644",1060644,50,145,3,198
"60645",1060645,149,68,8,225
"60646",1060646,85,113,5,203
"60647",1060647,163,109,21,293
"60648",1060648,65,137,11,213
"60649",1060649,173,328,21,522
"60650",1060650,119,161,16,296
"60651",1060651,22,271,5,298
"60652",1060652,152,106,8,266
"60653",1060653,65,194,4,263
"60654",1060654,31,92,2,125
"60655",1060655,179,57,6,242
"60656",1060656,95,115,3,213
"60657",1060657,215,68,25,308
"60658",1060658,68,161,25,254
"60659",1060659,138,88,3,229
"60660",1060660,14,16,0,30
"60661",1060661,169,76,9,254
"60662",1060662,105,207,12,324
"60663",1060663,34,6,2,42
"60664",1060664,19,9,0,28
"60665",1060665,103,176,11,290
"60666",1060666,56,197,2,255
"60667",1060667,89,101,4,194
"60668",1060668,215,57,14,286
"60669",1060669,72,164,18,254
"60670",1060670,74,100,5,179
"60671",1060671,51,139,4,194
"60672",1060672,121,111,6,238
"60673",1060673,93,177,9,279
"60674",1060674,152,31,6,189
"60675",1060675,98,127,3,228
"60676",1060676,121,83,6,210
"60677",1060677,63,216,7,286
"60678",1060678,93,173,6,272
"60679",1060679,185,14,4,203
"60680",1060680,99,13,7,119
"60681",1060681,107,61,3,171
"60682",1060682,44,206,10,260
"60683",1060683,67,117,2,186
"60684",1060684,112,67,9,188
"60685",1060685,53,263,14,330
"60686",1060686,53,117,6,176
"60687",1060687,30,199,5,234
"60688",1060688,142,127,9,278
"60689",1060689,171,47,7,225
"60690",1060690,168,83,15,266
"60691",1060691,90,157,8,255
"60692",1060692,46,11,0,57
"60693",1060693,16,101,5,122
"60694",1060694,41,238,6,285
"60695",1060695,188,55,9,252
"60696",1060696,51,239,11,301
"60697",1060697,93,100,7,200
"60698",1060698,93,105,6,204
"60699",1060699,142,75,13,230
"60700",1060700,60,106,5,171
"60701",1060701,110,103,6,219
"60702",1060702,205,66,8,279
"60703",1060703,82,141,12,235
"60704",1060704,116,85,16,217
"60705",1060705,168,151,28,347
"60706",1060706,93,59,4,156
"60707",1060707,81,258,15,354
"60708",1060708,147,85,4,236
"60709",1060709,81,202,11,294
"60710",1060710,34,52,2,88
"60711",1060711,128,71,10,209
"60712",1060712,91,116,13,220
"60713",1060713,49,48,3,100
"60714",1060714,99,139,19,257
"60715",1060715,72,226,13,311
"60716",1060716,172,40,7,219
"60717",1060717,105,132,3,240
"60718",1060718,26,244,4,274
"60719",1060719,42,148,7,197
"60720",1060720,180,31,8,219
"60721",1060721,75,138,5,218
"60722",1060722,118,126,8,252
"60723",1060723,166,20,3,189
"60724",1060724,130,23,5,158
"60725",1060725,31,115,13,159
"60726",1060726,153,74,13,240
"60727",1060727,121,121,4,246
"60728",1060728,220,19,5,244
"60729",1060729,30,20,5,55
"60730",1060730,176,76,4,256
"60731",1060731,26,231,6,263
"60732",1060732,105,178,11,294
"60733",1060733,170,11,6,187
"60734",1060734,92,172,8,272
"60735",1060735,220,74,16,310
"60736",1060736,90,75,7,172
"60737",1060737,156,34,6,196
"60738",1060738,62,116,2,180
"60739",1060739,125,81,15,221
"60740",1060740,245,31,15,291
"60741",1060741,131,78,6,215
"60742",1060742,202,32,7,241
"60743",1060743,50,62,12,124
"60744",1060744,104,104,18,226
"60745",1060745,34,36,1,71
"60746",1060746,35,138,3,176
"60747",1060747,48,167,7,222
"60748",1060748,168,31,3,202
"60749",1060749,69,159,4,232
"60750",1060750,180,102,12,294
"60751",1060751,18,7,4,29
"60752",1060752,10,1,2,13
"60753",1060753,131,56,10,197
"60754",1060754,59,229,8,296
"60755",1060755,112,146,6,264
"60756",1060756,54,226,6,286
"60757",1060757,110,138,2,250
"60758",1060758,239,93,10,342
"60759",1060759,237,12,6,255
"60760",1060760,145,110,6,261
"60761",1060761,142,71,5,218
"60762",1060762,176,13,1,190
"60763",1060763,151,87,6,244
"60764",1060764,105,69,3,177
"60765",1060765,144,147,15,306
"60766",1060766,119,57,11,187
"60767",1060767,197,73,5,275
"60768",1060768,187,59,13,259
"60769",1060769,99,193,9,301
"60770",1060770,9,338,4,351
"60771",1060771,194,41,11,246
"60772",1060772,32,32,2,66
"60773",1060773,34,39,7,80
"60774",1060774,160,106,19,285
"60775",1060775,207,28,3,238
"60776",1060776,26,251,2,279
"60777",1060777,98,53,7,158
"60778",1060778,132,55,4,191
"60779",1060779,148,53,13,214
"60780",1060780,218,66,17,301
"60781",1060781,132,79,14,225
"60782",1060782,23,52,5,80
"60783",1060783,111,168,7,286
"60784",1060784,207,49,11,267
"60785",1060785,92,133,11,236
"60786",1060786,161,113,12,286
"60787",1060787,162,43,7,212
"60788",1060788,180,60,9,249
"60789",1060789,93,103,5,201
"60790",1060790,115,191,21,327
"60791",1060791,165,65,7,237
"60792",1060792,247,9,1,257
"60793",1060793,94,36,4,134
"60794",1060794,102,79,9,190
"60795",1060795,60,122,4,186
"60796",1060796,89,55,7,151
"60797",1060797,152,71,17,240
"60798",1060798,41,130,9,180
"60799",1060799,96,57,2,155
"60800",1060800,175,13,6,194
"60801",1060801,107,67,12,186
"60802",1060802,157,107,9,273
"60803",1060803,183,105,7,295
"60804",1060804,115,91,9,215
"60805",1060805,115,137,8,260
"60806",1060806,202,39,9,250
"60807",1060807,34,27,0,61
"60808",1060808,57,150,12,219
"60809",1060809,53,185,20,258
"60810",1060810,142,149,9,300
"60811",1060811,79,254,14,347
"60812",1060812,234,20,6,260
"60813",1060813,53,71,1,125
"60814",1060814,38,46,1,85
"60815",1060815,83,162,3,248
"60816",1060816,185,96,13,294
"60817",1060817,38,262,7,307
"60818",1060818,81,110,10,201
"60819",1060819,69,226,10,305
"60820",1060820,91,65,3,159
"60821",1060821,54,225,6,285
"60822",1060822,224,21,5,250
"60823",1060823,125,87,5,217
"60824",1060824,45,183,8,236
"60825",1060825,136,57,8,201
"60826",1060826,110,36,10,156
"60827",1060827,97,45,15,157
"60828",1060828,55,131,1,187
"60829",1060829,10,93,2,105
"60830",1060830,166,108,8,282
"60831",1060831,214,80,7,301
"60832",1060832,42,244,19,305
"60833",1060833,14,212,10,236
"60834",1060834,50,18,5,73
"60835",1060835,156,33,12,201
"60836",1060836,70,214,12,296
"60837",1060837,146,119,6,271
"60838",1060838,59,77,3,139
"60839",1060839,297,3,3,303
"60840",1060840,112,32,5,149
"60841",1060841,114,107,1,222
"60842",1060842,139,161,11,311
"60843",1060843,201,7,6,214
"60844",1060844,122,127,12,261
"60845",1060845,72,105,6,183
"60846",1060846,111,79,10,200
"60847",1060847,63,225,0,288
"60848",1060848,141,62,7,210
"60849",1060849,182,64,9,255
"60850",1060850,230,71,11,312
"60851",1060851,149,76,7,232
"60852",1060852,54,143,16,213
"60853",1060853,101,78,5,184
"60854",1060854,149,105,10,264
"60855",1060855,1,12,0,13
"60856",1060856,179,77,10,266
"60857",1060857,69,160,24,253
"60858",1060858,139,128,9,276
"60859",1060859,131,68,6,205
"60860",1060860,60,77,10,147
"60861",1060861,69,190,8,267
"60862",1060862,107,31,3,141
"60863",1060863,47,250,4,301
"60864",1060864,107,167,10,284
"60865",1060865,118,164,12,294
"60866",1060866,158,133,16,307
"60867",1060867,139,145,9,293
"60868",1060868,25,28,1,54
"60869",1060869,34,28,0,62
"60870",1060870,122,15,6,143
"60871",1060871,175,39,36,250
"60872",1060872,162,63,8,233
"60873",1060873,210,103,8,321
"60874",1060874,32,19,0,51
"60875",1060875,26,210,6,242
"60876",1060876,190,37,10,237
"60877",1060877,4,4,1,9
"60878",1060878,147,80,8,235
"60879",1060879,78,132,12,222
"60880",1060880,178,61,6,245
"60881",1060881,60,38,5,103
"60882",1060882,30,91,4,125
"60883",1060883,48,27,3,78
"60884",1060884,115,43,1,159
"60885",1060885,209,11,5,225
"60886",1060886,116,123,6,245
"60887",1060887,126,45,16,187
"60888",1060888,60,54,10,124
"60889",1060889,63,104,6,173
"60890",1060890,61,204,3,268
"60891",1060891,60,171,6,237
"60892",1060892,8,172,3,183
"60893",1060893,84,100,7,191
"60894",1060894,73,120,9,202
"60895",1060895,17,38,2,57
"60896",1060896,24,190,15,229
"60897",1060897,110,18,0,128
"60898",1060898,61,103,10,174
"60899",1060899,135,95,8,238
"60900",1060900,49,44,2,95
"60901",1060901,118,73,4,195
"60902",1060902,46,128,2,176
"60903",1060903,125,131,3,259
"60904",1060904,80,178,11,269
"60905",1060905,139,131,9,279
"60906",1060906,217,30,12,259
"60907",1060907,105,103,6,214
"60908",1060908,147,112,10,269
"60909",1060909,240,40,3,283
"60910",1060910,128,103,14,245
"60911",1060911,198,9,2,209
"60912",1060912,84,59,4,147
"60913",1060913,10,12,0,22
"60914",1060914,70,170,31,271
"60915",1060915,161,26,4,191
"60916",1060916,213,38,19,270
"60917",1060917,36,214,2,252
"60918",1060918,164,64,9,237
"60919",1060919,106,28,4,138
"60920",1060920,216,21,4,241
"60921",1060921,96,12,2,110
"60922",1060922,141,130,10,281
"60923",1060923,101,147,9,257
"60924",1060924,125,50,4,179
"60925",1060925,109,50,6,165
"60926",1060926,84,35,5,124
"60927",1060927,280,116,27,423
"60928",1060928,191,20,4,215
"60929",1060929,94,118,11,223
"60930",1060930,172,27,5,204
"60931",1060931,144,138,13,295
"60932",1060932,68,18,3,89
"60933",1060933,193,101,6,300
"60934",1060934,51,52,11,114
"60935",1060935,184,37,5,226
"60936",1060936,192,57,11,260
"60937",1060937,32,209,14,255
"60938",1060938,35,47,3,85
"60939",1060939,85,79,17,181
"60940",1060940,28,221,4,253
"60941",1060941,50,220,8,278
"60942",1060942,54,209,6,269
"60943",1060943,125,43,8,176
"60944",1060944,24,0,1,25
"60945",1060945,39,201,4,244
"60946",1060946,133,35,4,172
"60947",1060947,135,57,5,197
"60948",1060948,50,143,13,206
"60949",1060949,31,67,1,99
"60950",1060950,226,26,9,261
"60951",1060951,16,25,0,41
"60952",1060952,125,98,8,231
"60953",1060953,78,160,6,244
"60954",1060954,212,42,11,265
"60955",1060955,39,29,1,69
"60956",1060956,158,85,11,254
"60957",1060957,118,150,20,288
"60958",1060958,14,37,0,51
"60959",1060959,59,121,5,185
"60960",1060960,177,133,33,343
"60961",1060961,77,186,4,267
"60962",1060962,136,162,11,309
"60963",1060963,51,130,5,186
"60964",1060964,64,22,2,88
"60965",1060965,33,17,1,51
"60966",1060966,17,41,1,59
"60967",1060967,59,7,0,66
"60968",1060968,110,65,6,181
"60969",1060969,79,150,5,234
"60970",1060970,107,30,2,139
"60971",1060971,123,42,40,205
"60972",1060972,26,149,1,176
"60973",1060973,151,39,11,201
"60974",1060974,234,23,5,262
"60975",1060975,64,216,17,297
"60976",1060976,107,136,3,246
"60977",1060977,78,129,11,218
"60978",1060978,129,81,9,219
"60979",1060979,252,65,10,327
"60980",1060980,86,147,2,235
"60981",1060981,71,121,9,201
"60982",1060982,72,166,2,240
"60983",1060983,46,57,4,107
"60984",1060984,126,65,7,198
"60985",1060985,138,28,1,167
"60986",1060986,42,42,7,91
"60987",1060987,132,52,14,198
"60988",1060988,196,21,5,222
"60989",1060989,178,53,9,240
"60990",1060990,31,204,6,241
"60991",1060991,98,147,6,251
"60992",1060992,116,160,3,279
"60993",1060993,152,83,5,240
"60994",1060994,68,197,4,269
"60995",1060995,244,38,14,296
"60996",1060996,61,36,4,101
"60997",1060997,74,201,5,280
"60998",1060998,47,58,1,106
"60999",1060999,89,79,11,179
"61000",1061000,52,118,1,171
"61001",1061001,60,183,4,247
"61002",1061002,92,218,5,315
"61003",1061003,165,59,8,232
"61004",1061004,158,39,5,202
"61005",1061005,59,237,9,305
"61006",1061006,33,213,6,252
"61007",1061007,29,100,4,133
"61008",1061008,104,57,3,164
"61009",1061009,159,66,1,226
"61010",1061010,136,43,3,182
"61011",1061011,164,46,9,219
"61012",1061012,227,39,4,270
"61013",1061013,95,174,5,274
"61014",1061014,9,30,1,40
"61015",1061015,19,261,4,284
"61016",1061016,24,17,1,42
"61017",1061017,107,212,4,323
"61018",1061018,28,6,2,36
"61019",1061019,17,78,1,96
"61020",1061020,70,66,3,139
"61021",1061021,99,72,3,174
"61022",1061022,95,34,17,146
"61023",1061023,39,237,5,281
"61024",1061024,43,26,2,71
"61025",1061025,46,74,2,122
"61026",1061026,44,262,11,317
"61027",1061027,44,178,8,230
"61028",1061028,53,65,10,128
"61029",1061029,10,16,0,26
"61030",1061030,15,7,2,24
"61031",1061031,141,137,5,283
"61032",1061032,46,102,2,150
"61033",1061033,9,10,2,21
"61034",1061034,88,61,3,152
"61035",1061035,144,122,12,278
"61036",1061036,70,201,6,277
"61037",1061037,16,179,5,200
"61038",1061038,41,207,6,254
"61039",1061039,93,178,7,278
"61040",1061040,19,9,4,32
"61041",1061041,117,110,2,229
"61042",1061042,142,40,2,184
"61043",1061043,61,224,4,289
"61044",1061044,72,180,19,271
"61045",1061045,74,251,4,329
"61046",1061046,171,55,10,236
"61047",1061047,105,204,6,315
"61048",1061048,120,164,8,292
"61049",1061049,57,215,6,278
"61050",1061050,129,90,11,230
"61051",1061051,171,50,7,228
"61052",1061052,141,78,13,232
"61053",1061053,74,17,6,97
"61054",1061054,165,16,4,185
"61055",1061055,139,89,9,237
"61056",1061056,139,58,4,201
"61057",1061057,79,0,1,80
"61058",1061058,249,39,18,306
"61059",1061059,124,65,6,195
"61060",1061060,161,57,11,229
"61061",1061061,79,192,10,281
"61062",1061062,116,162,29,307
"61063",1061063,117,137,21,275
"61064",1061064,91,59,8,158
"61065",1061065,78,13,3,94
"61066",1061066,164,63,6,233
"61067",1061067,176,89,8,273
"61068",1061068,168,25,3,196
"61069",1061069,43,245,4,292
"61070",1061070,123,3,5,131
"61071",1061071,128,89,14,231
"61072",1061072,94,183,9,286
"61073",1061073,115,205,13,333
"61074",1061074,28,12,7,47
"61075",1061075,149,40,5,194
"61076",1061076,80,192,3,275
"61077",1061077,80,84,5,169
"61078",1061078,187,41,3,231
"61079",1061079,225,25,7,257
"61080",1061080,173,43,0,216
"61081",1061081,168,93,10,271
"61082",1061082,131,34,12,177
"61083",1061083,84,184,15,283
"61084",1061084,71,144,10,225
"61085",1061085,162,13,6,181
"61086",1061086,58,162,4,224
"61087",1061087,27,275,2,304
"61088",1061088,51,180,7,238
"61089",1061089,125,62,6,193
"61090",1061090,97,79,11,187
"61091",1061091,34,14,6,54
"61092",1061092,175,94,11,280
"61093",1061093,60,227,11,298
"61094",1061094,16,94,2,112
"61095",1061095,30,265,4,299
"61096",1061096,30,8,1,39
"61097",1061097,70,197,7,274
"61098",1061098,48,272,11,331
"61099",1061099,105,107,7,219
"61100",1061100,71,262,8,341
"61101",1061101,29,38,3,70
"61102",1061102,79,72,3,154
"61103",1061103,67,42,3,112
"61104",1061104,43,22,3,68
"61105",1061105,121,154,16,291
"61106",1061106,76,94,9,179
"61107",1061107,11,2,0,13
"61108",1061108,28,220,7,255
"61109",1061109,125,17,4,146
"61110",1061110,166,99,7,272
"61111",1061111,68,71,0,139
"61112",1061112,208,51,6,265
"61113",1061113,4,3,4,11
"61114",1061114,144,136,10,290
"61115",1061115,101,38,5,144
"61116",1061116,135,9,6,150
"61117",1061117,232,36,11,279
"61118",1061118,144,57,2,203
"61119",1061119,100,41,10,151
"61120",1061120,12,62,2,76
"61121",1061121,177,121,11,309
"61122",1061122,116,63,6,185
"61123",1061123,164,87,10,261
"61124",1061124,112,94,6,212
"61125",1061125,171,37,9,217
"61126",1061126,147,17,1,165
"61127",1061127,48,15,1,64
"61128",1061128,149,78,6,233
"61129",1061129,77,167,20,264
"61130",1061130,145,75,0,220
"61131",1061131,73,171,9,253
"61132",1061132,198,82,13,293
"61133",1061133,111,66,6,183
"61134",1061134,96,102,17,215
"61135",1061135,101,79,15,195
"61136",1061136,185,148,16,349
"61137",1061137,100,130,30,260
"61138",1061138,113,21,0,134
"61139",1061139,131,55,12,198
"61140",1061140,69,131,5,205
"61141",1061141,38,147,7,192
"61142",1061142,55,8,1,64
"61143",1061143,151,43,4,198
"61144",1061144,119,27,5,151
"61145",1061145,141,54,9,204
"61146",1061146,35,151,9,195
"61147",1061147,194,37,5,236
"61148",1061148,229,33,11,273
"61149",1061149,18,15,9,42
"61150",1061150,37,247,5,289
"61151",1061151,53,204,6,263
"61152",1061152,50,176,6,232
"61153",1061153,131,45,5,181
"61154",1061154,66,28,13,107
"61155",1061155,84,110,10,204
"61156",1061156,54,225,0,279
"61157",1061157,116,19,5,140
"61158",1061158,157,13,5,175
"61159",1061159,105,168,19,292
"61160",1061160,174,117,9,300
"61161",1061161,163,20,11,194
"61162",1061162,112,71,5,188
"61163",1061163,114,90,14,218
"61164",1061164,19,230,4,253
"61165",1061165,148,40,7,195
"61166",1061166,121,113,7,241
"61167",1061167,24,204,4,232
"61168",1061168,63,161,17,241
"61169",1061169,36,140,7,183
"61170",1061170,88,84,6,178
"61171",1061171,129,144,22,295
"61172",1061172,186,91,12,289
"61173",1061173,98,186,7,291
"61174",1061174,154,30,4,188
"61175",1061175,40,154,15,209
"61176",1061176,24,215,7,246
"61177",1061177,166,113,10,289
"61178",1061178,100,72,8,180
"61179",1061179,97,138,8,243
"61180",1061180,71,158,20,249
"61181",1061181,114,154,10,278
"61182",1061182,171,74,4,249
"61183",1061183,150,43,10,203
"61184",1061184,201,80,11,292
"61185",1061185,144,52,5,201
"61186",1061186,29,263,8,300
"61187",1061187,26,23,1,50
"61188",1061188,57,227,11,295
"61189",1061189,99,171,16,286
"61190",1061190,94,139,22,255
"61191",1061191,120,185,4,309
"61192",1061192,145,56,7,208
"61193",1061193,153,14,7,174
"61194",1061194,83,45,4,132
"61195",1061195,57,206,4,267
"61196",1061196,170,97,12,279
"61197",1061197,91,190,10,291
"61198",1061198,100,57,5,162
"61199",1061199,189,37,10,236
"61200",1061200,122,59,9,190
"61201",1061201,0,68,0,68
"61202",1061202,51,23,5,79
"61203",1061203,80,217,4,301
"61204",1061204,44,226,14,284
"61205",1061205,60,218,11,289
"61206",1061206,124,129,11,264
"61207",1061207,28,23,5,56
"61208",1061208,112,127,13,252
"61209",1061209,100,29,8,137
"61210",1061210,128,47,7,182
"61211",1061211,188,97,23,308
"61212",1061212,125,98,13,236
"61213",1061213,57,115,4,176
"61214",1061214,90,111,15,216
"61215",1061215,132,156,16,304
"61216",1061216,184,132,25,341
"61217",1061217,100,56,4,160
"61218",1061218,38,184,11,233
"61219",1061219,95,223,7,325
"61220",1061220,146,121,17,284
"61221",1061221,98,30,9,137
"61222",1061222,159,149,4,312
"61223",1061223,122,140,23,285
"61224",1061224,96,77,14,187
"61225",1061225,64,235,8,307
"61226",1061226,183,36,5,224
"61227",1061227,150,136,4,290
"61228",1061228,10,8,1,19
"61229",1061229,204,56,4,264
"61230",1061230,189,25,5,219
"61231",1061231,186,18,5,209
"61232",1061232,166,98,22,286
"61233",1061233,108,70,2,180
"61234",1061234,169,129,13,311
"61235",1061235,24,124,3,151
"61236",1061236,126,139,6,271
"61237",1061237,171,71,11,253
"61238",1061238,115,160,15,290
"61239",1061239,77,84,6,167
"61240",1061240,202,92,14,308
"61241",1061241,24,7,1,32
"61242",1061242,9,33,2,44
"61243",1061243,151,59,8,218
"61244",1061244,75,28,2,105
"61245",1061245,146,92,16,254
"61246",1061246,81,122,4,207
"61247",1061247,90,222,9,321
"61248",1061248,116,167,30,313
"61249",1061249,28,177,1,206
"61250",1061250,184,101,17,302
"61251",1061251,36,227,12,275
"61252",1061252,51,177,14,242
"61253",1061253,79,142,11,232
"61254",1061254,32,225,5,262
"61255",1061255,93,37,5,135
"61256",1061256,8,154,1,163
"61257",1061257,103,55,8,166
"61258",1061258,142,110,5,257
"61259",1061259,152,27,4,183
"61260",1061260,132,64,2,198
"61261",1061261,15,13,1,29
"61262",1061262,195,88,1,284
"61263",1061263,51,244,5,300
"61264",1061264,23,234,4,261
"61265",1061265,177,77,23,277
"61266",1061266,145,115,18,278
"61267",1061267,152,137,15,304
"61268",1061268,207,38,8,253
"61269",1061269,31,229,5,265
"61270",1061270,131,51,11,193
"61271",1061271,81,212,6,299
"61272",1061272,42,140,11,193
"61273",1061273,56,173,14,243
"61274",1061274,146,52,8,206
"61275",1061275,49,54,1,104
"61276",1061276,23,250,4,277
"61277",1061277,79,37,1,117
"61278",1061278,155,90,3,248
"61279",1061279,118,29,5,152
"61280",1061280,146,88,11,245
"61281",1061281,121,149,11,281
"61282",1061282,148,43,4,195
"61283",1061283,248,41,8,297
"61284",1061284,121,120,10,251
"61285",1061285,62,167,10,239
"61286",1061286,79,75,5,159
"61287",1061287,115,95,0,210
"61288",1061288,154,48,12,214
"61289",1061289,70,219,6,295
"61290",1061290,124,138,20,282
"61291",1061291,130,207,19,356
"61292",1061292,106,91,10,207
"61293",1061293,112,139,11,262
"61294",1061294,96,164,2,262
"61295",1061295,22,7,1,30
"61296",1061296,97,134,12,243
"61297",1061297,113,106,8,227
"61298",1061298,83,101,6,190
"61299",1061299,55,53,10,118
"61300",1061300,80,69,14,163
"61301",1061301,130,77,7,214
"61302",1061302,100,142,13,255
"61303",1061303,90,81,8,179
"61304",1061304,138,73,14,225
"61305",1061305,27,35,2,64
"61306",1061306,55,233,5,293
"61307",1061307,76,153,6,235
"61308",1061308,48,37,5,90
"61309",1061309,77,42,2,121
"61310",1061310,256,24,10,290
"61311",1061311,237,27,7,271
"61312",1061312,77,12,3,92
"61313",1061313,78,85,8,171
"61314",1061314,113,43,11,167
"61315",1061315,202,40,5,247
"61316",1061316,83,11,1,95
"61317",1061317,139,154,4,297
"61318",1061318,210,23,4,237
"61319",1061319,150,95,2,247
"61320",1061320,83,77,10,170
"61321",1061321,182,44,16,242
"61322",1061322,169,77,15,261
"61323",1061323,161,105,13,279
"61324",1061324,170,21,9,200
"61325",1061325,10,80,1,91
"61326",1061326,30,185,2,217
"61327",1061327,128,143,15,286
"61328",1061328,211,27,7,245
"61329",1061329,82,209,6,297
"61330",1061330,108,108,8,224
"61331",1061331,25,136,1,162
"61332",1061332,116,51,4,171
"61333",1061333,165,76,6,247
"61334",1061334,132,79,11,222
"61335",1061335,183,22,6,211
"61336",1061336,92,102,6,200
"61337",1061337,97,193,9,299
"61338",1061338,41,116,13,170
"61339",1061339,27,201,3,231
"61340",1061340,113,79,2,194
"61341",1061341,73,154,8,235
"61342",1061342,57,232,9,298
"61343",1061343,21,213,1,235
"61344",1061344,50,167,14,231
"61345",1061345,230,89,7,326
"61346",1061346,41,226,4,271
"61347",1061347,135,129,0,264
"61348",1061348,112,25,6,143
"61349",1061349,92,157,7,256
"61350",1061350,198,93,15,306
"61351",1061351,16,48,1,65
"61352",1061352,17,180,7,204
"61353",1061353,68,195,14,277
"61354",1061354,42,6,2,50
"61355",1061355,55,52,2,109
"61356",1061356,5,15,0,20
"61357",1061357,95,54,1,150
"61358",1061358,111,185,9,305
"61359",1061359,71,66,11,148
"61360",1061360,176,77,11,264
"61361",1061361,184,96,11,291
"61362",1061362,45,185,11,241
"61363",1061363,157,40,26,223
"61364",1061364,76,196,14,286
"61365",1061365,197,74,6,277
"61366",1061366,15,39,2,56
"61367",1061367,55,242,5,302
"61368",1061368,86,44,4,134
"61369",1061369,133,39,9,181
"61370",1061370,22,108,4,134
"61371",1061371,194,63,9,266
"61372",1061372,90,224,5,319
"61373",1061373,83,208,13,304
"61374",1061374,44,191,4,239
"61375",1061375,92,190,16,298
"61376",1061376,120,66,9,195
"61377",1061377,103,151,12,266
"61378",1061378,17,229,2,248
"61379",1061379,67,66,9,142
"61380",1061380,129,89,16,234
"61381",1061381,88,119,10,217
"61382",1061382,178,108,16,302
"61383",1061383,154,28,2,184
"61384",1061384,121,44,3,168
"61385",1061385,49,260,5,314
"61386",1061386,48,196,1,245
"61387",1061387,21,21,4,46
"61388",1061388,215,53,25,293
"61389",1061389,121,116,2,239
"61390",1061390,143,109,19,271
"61391",1061391,161,86,18,265
"61392",1061392,146,43,5,194
"61393",1061393,67,204,2,273
"61394",1061394,125,116,16,257
"61395",1061395,85,142,5,232
"61396",1061396,178,84,6,268
"61397",1061397,91,324,13,428
"61398",1061398,94,118,3,215
"61399",1061399,118,41,8,167
"61400",1061400,164,42,3,209
"61401",1061401,182,48,14,244
"61402",1061402,43,226,6,275
"61403",1061403,189,85,7,281
"61404",1061404,40,180,4,224
"61405",1061405,39,14,2,55
"61406",1061406,181,46,9,236
"61407",1061407,164,84,12,260
"61408",1061408,122,157,4,283
"61409",1061409,170,49,8,227
"61410",1061410,72,188,8,268
"61411",1061411,85,165,9,259
"61412",1061412,86,121,11,218
"61413",1061413,191,88,12,291
"61414",1061414,98,198,14,310
"61415",1061415,58,150,2,210
"61416",1061416,147,62,8,217
"61417",1061417,219,54,7,280
"61418",1061418,63,165,3,231
"61419",1061419,68,174,7,249
"61420",1061420,147,75,9,231
"61421",1061421,204,74,7,285
"61422",1061422,73,87,4,164
"61423",1061423,42,252,6,300
"61424",1061424,93,94,6,193
"61425",1061425,209,26,6,241
"61426",1061426,95,111,27,233
"61427",1061427,85,220,18,323
"61428",1061428,172,19,4,195
"61429",1061429,79,5,2,86
"61430",1061430,217,46,15,278
"61431",1061431,133,77,16,226
"61432",1061432,193,2,0,195
"61433",1061433,115,44,8,167
"61434",1061434,102,19,5,126
"61435",1061435,101,102,14,217
"61436",1061436,171,38,6,215
"61437",1061437,138,138,9,285
"61438",1061438,153,102,3,258
"61439",1061439,7,128,3,138
"61440",1061440,151,77,7,235
"61441",1061441,147,7,5,159
"61442",1061442,71,36,2,109
"61443",1061443,82,35,4,121
"61444",1061444,76,212,25,313
"61445",1061445,114,198,18,330
"61446",1061446,177,92,3,272
"61447",1061447,94,163,12,269
"61448",1061448,135,53,7,195
"61449",1061449,24,21,4,49
"61450",1061450,146,121,12,279
"61451",1061451,155,70,6,231
"61452",1061452,37,7,0,44
"61453",1061453,180,48,10,238
"61454",1061454,100,248,8,356
"61455",1061455,81,70,3,154
"61456",1061456,64,114,23,201
"61457",1061457,69,181,11,261
"61458",1061458,108,94,21,223
"61459",1061459,92,131,2,225
"61460",1061460,199,66,5,270
"61461",1061461,127,123,10,260
"61462",1061462,152,52,9,213
"61463",1061463,72,133,6,211
"61464",1061464,39,188,8,235
"61465",1061465,158,45,15,218
"61466",1061466,17,2,0,19
"61467",1061467,205,68,10,283
"61468",1061468,157,65,10,232
"61469",1061469,116,162,11,289
"61470",1061470,37,299,4,340
"61471",1061471,203,31,4,238
"61472",1061472,175,110,13,298
"61473",1061473,26,224,2,252
"61474",1061474,86,164,5,255
"61475",1061475,157,75,10,242
"61476",1061476,34,161,1,196
"61477",1061477,51,166,17,234
"61478",1061478,98,197,22,317
"61479",1061479,82,75,1,158
"61480",1061480,129,16,3,148
"61481",1061481,91,131,8,230
"61482",1061482,208,13,0,221
"61483",1061483,150,29,5,184
"61484",1061484,55,162,9,226
"61485",1061485,96,153,7,256
"61486",1061486,48,235,0,283
"61487",1061487,167,82,7,256
"61488",1061488,125,157,16,298
"61489",1061489,3,7,0,10
"61490",1061490,81,181,5,267
"61491",1061491,56,179,11,246
"61492",1061492,153,63,5,221
"61493",1061493,100,178,8,286
"61494",1061494,103,99,2,204
"61495",1061495,18,32,2,52
"61496",1061496,211,27,4,242
"61497",1061497,57,57,5,119
"61498",1061498,165,48,9,222
"61499",1061499,96,110,9,215
"61500",1061500,148,119,18,285
"61501",1061501,136,142,14,292
"61502",1061502,145,127,19,291
"61503",1061503,113,99,16,228
"61504",1061504,160,81,13,254
"61505",1061505,63,178,20,261
"61506",1061506,190,30,8,228
"61507",1061507,108,63,10,181
"61508",1061508,98,219,19,336
"61509",1061509,80,40,3,123
"61510",1061510,52,226,20,298
"61511",1061511,59,48,2,109
"61512",1061512,48,21,1,70
"61513",1061513,171,55,3,229
"61514",1061514,29,198,6,233
"61515",1061515,128,110,13,251
"61516",1061516,25,258,6,289
"61517",1061517,115,141,21,277
"61518",1061518,64,161,6,231
"61519",1061519,46,96,2,144
"61520",1061520,38,244,15,297
"61521",1061521,87,227,6,320
"61522",1061522,28,93,5,126
"61523",1061523,134,126,14,274
"61524",1061524,108,40,3,151
"61525",1061525,122,48,5,175
"61526",1061526,147,86,6,239
"61527",1061527,45,21,7,73
"61528",1061528,81,57,5,143
"61529",1061529,132,86,7,225
"61530",1061530,221,63,12,296
"61531",1061531,60,46,4,110
"61532",1061532,48,40,3,91
"61533",1061533,127,170,5,302
"61534",1061534,46,181,5,232
"61535",1061535,22,233,2,257
"61536",1061536,11,14,1,26
"61537",1061537,138,82,23,243
"61538",1061538,45,113,3,161
"61539",1061539,122,115,3,240
"61540",1061540,167,33,6,206
"61541",1061541,97,177,7,281
"61542",1061542,63,70,15,148
"61543",1061543,163,55,12,230
"61544",1061544,125,20,0,145
"61545",1061545,101,116,6,223
"61546",1061546,138,49,12,199
"61547",1061547,118,60,7,185
"61548",1061548,50,254,4,308
"61549",1061549,132,95,11,238
"61550",1061550,272,12,2,286
"61551",1061551,149,46,11,206
"61552",1061552,102,202,17,321
"61553",1061553,81,108,8,197
"61554",1061554,131,109,10,250
"61555",1061555,57,271,9,337
"61556",1061556,150,90,6,246
"61557",1061557,12,45,2,59
"61558",1061558,145,52,3,200
"61559",1061559,186,103,20,309
"61560",1061560,153,122,17,292
"61561",1061561,74,143,6,223
"61562",1061562,208,51,4,263
"61563",1061563,60,144,10,214
"61564",1061564,161,101,10,272
"61565",1061565,29,180,10,219
"61566",1061566,108,131,16,255
"61567",1061567,93,30,1,124
"61568",1061568,162,89,20,271
"61569",1061569,95,184,10,289
"61570",1061570,78,202,12,292
"61571",1061571,59,180,4,243
"61572",1061572,44,140,4,188
"61573",1061573,217,41,4,262
"61574",1061574,118,104,11,233
"61575",1061575,71,28,1,100
"61576",1061576,61,134,7,202
"61577",1061577,193,57,10,260
"61578",1061578,126,142,22,290
"61579",1061579,131,30,9,170
"61580",1061580,155,114,6,275
"61581",1061581,65,201,8,274
"61582",1061582,199,105,13,317
"61583",1061583,174,47,20,241
"61584",1061584,226,2,1,229
"61585",1061585,217,10,8,235
"61586",1061586,123,100,4,227
"61587",1061587,143,76,8,227
"61588",1061588,148,126,9,283
"61589",1061589,78,140,9,227
"61590",1061590,155,87,11,253
"61591",1061591,76,184,4,264
"61592",1061592,46,154,2,202
"61593",1061593,119,44,4,167
"61594",1061594,156,82,17,255
"61595",1061595,113,87,6,206
"61596",1061596,22,146,4,172
"61597",1061597,15,236,0,251
"61598",1061598,137,74,6,217
"61599",1061599,105,156,4,265
"61600",1061600,32,276,8,316
"61601",1061601,87,168,13,268
"61602",1061602,136,123,5,264
"61603",1061603,112,67,3,182
"61604",1061604,156,140,2,298
"61605",1061605,49,274,4,327
"61606",1061606,61,9,3,73
"61607",1061607,35,160,5,200
"61608",1061608,89,103,4,196
"61609",1061609,192,95,8,295
"61610",1061610,76,174,24,274
"61611",1061611,49,181,11,241
"61612",1061612,230,27,13,270
"61613",1061613,179,54,4,237
"61614",1061614,198,60,3,261
"61615",1061615,193,46,6,245
"61616",1061616,175,61,5,241
"61617",1061617,36,77,7,120
"61618",1061618,67,31,5,103
"61619",1061619,101,158,12,271
"61620",1061620,151,104,4,259
"61621",1061621,104,39,7,150
"61622",1061622,73,146,6,225
"61623",1061623,80,111,14,205
"61624",1061624,76,181,2,259
"61625",1061625,166,62,5,233
"61626",1061626,140,76,11,227
"61627",1061627,103,112,23,238
"61628",1061628,57,104,10,171
"61629",1061629,48,139,8,195
"61630",1061630,70,101,2,173
"61631",1061631,217,21,6,244
"61632",1061632,38,206,3,247
"61633",1061633,58,118,3,179
"61634",1061634,155,80,14,249
"61635",1061635,118,52,4,174
"61636",1061636,35,309,5,349
"61637",1061637,88,140,8,236
"61638",1061638,10,4,0,14
"61639",1061639,193,33,11,237
"61640",1061640,13,12,1,26
"61641",1061641,187,85,18,290
"61642",1061642,188,51,1,240
"61643",1061643,130,120,7,257
"61644",1061644,45,11,5,61
"61645",1061645,95,63,2,160
"61646",1061646,134,8,0,142
"61647",1061647,15,126,6,147
"61648",1061648,262,16,1,279
"61649",1061649,75,12,2,89
"61650",1061650,161,74,10,245
"61651",1061651,146,91,11,248
"61652",1061652,206,10,2,218
"61653",1061653,249,32,9,290
"61654",1061654,157,69,19,245
"61655",1061655,50,205,18,273
"61656",1061656,97,34,10,141
"61657",1061657,95,123,4,222
"61658",1061658,157,59,2,218
"61659",1061659,132,146,6,284
"61660",1061660,97,162,16,275
"61661",1061661,79,26,8,113
"61662",1061662,198,13,2,213
"61663",1061663,157,37,5,199
"61664",1061664,168,105,11,284
"61665",1061665,15,44,2,61
"61666",1061666,80,149,16,245
"61667",1061667,6,38,0,44
"61668",1061668,179,84,8,271
"61669",1061669,124,53,5,182
"61670",1061670,47,126,5,178
"61671",1061671,170,47,15,232
"61672",1061672,55,166,14,235
"61673",1061673,25,156,5,186
"61674",1061674,97,67,5,169
"61675",1061675,131,143,17,291
"61676",1061676,97,205,6,308
"61677",1061677,125,99,21,245
"61678",1061678,155,25,4,184
"61679",1061679,167,67,21,255
"61680",1061680,34,59,3,96
"61681",1061681,82,178,13,273
"61682",1061682,113,81,8,202
"61683",1061683,75,21,1,97
"61684",1061684,175,44,17,236
"61685",1061685,110,43,5,158
"61686",1061686,88,133,4,225
"61687",1061687,146,53,9,208
"61688",1061688,142,92,6,240
"61689",1061689,79,182,4,265
"61690",1061690,166,66,4,236
"61691",1061691,154,83,9,246
"61692",1061692,123,52,8,183
"61693",1061693,160,82,12,254
"61694",1061694,87,121,1,209
"61695",1061695,189,40,10,239
"61696",1061696,55,191,2,248
"61697",1061697,85,95,11,191
"61698",1061698,36,89,7,132
"61699",1061699,66,171,17,254
"61700",1061700,103,109,4,216
"61701",1061701,186,35,15,236
"61702",1061702,198,29,12,239
"61703",1061703,46,21,1,68
"61704",1061704,121,70,15,206
"61705",1061705,189,0,1,190
"61706",1061706,83,185,8,276
"61707",1061707,265,14,9,288
"61708",1061708,102,147,9,258
"61709",1061709,149,107,14,270
"61710",1061710,62,145,6,213
"61711",1061711,63,220,9,292
"61712",1061712,66,82,10,158
"61713",1061713,64,226,16,306
"61714",1061714,103,76,4,183
"61715",1061715,117,198,8,323
"61716",1061716,11,3,1,15
"61717",1061717,93,150,1,244
"61718",1061718,250,19,5,274
"61719",1061719,198,35,9,242
"61720",1061720,118,61,7,186
"61721",1061721,96,18,4,118
"61722",1061722,26,114,2,142
"61723",1061723,118,35,5,158
"61724",1061724,44,195,4,243
"61725",1061725,150,64,7,221
"61726",1061726,224,44,8,276
"61727",1061727,143,99,8,250
"61728",1061728,238,2,0,240
"61729",1061729,204,41,5,250
"61730",1061730,68,60,5,133
"61731",1061731,141,147,33,321
"61732",1061732,107,55,1,163
"61733",1061733,55,110,1,166
"61734",1061734,133,138,13,284
"61735",1061735,6,37,1,44
"61736",1061736,109,124,21,254
"61737",1061737,209,123,17,349
"61738",1061738,59,228,2,289
"61739",1061739,65,202,5,272
"61740",1061740,25,36,3,64
"61741",1061741,115,132,2,249
"61742",1061742,78,123,11,212
"61743",1061743,77,205,2,284
"61744",1061744,75,61,11,147
"61745",1061745,177,40,8,225
"61746",1061746,39,85,3,127
"61747",1061747,66,17,3,86
"61748",1061748,106,165,7,278
"61749",1061749,59,32,6,97
"61750",1061750,31,26,0,57
"61751",1061751,130,25,5,160
"61752",1061752,221,10,3,234
"61753",1061753,174,69,9,252
"61754",1061754,44,247,4,295
"61755",1061755,159,45,4,208
"61756",1061756,156,22,4,182
"61757",1061757,91,56,6,153
"61758",1061758,48,106,2,156
"61759",1061759,87,213,8,308
"61760",1061760,139,57,8,204
"61761",1061761,21,42,2,65
"61762",1061762,231,44,9,284
"61763",1061763,7,171,8,186
"61764",1061764,65,35,0,100
"61765",1061765,59,43,3,105
"61766",1061766,97,153,18,268
"61767",1061767,97,157,15,269
"61768",1061768,50,163,5,218
"61769",1061769,132,31,11,174
"61770",1061770,64,18,2,84
"61771",1061771,129,68,10,207
"61772",1061772,147,57,10,214
"61773",1061773,49,256,5,310
"61774",1061774,92,127,12,231
"61775",1061775,156,46,6,208
"61776",1061776,95,143,10,248
"61777",1061777,128,56,4,188
"61778",1061778,156,64,14,234
"61779",1061779,121,34,3,158
"61780",1061780,151,18,3,172
"61781",1061781,170,129,1,300
"61782",1061782,264,46,5,315
"61783",1061783,92,187,8,287
"61784",1061784,49,125,2,176
"61785",1061785,156,104,10,270
"61786",1061786,134,53,3,190
"61787",1061787,166,127,17,310
"61788",1061788,146,54,3,203
"61789",1061789,129,194,4,327
"61790",1061790,117,67,12,196
"61791",1061791,50,144,16,210
"61792",1061792,149,24,11,184
"61793",1061793,11,71,2,84
"61794",1061794,177,59,3,239
"61795",1061795,136,61,0,197
"61796",1061796,32,228,6,266
"61797",1061797,63,211,4,278
"61798",1061798,189,42,13,244
"61799",1061799,132,23,4,159
"61800",1061800,127,161,10,298
"61801",1061801,183,39,12,234
"61802",1061802,154,58,7,219
"61803",1061803,134,96,2,232
"61804",1061804,121,149,10,280
"61805",1061805,206,33,14,253
"61806",1061806,122,65,6,193
"61807",1061807,145,68,8,221
"61808",1061808,117,157,16,290
"61809",1061809,236,36,12,284
"61810",1061810,87,218,14,319
"61811",1061811,12,46,3,61
"61812",1061812,48,142,7,197
"61813",1061813,189,19,1,209
"61814",1061814,8,10,0,18
"61815",1061815,31,37,2,70
"61816",1061816,192,52,5,249
"61817",1061817,130,37,11,178
"61818",1061818,60,173,13,246
"61819",1061819,140,52,9,201
"61820",1061820,191,120,6,317
"61821",1061821,53,184,2,239
"61822",1061822,97,176,14,287
"61823",1061823,152,128,18,298
"61824",1061824,177,31,5,213
"61825",1061825,86,131,7,224
"61826",1061826,115,108,14,237
"61827",1061827,47,53,3,103
"61828",1061828,52,80,2,134
"61829",1061829,167,76,10,253
"61830",1061830,90,126,10,226
"61831",1061831,148,103,14,265
"61832",1061832,75,155,15,245
"61833",1061833,60,222,4,286
"61834",1061834,189,72,17,278
"61835",1061835,209,40,7,256
"61836",1061836,239,51,6,296
"61837",1061837,69,71,1,141
"61838",1061838,227,58,14,299
"61839",1061839,97,13,2,112
"61840",1061840,136,85,12,233
"61841",1061841,165,68,3,236
"61842",1061842,92,61,8,161
"61843",1061843,137,76,7,220
"61844",1061844,148,91,13,252
"61845",1061845,177,83,7,267
"61846",1061846,146,43,11,200
"61847",1061847,24,7,0,31
"61848",1061848,157,142,8,307
"61849",1061849,131,110,3,244
"61850",1061850,68,175,14,257
"61851",1061851,89,116,4,209
"61852",1061852,86,246,12,344
"61853",1061853,20,215,8,243
"61854",1061854,125,109,9,243
"61855",1061855,43,211,7,261
"61856",1061856,14,8,2,24
"61857",1061857,16,244,9,269
"61858",1061858,200,62,9,271
"61859",1061859,181,20,9,210
"61860",1061860,48,1,3,52
"61861",1061861,4,15,0,19
"61862",1061862,6,144,0,150
"61863",1061863,168,10,10,188
"61864",1061864,121,141,17,279
"61865",1061865,105,132,9,246
"61866",1061866,62,202,9,273
"61867",1061867,194,83,8,285
"61868",1061868,155,91,9,255
"61869",1061869,23,64,3,90
"61870",1061870,151,130,1,282
"61871",1061871,43,43,5,91
"61872",1061872,101,54,7,162
"61873",1061873,101,169,17,287
"61874",1061874,109,59,7,175
"61875",1061875,149,206,14,369
"61876",1061876,31,335,1,367
"61877",1061877,177,75,14,266
"61878",1061878,43,11,5,59
"61879",1061879,53,127,10,190
"61880",1061880,256,33,17,306
"61881",1061881,159,15,9,183
"61882",1061882,200,21,6,227
"61883",1061883,97,124,3,224
"61884",1061884,60,34,4,98
"61885",1061885,71,87,8,166
"61886",1061886,110,142,16,268
"61887",1061887,150,87,11,248
"61888",1061888,188,6,1,195
"61889",1061889,51,7,0,58
"61890",1061890,163,38,5,206
"61891",1061891,121,146,8,275
"61892",1061892,15,6,1,22
"61893",1061893,32,279,7,318
"61894",1061894,46,161,5,212
"61895",1061895,171,21,7,199
"61896",1061896,98,55,5,158
"61897",1061897,62,166,10,238
"61898",1061898,56,3,3,62
"61899",1061899,184,38,12,234
"61900",1061900,126,135,3,264
"61901",1061901,138,83,6,227
"61902",1061902,25,37,2,64
"61903",1061903,195,2,4,201
"61904",1061904,23,153,2,178
"61905",1061905,16,70,1,87
"61906",1061906,52,111,9,172
"61907",1061907,112,16,3,131
"61908",1061908,165,6,5,176
"61909",1061909,237,57,11,305
"61910",1061910,48,0,1,49
"61911",1061911,195,17,4,216
"61912",1061912,62,207,7,276
"61913",1061913,96,59,5,160
"61914",1061914,80,178,16,274
"61915",1061915,111,91,15,217
"61916",1061916,114,41,3,158
"61917",1061917,201,62,12,275
"61918",1061918,226,21,6,253
"61919",1061919,69,209,20,298
"61920",1061920,141,1,1,143
"61921",1061921,38,169,3,210
"61922",1061922,183,34,3,220
"61923",1061923,93,224,14,331
"61924",1061924,81,17,2,100
"61925",1061925,106,106,16,228
"61926",1061926,16,10,1,27
"61927",1061927,143,172,12,327
"61928",1061928,38,38,2,78
"61929",1061929,125,173,8,306
"61930",1061930,173,82,5,260
"61931",1061931,161,47,16,224
"61932",1061932,46,262,3,311
"61933",1061933,49,54,11,114
"61934",1061934,13,135,1,149
"61935",1061935,214,65,11,290
"61936",1061936,174,36,11,221
"61937",1061937,114,38,6,158
"61938",1061938,143,52,11,206
"61939",1061939,217,32,9,258
"61940",1061940,63,143,6,212
"61941",1061941,110,110,8,228
"61942",1061942,215,48,16,279
"61943",1061943,161,49,4,214
"61944",1061944,142,23,4,169
"61945",1061945,65,221,2,288
"61946",1061946,109,59,4,172
"61947",1061947,95,176,5,276
"61948",1061948,60,134,7,201
"61949",1061949,39,211,6,256
"61950",1061950,105,190,10,305
"61951",1061951,137,32,11,180
"61952",1061952,77,8,7,92
"61953",1061953,229,19,7,255
"61954",1061954,185,18,6,209
"61955",1061955,105,158,11,274
"61956",1061956,131,35,2,168
"61957",1061957,206,60,14,280
"61958",1061958,217,1,6,224
"61959",1061959,66,149,3,218
"61960",1061960,93,114,2,209
"61961",1061961,91,147,9,247
"61962",1061962,174,65,5,244
"61963",1061963,3,19,1,23
"61964",1061964,245,10,3,258
"61965",1061965,13,14,3,30
"61966",1061966,177,92,6,275
"61967",1061967,110,80,19,209
"61968",1061968,67,170,14,251
"61969",1061969,94,67,8,169
"61970",1061970,146,119,9,274
"61971",1061971,231,2,5,238
"61972",1061972,162,64,6,232
"61973",1061973,156,103,11,270
"61974",1061974,103,141,11,255
"61975",1061975,126,72,2,200
"61976",1061976,158,39,6,203
"61977",1061977,163,63,2,228
"61978",1061978,82,148,4,234
"61979",1061979,120,94,13,227
"61980",1061980,15,14,3,32
"61981",1061981,117,74,4,195
"61982",1061982,95,129,10,234
"61983",1061983,63,39,4,106
"61984",1061984,97,137,3,237
"61985",1061985,96,102,3,201
"61986",1061986,152,86,15,253
"61987",1061987,194,89,6,289
"61988",1061988,14,2,2,18
"61989",1061989,152,168,10,330
"61990",1061990,195,51,11,257
"61991",1061991,89,187,9,285
"61992",1061992,181,139,8,328
"61993",1061993,196,52,3,251
"61994",1061994,2,14,2,18
"61995",1061995,62,152,0,214
"61996",1061996,95,30,1,126
"61997",1061997,88,96,8,192
"61998",1061998,96,166,7,269
"61999",1061999,49,166,5,220
"62000",1062000,368,56,27,451
"62001",1062001,10,73,1,84
"62002",1062002,9,13,1,23
"62003",1062003,191,39,9,239
"62004",1062004,149,164,6,319
"62005",1062005,182,83,6,271
"62006",1062006,159,88,18,265
"62007",1062007,113,95,0,208
"62008",1062008,24,177,3,204
"62009",1062009,49,245,2,296
"62010",1062010,179,121,15,315
"62011",1062011,49,209,8,266
"62012",1062012,162,90,3,255
"62013",1062013,168,21,4,193
"62014",1062014,159,89,6,254
"62015",1062015,199,24,15,238
"62016",1062016,133,41,8,182
"62017",1062017,90,161,18,269
"62018",1062018,146,47,6,199
"62019",1062019,129,80,14,223
"62020",1062020,138,114,10,262
"62021",1062021,40,106,3,149
"62022",1062022,211,28,3,242
"62023",1062023,106,112,11,229
"62024",1062024,93,177,10,280
"62025",1062025,157,125,6,288
"62026",1062026,60,144,6,210
"62027",1062027,15,24,3,42
"62028",1062028,210,99,13,322
"62029",1062029,243,9,5,257
"62030",1062030,5,67,0,72
"62031",1062031,120,48,8,176
"62032",1062032,115,115,17,247
"62033",1062033,119,52,24,195
"62034",1062034,73,132,15,220
"62035",1062035,111,35,5,151
"62036",1062036,131,87,14,232
"62037",1062037,5,6,0,11
"62038",1062038,77,234,0,311
"62039",1062039,80,174,26,280
"62040",1062040,94,159,2,255
"62041",1062041,195,114,21,330
"62042",1062042,74,235,13,322
"62043",1062043,55,154,6,215
"62044",1062044,160,9,6,175
"62045",1062045,83,123,16,222
"62046",1062046,26,36,3,65
"62047",1062047,159,72,8,239
"62048",1062048,43,206,6,255
"62049",1062049,39,238,12,289
"62050",1062050,77,190,8,275
"62051",1062051,76,173,11,260
"62052",1062052,42,93,7,142
"62053",1062053,114,116,10,240
"62054",1062054,110,163,8,281
"62055",1062055,29,203,9,241
"62056",1062056,171,42,2,215
"62057",1062057,176,70,9,255
"62058",1062058,162,93,12,267
"62059",1062059,60,147,6,213
"62060",1062060,224,68,14,306
"62061",1062061,131,122,9,262
"62062",1062062,35,30,1,66
"62063",1062063,161,16,4,181
"62064",1062064,130,75,6,211
"62065",1062065,12,4,0,16
"62066",1062066,128,130,11,269
"62067",1062067,172,25,9,206
"62068",1062068,94,186,13,293
"62069",1062069,169,157,11,337
"62070",1062070,12,43,4,59
"62071",1062071,157,155,4,316
"62072",1062072,223,37,14,274
"62073",1062073,51,118,9,178
"62074",1062074,197,44,6,247
"62075",1062075,140,68,12,220
"62076",1062076,152,42,5,199
"62077",1062077,94,134,29,257
"62078",1062078,103,157,2,262
"62079",1062079,216,26,4,246
"62080",1062080,163,55,7,225
"62081",1062081,237,44,2,283
"62082",1062082,203,66,13,282
"62083",1062083,250,0,0,250
"62084",1062084,48,7,1,56
"62085",1062085,47,315,5,367
"62086",1062086,63,68,3,134
"62087",1062087,4,198,3,205
"62088",1062088,215,75,28,318
"62089",1062089,155,127,7,289
"62090",1062090,237,4,8,249
"62091",1062091,44,76,9,129
"62092",1062092,167,65,2,234
"62093",1062093,116,154,8,278
"62094",1062094,136,12,2,150
"62095",1062095,218,33,8,259
"62096",1062096,17,251,3,271
"62097",1062097,113,110,10,233
"62098",1062098,135,106,22,263
"62099",1062099,101,162,5,268
"62100",1062100,154,46,6,206
"62101",1062101,204,49,2,255
"62102",1062102,91,196,3,290
"62103",1062103,192,22,8,222
"62104",1062104,21,115,5,141
"62105",1062105,17,16,2,35
"62106",1062106,31,212,0,243
"62107",1062107,101,49,6,156
"62108",1062108,38,271,3,312
"62109",1062109,12,181,9,202
"62110",1062110,46,224,4,274
"62111",1062111,79,193,6,278
"62112",1062112,28,44,2,74
"62113",1062113,124,87,13,224
"62114",1062114,40,281,12,333
"62115",1062115,125,47,4,176
"62116",1062116,222,67,14,303
"62117",1062117,148,130,5,283
"62118",1062118,80,6,3,89
"62119",1062119,47,92,6,145
"62120",1062120,154,131,17,302
"62121",1062121,56,248,5,309
"62122",1062122,130,50,6,186
"62123",1062123,168,36,2,206
"62124",1062124,153,35,6,194
"62125",1062125,63,191,5,259
"62126",1062126,44,99,3,146
"62127",1062127,44,105,1,150
"62128",1062128,112,7,1,120
"62129",1062129,33,135,5,173
"62130",1062130,204,20,6,230
"62131",1062131,97,181,10,288
"62132",1062132,62,216,7,285
"62133",1062133,187,33,40,260
"62134",1062134,70,90,10,170
"62135",1062135,141,64,4,209
"62136",1062136,113,150,18,281
"62137",1062137,100,143,23,266
"62138",1062138,134,108,12,254
"62139",1062139,152,61,6,219
"62140",1062140,192,57,4,253
"62141",1062141,23,62,2,87
"62142",1062142,58,19,1,78
"62143",1062143,12,43,6,61
"62144",1062144,96,147,17,260
"62145",1062145,137,77,7,221
"62146",1062146,128,31,4,163
"62147",1062147,104,192,9,305
"62148",1062148,156,13,1,170
"62149",1062149,122,75,4,201
"62150",1062150,191,62,14,267
"62151",1062151,147,63,8,218
"62152",1062152,86,99,3,188
"62153",1062153,17,81,1,99
"62154",1062154,201,47,10,258
"62155",1062155,99,141,10,250
"62156",1062156,102,0,2,104
"62157",1062157,67,244,5,316
"62158",1062158,128,67,7,202
"62159",1062159,253,8,12,273
"62160",1062160,112,49,6,167
"62161",1062161,72,204,3,279
"62162",1062162,116,59,7,182
"62163",1062163,205,114,16,335
"62164",1062164,166,97,9,272
"62165",1062165,119,45,6,170
"62166",1062166,162,93,21,276
"62167",1062167,180,51,1,232
"62168",1062168,70,120,7,197
"62169",1062169,116,52,7,175
"62170",1062170,200,36,25,261
"62171",1062171,26,149,2,177
"62172",1062172,179,51,12,242
"62173",1062173,84,135,7,226
"62174",1062174,156,116,9,281
"62175",1062175,31,216,2,249
"62176",1062176,30,249,2,281
"62177",1062177,71,233,4,308
"62178",1062178,223,22,14,259
"62179",1062179,67,107,2,176
"62180",1062180,95,140,4,239
"62181",1062181,217,17,7,241
"62182",1062182,64,45,4,113
"62183",1062183,37,47,10,94
"62184",1062184,238,68,9,315
"62185",1062185,96,163,11,270
"62186",1062186,104,70,10,184
"62187",1062187,131,108,17,256
"62188",1062188,131,14,4,149
"62189",1062189,137,26,8,171
"62190",1062190,42,119,7,168
"62191",1062191,97,113,17,227
"62192",1062192,191,36,7,234
"62193",1062193,100,12,5,117
"62194",1062194,53,108,5,166
"62195",1062195,227,84,12,323
"62196",1062196,111,78,9,198
"62197",1062197,93,188,7,288
"62198",1062198,128,112,10,250
"62199",1062199,214,20,6,240
"62200",1062200,98,198,5,301
"62201",1062201,127,62,9,198
"62202",1062202,60,21,1,82
"62203",1062203,148,57,9,214
"62204",1062204,72,45,3,120
"62205",1062205,26,325,4,355
"62206",1062206,26,128,2,156
"62207",1062207,125,16,6,147
"62208",1062208,98,128,10,236
"62209",1062209,168,96,26,290
"62210",1062210,87,183,4,274
"62211",1062211,151,197,6,354
"62212",1062212,115,60,3,178
"62213",1062213,159,149,3,311
"62214",1062214,140,98,6,244
"62215",1062215,75,123,9,207
"62216",1062216,18,188,1,207
"62217",1062217,100,111,8,219
"62218",1062218,32,235,5,272
"62219",1062219,92,180,4,276
"62220",1062220,138,36,3,177
"62221",1062221,166,52,12,230
"62222",1062222,27,266,3,296
"62223",1062223,138,36,0,174
"62224",1062224,37,258,7,302
"62225",1062225,61,190,11,262
"62226",1062226,32,218,8,258
"62227",1062227,198,51,2,251
"62228",1062228,197,11,5,213
"62229",1062229,146,39,5,190
"62230",1062230,171,85,4,260
"62231",1062231,150,31,1,182
"62232",1062232,50,84,11,145
"62233",1062233,123,54,4,181
"62234",1062234,159,93,9,261
"62235",1062235,232,63,6,301
"62236",1062236,88,173,19,280
"62237",1062237,143,125,13,281
"62238",1062238,21,131,3,155
"62239",1062239,171,63,7,241
"62240",1062240,227,54,21,302
"62241",1062241,230,47,15,292
"62242",1062242,140,161,9,310
"62243",1062243,164,68,7,239
"62244",1062244,108,132,12,252
"62245",1062245,214,41,12,267
"62246",1062246,72,158,1,231
"62247",1062247,35,151,6,192
"62248",1062248,207,75,19,301
"62249",1062249,113,117,8,238
"62250",1062250,110,44,9,163
"62251",1062251,118,141,9,268
"62252",1062252,203,77,15,295
"62253",1062253,104,88,15,207
"62254",1062254,93,163,7,263
"62255",1062255,95,89,3,187
"62256",1062256,130,124,5,259
"62257",1062257,117,149,13,279
"62258",1062258,148,82,3,233
"62259",1062259,151,36,4,191
"62260",1062260,31,135,3,169
"62261",1062261,38,23,3,64
"62262",1062262,164,66,6,236
"62263",1062263,44,90,6,140
"62264",1062264,70,76,15,161
"62265",1062265,192,16,1,209
"62266",1062266,66,78,9,153
"62267",1062267,152,80,16,248
"62268",1062268,162,51,8,221
"62269",1062269,20,8,2,30
"62270",1062270,112,114,1,227
"62271",1062271,220,20,5,245
"62272",1062272,33,15,1,49
"62273",1062273,36,196,4,236
"62274",1062274,165,72,9,246
"62275",1062275,36,247,10,293
"62276",1062276,73,181,5,259
"62277",1062277,177,138,16,331
"62278",1062278,23,7,1,31
"62279",1062279,93,165,11,269
"62280",1062280,84,160,6,250
"62281",1062281,196,35,5,236
"62282",1062282,28,37,6,71
"62283",1062283,104,54,2,160
"62284",1062284,208,65,11,284
"62285",1062285,88,86,2,176
"62286",1062286,78,191,14,283
"62287",1062287,208,83,6,297
"62288",1062288,52,129,10,191
"62289",1062289,181,21,8,210
"62290",1062290,60,117,11,188
"62291",1062291,153,38,6,197
"62292",1062292,1,4,0,5
"62293",1062293,181,59,5,245
"62294",1062294,155,106,7,268
"62295",1062295,37,233,6,276
"62296",1062296,138,53,10,201
"62297",1062297,108,146,27,281
"62298",1062298,128,11,2,141
"62299",1062299,169,75,6,250
"62300",1062300,83,174,5,262
"62301",1062301,114,15,1,130
"62302",1062302,183,59,9,251
"62303",1062303,194,26,4,224
"62304",1062304,225,25,7,257
"62305",1062305,56,150,12,218
"62306",1062306,63,269,8,340
"62307",1062307,122,193,9,324
"62308",1062308,126,80,7,213
"62309",1062309,180,60,5,245
"62310",1062310,69,84,18,171
"62311",1062311,66,103,2,171
"62312",1062312,166,74,14,254
"62313",1062313,11,179,9,199
"62314",1062314,127,114,1,242
"62315",1062315,172,52,6,230
"62316",1062316,125,99,9,233
"62317",1062317,137,47,10,194
"62318",1062318,96,214,18,328
"62319",1062319,123,91,4,218
"62320",1062320,30,167,3,200
"62321",1062321,117,53,3,173
"62322",1062322,182,39,8,229
"62323",1062323,188,122,7,317
"62324",1062324,44,66,0,110
"62325",1062325,28,153,2,183
"62326",1062326,45,214,12,271
"62327",1062327,21,177,4,202
"62328",1062328,38,140,6,184
"62329",1062329,69,163,13,245
"62330",1062330,154,134,18,306
"62331",1062331,214,0,3,217
"62332",1062332,174,12,2,188
"62333",1062333,5,12,1,18
"62334",1062334,213,34,5,252
"62335",1062335,188,133,19,340
"62336",1062336,98,43,6,147
"62337",1062337,157,8,4,169
"62338",1062338,131,64,11,206
"62339",1062339,213,25,7,245
"62340",1062340,255,6,2,263
"62341",1062341,43,20,3,66
"62342",1062342,127,53,4,184
"62343",1062343,100,115,6,221
"62344",1062344,248,11,7,266
"62345",1062345,109,217,9,335
"62346",1062346,49,170,11,230
"62347",1062347,109,40,6,155
"62348",1062348,116,162,1,279
"62349",1062349,80,50,2,132
"62350",1062350,93,151,19,263
"62351",1062351,37,208,13,258
"62352",1062352,186,28,10,224
"62353",1062353,103,57,3,163
"62354",1062354,37,200,9,246
"62355",1062355,168,98,8,274
"62356",1062356,63,34,2,99
"62357",1062357,19,263,1,283
"62358",1062358,52,55,4,111
"62359",1062359,69,56,2,127
"62360",1062360,127,143,3,273
"62361",1062361,203,13,4,220
"62362",1062362,62,190,8,260
"62363",1062363,104,178,6,288
"62364",1062364,93,138,6,237
"62365",1062365,49,182,1,232
"62366",1062366,146,51,18,215
"62367",1062367,54,108,11,173
"62368",1062368,39,71,2,112
"62369",1062369,39,102,8,149
"62370",1062370,171,7,2,180
"62371",1062371,139,35,4,178
"62372",1062372,164,105,16,285
"62373",1062373,93,206,10,309
"62374",1062374,151,132,11,294
"62375",1062375,129,8,8,145
"62376",1062376,110,48,3,161
"62377",1062377,116,6,5,127
"62378",1062378,67,172,18,257
"62379",1062379,76,140,7,223
"62380",1062380,104,166,4,274
"62381",1062381,97,87,9,193
"62382",1062382,55,170,1,226
"62383",1062383,166,71,7,244
"62384",1062384,109,82,6,197
"62385",1062385,193,102,15,310
"62386",1062386,177,30,4,211
"62387",1062387,202,31,2,235
"62388",1062388,39,217,4,260
"62389",1062389,167,62,2,231
"62390",1062390,178,23,3,204
"62391",1062391,260,3,0,263
"62392",1062392,212,99,19,330
"62393",1062393,218,44,4,266
"62394",1062394,146,38,3,187
"62395",1062395,153,100,6,259
"62396",1062396,43,242,11,296
"62397",1062397,115,63,9,187
"62398",1062398,214,100,18,332
"62399",1062399,179,65,8,252
"62400",1062400,75,188,12,275
"62401",1062401,37,189,3,229
"62402",1062402,24,15,0,39
"62403",1062403,212,34,6,252
"62404",1062404,142,156,17,315
"62405",1062405,97,118,11,226
"62406",1062406,202,32,6,240
"62407",1062407,137,13,1,151
"62408",1062408,35,53,3,91
"62409",1062409,63,221,10,294
"62410",1062410,48,169,10,227
"62411",1062411,63,251,6,320
"62412",1062412,99,27,1,127
"62413",1062413,173,89,3,265
"62414",1062414,67,189,2,258
"62415",1062415,38,194,2,234
"62416",1062416,86,84,5,175
"62417",1062417,150,132,18,300
"62418",1062418,91,107,8,206
"62419",1062419,225,68,18,311
"62420",1062420,234,33,10,277
"62421",1062421,37,124,6,167
"62422",1062422,121,165,9,295
"62423",1062423,185,117,11,313
"62424",1062424,81,12,1,94
"62425",1062425,92,95,5,192
"62426",1062426,117,79,1,197
"62427",1062427,121,38,9,168
"62428",1062428,2,4,1,7
"62429",1062429,215,36,3,254
"62430",1062430,229,52,12,293
"62431",1062431,50,173,4,227
"62432",1062432,85,156,6,247
"62433",1062433,65,62,10,137
"62434",1062434,74,126,13,213
"62435",1062435,98,128,3,229
"62436",1062436,176,20,13,209
"62437",1062437,110,54,6,170
"62438",1062438,11,6,0,17
"62439",1062439,105,93,5,203
"62440",1062440,25,244,8,277
"62441",1062441,145,82,10,237
"62442",1062442,34,106,7,147
"62443",1062443,122,64,7,193
"62444",1062444,191,36,4,231
"62445",1062445,5,4,1,10
"62446",1062446,141,124,3,268
"62447",1062447,198,63,3,264
"62448",1062448,93,135,14,242
"62449",1062449,112,34,5,151
"62450",1062450,103,158,32,293
"62451",1062451,73,175,4,252
"62452",1062452,43,198,6,247
"62453",1062453,177,60,10,247
"62454",1062454,108,166,13,287
"62455",1062455,63,208,5,276
"62456",1062456,98,96,5,199
"62457",1062457,216,47,13,276
"62458",1062458,112,62,6,180
"62459",1062459,14,1,2,17
"62460",1062460,114,82,14,210
"62461",1062461,111,97,6,214
"62462",1062462,73,146,27,246
"62463",1062463,26,154,2,182
"62464",1062464,25,19,1,45
"62465",1062465,27,143,3,173
"62466",1062466,174,116,9,299
"62467",1062467,7,4,1,12
"62468",1062468,93,147,10,250
"62469",1062469,214,44,10,268
"62470",1062470,90,93,1,184
"62471",1062471,105,78,12,195
"62472",1062472,18,158,4,180
"62473",1062473,19,203,1,223
"62474",1062474,226,37,7,270
"62475",1062475,148,143,13,304
"62476",1062476,68,94,11,173
"62477",1062477,41,226,6,273
"62478",1062478,22,227,3,252
"62479",1062479,90,149,13,252
"62480",1062480,99,102,6,207
"62481",1062481,130,77,8,215
"62482",1062482,167,5,2,174
"62483",1062483,107,109,7,223
"62484",1062484,125,17,4,146
"62485",1062485,81,161,16,258
"62486",1062486,82,162,10,254
"62487",1062487,143,114,8,265
"62488",1062488,148,55,5,208
"62489",1062489,33,151,3,187
"62490",1062490,74,109,14,197
"62491",1062491,14,220,1,235
"62492",1062492,37,177,9,223
"62493",1062493,78,46,5,129
"62494",1062494,71,32,8,111
"62495",1062495,81,118,14,213
"62496",1062496,112,114,27,253
"62497",1062497,176,44,9,229
"62498",1062498,167,64,10,241
"62499",1062499,140,39,7,186
"62500",1062500,47,187,15,249
"62501",1062501,74,38,3,115
"62502",1062502,210,35,5,250
"62503",1062503,234,9,4,247
"62504",1062504,105,52,10,167
"62505",1062505,44,1,0,45
"62506",1062506,68,53,2,123
"62507",1062507,132,73,11,216
"62508",1062508,224,32,7,263
"62509",1062509,220,32,11,263
"62510",1062510,36,225,0,261
"62511",1062511,145,94,25,264
"62512",1062512,81,149,6,236
"62513",1062513,31,259,5,295
"62514",1062514,83,155,5,243
"62515",1062515,73,97,1,171
"62516",1062516,19,56,2,77
"62517",1062517,86,114,4,204
"62518",1062518,69,152,11,232
"62519",1062519,76,200,6,282
"62520",1062520,118,58,24,200
"62521",1062521,92,200,17,309
"62522",1062522,169,35,4,208
"62523",1062523,33,188,0,221
"62524",1062524,22,285,2,309
"62525",1062525,167,69,8,244
"62526",1062526,114,116,6,236
"62527",1062527,129,31,9,169
"62528",1062528,82,11,2,95
"62529",1062529,162,11,5,178
"62530",1062530,72,202,2,276
"62531",1062531,45,14,1,60
"62532",1062532,118,88,9,215
"62533",1062533,233,31,7,271
"62534",1062534,170,115,22,307
"62535",1062535,204,69,5,278
"62536",1062536,61,213,3,277
"62537",1062537,163,84,7,254
"62538",1062538,129,53,19,201
"62539",1062539,26,350,4,380
"62540",1062540,44,162,5,211
"62541",1062541,152,57,2,211
"62542",1062542,175,102,19,296
"62543",1062543,50,159,1,210
"62544",1062544,64,91,7,162
"62545",1062545,143,118,18,279
"62546",1062546,56,158,8,222
"62547",1062547,139,92,11,242
"62548",1062548,198,111,17,326
"62549",1062549,59,143,11,213
"62550",1062550,75,50,5,130
"62551",1062551,98,34,5,137
"62552",1062552,182,108,15,305
"62553",1062553,75,10,4,89
"62554",1062554,249,16,8,273
"62555",1062555,159,38,6,203
"62556",1062556,177,37,5,219
"62557",1062557,188,32,3,223
"62558",1062558,90,184,10,284
"62559",1062559,79,201,9,289
"62560",1062560,212,54,2,268
"62561",1062561,46,63,5,114
"62562",1062562,34,273,11,318
"62563",1062563,56,174,19,249
"62564",1062564,143,93,2,238
"62565",1062565,101,175,3,279
"62566",1062566,154,32,13,199
"62567",1062567,57,216,5,278
"62568",1062568,232,81,14,327
"62569",1062569,119,61,1,181
"62570",1062570,73,175,32,280
"62571",1062571,50,11,6,67
"62572",1062572,26,196,3,225
"62573",1062573,118,80,14,212
"62574",1062574,225,72,20,317
"62575",1062575,109,24,3,136
"62576",1062576,92,51,11,154
"62577",1062577,43,10,3,56
"62578",1062578,173,37,13,223
"62579",1062579,69,44,4,117
"62580",1062580,140,115,7,262
"62581",1062581,230,57,15,302
"62582",1062582,44,215,11,270
"62583",1062583,225,62,15,302
"62584",1062584,121,71,2,194
"62585",1062585,128,157,4,289
"62586",1062586,3,6,0,9
"62587",1062587,183,45,8,236
"62588",1062588,50,174,7,231
"62589",1062589,102,88,14,204
"62590",1062590,47,201,8,256
"62591",1062591,277,7,12,296
"62592",1062592,206,10,6,222
"62593",1062593,205,65,23,293
"62594",1062594,226,17,7,250
"62595",1062595,190,93,15,298
"62596",1062596,110,101,11,222
"62597",1062597,46,269,8,323
"62598",1062598,214,57,9,280
"62599",1062599,109,231,9,349
"62600",1062600,21,262,7,290
"62601",1062601,85,48,5,138
"62602",1062602,106,133,3,242
"62603",1062603,65,190,9,264
"62604",1062604,168,69,13,250
"62605",1062605,200,37,12,249
"62606",1062606,41,218,4,263
"62607",1062607,100,80,10,190
"62608",1062608,182,80,13,275
"62609",1062609,81,190,15,286
"62610",1062610,137,96,8,241
"62611",1062611,56,155,8,219
"62612",1062612,64,133,14,211
"62613",1062613,8,10,0,18
"62614",1062614,51,46,4,101
"62615",1062615,91,150,11,252
"62616",1062616,110,140,26,276
"62617",1062617,144,130,7,281
"62618",1062618,59,217,1,277
"62619",1062619,103,71,5,179
"62620",1062620,140,44,15,199
"62621",1062621,96,78,3,177
"62622",1062622,81,133,4,218
"62623",1062623,70,81,7,158
"62624",1062624,61,112,21,194
"62625",1062625,178,77,20,275
"62626",1062626,207,99,9,315
"62627",1062627,209,42,7,258
"62628",1062628,96,88,2,186
"62629",1062629,55,168,9,232
"62630",1062630,199,21,4,224
"62631",1062631,43,16,6,65
"62632",1062632,20,257,1,278
"62633",1062633,62,176,9,247
"62634",1062634,107,177,9,293
"62635",1062635,110,125,2,237
"62636",1062636,116,57,15,188
"62637",1062637,107,70,7,184
"62638",1062638,29,207,8,244
"62639",1062639,172,117,14,303
"62640",1062640,44,111,14,169
"62641",1062641,59,185,17,261
"62642",1062642,9,56,4,69
"62643",1062643,169,39,12,220
"62644",1062644,99,82,8,189
"62645",1062645,197,70,10,277
"62646",1062646,117,26,7,150
"62647",1062647,217,30,10,257
"62648",1062648,167,61,4,232
"62649",1062649,75,129,3,207
"62650",1062650,234,81,9,324
"62651",1062651,203,54,6,263
"62652",1062652,39,180,5,224
"62653",1062653,31,46,5,82
"62654",1062654,34,90,2,126
"62655",1062655,239,42,10,291
"62656",1062656,151,80,5,236
"62657",1062657,33,187,8,228
"62658",1062658,155,35,6,196
"62659",1062659,141,94,3,238
"62660",1062660,60,5,1,66
"62661",1062661,104,184,22,310
"62662",1062662,91,187,4,282
"62663",1062663,76,29,4,109
"62664",1062664,165,53,8,226
"62665",1062665,185,106,17,308
"62666",1062666,62,202,4,268
"62667",1062667,116,10,2,128
"62668",1062668,154,43,5,202
"62669",1062669,75,113,10,198
"62670",1062670,29,160,10,199
"62671",1062671,11,172,2,185
"62672",1062672,125,1,3,129
"62673",1062673,242,0,1,243
"62674",1062674,151,78,14,243
"62675",1062675,123,35,8,166
"62676",1062676,41,308,6,355
"62677",1062677,181,12,1,194
"62678",1062678,117,40,12,169
"62679",1062679,43,22,2,67
"62680",1062680,20,8,1,29
"62681",1062681,153,150,14,317
"62682",1062682,40,49,4,93
"62683",1062683,82,178,12,272
"62684",1062684,101,142,4,247
"62685",1062685,104,15,3,122
"62686",1062686,75,210,18,303
"62687",1062687,25,163,9,197
"62688",1062688,63,233,4,300
"62689",1062689,116,115,3,234
"62690",1062690,146,48,10,204
"62691",1062691,52,206,11,269
"62692",1062692,131,5,1,137
"62693",1062693,41,255,5,301
"62694",1062694,53,249,12,314
"62695",1062695,95,134,10,239
"62696",1062696,105,150,10,265
"62697",1062697,46,138,4,188
"62698",1062698,100,43,3,146
"62699",1062699,83,140,2,225
"62700",1062700,152,100,4,256
"62701",1062701,26,5,0,31
"62702",1062702,136,47,5,188
"62703",1062703,40,213,2,255
"62704",1062704,91,23,2,116
"62705",1062705,73,216,5,294
"62706",1062706,156,49,9,214
"62707",1062707,230,29,3,262
"62708",1062708,134,138,20,292
"62709",1062709,19,214,2,235
"62710",1062710,145,43,10,198
"62711",1062711,169,103,9,281
"62712",1062712,153,133,12,298
"62713",1062713,113,146,18,277
"62714",1062714,176,134,16,326
"62715",1062715,41,253,4,298
"62716",1062716,150,105,2,257
"62717",1062717,170,89,21,280
"62718",1062718,128,120,11,259
"62719",1062719,132,35,6,173
"62720",1062720,52,244,6,302
"62721",1062721,68,238,3,309
"62722",1062722,160,93,10,263
"62723",1062723,144,88,6,238
"62724",1062724,118,34,4,156
"62725",1062725,101,175,9,285
"62726",1062726,119,71,4,194
"62727",1062727,126,181,8,315
"62728",1062728,141,117,4,262
"62729",1062729,15,73,4,92
"62730",1062730,77,221,1,299
"62731",1062731,71,8,1,80
"62732",1062732,92,72,15,179
"62733",1062733,57,140,2,199
"62734",1062734,146,135,5,286
"62735",1062735,70,66,4,140
"62736",1062736,125,127,16,268
"62737",1062737,235,47,9,291
"62738",1062738,227,70,8,305
"62739",1062739,36,84,5,125
"62740",1062740,25,65,3,93
"62741",1062741,77,211,7,295
"62742",1062742,115,106,13,234
"62743",1062743,156,126,15,297
"62744",1062744,80,88,7,175
"62745",1062745,134,97,0,231
"62746",1062746,82,86,11,179
"62747",1062747,212,43,5,260
"62748",1062748,62,13,0,75
"62749",1062749,203,56,4,263
"62750",1062750,67,132,13,212
"62751",1062751,29,39,4,72
"62752",1062752,7,22,0,29
"62753",1062753,130,169,6,305
"62754",1062754,126,57,20,203
"62755",1062755,117,25,3,145
"62756",1062756,142,67,8,217
"62757",1062757,23,75,5,103
"62758",1062758,188,80,6,274
"62759",1062759,113,12,3,128
"62760",1062760,144,15,7,166
"62761",1062761,197,66,8,271
"62762",1062762,185,34,4,223
"62763",1062763,102,21,7,130
"62764",1062764,202,14,4,220
"62765",1062765,132,101,12,245
"62766",1062766,236,22,5,263
"62767",1062767,79,255,8,342
"62768",1062768,45,18,1,64
"62769",1062769,194,136,10,340
"62770",1062770,172,41,18,231
"62771",1062771,45,138,4,187
"62772",1062772,54,248,2,304
"62773",1062773,55,245,14,314
"62774",1062774,128,113,12,253
"62775",1062775,132,147,7,286
"62776",1062776,150,69,7,226
"62777",1062777,150,32,9,191
"62778",1062778,109,33,5,147
"62779",1062779,129,55,1,185
"62780",1062780,220,20,4,244
"62781",1062781,105,45,5,155
"62782",1062782,133,58,1,192
"62783",1062783,41,188,2,231
"62784",1062784,132,56,4,192
"62785",1062785,151,29,10,190
"62786",1062786,88,392,25,505
"62787",1062787,117,65,14,196
"62788",1062788,117,70,13,200
"62789",1062789,15,16,1,32
"62790",1062790,213,34,11,258
"62791",1062791,63,145,10,218
"62792",1062792,59,226,10,295
"62793",1062793,98,63,7,168
"62794",1062794,90,74,4,168
"62795",1062795,186,98,7,291
"62796",1062796,66,164,5,235
"62797",1062797,63,53,5,121
"62798",1062798,117,61,7,185
"62799",1062799,73,116,10,199
"62800",1062800,135,103,9,247
"62801",1062801,74,154,6,234
"62802",1062802,171,92,6,269
"62803",1062803,118,18,3,139
"62804",1062804,70,100,7,177
"62805",1062805,30,249,2,281
"62806",1062806,8,185,7,200
"62807",1062807,163,107,7,277
"62808",1062808,143,60,9,212
"62809",1062809,43,154,8,205
"62810",1062810,134,79,6,219
"62811",1062811,165,62,9,236
"62812",1062812,84,119,5,208
"62813",1062813,115,99,6,220
"62814",1062814,147,131,5,283
"62815",1062815,134,111,8,253
"62816",1062816,200,59,3,262
"62817",1062817,94,146,12,252
"62818",1062818,140,143,7,290
"62819",1062819,145,52,6,203
"62820",1062820,46,132,10,188
"62821",1062821,122,168,14,304
"62822",1062822,277,10,14,301
"62823",1062823,37,32,3,72
"62824",1062824,103,88,11,202
"62825",1062825,114,140,7,261
"62826",1062826,162,85,6,253
"62827",1062827,27,3,1,31
"62828",1062828,51,42,4,97
"62829",1062829,13,41,0,54
"62830",1062830,158,69,16,243
"62831",1062831,166,66,16,248
"62832",1062832,33,85,1,119
"62833",1062833,39,219,1,259
"62834",1062834,44,119,15,178
"62835",1062835,154,91,12,257
"62836",1062836,7,95,0,102
"62837",1062837,100,187,18,305
"62838",1062838,151,20,12,183
"62839",1062839,161,47,5,213
"62840",1062840,141,55,2,198
"62841",1062841,88,12,2,102
"62842",1062842,155,32,12,199
"62843",1062843,119,66,11,196
"62844",1062844,160,37,3,200
"62845",1062845,236,53,15,304
"62846",1062846,47,160,9,216
"62847",1062847,98,43,5,146
"62848",1062848,111,153,4,268
"62849",1062849,70,198,12,280
"62850",1062850,146,78,11,235
"62851",1062851,162,63,7,232
"62852",1062852,203,58,6,267
"62853",1062853,271,10,8,289
"62854",1062854,109,15,2,126
"62855",1062855,215,84,7,306
"62856",1062856,197,39,6,242
"62857",1062857,16,23,1,40
"62858",1062858,6,9,1,16
"62859",1062859,121,44,8,173
"62860",1062860,56,260,6,322
"62861",1062861,238,7,4,249
"62862",1062862,67,220,8,295
"62863",1062863,70,83,9,162
"62864",1062864,124,106,10,240
"62865",1062865,56,192,10,258
"62866",1062866,216,56,5,277
"62867",1062867,213,78,17,308
"62868",1062868,80,120,19,219
"62869",1062869,36,192,4,232
"62870",1062870,87,105,5,197
"62871",1062871,152,43,9,204
"62872",1062872,220,19,13,252
"62873",1062873,100,181,8,289
"62874",1062874,103,183,20,306
"62875",1062875,50,218,10,278
"62876",1062876,185,84,13,282
"62877",1062877,30,224,2,256
"62878",1062878,23,144,4,171
"62879",1062879,69,103,19,191
"62880",1062880,46,206,1,253
"62881",1062881,159,58,2,219
"62882",1062882,164,42,8,214
"62883",1062883,33,12,3,48
"62884",1062884,99,156,12,267
"62885",1062885,19,235,3,257
"62886",1062886,64,216,4,284
"62887",1062887,214,84,11,309
"62888",1062888,10,6,2,18
"62889",1062889,109,106,16,231
"62890",1062890,133,62,8,203
"62891",1062891,87,72,20,179
"62892",1062892,109,123,8,240
"62893",1062893,105,100,9,214
"62894",1062894,103,120,17,240
"62895",1062895,40,165,1,206
"62896",1062896,32,134,1,167
"62897",1062897,188,96,13,297
"62898",1062898,5,83,0,88
"62899",1062899,201,41,4,246
"62900",1062900,78,203,3,284
"62901",1062901,71,149,18,238
"62902",1062902,191,76,7,274
"62903",1062903,72,84,3,159
"62904",1062904,86,224,9,319
"62905",1062905,135,91,20,246
"62906",1062906,251,55,9,315
"62907",1062907,104,28,2,134
"62908",1062908,35,130,0,165
"62909",1062909,30,50,1,81
"62910",1062910,50,145,7,202
"62911",1062911,18,5,0,23
"62912",1062912,85,164,8,257
"62913",1062913,78,193,9,280
"62914",1062914,166,39,5,210
"62915",1062915,145,87,4,236
"62916",1062916,242,17,7,266
"62917",1062917,165,72,15,252
"62918",1062918,37,203,1,241
"62919",1062919,88,348,4,440
"62920",1062920,69,28,5,102
"62921",1062921,122,28,6,156
"62922",1062922,15,9,0,24
"62923",1062923,176,76,10,262
"62924",1062924,135,159,18,312
"62925",1062925,126,101,12,239
"62926",1062926,34,290,11,335
"62927",1062927,42,135,12,189
"62928",1062928,28,228,9,265
"62929",1062929,47,239,16,302
"62930",1062930,74,43,7,124
"62931",1062931,157,135,14,306
"62932",1062932,111,20,4,135
"62933",1062933,83,82,10,175
"62934",1062934,93,168,13,274
"62935",1062935,84,21,5,110
"62936",1062936,114,148,20,282
"62937",1062937,58,223,1,282
"62938",1062938,53,244,12,309
"62939",1062939,111,121,5,237
"62940",1062940,175,13,17,205
"62941",1062941,91,107,12,210
"62942",1062942,69,29,2,100
"62943",1062943,206,21,10,237
"62944",1062944,129,39,5,173
"62945",1062945,65,109,8,182
"62946",1062946,233,21,7,261
"62947",1062947,226,33,4,263
"62948",1062948,152,59,5,216
"62949",1062949,49,162,3,214
"62950",1062950,38,267,8,313
"62951",1062951,143,82,6,231
"62952",1062952,25,94,1,120
"62953",1062953,129,99,14,242
"62954",1062954,82,117,4,203
"62955",1062955,133,82,10,225
"62956",1062956,207,39,12,258
"62957",1062957,84,134,4,222
"62958",1062958,132,97,12,241
"62959",1062959,105,163,9,277
"62960",1062960,56,67,2,125
"62961",1062961,204,77,19,300
"62962",1062962,232,27,7,266
"62963",1062963,85,55,1,141
"62964",1062964,19,169,0,188
"62965",1062965,74,188,3,265
"62966",1062966,125,89,10,224
"62967",1062967,262,78,6,346
"62968",1062968,243,20,8,271
"62969",1062969,163,107,11,281
"62970",1062970,53,82,3,138
"62971",1062971,156,105,21,282
"62972",1062972,96,195,12,303
"62973",1062973,103,114,19,236
"62974",1062974,55,114,14,183
"62975",1062975,87,187,10,284
"62976",1062976,171,109,13,293
"62977",1062977,39,11,3,53
"62978",1062978,59,193,18,270
"62979",1062979,138,151,10,299
"62980",1062980,211,71,22,304
"62981",1062981,86,23,4,113
"62982",1062982,22,185,18,225
"62983",1062983,55,214,13,282
"62984",1062984,57,139,10,206
"62985",1062985,93,57,5,155
"62986",1062986,129,91,7,227
"62987",1062987,46,201,3,250
"62988",1062988,156,62,7,225
"62989",1062989,164,81,6,251
"62990",1062990,128,99,14,241
"62991",1062991,90,113,10,213
"62992",1062992,36,225,2,263
"62993",1062993,56,211,1,268
"62994",1062994,181,80,7,268
"62995",1062995,151,111,18,280
"62996",1062996,121,90,21,232
"62997",1062997,108,17,3,128
"62998",1062998,77,0,1,78
"62999",1062999,6,50,0,56
"63000",1063000,114,98,10,222
"63001",1063001,154,115,9,278
"63002",1063002,107,54,2,163
"63003",1063003,47,246,4,297
"63004",1063004,53,144,1,198
"63005",1063005,49,189,9,247
"63006",1063006,56,242,3,301
"63007",1063007,108,115,9,232
"63008",1063008,117,131,2,250
"63009",1063009,79,85,8,172
"63010",1063010,20,246,2,268
"63011",1063011,77,172,10,259
"63012",1063012,135,72,20,227
"63013",1063013,110,172,17,299
"63014",1063014,84,141,10,235
"63015",1063015,47,190,15,252
"63016",1063016,156,95,3,254
"63017",1063017,30,218,4,252
"63018",1063018,199,15,6,220
"63019",1063019,153,43,7,203
"63020",1063020,12,76,1,89
"63021",1063021,68,7,3,78
"63022",1063022,53,176,7,236
"63023",1063023,56,194,18,268
"63024",1063024,137,109,19,265
"63025",1063025,110,173,11,294
"63026",1063026,40,165,2,207
"63027",1063027,93,128,6,227
"63028",1063028,170,52,14,236
"63029",1063029,183,24,7,214
"63030",1063030,173,100,4,277
"63031",1063031,163,95,11,269
"63032",1063032,101,148,3,252
"63033",1063033,253,42,8,303
"63034",1063034,156,49,6,211
"63035",1063035,16,51,1,68
"63036",1063036,163,69,5,237
"63037",1063037,96,172,6,274
"63038",1063038,143,38,8,189
"63039",1063039,84,72,5,161
"63040",1063040,12,6,3,21
"63041",1063041,142,15,5,162
"63042",1063042,58,197,9,264
"63043",1063043,138,26,4,168
"63044",1063044,72,46,7,125
"63045",1063045,139,55,3,197
"63046",1063046,54,191,7,252
"63047",1063047,114,93,6,213
"63048",1063048,67,184,3,254
"63049",1063049,176,40,6,222
"63050",1063050,52,119,14,185
"63051",1063051,125,2,2,129
"63052",1063052,13,220,5,238
"63053",1063053,228,50,10,288
"63054",1063054,202,36,8,246
"63055",1063055,75,169,6,250
"63056",1063056,107,120,10,237
"63057",1063057,136,39,9,184
"63058",1063058,163,24,6,193
"63059",1063059,94,99,10,203
"63060",1063060,66,166,10,242
"63061",1063061,68,186,7,261
"63062",1063062,82,107,14,203
"63063",1063063,12,20,1,33
"63064",1063064,34,232,2,268
"63065",1063065,185,56,2,243
"63066",1063066,125,62,5,192
"63067",1063067,259,10,6,275
"63068",1063068,175,25,5,205
"63069",1063069,193,104,15,312
"63070",1063070,102,108,18,228
"63071",1063071,125,91,6,222
"63072",1063072,64,266,11,341
"63073",1063073,67,201,12,280
"63074",1063074,37,214,5,256
"63075",1063075,50,142,3,195
"63076",1063076,186,62,11,259
"63077",1063077,18,64,10,92
"63078",1063078,103,175,8,286
"63079",1063079,139,14,10,163
"63080",1063080,172,21,7,200
"63081",1063081,13,8,1,22
"63082",1063082,137,53,10,200
"63083",1063083,225,28,7,260
"63084",1063084,131,96,6,233
"63085",1063085,48,109,1,158
"63086",1063086,147,55,10,212
"63087",1063087,145,121,13,279
"63088",1063088,31,1,0,32
"63089",1063089,208,17,5,230
"63090",1063090,50,119,3,172
"63091",1063091,143,68,9,220
"63092",1063092,128,83,8,219
"63093",1063093,170,30,5,205
"63094",1063094,197,49,15,261
"63095",1063095,125,22,3,150
"63096",1063096,150,103,7,260
"63097",1063097,60,217,6,283
"63098",1063098,58,195,7,260
"63099",1063099,179,119,10,308
"63100",1063100,170,34,11,215
"63101",1063101,15,60,4,79
"63102",1063102,99,66,5,170
"63103",1063103,220,14,1,235
"63104",1063104,233,13,2,248
"63105",1063105,42,89,6,137
"63106",1063106,39,235,13,287
"63107",1063107,90,23,10,123
"63108",1063108,124,9,3,136
"63109",1063109,130,64,7,201
"63110",1063110,78,125,18,221
"63111",1063111,185,101,18,304
"63112",1063112,100,357,15,472
"63113",1063113,170,16,6,192
"63114",1063114,40,225,14,279
"63115",1063115,104,7,7,118
"63116",1063116,129,167,18,314
"63117",1063117,264,7,3,274
"63118",1063118,100,152,8,260
"63119",1063119,143,83,4,230
"63120",1063120,191,8,2,201
"63121",1063121,180,74,18,272
"63122",1063122,298,33,5,336
"63123",1063123,50,198,8,256
"63124",1063124,106,158,14,278
"63125",1063125,36,95,3,134
"63126",1063126,239,35,3,277
"63127",1063127,157,35,3,195
"63128",1063128,265,5,25,295
"63129",1063129,194,87,15,296
"63130",1063130,133,79,8,220
"63131",1063131,84,125,5,214
"63132",1063132,132,48,11,191
"63133",1063133,228,63,13,304
"63134",1063134,46,143,2,191
"63135",1063135,58,205,4,267
"63136",1063136,48,152,13,213
"63137",1063137,185,82,4,271
"63138",1063138,5,18,0,23
"63139",1063139,141,75,8,224
"63140",1063140,175,32,8,215
"63141",1063141,42,30,5,77
"63142",1063142,103,204,18,325
"63143",1063143,77,61,6,144
"63144",1063144,182,32,12,226
"63145",1063145,116,77,3,196
"63146",1063146,62,120,9,191
"63147",1063147,162,37,6,205
"63148",1063148,174,46,3,223
"63149",1063149,31,213,8,252
"63150",1063150,75,114,7,196
"63151",1063151,180,64,9,253
"63152",1063152,72,127,4,203
"63153",1063153,60,164,15,239
"63154",1063154,22,17,3,42
"63155",1063155,44,217,4,265
"63156",1063156,202,57,9,268
"63157",1063157,188,46,2,236
"63158",1063158,167,64,11,242
"63159",1063159,81,130,6,217
"63160",1063160,120,81,14,215
"63161",1063161,115,34,5,154
"63162",1063162,179,15,1,195
"63163",1063163,44,53,3,100
"63164",1063164,183,56,6,245
"63165",1063165,159,86,8,253
"63166",1063166,21,131,3,155
"63167",1063167,107,117,4,228
"63168",1063168,11,261,2,274
"63169",1063169,149,25,1,175
"63170",1063170,63,123,16,202
"63171",1063171,40,94,6,140
"63172",1063172,92,106,4,202
"63173",1063173,142,39,2,183
"63174",1063174,28,187,10,225
"63175",1063175,182,97,8,287
"63176",1063176,25,243,4,272
"63177",1063177,92,174,14,280
"63178",1063178,133,5,0,138
"63179",1063179,80,97,6,183
"63180",1063180,46,47,2,95
"63181",1063181,62,52,7,121
"63182",1063182,24,2,1,27
"63183",1063183,21,235,2,258
"63184",1063184,112,102,5,219
"63185",1063185,145,24,3,172
"63186",1063186,80,159,4,243
"63187",1063187,85,181,19,285
"63188",1063188,28,4,0,32
"63189",1063189,175,26,6,207
"63190",1063190,30,166,5,201
"63191",1063191,20,73,3,96
"63192",1063192,75,50,7,132
"63193",1063193,46,235,9,290
"63194",1063194,159,79,3,241
"63195",1063195,225,33,10,268
"63196",1063196,201,109,4,314
"63197",1063197,45,265,3,313
"63198",1063198,58,234,4,296
"63199",1063199,185,147,11,343
"63200",1063200,144,67,8,219
"63201",1063201,165,66,6,237
"63202",1063202,125,140,9,274
"63203",1063203,56,235,16,307
"63204",1063204,63,105,6,174
"63205",1063205,31,10,1,42
"63206",1063206,88,195,10,293
"63207",1063207,119,124,14,257
"63208",1063208,59,7,5,71
"63209",1063209,145,123,7,275
"63210",1063210,173,47,19,239
"63211",1063211,82,171,3,256
"63212",1063212,101,97,10,208
"63213",1063213,67,165,9,241
"63214",1063214,82,232,12,326
"63215",1063215,29,9,1,39
"63216",1063216,129,156,9,294
"63217",1063217,130,101,9,240
"63218",1063218,191,25,8,224
"63219",1063219,211,36,5,252
"63220",1063220,52,237,4,293
"63221",1063221,144,27,3,174
"63222",1063222,116,12,2,130
"63223",1063223,167,100,17,284
"63224",1063224,122,123,10,255
"63225",1063225,98,120,7,225
"63226",1063226,71,216,9,296
"63227",1063227,57,188,2,247
"63228",1063228,194,48,10,252
"63229",1063229,191,48,4,243
"63230",1063230,107,124,9,240
"63231",1063231,12,10,0,22
"63232",1063232,172,78,4,254
"63233",1063233,94,65,1,160
"63234",1063234,101,168,15,284
"63235",1063235,57,153,0,210
"63236",1063236,78,101,9,188
"63237",1063237,196,38,6,240
"63238",1063238,52,151,9,212
"63239",1063239,61,71,3,135
"63240",1063240,47,90,9,146
"63241",1063241,49,139,5,193
"63242",1063242,36,171,6,213
"63243",1063243,192,73,33,298
"63244",1063244,105,155,6,266
"63245",1063245,113,54,4,171
"63246",1063246,67,181,25,273
"63247",1063247,122,87,12,221
"63248",1063248,59,80,9,148
"63249",1063249,185,26,6,217
"63250",1063250,147,147,17,311
"63251",1063251,126,126,10,262
"63252",1063252,143,81,12,236
"63253",1063253,102,145,4,251
"63254",1063254,59,195,6,260
"63255",1063255,236,42,7,285
"63256",1063256,88,93,9,190
"63257",1063257,236,82,13,331
"63258",1063258,65,225,6,296
"63259",1063259,31,12,0,43
"63260",1063260,146,103,7,256
"63261",1063261,175,144,12,331
"63262",1063262,39,167,9,215
"63263",1063263,72,354,19,445
"63264",1063264,84,115,6,205
"63265",1063265,104,84,4,192
"63266",1063266,114,183,9,306
"63267",1063267,158,28,10,196
"63268",1063268,42,33,4,79
"63269",1063269,41,164,7,212
"63270",1063270,185,36,3,224
"63271",1063271,60,223,5,288
"63272",1063272,260,18,8,286
"63273",1063273,6,4,1,11
"63274",1063274,21,264,6,291
"63275",1063275,46,149,1,196
"63276",1063276,25,107,1,133
"63277",1063277,272,0,7,279
"63278",1063278,65,146,6,217
"63279",1063279,128,207,15,350
"63280",1063280,142,64,11,217
"63281",1063281,217,97,14,328
"63282",1063282,183,29,10,222
"63283",1063283,72,174,7,253
"63284",1063284,241,20,0,261
"63285",1063285,149,55,4,208
"63286",1063286,21,54,2,77
"63287",1063287,90,131,4,225
"63288",1063288,108,118,10,236
"63289",1063289,160,108,7,275
"63290",1063290,202,30,7,239
"63291",1063291,149,141,14,304
"63292",1063292,233,59,3,295
"63293",1063293,162,10,19,191
"63294",1063294,3,11,0,14
"63295",1063295,35,243,2,280
"63296",1063296,142,49,8,199
"63297",1063297,63,141,3,207
"63298",1063298,262,12,1,275
"63299",1063299,172,49,10,231
"63300",1063300,151,69,6,226
"63301",1063301,121,31,9,161
"63302",1063302,34,229,2,265
"63303",1063303,36,269,5,310
"63304",1063304,49,188,7,244
"63305",1063305,39,32,3,74
"63306",1063306,154,21,5,180
"63307",1063307,49,189,5,243
"63308",1063308,130,41,11,182
"63309",1063309,284,40,13,337
"63310",1063310,150,113,6,269
"63311",1063311,5,43,2,50
"63312",1063312,93,97,5,195
"63313",1063313,166,43,2,211
"63314",1063314,229,31,12,272
"63315",1063315,109,1,0,110
"63316",1063316,105,171,7,283
"63317",1063317,54,230,5,289
"63318",1063318,103,181,14,298
"63319",1063319,131,96,8,235
"63320",1063320,74,188,6,268
"63321",1063321,179,90,11,280
"63322",1063322,102,127,8,237
"63323",1063323,190,42,2,234
"63324",1063324,139,91,19,249
"63325",1063325,69,248,10,327
"63326",1063326,106,114,5,225
"63327",1063327,128,51,2,181
"63328",1063328,54,41,3,98
"63329",1063329,68,143,19,230
"63330",1063330,244,13,3,260
"63331",1063331,8,127,3,138
"63332",1063332,172,33,8,213
"63333",1063333,55,227,4,286
"63334",1063334,29,112,4,145
"63335",1063335,141,70,24,235
"63336",1063336,20,164,4,188
"63337",1063337,17,165,0,182
"63338",1063338,139,12,2,153
"63339",1063339,107,72,15,194
"63340",1063340,162,116,2,280
"63341",1063341,42,189,12,243
"63342",1063342,76,171,11,258
"63343",1063343,60,60,3,123
"63344",1063344,140,25,5,170
"63345",1063345,230,14,7,251
"63346",1063346,171,51,5,227
"63347",1063347,59,58,5,122
"63348",1063348,162,51,8,221
"63349",1063349,88,183,6,277
"63350",1063350,114,151,8,273
"63351",1063351,55,66,5,126
"63352",1063352,32,285,6,323
"63353",1063353,36,186,5,227
"63354",1063354,24,167,4,195
"63355",1063355,150,58,15,223
"63356",1063356,26,77,5,108
"63357",1063357,50,9,1,60
"63358",1063358,50,61,6,117
"63359",1063359,20,36,1,57
"63360",1063360,172,124,15,311
"63361",1063361,106,203,11,320
"63362",1063362,133,88,5,226
"63363",1063363,105,57,5,167
"63364",1063364,186,75,9,270
"63365",1063365,44,106,1,151
"63366",1063366,105,162,8,275
"63367",1063367,28,17,2,47
"63368",1063368,67,145,7,219
"63369",1063369,124,13,4,141
"63370",1063370,153,60,12,225
"63371",1063371,142,35,4,181
"63372",1063372,96,157,15,268
"63373",1063373,143,111,5,259
"63374",1063374,35,147,4,186
"63375",1063375,179,46,6,231
"63376",1063376,51,24,4,79
"63377",1063377,113,59,5,177
"63378",1063378,192,73,14,279
"63379",1063379,57,192,8,257
"63380",1063380,86,14,5,105
"63381",1063381,139,65,8,212
"63382",1063382,7,6,0,13
"63383",1063383,163,69,9,241
"63384",1063384,114,129,4,247
"63385",1063385,11,233,4,248
"63386",1063386,80,150,10,240
"63387",1063387,108,147,2,257
"63388",1063388,192,50,10,252
"63389",1063389,95,143,4,242
"63390",1063390,105,24,7,136
"63391",1063391,6,154,0,160
"63392",1063392,143,78,4,225
"63393",1063393,20,81,2,103
"63394",1063394,188,62,15,265
"63395",1063395,156,63,11,230
"63396",1063396,43,13,3,59
"63397",1063397,158,115,3,276
"63398",1063398,84,176,3,263
"63399",1063399,131,144,0,275
"63400",1063400,51,124,16,191
"63401",1063401,78,126,4,208
"63402",1063402,134,134,13,281
"63403",1063403,207,24,15,246
"63404",1063404,82,200,7,289
"63405",1063405,32,32,1,65
"63406",1063406,3,10,0,13
"63407",1063407,1,7,1,9
"63408",1063408,83,5,3,91
"63409",1063409,147,38,10,195
"63410",1063410,40,50,1,91
"63411",1063411,42,306,3,351
"63412",1063412,56,42,4,102
"63413",1063413,187,29,18,234
"63414",1063414,163,41,6,210
"63415",1063415,181,107,2,290
"63416",1063416,234,32,8,274
"63417",1063417,138,91,5,234
"63418",1063418,73,51,2,126
"63419",1063419,57,3,0,60
"63420",1063420,142,20,6,168
"63421",1063421,108,22,4,134
"63422",1063422,127,97,14,238
"63423",1063423,93,210,5,308
"63424",1063424,72,179,4,255
"63425",1063425,225,33,8,266
"63426",1063426,37,226,5,268
"63427",1063427,70,127,15,212
"63428",1063428,12,5,1,18
"63429",1063429,149,46,6,201
"63430",1063430,8,17,0,25
"63431",1063431,66,255,15,336
"63432",1063432,123,139,21,283
"63433",1063433,91,171,4,266
"63434",1063434,28,192,1,221
"63435",1063435,201,67,8,276
"63436",1063436,62,174,6,242
"63437",1063437,191,118,22,331
"63438",1063438,192,25,6,223
"63439",1063439,201,96,15,312
"63440",1063440,11,9,2,22
"63441",1063441,168,39,4,211
"63442",1063442,244,20,10,274
"63443",1063443,65,171,6,242
"63444",1063444,123,55,4,182
"63445",1063445,186,89,5,280
"63446",1063446,76,49,3,128
"63447",1063447,0,0,0,0
"63448",1063448,48,154,5,207
"63449",1063449,97,56,6,159
"63450",1063450,146,7,2,155
"63451",1063451,99,56,7,162
"63452",1063452,165,58,11,234
"63453",1063453,74,95,7,176
"63454",1063454,55,152,7,214
"63455",1063455,45,255,9,309
"63456",1063456,5,49,1,55
"63457",1063457,116,97,6,219
"63458",1063458,70,28,5,103
"63459",1063459,101,186,8,295
"63460",1063460,183,41,8,232
"63461",1063461,107,67,12,186
"63462",1063462,17,221,5,243
"63463",1063463,202,29,15,246
"63464",1063464,23,134,3,160
"63465",1063465,123,98,1,222
"63466",1063466,57,151,5,213
"63467",1063467,31,4,1,36
"63468",1063468,163,40,10,213
"63469",1063469,154,78,4,236
"63470",1063470,7,30,0,37
"63471",1063471,147,51,9,207
"63472",1063472,73,171,8,252
"63473",1063473,204,22,8,234
"63474",1063474,171,21,3,195
"63475",1063475,121,94,6,221
"63476",1063476,86,238,4,328
"63477",1063477,102,122,8,232
"63478",1063478,17,55,3,75
"63479",1063479,16,77,3,96
"63480",1063480,95,166,8,269
"63481",1063481,85,109,3,197
"63482",1063482,70,92,11,173
"63483",1063483,49,277,2,328
"63484",1063484,42,107,6,155
"63485",1063485,205,42,7,254
"63486",1063486,162,25,6,193
"63487",1063487,66,214,5,285
"63488",1063488,48,85,7,140
"63489",1063489,164,84,9,257
"63490",1063490,96,60,4,160
"63491",1063491,106,180,11,297
"63492",1063492,57,150,8,215
"63493",1063493,111,73,15,199
"63494",1063494,103,94,7,204
"63495",1063495,146,75,15,236
"63496",1063496,136,155,19,310
"63497",1063497,68,185,14,267
"63498",1063498,32,199,2,233
"63499",1063499,57,176,3,236
"63500",1063500,51,194,15,260
"63501",1063501,102,122,4,228
"63502",1063502,115,88,6,209
"63503",1063503,116,132,16,264
"63504",1063504,131,8,8,147
"63505",1063505,199,65,16,280
"63506",1063506,147,59,9,215
"63507",1063507,28,193,0,221
"63508",1063508,25,64,1,90
"63509",1063509,274,54,11,339
"63510",1063510,91,248,17,356
"63511",1063511,225,18,3,246
"63512",1063512,127,129,8,264
"63513",1063513,154,112,9,275
"63514",1063514,122,110,12,244
"63515",1063515,218,58,11,287
"63516",1063516,118,17,2,137
"63517",1063517,130,92,12,234
"63518",1063518,130,6,9,145
"63519",1063519,94,82,8,184
"63520",1063520,251,34,5,290
"63521",1063521,93,174,18,285
"63522",1063522,202,39,12,253
"63523",1063523,116,82,10,208
"63524",1063524,38,279,9,326
"63525",1063525,141,114,4,259
"63526",1063526,37,271,3,311
"63527",1063527,81,73,7,161
"63528",1063528,154,93,13,260
"63529",1063529,131,48,8,187
"63530",1063530,12,16,2,30
"63531",1063531,24,130,2,156
"63532",1063532,167,47,6,220
"63533",1063533,72,213,4,289
"63534",1063534,126,97,6,229
"63535",1063535,68,92,11,171
"63536",1063536,116,151,5,272
"63537",1063537,32,98,3,133
"63538",1063538,207,24,14,245
"63539",1063539,116,154,7,277
"63540",1063540,183,95,10,288
"63541",1063541,91,32,1,124
"63542",1063542,131,85,6,222
"63543",1063543,206,31,7,244
"63544",1063544,187,51,10,248
"63545",1063545,110,204,4,318
"63546",1063546,141,149,20,310
"63547",1063547,251,59,8,318
"63548",1063548,95,117,11,223
"63549",1063549,28,52,11,91
"63550",1063550,29,100,4,133
"63551",1063551,141,42,8,191
"63552",1063552,205,25,7,237
"63553",1063553,106,64,5,175
"63554",1063554,110,65,5,180
"63555",1063555,143,48,15,206
"63556",1063556,48,239,8,295
"63557",1063557,25,97,1,123
"63558",1063558,15,170,1,186
"63559",1063559,85,75,8,168
"63560",1063560,162,84,6,252
"63561",1063561,40,277,2,319
"63562",1063562,162,98,18,278
"63563",1063563,72,49,3,124
"63564",1063564,138,107,7,252
"63565",1063565,72,155,11,238
"63566",1063566,33,60,0,93
"63567",1063567,141,51,4,196
"63568",1063568,52,14,3,69
"63569",1063569,178,42,6,226
"63570",1063570,117,60,9,186
"63571",1063571,9,294,4,307
"63572",1063572,168,105,7,280
"63573",1063573,146,65,10,221
"63574",1063574,73,106,11,190
"63575",1063575,52,38,2,92
"63576",1063576,24,231,4,259
"63577",1063577,126,101,7,234
"63578",1063578,87,21,2,110
"63579",1063579,33,100,2,135
"63580",1063580,162,48,5,215
"63581",1063581,148,34,11,193
"63582",1063582,116,44,4,164
"63583",1063583,27,236,8,271
"63584",1063584,113,45,9,167
"63585",1063585,160,27,8,195
"63586",1063586,59,61,4,124
"63587",1063587,197,20,6,223
"63588",1063588,30,215,3,248
"63589",1063589,37,221,6,264
"63590",1063590,147,21,3,171
"63591",1063591,52,237,6,295
"63592",1063592,73,146,12,231
"63593",1063593,227,20,7,254
"63594",1063594,18,9,3,30
"63595",1063595,38,19,5,62
"63596",1063596,97,112,7,216
"63597",1063597,187,22,7,216
"63598",1063598,55,37,16,108
"63599",1063599,103,68,6,177
"63600",1063600,93,230,13,336
"63601",1063601,10,3,0,13
"63602",1063602,143,89,5,237
"63603",1063603,61,168,6,235
"63604",1063604,170,92,4,266
"63605",1063605,52,192,10,254
"63606",1063606,105,123,16,244
"63607",1063607,281,38,9,328
"63608",1063608,170,104,6,280
"63609",1063609,102,85,9,196
"63610",1063610,139,30,6,175
"63611",1063611,56,5,3,64
"63612",1063612,78,157,4,239
"63613",1063613,50,192,10,252
"63614",1063614,49,129,3,181
"63615",1063615,157,86,5,248
"63616",1063616,40,94,3,137
"63617",1063617,247,15,13,275
"63618",1063618,167,20,7,194
"63619",1063619,122,91,0,213
"63620",1063620,41,19,1,61
"63621",1063621,245,17,3,265
"63622",1063622,143,77,28,248
"63623",1063623,11,88,2,101
"63624",1063624,40,222,2,264
"63625",1063625,78,136,7,221
"63626",1063626,127,201,9,337
"63627",1063627,103,74,12,189
"63628",1063628,204,21,9,234
"63629",1063629,27,111,0,138
"63630",1063630,24,251,1,276
"63631",1063631,97,161,4,262
"63632",1063632,24,75,3,102
"63633",1063633,61,240,13,314
"63634",1063634,78,35,5,118
"63635",1063635,155,47,1,203
"63636",1063636,81,218,10,309
"63637",1063637,15,74,2,91
"63638",1063638,188,38,2,228
"63639",1063639,138,95,3,236
"63640",1063640,82,81,15,178
"63641",1063641,124,178,5,307
"63642",1063642,214,106,18,338
"63643",1063643,166,115,4,285
"63644",1063644,171,122,13,306
"63645",1063645,204,45,8,257
"63646",1063646,115,46,8,169
"63647",1063647,229,30,2,261
"63648",1063648,8,5,1,14
"63649",1063649,173,82,14,269
"63650",1063650,67,198,4,269
"63651",1063651,102,118,6,226
"63652",1063652,4,4,0,8
"63653",1063653,75,177,3,255
"63654",1063654,152,103,20,275
"63655",1063655,97,83,10,190
"63656",1063656,52,126,4,182
"63657",1063657,34,74,8,116
"63658",1063658,101,159,7,267
"63659",1063659,93,149,11,253
"63660",1063660,74,24,1,99
"63661",1063661,103,213,12,328
"63662",1063662,248,28,8,284
"63663",1063663,59,81,2,142
"63664",1063664,164,106,14,284
"63665",1063665,176,42,8,226
"63666",1063666,35,143,13,191
"63667",1063667,95,58,8,161
"63668",1063668,50,134,17,201
"63669",1063669,176,117,11,304
"63670",1063670,146,32,5,183
"63671",1063671,76,189,5,270
"63672",1063672,89,157,10,256
"63673",1063673,83,171,14,268
"63674",1063674,113,143,4,260
"63675",1063675,77,180,18,275
"63676",1063676,199,24,2,225
"63677",1063677,101,200,10,311
"63678",1063678,109,172,10,291
"63679",1063679,56,142,3,201
"63680",1063680,68,194,8,270
"63681",1063681,147,63,8,218
"63682",1063682,29,120,4,153
"63683",1063683,20,2,0,22
"63684",1063684,45,17,4,66
"63685",1063685,94,166,4,264
"63686",1063686,19,56,4,79
"63687",1063687,34,94,1,129
"63688",1063688,1,5,0,6
"63689",1063689,53,194,3,250
"63690",1063690,17,223,5,245
"63691",1063691,23,175,9,207
"63692",1063692,162,83,10,255
"63693",1063693,94,164,9,267
"63694",1063694,177,85,4,266
"63695",1063695,119,53,8,180
"63696",1063696,51,79,2,132
"63697",1063697,73,21,8,102
"63698",1063698,130,13,3,146
"63699",1063699,149,33,12,194
"63700",1063700,72,95,15,182
"63701",1063701,42,248,8,298
"63702",1063702,79,136,10,225
"63703",1063703,132,28,9,169
"63704",1063704,100,104,7,211
"63705",1063705,24,199,9,232
"63706",1063706,169,36,5,210
"63707",1063707,75,69,6,150
"63708",1063708,87,22,6,115
"63709",1063709,63,101,15,179
"63710",1063710,50,216,1,267
"63711",1063711,121,177,10,308
"63712",1063712,44,269,10,323
"63713",1063713,127,132,7,266
"63714",1063714,101,137,10,248
"63715",1063715,174,58,8,240
"63716",1063716,146,134,17,297
"63717",1063717,95,119,8,222
"63718",1063718,5,13,1,19
"63719",1063719,30,34,1,65
"63720",1063720,52,81,1,134
"63721",1063721,139,116,8,263
"63722",1063722,63,222,5,290
"63723",1063723,44,7,0,51
"63724",1063724,199,80,12,291
"63725",1063725,23,0,0,23
"63726",1063726,75,242,7,324
"63727",1063727,139,100,5,244
"63728",1063728,170,88,12,270
"63729",1063729,59,103,2,164
"63730",1063730,44,240,3,287
"63731",1063731,116,193,4,313
"63732",1063732,82,111,3,196
"63733",1063733,107,179,9,295
"63734",1063734,101,179,13,293
"63735",1063735,154,113,13,280
"63736",1063736,198,99,9,306
"63737",1063737,180,50,10,240
"63738",1063738,66,153,0,219
"63739",1063739,84,141,8,233
"63740",1063740,200,46,8,254
"63741",1063741,10,72,2,84
"63742",1063742,105,30,9,144
"63743",1063743,70,196,14,280
"63744",1063744,23,12,4,39
"63745",1063745,162,186,7,355
"63746",1063746,43,222,15,280
"63747",1063747,101,106,7,214
"63748",1063748,28,221,5,254
"63749",1063749,40,180,7,227
"63750",1063750,86,24,1,111
"63751",1063751,58,198,5,261
"63752",1063752,90,148,4,242
"63753",1063753,73,126,3,202
"63754",1063754,174,155,14,343
"63755",1063755,58,179,18,255
"63756",1063756,41,162,5,208
"63757",1063757,202,105,9,316
"63758",1063758,135,105,6,246
"63759",1063759,79,7,5,91
"63760",1063760,31,44,5,80
"63761",1063761,6,22,2,30
"63762",1063762,61,9,2,72
"63763",1063763,39,239,3,281
"63764",1063764,73,19,8,100
"63765",1063765,177,15,5,197
"63766",1063766,175,17,6,198
"63767",1063767,104,45,7,156
"63768",1063768,43,171,5,219
"63769",1063769,158,33,5,196
"63770",1063770,62,65,3,130
"63771",1063771,82,69,6,157
"63772",1063772,121,121,8,250
"63773",1063773,4,22,0,26
"63774",1063774,120,46,1,167
"63775",1063775,59,73,0,132
"63776",1063776,66,16,4,86
"63777",1063777,151,75,8,234
"63778",1063778,198,9,4,211
"63779",1063779,100,126,3,229
"63780",1063780,168,101,5,274
"63781",1063781,229,59,13,301
"63782",1063782,156,56,3,215
"63783",1063783,135,31,2,168
"63784",1063784,31,46,1,78
"63785",1063785,60,222,10,292
"63786",1063786,215,118,11,344
"63787",1063787,184,20,3,207
"63788",1063788,42,134,6,182
"63789",1063789,169,102,14,285
"63790",1063790,127,92,6,225
"63791",1063791,128,118,5,251
"63792",1063792,44,233,9,286
"63793",1063793,17,151,0,168
"63794",1063794,115,192,10,317
"63795",1063795,26,177,1,204
"63796",1063796,82,124,5,211
"63797",1063797,174,59,11,244
"63798",1063798,250,66,11,327
"63799",1063799,1,22,0,23
"63800",1063800,109,26,3,138
"63801",1063801,109,141,3,253
"63802",1063802,69,104,9,182
"63803",1063803,98,137,8,243
"63804",1063804,102,194,11,307
"63805",1063805,91,116,10,217
"63806",1063806,87,33,8,128
"63807",1063807,152,53,5,210
"63808",1063808,192,117,10,319
"63809",1063809,105,194,13,312
"63810",1063810,173,12,4,189
"63811",1063811,97,115,2,214
"63812",1063812,153,36,8,197
"63813",1063813,176,80,9,265
"63814",1063814,101,134,21,256
"63815",1063815,46,16,1,63
"63816",1063816,133,88,19,240
"63817",1063817,191,43,7,241
"63818",1063818,3,15,0,18
"63819",1063819,61,202,4,267
"63820",1063820,162,123,20,305
"63821",1063821,130,124,4,258
"63822",1063822,219,50,13,282
"63823",1063823,124,203,16,343
"63824",1063824,137,57,4,198
"63825",1063825,145,122,7,274
"63826",1063826,34,33,0,67
"63827",1063827,45,5,2,52
"63828",1063828,43,107,3,153
"63829",1063829,129,164,17,310
"63830",1063830,124,86,9,219
"63831",1063831,95,59,4,158
"63832",1063832,43,120,2,165
"63833",1063833,206,49,10,265
"63834",1063834,119,53,15,187
"63835",1063835,93,178,4,275
"63836",1063836,42,66,13,121
"63837",1063837,98,56,2,156
"63838",1063838,33,68,2,103
"63839",1063839,15,39,0,54
"63840",1063840,72,50,4,126
"63841",1063841,212,34,12,258
"63842",1063842,77,209,9,295
"63843",1063843,92,100,8,200
"63844",1063844,137,102,1,240
"63845",1063845,147,27,3,177
"63846",1063846,105,53,3,161
"63847",1063847,78,104,7,189
"63848",1063848,89,232,7,328
"63849",1063849,172,73,11,256
"63850",1063850,104,31,5,140
"63851",1063851,78,95,6,179
"63852",1063852,139,114,1,254
"63853",1063853,172,7,7,186
"63854",1063854,93,159,10,262
"63855",1063855,9,6,0,15
"63856",1063856,174,85,13,272
"63857",1063857,43,263,7,313
"63858",1063858,39,226,3,268
"63859",1063859,110,101,7,218
"63860",1063860,136,152,12,300
"63861",1063861,85,99,12,196
"63862",1063862,120,24,3,147
"63863",1063863,151,113,4,268
"63864",1063864,109,103,13,225
"63865",1063865,160,134,15,309
"63866",1063866,63,53,5,121
"63867",1063867,91,43,3,137
"63868",1063868,30,214,5,249
"63869",1063869,107,137,17,261
"63870",1063870,71,82,3,156
"63871",1063871,130,61,13,204
"63872",1063872,159,91,5,255
"63873",1063873,159,130,10,299
"63874",1063874,63,20,2,85
"63875",1063875,16,254,2,272
"63876",1063876,246,17,7,270
"63877",1063877,182,86,8,276
"63878",1063878,47,161,21,229
"63879",1063879,192,95,7,294
"63880",1063880,161,87,12,260
"63881",1063881,92,170,9,271
"63882",1063882,18,5,0,23
"63883",1063883,42,122,9,173
"63884",1063884,149,65,8,222
"63885",1063885,101,36,9,146
"63886",1063886,168,22,5,195
"63887",1063887,28,174,3,205
"63888",1063888,178,173,15,366
"63889",1063889,35,8,1,44
"63890",1063890,145,109,4,258
"63891",1063891,45,11,2,58
"63892",1063892,30,253,2,285
"63893",1063893,65,148,7,220
"63894",1063894,260,22,4,286
"63895",1063895,139,161,9,309
"63896",1063896,128,45,10,183
"63897",1063897,95,117,22,234
"63898",1063898,160,79,12,251
"63899",1063899,77,204,7,288
"63900",1063900,51,279,5,335
"63901",1063901,210,65,17,292
"63902",1063902,132,37,13,182
"63903",1063903,80,1,1,82
"63904",1063904,139,63,1,203
"63905",1063905,97,56,9,162
"63906",1063906,116,27,0,143
"63907",1063907,205,54,8,267
"63908",1063908,275,33,5,313
"63909",1063909,95,22,7,124
"63910",1063910,72,124,10,206
"63911",1063911,169,160,25,354
"63912",1063912,79,210,10,299
"63913",1063913,99,129,9,237
"63914",1063914,75,220,6,301
"63915",1063915,95,134,14,243
"63916",1063916,156,103,13,272
"63917",1063917,152,47,10,209
"63918",1063918,31,219,0,250
"63919",1063919,176,88,23,287
"63920",1063920,39,174,8,221
"63921",1063921,18,11,0,29
"63922",1063922,45,166,9,220
"63923",1063923,177,49,8,234
"63924",1063924,202,61,9,272
"63925",1063925,49,239,4,292
"63926",1063926,63,142,19,224
"63927",1063927,176,27,8,211
"63928",1063928,202,76,2,280
"63929",1063929,111,44,4,159
"63930",1063930,110,141,10,261
"63931",1063931,113,79,21,213
"63932",1063932,95,166,18,279
"63933",1063933,15,146,4,165
"63934",1063934,138,21,3,162
"63935",1063935,70,106,7,183
"63936",1063936,147,95,12,254
"63937",1063937,57,11,2,70
"63938",1063938,38,168,2,208
"63939",1063939,122,170,6,298
"63940",1063940,73,173,5,251
"63941",1063941,108,93,3,204
"63942",1063942,19,155,3,177
"63943",1063943,103,33,2,138
"63944",1063944,59,72,2,133
"63945",1063945,81,145,2,228
"63946",1063946,116,39,8,163
"63947",1063947,37,149,15,201
"63948",1063948,67,247,9,323
"63949",1063949,163,95,9,267
"63950",1063950,42,167,3,212
"63951",1063951,65,251,13,329
"63952",1063952,135,91,7,233
"63953",1063953,162,99,18,279
"63954",1063954,116,21,5,142
"63955",1063955,160,131,8,299
"63956",1063956,162,50,24,236
"63957",1063957,78,199,13,290
"63958",1063958,90,104,16,210
"63959",1063959,106,191,15,312
"63960",1063960,129,7,1,137
"63961",1063961,34,54,9,97
"63962",1063962,34,261,6,301
"63963",1063963,26,232,2,260
"63964",1063964,50,35,6,91
"63965",1063965,8,7,3,18
"63966",1063966,148,159,8,315
"63967",1063967,2,61,0,63
"63968",1063968,115,68,3,186
"63969",1063969,156,85,4,245
"63970",1063970,132,116,8,256
"63971",1063971,202,51,8,261
"63972",1063972,214,18,8,240
"63973",1063973,165,167,17,349
"63974",1063974,55,202,5,262
"63975",1063975,76,180,4,260
"63976",1063976,160,90,7,257
"63977",1063977,102,84,11,197
"63978",1063978,94,110,12,216
"63979",1063979,85,199,6,290
"63980",1063980,147,31,9,187
"63981",1063981,135,101,7,243
"63982",1063982,159,71,9,239
"63983",1063983,86,109,4,199
"63984",1063984,47,139,4,190
"63985",1063985,240,20,5,265
"63986",1063986,225,89,17,331
"63987",1063987,167,61,12,240
"63988",1063988,149,43,7,199
"63989",1063989,52,182,8,242
"63990",1063990,98,116,8,222
"63991",1063991,103,47,11,161
"63992",1063992,71,104,11,186
"63993",1063993,30,223,5,258
"63994",1063994,72,66,3,141
"63995",1063995,207,16,6,229
"63996",1063996,16,38,1,55
"63997",1063997,22,277,3,302
"63998",1063998,101,57,3,161
"63999",1063999,123,197,14,334
"64000",1064000,137,106,5,248
"64001",1064001,71,122,4,197
"64002",1064002,110,54,9,173
"64003",1064003,173,70,11,254
"64004",1064004,36,166,3,205
"64005",1064005,88,175,14,277
"64006",1064006,114,169,7,290
"64007",1064007,138,88,6,232
"64008",1064008,147,38,4,189
"64009",1064009,140,139,3,282
"64010",1064010,16,254,13,283
"64011",1064011,15,30,3,48
"64012",1064012,216,99,21,336
"64013",1064013,128,70,9,207
"64014",1064014,40,17,2,59
"64015",1064015,75,117,17,209
"64016",1064016,13,272,5,290
"64017",1064017,104,59,2,165
"64018",1064018,60,166,3,229
"64019",1064019,50,208,2,260
"64020",1064020,70,234,7,311
"64021",1064021,88,171,4,263
"64022",1064022,143,118,8,269
"64023",1064023,83,104,5,192
"64024",1064024,113,151,11,275
"64025",1064025,159,97,7,263
"64026",1064026,149,44,13,206
"64027",1064027,104,165,6,275
"64028",1064028,95,174,11,280
"64029",1064029,139,51,4,194
"64030",1064030,82,117,11,210
"64031",1064031,97,108,10,215
"64032",1064032,76,19,5,100
"64033",1064033,74,65,4,143
"64034",1064034,97,145,12,254
"64035",1064035,74,204,4,282
"64036",1064036,108,161,10,279
"64037",1064037,177,35,1,213
"64038",1064038,151,38,4,193
"64039",1064039,101,124,8,233
"64040",1064040,97,125,2,224
"64041",1064041,16,21,2,39
"64042",1064042,175,33,0,208
"64043",1064043,186,216,26,428
"64044",1064044,243,26,15,284
"64045",1064045,129,121,18,268
"64046",1064046,93,114,17,224
"64047",1064047,88,159,10,257
"64048",1064048,197,21,7,225
"64049",1064049,178,57,22,257
"64050",1064050,239,24,11,274
"64051",1064051,96,125,11,232
"64052",1064052,153,135,23,311
"64053",1064053,203,76,16,295
"64054",1064054,134,40,7,181
"64055",1064055,79,145,3,227
"64056",1064056,150,68,4,222
"64057",1064057,173,82,2,257
"64058",1064058,74,6,0,80
"64059",1064059,151,72,5,228
"64060",1064060,45,202,4,251
"64061",1064061,216,85,14,315
"64062",1064062,99,51,12,162
"64063",1064063,121,64,5,190
"64064",1064064,235,42,11,288
"64065",1064065,196,99,12,307
"64066",1064066,72,245,9,326
"64067",1064067,110,84,11,205
"64068",1064068,96,115,9,220
"64069",1064069,86,67,2,155
"64070",1064070,151,51,5,207
"64071",1064071,127,71,2,200
"64072",1064072,151,64,7,222
"64073",1064073,39,250,3,292
"64074",1064074,129,67,5,201
"64075",1064075,52,228,5,285
"64076",1064076,92,17,5,114
"64077",1064077,101,111,10,222
"64078",1064078,54,32,1,87
"64079",1064079,1,2,0,3
"64080",1064080,71,159,10,240
"64081",1064081,55,234,2,291
"64082",1064082,139,60,17,216
"64083",1064083,4,5,1,10
"64084",1064084,98,165,11,274
"64085",1064085,154,119,8,281
"64086",1064086,211,23,2,236
"64087",1064087,61,121,11,193
"64088",1064088,6,2,0,8
"64089",1064089,102,8,1,111
"64090",1064090,66,124,5,195
"64091",1064091,63,185,9,257
"64092",1064092,216,12,12,240
"64093",1064093,50,248,11,309
"64094",1064094,5,100,0,105
"64095",1064095,121,112,10,243
"64096",1064096,83,172,1,256
"64097",1064097,107,167,23,297
"64098",1064098,64,182,2,248
"64099",1064099,67,127,1,195
"64100",1064100,9,237,4,250
"64101",1064101,125,157,8,290
"64102",1064102,86,181,19,286
"64103",1064103,143,14,7,164
"64104",1064104,137,72,19,228
"64105",1064105,197,45,12,254
"64106",1064106,44,201,11,256
"64107",1064107,102,180,6,288
"64108",1064108,22,223,3,248
"64109",1064109,153,46,6,205
"64110",1064110,105,102,8,215
"64111",1064111,67,102,7,176
"64112",1064112,176,28,7,211
"64113",1064113,51,239,7,297
"64114",1064114,106,47,2,155
"64115",1064115,168,112,4,284
"64116",1064116,227,46,11,284
"64117",1064117,39,166,5,210
"64118",1064118,111,124,9,244
"64119",1064119,173,13,7,193
"64120",1064120,131,13,6,150
"64121",1064121,33,269,3,305
"64122",1064122,132,97,3,232
"64123",1064123,191,80,16,287
"64124",1064124,81,185,8,274
"64125",1064125,85,160,3,248
"64126",1064126,16,105,1,122
"64127",1064127,167,105,10,282
"64128",1064128,47,22,0,69
"64129",1064129,77,163,3,243
"64130",1064130,151,102,0,253
"64131",1064131,119,124,17,260
"64132",1064132,128,68,7,203
"64133",1064133,40,44,3,87
"64134",1064134,30,27,6,63
"64135",1064135,97,30,2,129
"64136",1064136,141,107,13,261
"64137",1064137,97,138,5,240
"64138",1064138,232,79,12,323
"64139",1064139,14,49,1,64
"64140",1064140,216,34,10,260
"64141",1064141,141,59,13,213
"64142",1064142,79,128,2,209
"64143",1064143,152,42,5,199
"64144",1064144,127,108,0,235
"64145",1064145,156,65,14,235
"64146",1064146,21,166,4,191
"64147",1064147,126,41,13,180
"64148",1064148,6,25,0,31
"64149",1064149,225,95,13,333
"64150",1064150,172,90,12,274
"64151",1064151,125,130,8,263
"64152",1064152,58,227,13,298
"64153",1064153,140,59,18,217
"64154",1064154,77,109,9,195
"64155",1064155,165,29,5,199
"64156",1064156,176,13,3,192
"64157",1064157,145,5,6,156
"64158",1064158,132,135,12,279
"64159",1064159,189,113,19,321
"64160",1064160,67,251,19,337
"64161",1064161,93,15,3,111
"64162",1064162,135,87,11,233
"64163",1064163,53,142,2,197
"64164",1064164,98,179,19,296
"64165",1064165,109,75,7,191
"64166",1064166,134,68,1,203
"64167",1064167,51,65,7,123
"64168",1064168,147,39,3,189
"64169",1064169,145,134,11,290
"64170",1064170,50,82,9,141
"64171",1064171,195,113,16,324
"64172",1064172,59,205,16,280
"64173",1064173,82,139,18,239
"64174",1064174,71,231,6,308
"64175",1064175,124,166,8,298
"64176",1064176,116,184,12,312
"64177",1064177,118,107,13,238
"64178",1064178,127,74,3,204
"64179",1064179,87,157,6,250
"64180",1064180,81,102,21,204
"64181",1064181,84,124,12,220
"64182",1064182,76,31,2,109
"64183",1064183,31,18,4,53
"64184",1064184,37,193,7,237
"64185",1064185,54,158,8,220
"64186",1064186,126,144,13,283
"64187",1064187,103,81,4,188
"64188",1064188,143,85,10,238
"64189",1064189,70,155,3,228
"64190",1064190,184,44,5,233
"64191",1064191,83,74,2,159
"64192",1064192,47,168,7,222
"64193",1064193,56,107,4,167
"64194",1064194,92,178,6,276
"64195",1064195,12,34,2,48
"64196",1064196,189,128,12,329
"64197",1064197,170,54,11,235
"64198",1064198,79,169,21,269
"64199",1064199,63,149,4,216
"64200",1064200,233,28,6,267
"64201",1064201,138,108,12,258
"64202",1064202,120,64,16,200
"64203",1064203,165,3,2,170
"64204",1064204,135,131,20,286
"64205",1064205,130,115,6,251
"64206",1064206,122,136,7,265
"64207",1064207,58,253,11,322
"64208",1064208,56,213,8,277
"64209",1064209,268,11,15,294
"64210",1064210,116,85,8,209
"64211",1064211,111,200,10,321
"64212",1064212,67,173,4,244
"64213",1064213,213,34,4,251
"64214",1064214,52,41,7,100
"64215",1064215,47,59,1,107
"64216",1064216,5,69,0,74
"64217",1064217,65,186,5,256
"64218",1064218,20,3,1,24
"64219",1064219,80,76,4,160
"64220",1064220,244,51,5,300
"64221",1064221,175,54,4,233
"64222",1064222,95,134,8,237
"64223",1064223,110,184,8,302
"64224",1064224,98,94,10,202
"64225",1064225,101,50,9,160
"64226",1064226,59,256,2,317
"64227",1064227,57,167,7,231
"64228",1064228,70,223,10,303
"64229",1064229,165,54,11,230
"64230",1064230,2,3,0,5
"64231",1064231,186,24,4,214
"64232",1064232,162,107,4,273
"64233",1064233,62,67,6,135
"64234",1064234,31,191,7,229
"64235",1064235,136,56,21,213
"64236",1064236,101,176,10,287
"64237",1064237,117,22,4,143
"64238",1064238,131,86,9,226
"64239",1064239,42,232,15,289
"64240",1064240,122,72,4,198
"64241",1064241,92,208,27,327
"64242",1064242,7,4,1,12
"64243",1064243,134,100,10,244
"64244",1064244,114,141,13,268
"64245",1064245,83,58,9,150
"64246",1064246,142,112,9,263
"64247",1064247,106,15,2,123
"64248",1064248,57,23,2,82
"64249",1064249,137,107,5,249
"64250",1064250,253,76,19,348
"64251",1064251,43,154,7,204
"64252",1064252,191,45,9,245
"64253",1064253,93,109,14,216
"64254",1064254,180,116,8,304
"64255",1064255,170,78,20,268
"64256",1064256,117,169,7,293
"64257",1064257,182,85,9,276
"64258",1064258,216,61,6,283
"64259",1064259,75,10,2,87
"64260",1064260,94,40,2,136
"64261",1064261,135,85,1,221
"64262",1064262,62,266,13,341
"64263",1064263,119,64,4,187
"64264",1064264,139,139,13,291
"64265",1064265,29,1,2,32
"64266",1064266,96,181,7,284
"64267",1064267,114,191,21,326
"64268",1064268,213,46,15,274
"64269",1064269,114,142,10,266
"64270",1064270,12,7,0,19
"64271",1064271,58,205,15,278
"64272",1064272,89,160,6,255
"64273",1064273,150,140,4,294
"64274",1064274,16,233,4,253
"64275",1064275,74,204,10,288
"64276",1064276,19,60,1,80
"64277",1064277,198,37,5,240
"64278",1064278,93,167,12,272
"64279",1064279,180,61,8,249
"64280",1064280,25,131,6,162
"64281",1064281,39,253,18,310
"64282",1064282,146,119,15,280
"64283",1064283,117,23,13,153
"64284",1064284,123,33,3,159
"64285",1064285,48,242,6,296
"64286",1064286,219,20,3,242
"64287",1064287,90,211,5,306
"64288",1064288,49,280,5,334
"64289",1064289,119,160,5,284
"64290",1064290,197,72,5,274
"64291",1064291,38,141,5,184
"64292",1064292,32,6,1,39
"64293",1064293,82,127,20,229
"64294",1064294,36,63,7,106
"64295",1064295,24,212,5,241
"64296",1064296,185,14,1,200
"64297",1064297,191,35,8,234
"64298",1064298,139,38,8,185
"64299",1064299,210,97,12,319
"64300",1064300,126,96,8,230
"64301",1064301,126,93,8,227
"64302",1064302,90,171,7,268
"64303",1064303,168,38,7,213
"64304",1064304,59,225,20,304
"64305",1064305,84,186,20,290
"64306",1064306,99,48,5,152
"64307",1064307,186,145,6,337
"64308",1064308,98,182,8,288
"64309",1064309,127,177,4,308
"64310",1064310,74,44,5,123
"64311",1064311,151,91,6,248
"64312",1064312,161,53,7,221
"64313",1064313,31,135,1,167
"64314",1064314,82,163,6,251
"64315",1064315,230,21,5,256
"64316",1064316,126,133,12,271
"64317",1064317,131,155,10,296
"64318",1064318,202,22,5,229
"64319",1064319,211,11,5,227
"64320",1064320,22,34,2,58
"64321",1064321,102,105,4,211
"64322",1064322,184,54,8,246
"64323",1064323,187,64,12,263
"64324",1064324,185,46,10,241
"64325",1064325,50,28,11,89
"64326",1064326,159,99,13,271
"64327",1064327,56,78,3,137
"64328",1064328,95,191,3,289
"64329",1064329,151,85,10,246
"64330",1064330,10,5,0,15
"64331",1064331,157,118,15,290
"64332",1064332,169,101,13,283
"64333",1064333,149,101,5,255
"64334",1064334,185,35,9,229
"64335",1064335,138,27,6,171
"64336",1064336,4,197,5,206
"64337",1064337,159,130,22,311
"64338",1064338,64,8,2,74
"64339",1064339,46,147,4,197
"64340",1064340,140,25,3,168
"64341",1064341,117,143,12,272
"64342",1064342,3,152,1,156
"64343",1064343,44,17,3,64
"64344",1064344,188,19,13,220
"64345",1064345,65,190,5,260
"64346",1064346,105,131,10,246
"64347",1064347,224,24,21,269
"64348",1064348,62,41,6,109
"64349",1064349,105,46,11,162
"64350",1064350,156,130,13,299
"64351",1064351,156,41,11,208
"64352",1064352,212,83,16,311
"64353",1064353,126,87,15,228
"64354",1064354,108,68,9,185
"64355",1064355,55,197,11,263
"64356",1064356,124,92,10,226
"64357",1064357,49,170,11,230
"64358",1064358,119,50,4,173
"64359",1064359,18,209,3,230
"64360",1064360,192,72,18,282
"64361",1064361,113,88,12,213
"64362",1064362,144,68,5,217
"64363",1064363,72,111,11,194
"64364",1064364,225,32,4,261
"64365",1064365,88,93,15,196
"64366",1064366,151,11,6,168
"64367",1064367,68,119,5,192
"64368",1064368,122,92,15,229
"64369",1064369,141,93,13,247
"64370",1064370,73,217,7,297
"64371",1064371,41,54,5,100
"64372",1064372,111,140,4,255
"64373",1064373,144,115,19,278
"64374",1064374,124,137,11,272
"64375",1064375,12,33,4,49
"64376",1064376,205,37,11,253
"64377",1064377,17,38,2,57
"64378",1064378,95,134,8,237
"64379",1064379,72,160,7,239
"64380",1064380,154,44,11,209
"64381",1064381,163,6,4,173
"64382",1064382,102,81,12,195
"64383",1064383,111,57,6,174
"64384",1064384,180,46,8,234
"64385",1064385,85,30,1,116
"64386",1064386,27,164,8,199
"64387",1064387,177,43,17,237
"64388",1064388,133,79,6,218
"64389",1064389,20,224,5,249
"64390",1064390,101,145,16,262
"64391",1064391,63,216,3,282
"64392",1064392,86,55,12,153
"64393",1064393,134,138,26,298
"64394",1064394,175,16,7,198
"64395",1064395,131,98,13,242
"64396",1064396,129,112,14,255
"64397",1064397,192,48,12,252
"64398",1064398,150,15,5,170
"64399",1064399,233,62,16,311
"64400",1064400,43,131,8,182
"64401",1064401,67,177,16,260
"64402",1064402,44,147,3,194
"64403",1064403,52,215,10,277
"64404",1064404,76,168,9,253
"64405",1064405,26,153,9,188
"64406",1064406,45,196,3,244
"64407",1064407,15,190,3,208
"64408",1064408,59,73,1,133
"64409",1064409,58,83,7,148
"64410",1064410,34,44,1,79
"64411",1064411,60,210,8,278
"64412",1064412,0,0,0,0
"64413",1064413,39,110,3,152
"64414",1064414,128,118,9,255
"64415",1064415,126,83,15,224
"64416",1064416,79,44,8,131
"64417",1064417,168,36,4,208
"64418",1064418,95,147,6,248
"64419",1064419,208,80,9,297
"64420",1064420,67,180,4,251
"64421",1064421,60,259,2,321
"64422",1064422,198,56,6,260
"64423",1064423,147,90,7,244
"64424",1064424,175,36,9,220
"64425",1064425,85,67,12,164
"64426",1064426,34,258,3,295
"64427",1064427,256,69,16,341
"64428",1064428,150,70,6,226
"64429",1064429,88,120,17,225
"64430",1064430,16,7,0,23
"64431",1064431,137,49,12,198
"64432",1064432,40,263,16,319
"64433",1064433,106,95,1,202
"64434",1064434,55,143,1,199
"64435",1064435,227,15,5,247
"64436",1064436,155,138,22,315
"64437",1064437,39,215,9,263
"64438",1064438,162,177,19,358
"64439",1064439,128,10,20,158
"64440",1064440,32,54,3,89
"64441",1064441,34,225,4,263
"64442",1064442,124,29,5,158
"64443",1064443,104,36,6,146
"64444",1064444,25,74,7,106
"64445",1064445,107,4,1,112
"64446",1064446,200,66,7,273
"64447",1064447,32,220,4,256
"64448",1064448,176,2,0,178
"64449",1064449,110,86,12,208
"64450",1064450,220,50,8,278
"64451",1064451,57,215,1,273
"64452",1064452,170,19,2,191
"64453",1064453,217,41,11,269
"64454",1064454,161,76,10,247
"64455",1064455,194,92,13,299
"64456",1064456,87,131,6,224
"64457",1064457,108,41,4,153
"64458",1064458,65,223,3,291
"64459",1064459,226,42,19,287
"64460",1064460,102,52,5,159
"64461",1064461,109,152,14,275
"64462",1064462,210,71,13,294
"64463",1064463,83,173,16,272
"64464",1064464,238,77,13,328
"64465",1064465,180,113,12,305
"64466",1064466,69,175,6,250
"64467",1064467,149,29,3,181
"64468",1064468,214,106,12,332
"64469",1064469,110,49,4,163
"64470",1064470,34,253,7,294
"64471",1064471,112,144,24,280
"64472",1064472,29,21,5,55
"64473",1064473,10,5,0,15
"64474",1064474,58,231,14,303
"64475",1064475,95,118,10,223
"64476",1064476,90,213,15,318
"64477",1064477,38,257,4,299
"64478",1064478,47,154,5,206
"64479",1064479,51,133,5,189
"64480",1064480,167,54,12,233
"64481",1064481,96,146,14,256
"64482",1064482,55,51,4,110
"64483",1064483,176,12,9,197
"64484",1064484,91,35,8,134
"64485",1064485,89,97,9,195
"64486",1064486,91,142,15,248
"64487",1064487,112,157,20,289
"64488",1064488,188,81,11,280
"64489",1064489,30,244,2,276
"64490",1064490,97,142,6,245
"64491",1064491,15,150,2,167
"64492",1064492,165,87,8,260
"64493",1064493,72,37,2,111
"64494",1064494,86,175,9,270
"64495",1064495,167,58,10,235
"64496",1064496,130,97,5,232
"64497",1064497,3,244,2,249
"64498",1064498,111,42,5,158
"64499",1064499,170,115,24,309
"64500",1064500,48,44,7,99
"64501",1064501,41,245,14,300
"64502",1064502,78,91,2,171
"64503",1064503,169,23,5,197
"64504",1064504,142,100,8,250
"64505",1064505,25,52,2,79
"64506",1064506,262,21,10,293
"64507",1064507,17,231,5,253
"64508",1064508,280,45,9,334
"64509",1064509,192,26,6,224
"64510",1064510,153,71,10,234
"64511",1064511,126,38,7,171
"64512",1064512,146,111,9,266
"64513",1064513,113,172,17,302
"64514",1064514,157,43,9,209
"64515",1064515,253,0,0,253
"64516",1064516,230,42,3,275
"64517",1064517,115,83,3,201
"64518",1064518,34,10,4,48
"64519",1064519,36,209,6,251
"64520",1064520,97,9,4,110
"64521",1064521,40,0,0,40
"64522",1064522,71,209,15,295
"64523",1064523,148,27,7,182
"64524",1064524,126,17,7,150
"64525",1064525,194,31,6,231
"64526",1064526,207,31,7,245
"64527",1064527,83,37,3,123
"64528",1064528,229,52,8,289
"64529",1064529,56,229,12,297
"64530",1064530,22,199,0,221
"64531",1064531,223,68,12,303
"64532",1064532,65,173,15,253
"64533",1064533,116,64,4,184
"64534",1064534,88,167,8,263
"64535",1064535,147,92,8,247
"64536",1064536,155,86,9,250
"64537",1064537,139,113,7,259
"64538",1064538,92,121,15,228
"64539",1064539,26,321,3,350
"64540",1064540,107,88,0,195
"64541",1064541,58,60,2,120
"64542",1064542,81,199,4,284
"64543",1064543,43,273,2,318
"64544",1064544,55,59,8,122
"64545",1064545,20,189,7,216
"64546",1064546,151,26,6,183
"64547",1064547,60,150,11,221
"64548",1064548,20,267,2,289
"64549",1064549,115,202,8,325
"64550",1064550,234,30,12,276
"64551",1064551,101,164,15,280
"64552",1064552,72,135,20,227
"64553",1064553,221,29,5,255
"64554",1064554,145,61,6,212
"64555",1064555,55,29,1,85
"64556",1064556,141,53,2,196
"64557",1064557,60,113,6,179
"64558",1064558,162,110,29,301
"64559",1064559,119,15,4,138
"64560",1064560,190,73,6,269
"64561",1064561,98,98,0,196
"64562",1064562,114,74,10,198
"64563",1064563,65,224,12,301
"64564",1064564,35,108,8,151
"64565",1064565,86,15,0,101
"64566",1064566,167,35,13,215
"64567",1064567,145,116,8,269
"64568",1064568,127,119,10,256
"64569",1064569,73,50,4,127
"64570",1064570,28,242,5,275
"64571",1064571,89,121,4,214
"64572",1064572,68,74,0,142
"64573",1064573,41,198,3,242
"64574",1064574,68,59,19,146
"64575",1064575,99,108,6,213
"64576",1064576,106,62,10,178
"64577",1064577,75,3,2,80
"64578",1064578,41,191,0,232
"64579",1064579,109,170,6,285
"64580",1064580,162,66,1,229
"64581",1064581,36,208,3,247
"64582",1064582,7,92,0,99
"64583",1064583,102,75,6,183
"64584",1064584,145,48,7,200
"64585",1064585,129,101,9,239
"64586",1064586,177,53,16,246
"64587",1064587,199,9,7,215
"64588",1064588,26,191,4,221
"64589",1064589,11,27,3,41
"64590",1064590,82,216,17,315
"64591",1064591,174,96,4,274
"64592",1064592,68,163,15,246
"64593",1064593,177,64,14,255
"64594",1064594,200,93,9,302
"64595",1064595,100,128,11,239
"64596",1064596,109,42,10,161
"64597",1064597,43,10,5,58
"64598",1064598,27,17,3,47
"64599",1064599,169,75,16,260
"64600",1064600,30,234,5,269
"64601",1064601,149,309,25,483
"64602",1064602,99,99,14,212
"64603",1064603,76,184,9,269
"64604",1064604,167,35,10,212
"64605",1064605,149,89,6,244
"64606",1064606,67,134,7,208
"64607",1064607,44,166,7,217
"64608",1064608,44,42,7,93
"64609",1064609,88,137,5,230
"64610",1064610,19,181,3,203
"64611",1064611,69,191,6,266
"64612",1064612,83,156,12,251
"64613",1064613,152,139,18,309
"64614",1064614,233,11,7,251
"64615",1064615,187,78,12,277
"64616",1064616,213,17,10,240
"64617",1064617,181,75,10,266
"64618",1064618,45,210,4,259
"64619",1064619,25,28,2,55
"64620",1064620,108,110,8,226
"64621",1064621,119,158,5,282
"64622",1064622,63,196,13,272
"64623",1064623,51,164,1,216
"64624",1064624,135,15,4,154
"64625",1064625,171,64,8,243
"64626",1064626,101,102,6,209
"64627",1064627,81,110,6,197
"64628",1064628,35,25,4,64
"64629",1064629,97,134,8,239
"64630",1064630,221,31,9,261
"64631",1064631,109,71,5,185
"64632",1064632,135,122,4,261
"64633",1064633,95,168,9,272
"64634",1064634,63,47,3,113
"64635",1064635,63,230,2,295
"64636",1064636,75,209,12,296
"64637",1064637,144,16,9,169
"64638",1064638,80,65,4,149
"64639",1064639,1,0,0,1
"64640",1064640,84,187,4,275
"64641",1064641,191,40,8,239
"64642",1064642,60,176,6,242
"64643",1064643,11,16,1,28
"64644",1064644,155,21,9,185
"64645",1064645,132,92,5,229
"64646",1064646,81,16,3,100
"64647",1064647,101,53,4,158
"64648",1064648,54,156,16,226
"64649",1064649,181,32,6,219
"64650",1064650,174,65,9,248
"64651",1064651,219,18,12,249
"64652",1064652,166,94,11,271
"64653",1064653,91,185,4,280
"64654",1064654,27,4,1,32
"64655",1064655,50,121,4,175
"64656",1064656,111,70,9,190
"64657",1064657,143,37,8,188
"64658",1064658,120,152,4,276
"64659",1064659,132,145,41,318
"64660",1064660,165,59,8,232
"64661",1064661,132,99,8,239
"64662",1064662,24,105,1,130
"64663",1064663,154,96,12,262
"64664",1064664,45,126,5,176
"64665",1064665,61,141,12,214
"64666",1064666,33,27,2,62
"64667",1064667,47,14,1,62
"64668",1064668,46,159,15,220
"64669",1064669,217,62,12,291
"64670",1064670,62,222,11,295
"64671",1064671,9,6,0,15
"64672",1064672,159,82,2,243
"64673",1064673,211,39,6,256
"64674",1064674,218,18,9,245
"64675",1064675,104,88,13,205
"64676",1064676,114,130,2,246
"64677",1064677,121,23,5,149
"64678",1064678,117,15,1,133
"64679",1064679,110,213,10,333
"64680",1064680,69,118,33,220
"64681",1064681,77,153,1,231
"64682",1064682,168,46,4,218
"64683",1064683,33,195,9,237
"64684",1064684,100,21,6,127
"64685",1064685,61,78,5,144
"64686",1064686,160,27,4,191
"64687",1064687,68,141,14,223
"64688",1064688,132,58,14,204
"64689",1064689,126,54,10,190
"64690",1064690,169,50,13,232
"64691",1064691,132,163,6,301
"64692",1064692,66,250,9,325
"64693",1064693,120,129,15,264
"64694",1064694,121,112,5,238
"64695",1064695,104,185,6,295
"64696",1064696,25,277,7,309
"64697",1064697,177,66,19,262
"64698",1064698,41,256,8,305
"64699",1064699,165,90,9,264
"64700",1064700,76,144,3,223
"64701",1064701,65,167,9,241
"64702",1064702,210,43,6,259
"64703",1064703,227,69,14,310
"64704",1064704,101,113,10,224
"64705",1064705,43,248,11,302
"64706",1064706,131,148,12,291
"64707",1064707,94,150,13,257
"64708",1064708,110,68,13,191
"64709",1064709,81,190,10,281
"64710",1064710,119,89,17,225
"64711",1064711,31,185,3,219
"64712",1064712,111,63,13,187
"64713",1064713,8,3,2,13
"64714",1064714,104,154,4,262
"64715",1064715,199,56,9,264
"64716",1064716,171,106,11,288
"64717",1064717,37,147,3,187
"64718",1064718,145,38,2,185
"64719",1064719,173,95,22,290
"64720",1064720,129,152,11,292
"64721",1064721,68,137,10,215
"64722",1064722,39,20,4,63
"64723",1064723,124,42,3,169
"64724",1064724,153,70,3,226
"64725",1064725,41,75,11,127
"64726",1064726,69,185,4,258
"64727",1064727,147,159,7,313
"64728",1064728,84,78,2,164
"64729",1064729,189,28,5,222
"64730",1064730,153,30,7,190
"64731",1064731,26,92,4,122
"64732",1064732,21,249,6,276
"64733",1064733,33,157,8,198
"64734",1064734,130,121,18,269
"64735",1064735,40,254,15,309
"64736",1064736,31,125,4,160
"64737",1064737,35,119,3,157
"64738",1064738,95,185,21,301
"64739",1064739,65,134,4,203
"64740",1064740,169,49,5,223
"64741",1064741,99,44,5,148
"64742",1064742,107,132,4,243
"64743",1064743,99,117,14,230
"64744",1064744,51,276,6,333
"64745",1064745,111,149,23,283
"64746",1064746,11,62,2,75
"64747",1064747,10,9,0,19
"64748",1064748,214,87,2,303
"64749",1064749,96,45,7,148
"64750",1064750,203,18,5,226
"64751",1064751,122,141,19,282
"64752",1064752,113,161,8,282
"64753",1064753,183,99,9,291
"64754",1064754,157,45,15,217
"64755",1064755,89,205,4,298
"64756",1064756,45,190,2,237
"64757",1064757,133,112,9,254
"64758",1064758,167,57,18,242
"64759",1064759,190,112,10,312
"64760",1064760,46,303,5,354
"64761",1064761,37,48,7,92
"64762",1064762,126,75,2,203
"64763",1064763,40,251,7,298
"64764",1064764,172,79,21,272
"64765",1064765,135,61,10,206
"64766",1064766,20,2,3,25
"64767",1064767,139,109,7,255
"64768",1064768,152,107,6,265
"64769",1064769,92,100,7,199
"64770",1064770,116,66,6,188
"64771",1064771,91,58,4,153
"64772",1064772,124,188,7,319
"64773",1064773,61,88,9,158
"64774",1064774,85,111,3,199
"64775",1064775,112,51,1,164
"64776",1064776,189,62,2,253
"64777",1064777,133,130,0,263
"64778",1064778,62,185,4,251
"64779",1064779,65,96,10,171
"64780",1064780,112,6,3,121
"64781",1064781,67,11,3,81
"64782",1064782,139,37,9,185
"64783",1064783,122,56,4,182
"64784",1064784,169,49,3,221
"64785",1064785,18,28,3,49
"64786",1064786,87,28,5,120
"64787",1064787,219,68,8,295
"64788",1064788,118,31,7,156
"64789",1064789,162,23,1,186
"64790",1064790,124,98,6,228
"64791",1064791,34,209,16,259
"64792",1064792,179,48,8,235
"64793",1064793,90,166,22,278
"64794",1064794,110,192,12,314
"64795",1064795,96,55,9,160
"64796",1064796,44,237,4,285
"64797",1064797,115,126,9,250
"64798",1064798,143,97,11,251
"64799",1064799,108,106,2,216
"64800",1064800,56,103,9,168
"64801",1064801,98,176,8,282
"64802",1064802,235,68,13,316
"64803",1064803,122,194,25,341
"64804",1064804,45,185,5,235
"64805",1064805,105,140,16,261
"64806",1064806,143,104,6,253
"64807",1064807,140,10,5,155
"64808",1064808,34,154,4,192
"64809",1064809,88,204,7,299
"64810",1064810,131,100,2,233
"64811",1064811,58,208,17,283
"64812",1064812,143,132,18,293
"64813",1064813,83,128,18,229
"64814",1064814,16,317,6,339
"64815",1064815,86,128,3,217
"64816",1064816,241,82,4,327
"64817",1064817,130,41,4,175
"64818",1064818,96,87,8,191
"64819",1064819,144,70,7,221
"64820",1064820,23,2,0,25
"64821",1064821,5,87,2,94
"64822",1064822,33,38,0,71
"64823",1064823,92,49,11,152
"64824",1064824,170,17,8,195
"64825",1064825,213,37,7,257
"64826",1064826,68,72,7,147
"64827",1064827,172,57,17,246
"64828",1064828,42,114,5,161
"64829",1064829,8,1,1,10
"64830",1064830,168,77,2,247
"64831",1064831,153,64,9,226
"64832",1064832,139,109,12,260
"64833",1064833,96,191,24,311
"64834",1064834,90,196,4,290
"64835",1064835,185,66,15,266
"64836",1064836,23,195,3,221
"64837",1064837,73,174,23,270
"64838",1064838,84,202,6,292
"64839",1064839,26,15,6,47
"64840",1064840,76,118,2,196
"64841",1064841,170,29,10,209
"64842",1064842,139,101,17,257
"64843",1064843,48,9,2,59
"64844",1064844,59,18,1,78
"64845",1064845,198,45,11,254
"64846",1064846,145,78,4,227
"64847",1064847,156,93,22,271
"64848",1064848,55,236,10,301
"64849",1064849,72,0,0,72
"64850",1064850,80,183,11,274
"64851",1064851,171,71,21,263
"64852",1064852,227,38,9,274
"64853",1064853,109,142,19,270
"64854",1064854,127,17,2,146
"64855",1064855,78,152,4,234
"64856",1064856,68,125,6,199
"64857",1064857,91,187,11,289
"64858",1064858,36,120,1,157
"64859",1064859,129,112,9,250
"64860",1064860,29,302,8,339
"64861",1064861,96,99,6,201
"64862",1064862,119,215,12,346
"64863",1064863,132,63,8,203
"64864",1064864,75,112,16,203
"64865",1064865,143,55,2,200
"64866",1064866,173,93,8,274
"64867",1064867,76,47,4,127
"64868",1064868,123,143,6,272
"64869",1064869,153,80,4,237
"64870",1064870,247,48,8,303
"64871",1064871,153,56,7,216
"64872",1064872,24,167,5,196
"64873",1064873,188,88,10,286
"64874",1064874,126,46,6,178
"64875",1064875,70,45,5,120
"64876",1064876,63,208,3,274
"64877",1064877,147,81,14,242
"64878",1064878,131,53,1,185
"64879",1064879,33,251,6,290
"64880",1064880,31,171,2,204
"64881",1064881,95,141,12,248
"64882",1064882,113,48,7,168
"64883",1064883,129,113,12,254
"64884",1064884,176,99,19,294
"64885",1064885,6,2,0,8
"64886",1064886,106,65,8,179
"64887",1064887,62,122,5,189
"64888",1064888,69,185,11,265
"64889",1064889,78,239,5,322
"64890",1064890,220,43,9,272
"64891",1064891,187,69,10,266
"64892",1064892,114,97,16,227
"64893",1064893,145,6,2,153
"64894",1064894,88,74,2,164
"64895",1064895,79,141,12,232
"64896",1064896,139,82,5,226
"64897",1064897,232,15,6,253
"64898",1064898,13,14,0,27
"64899",1064899,126,195,6,327
"64900",1064900,17,62,2,81
"64901",1064901,76,52,3,131
"64902",1064902,90,23,5,118
"64903",1064903,8,8,1,17
"64904",1064904,76,141,8,225
"64905",1064905,32,229,7,268
"64906",1064906,91,83,5,179
"64907",1064907,83,72,7,162
"64908",1064908,59,257,8,324
"64909",1064909,201,44,6,251
"64910",1064910,60,246,7,313
"64911",1064911,28,148,6,182
"64912",1064912,58,0,0,58
"64913",1064913,9,26,2,37
"64914",1064914,88,148,5,241
"64915",1064915,168,24,4,196
"64916",1064916,151,45,9,205
"64917",1064917,220,40,17,277
"64918",1064918,46,133,10,189
"64919",1064919,21,240,3,264
"64920",1064920,104,75,3,182
"64921",1064921,194,12,8,214
"64922",1064922,80,76,5,161
"64923",1064923,92,187,19,298
"64924",1064924,137,126,14,277
"64925",1064925,152,32,16,200
"64926",1064926,320,76,16,412
"64927",1064927,262,12,9,283
"64928",1064928,113,78,11,202
"64929",1064929,187,115,24,326
"64930",1064930,134,109,8,251
"64931",1064931,147,31,14,192
"64932",1064932,9,12,0,21
"64933",1064933,78,147,5,230
"64934",1064934,69,56,9,134
"64935",1064935,104,116,16,236
"64936",1064936,75,205,17,297
"64937",1064937,107,136,11,254
"64938",1064938,168,33,2,203
"64939",1064939,71,40,4,115
"64940",1064940,13,43,2,58
"64941",1064941,114,82,15,211
"64942",1064942,70,188,13,271
"64943",1064943,123,62,2,187
"64944",1064944,18,22,1,41
"64945",1064945,171,16,5,192
"64946",1064946,17,198,3,218
"64947",1064947,44,163,10,217
"64948",1064948,19,126,0,145
"64949",1064949,54,31,3,88
"64950",1064950,129,156,8,293
"64951",1064951,178,38,4,220
"64952",1064952,22,163,7,192
"64953",1064953,203,110,16,329
"64954",1064954,32,198,4,234
"64955",1064955,136,65,20,221
"64956",1064956,215,112,10,337
"64957",1064957,60,173,3,236
"64958",1064958,161,42,8,211
"64959",1064959,120,150,20,290
"64960",1064960,67,169,19,255
"64961",1064961,34,256,4,294
"64962",1064962,143,25,1,169
"64963",1064963,6,111,2,119
"64964",1064964,41,275,10,326
"64965",1064965,133,39,7,179
"64966",1064966,119,25,4,148
"64967",1064967,186,56,9,251
"64968",1064968,189,31,5,225
"64969",1064969,157,118,15,290
"64970",1064970,158,34,6,198
"64971",1064971,73,193,6,272
"64972",1064972,59,215,12,286
"64973",1064973,75,193,1,269
"64974",1064974,177,29,5,211
"64975",1064975,115,209,20,344
"64976",1064976,61,150,9,220
"64977",1064977,60,220,6,286
"64978",1064978,164,43,2,209
"64979",1064979,24,116,2,142
"64980",1064980,77,93,4,174
"64981",1064981,143,10,4,157
"64982",1064982,115,134,4,253
"64983",1064983,27,212,6,245
"64984",1064984,161,121,16,298
"64985",1064985,53,214,4,271
"64986",1064986,96,63,0,159
"64987",1064987,96,118,5,219
"64988",1064988,167,43,9,219
"64989",1064989,98,194,12,304
"64990",1064990,50,37,3,90
"64991",1064991,243,20,4,267
"64992",1064992,87,139,6,232
"64993",1064993,74,197,4,275
"64994",1064994,72,190,14,276
"64995",1064995,76,147,12,235
"64996",1064996,120,26,8,154
"64997",1064997,48,203,13,264
"64998",1064998,105,187,12,304
"64999",1064999,13,5,0,18
"65000",1065000,65,86,4,155
"65001",1065001,142,49,9,200
"65002",1065002,188,66,14,268
"65003",1065003,174,132,18,324
"65004",1065004,121,153,13,287
"65005",1065005,59,137,7,203
"65006",1065006,130,78,12,220
"65007",1065007,146,68,18,232
"65008",1065008,164,98,11,273
"65009",1065009,81,59,10,150
"65010",1065010,25,108,3,136
"65011",1065011,173,122,11,306
"65012",1065012,17,25,0,42
"65013",1065013,36,197,5,238
"65014",1065014,18,265,7,290
"65015",1065015,206,45,11,262
"65016",1065016,183,48,5,236
"65017",1065017,64,142,4,210
"65018",1065018,114,202,10,326
"65019",1065019,38,27,2,67
"65020",1065020,83,64,5,152
"65021",1065021,50,258,5,313
"65022",1065022,90,210,7,307
"65023",1065023,217,26,4,247
"65024",1065024,79,157,4,240
"65025",1065025,5,17,3,25
"65026",1065026,61,22,3,86
"65027",1065027,146,91,11,248
"65028",1065028,83,107,13,203
"65029",1065029,218,29,5,252
"65030",1065030,176,121,11,308
"65031",1065031,80,162,10,252
"65032",1065032,211,101,19,331
"65033",1065033,50,178,3,231
"65034",1065034,132,146,10,288
"65035",1065035,56,160,4,220
"65036",1065036,63,176,20,259
"65037",1065037,14,9,0,23
"65038",1065038,129,190,12,331
"65039",1065039,68,139,5,212
"65040",1065040,183,101,8,292
"65041",1065041,41,1,2,44
"65042",1065042,128,63,11,202
"65043",1065043,129,95,10,234
"65044",1065044,142,47,5,194
"65045",1065045,213,17,2,232
"65046",1065046,112,101,9,222
"65047",1065047,103,66,12,181
"65048",1065048,8,43,0,51
"65049",1065049,126,100,16,242
"65050",1065050,41,77,5,123
"65051",1065051,7,4,0,11
"65052",1065052,99,37,1,137
"65053",1065053,102,119,15,236
"65054",1065054,115,133,15,263
"65055",1065055,66,67,13,146
"65056",1065056,82,206,13,301
"65057",1065057,145,69,12,226
"65058",1065058,259,53,2,314
"65059",1065059,122,173,16,311
"65060",1065060,99,125,4,228
"65061",1065061,132,64,11,207
"65062",1065062,103,170,6,279
"65063",1065063,78,104,9,191
"65064",1065064,127,100,7,234
"65065",1065065,143,83,7,233
"65066",1065066,188,52,15,255
"65067",1065067,79,162,10,251
"65068",1065068,68,247,5,320
"65069",1065069,154,61,12,227
"65070",1065070,87,78,9,174
"65071",1065071,174,12,0,186
"65072",1065072,96,212,12,320
"65073",1065073,140,133,6,279
"65074",1065074,18,240,2,260
"65075",1065075,32,221,8,261
"65076",1065076,119,41,3,163
"65077",1065077,186,31,10,227
"65078",1065078,263,41,7,311
"65079",1065079,101,211,17,329
"65080",1065080,73,158,6,237
"65081",1065081,115,94,13,222
"65082",1065082,17,161,7,185
"65083",1065083,201,51,11,263
"65084",1065084,95,192,4,291
"65085",1065085,81,169,13,263
"65086",1065086,168,138,13,319
"65087",1065087,179,6,7,192
"65088",1065088,25,26,7,58
"65089",1065089,134,73,9,216
"65090",1065090,96,91,15,202
"65091",1065091,142,66,3,211
"65092",1065092,105,111,18,234
"65093",1065093,104,126,3,233
"65094",1065094,65,199,7,271
"65095",1065095,160,128,5,293
"65096",1065096,99,173,13,285
"65097",1065097,7,0,0,7
"65098",1065098,277,25,3,305
"65099",1065099,191,46,4,241
"65100",1065100,131,168,9,308
"65101",1065101,88,211,12,311
"65102",1065102,129,55,5,189
"65103",1065103,88,182,4,274
"65104",1065104,229,95,19,343
"65105",1065105,219,37,12,268
"65106",1065106,141,55,1,197
"65107",1065107,194,39,6,239
"65108",1065108,195,22,6,223
"65109",1065109,207,13,2,222
"65110",1065110,185,96,1,282
"65111",1065111,26,135,4,165
"65112",1065112,157,143,5,305
"65113",1065113,8,4,1,13
"65114",1065114,110,63,10,183
"65115",1065115,195,84,11,290
"65116",1065116,94,163,18,275
"65117",1065117,108,129,12,249
"65118",1065118,170,74,13,257
"65119",1065119,64,337,19,420
"65120",1065120,217,33,5,255
"65121",1065121,12,20,10,42
"65122",1065122,192,68,11,271
"65123",1065123,61,150,14,225
"65124",1065124,61,37,9,107
"65125",1065125,3,9,0,12
"65126",1065126,163,5,0,168
"65127",1065127,8,5,0,13
"65128",1065128,141,114,13,268
"65129",1065129,62,147,19,228
"65130",1065130,114,184,2,300
"65131",1065131,32,17,5,54
"65132",1065132,19,95,5,119
"65133",1065133,144,56,3,203
"65134",1065134,34,27,2,63
"65135",1065135,141,157,7,305
"65136",1065136,143,91,4,238
"65137",1065137,64,72,11,147
"65138",1065138,88,119,8,215
"65139",1065139,113,69,3,185
"65140",1065140,80,136,13,229
"65141",1065141,22,142,2,166
"65142",1065142,83,90,11,184
"65143",1065143,135,23,8,166
"65144",1065144,48,254,4,306
"65145",1065145,25,18,5,48
"65146",1065146,32,49,1,82
"65147",1065147,138,56,4,198
"65148",1065148,17,3,0,20
"65149",1065149,19,214,6,239
"65150",1065150,122,154,18,294
"65151",1065151,77,177,9,263
"65152",1065152,50,19,5,74
"65153",1065153,199,4,2,205
"65154",1065154,67,113,15,195
"65155",1065155,69,153,3,225
"65156",1065156,137,70,9,216
"65157",1065157,204,56,4,264
"65158",1065158,128,46,3,177
"65159",1065159,25,97,3,125
"65160",1065160,120,74,3,197
"65161",1065161,53,292,7,352
"65162",1065162,79,221,4,304
"65163",1065163,102,136,10,248
"65164",1065164,118,1,1,120
"65165",1065165,59,204,10,273
"65166",1065166,156,73,12,241
"65167",1065167,136,108,10,254
"65168",1065168,54,224,5,283
"65169",1065169,75,185,5,265
"65170",1065170,36,12,1,49
"65171",1065171,69,179,7,255
"65172",1065172,76,118,5,199
"65173",1065173,32,229,6,267
"65174",1065174,122,62,2,186
"65175",1065175,12,8,0,20
"65176",1065176,75,186,1,262
"65177",1065177,163,40,6,209
"65178",1065178,69,184,9,262
"65179",1065179,111,120,8,239
"65180",1065180,129,87,10,226
"65181",1065181,106,211,19,336
"65182",1065182,28,249,1,278
"65183",1065183,70,139,17,226
"65184",1065184,142,56,6,204
"65185",1065185,113,13,3,129
"65186",1065186,115,92,14,221
"65187",1065187,171,45,3,219
"65188",1065188,85,161,0,246
"65189",1065189,20,101,4,125
"65190",1065190,223,62,13,298
"65191",1065191,130,30,12,172
"65192",1065192,106,167,19,292
"65193",1065193,150,106,14,270
"65194",1065194,108,36,5,149
"65195",1065195,127,83,11,221
"65196",1065196,118,150,7,275
"65197",1065197,129,64,14,207
"65198",1065198,71,131,4,206
"65199",1065199,159,105,19,283
"65200",1065200,131,116,10,257
"65201",1065201,93,127,6,226
"65202",1065202,187,69,7,263
"65203",1065203,20,30,4,54
"65204",1065204,221,46,0,267
"65205",1065205,150,185,7,342
"65206",1065206,116,171,7,294
"65207",1065207,69,84,5,158
"65208",1065208,151,43,5,199
"65209",1065209,71,187,13,271
"65210",1065210,107,42,4,153
"65211",1065211,24,287,1,312
"65212",1065212,112,159,8,279
"65213",1065213,181,47,9,237
"65214",1065214,164,55,11,230
"65215",1065215,100,74,7,181
"65216",1065216,200,41,15,256
"65217",1065217,172,84,12,268
"65218",1065218,186,47,7,240
"65219",1065219,72,189,5,266
"65220",1065220,53,248,4,305
"65221",1065221,127,133,18,278
"65222",1065222,61,165,3,229
"65223",1065223,195,33,15,243
"65224",1065224,152,120,11,283
"65225",1065225,125,118,33,276
"65226",1065226,125,158,10,293
"65227",1065227,122,138,11,271
"65228",1065228,77,68,5,150
"65229",1065229,64,184,8,256
"65230",1065230,55,69,6,130
"65231",1065231,146,76,8,230
"65232",1065232,157,121,10,288
"65233",1065233,152,113,11,276
"65234",1065234,12,8,1,21
"65235",1065235,54,33,1,88
"65236",1065236,190,48,5,243
"65237",1065237,87,182,9,278
"65238",1065238,60,211,9,280
"65239",1065239,252,22,15,289
"65240",1065240,38,116,7,161
"65241",1065241,38,200,6,244
"65242",1065242,79,39,1,119
"65243",1065243,206,43,3,252
"65244",1065244,146,137,7,290
"65245",1065245,183,35,12,230
"65246",1065246,160,67,4,231
"65247",1065247,54,135,18,207
"65248",1065248,242,47,10,299
"65249",1065249,215,73,24,312
"65250",1065250,35,58,1,94
"65251",1065251,161,68,7,236
"65252",1065252,18,13,3,34
"65253",1065253,104,60,5,169
"65254",1065254,45,36,6,87
"65255",1065255,190,78,12,280
"65256",1065256,17,111,4,132
"65257",1065257,77,177,16,270
"65258",1065258,131,90,2,223
"65259",1065259,86,234,12,332
"65260",1065260,17,25,2,44
"65261",1065261,141,121,4,266
"65262",1065262,34,193,7,234
"65263",1065263,124,82,11,217
"65264",1065264,83,35,8,126
"65265",1065265,142,16,6,164
"65266",1065266,72,225,11,308
"65267",1065267,206,34,13,253
"65268",1065268,150,53,16,219
"65269",1065269,120,53,8,181
"65270",1065270,179,39,9,227
"65271",1065271,125,153,7,285
"65272",1065272,95,140,16,251
"65273",1065273,98,111,2,211
"65274",1065274,51,63,1,115
"65275",1065275,166,75,2,243
"65276",1065276,106,8,3,117
"65277",1065277,106,170,5,281
"65278",1065278,131,174,6,311
"65279",1065279,102,31,3,136
"65280",1065280,43,229,5,277
"65281",1065281,164,42,2,208
"65282",1065282,160,94,5,259
"65283",1065283,148,116,4,268
"65284",1065284,23,8,1,32
"65285",1065285,116,190,11,317
"65286",1065286,123,63,3,189
"65287",1065287,125,33,4,162
"65288",1065288,31,227,7,265
"65289",1065289,20,4,0,24
"65290",1065290,196,76,12,284
"65291",1065291,70,18,3,91
"65292",1065292,60,49,6,115
"65293",1065293,119,140,6,265
"65294",1065294,47,129,3,179
"65295",1065295,260,24,4,288
"65296",1065296,264,47,11,322
"65297",1065297,90,149,1,240
"65298",1065298,27,16,3,46
"65299",1065299,118,20,4,142
"65300",1065300,97,29,6,132
"65301",1065301,198,76,15,289
"65302",1065302,83,121,16,220
"65303",1065303,105,70,10,185
"65304",1065304,97,194,4,295
"65305",1065305,64,182,6,252
"65306",1065306,34,243,1,278
"65307",1065307,73,2,6,81
"65308",1065308,33,0,1,34
"65309",1065309,110,356,10,476
"65310",1065310,41,182,6,229
"65311",1065311,104,132,13,249
"65312",1065312,114,75,12,201
"65313",1065313,32,220,4,256
"65314",1065314,43,198,6,247
"65315",1065315,165,34,11,210
"65316",1065316,45,209,5,259
"65317",1065317,78,25,10,113
"65318",1065318,133,159,22,314
"65319",1065319,183,66,1,250
"65320",1065320,136,35,9,180
"65321",1065321,51,171,1,223
"65322",1065322,190,23,3,216
"65323",1065323,136,122,3,261
"65324",1065324,70,202,8,280
"65325",1065325,88,13,1,102
"65326",1065326,65,240,7,312
"65327",1065327,133,101,8,242
"65328",1065328,90,144,13,247
"65329",1065329,60,166,5,231
"65330",1065330,108,25,7,140
"65331",1065331,59,80,8,147
"65332",1065332,92,98,9,199
"65333",1065333,161,70,3,234
"65334",1065334,38,228,3,269
"65335",1065335,165,14,3,182
"65336",1065336,114,21,12,147
"65337",1065337,187,136,18,341
"65338",1065338,178,89,13,280
"65339",1065339,41,184,8,233
"65340",1065340,185,55,18,258
"65341",1065341,37,190,4,231
"65342",1065342,158,122,12,292
"65343",1065343,60,206,11,277
"65344",1065344,90,109,21,220
"65345",1065345,39,222,8,269
"65346",1065346,120,52,8,180
"65347",1065347,76,225,6,307
"65348",1065348,120,123,9,252
"65349",1065349,145,74,9,228
"65350",1065350,55,9,9,73
"65351",1065351,93,49,4,146
"65352",1065352,104,148,7,259
"65353",1065353,59,2,1,62
"65354",1065354,108,130,6,244
"65355",1065355,280,40,14,334
"65356",1065356,157,72,11,240
"65357",1065357,58,50,7,115
"65358",1065358,187,55,19,261
"65359",1065359,69,156,10,235
"65360",1065360,112,78,1,191
"65361",1065361,32,69,8,109
"65362",1065362,94,50,4,148
"65363",1065363,106,174,6,286
"65364",1065364,69,138,21,228
"65365",1065365,106,83,7,196
"65366",1065366,73,105,11,189
"65367",1065367,175,41,5,221
"65368",1065368,149,180,16,345
"65369",1065369,100,158,12,270
"65370",1065370,52,151,3,206
"65371",1065371,48,215,23,286
"65372",1065372,144,48,9,201
"65373",1065373,162,84,4,250
"65374",1065374,175,67,13,255
"65375",1065375,25,26,3,54
"65376",1065376,66,102,10,178
"65377",1065377,187,46,6,239
"65378",1065378,69,29,7,105
"65379",1065379,166,130,12,308
"65380",1065380,97,39,3,139
"65381",1065381,30,231,7,268
"65382",1065382,84,30,3,117
"65383",1065383,84,134,10,228
"65384",1065384,13,197,4,214
"65385",1065385,141,166,5,312
"65386",1065386,168,72,13,253
"65387",1065387,65,182,19,266
"65388",1065388,94,112,11,217
"65389",1065389,76,122,11,209
"65390",1065390,114,108,16,238
"65391",1065391,69,12,3,84
"65392",1065392,38,311,2,351
"65393",1065393,12,81,8,101
"65394",1065394,165,62,11,238
"65395",1065395,4,14,1,19
"65396",1065396,74,207,4,285
"65397",1065397,188,51,9,248
"65398",1065398,123,58,8,189
"65399",1065399,89,11,4,104
"65400",1065400,21,205,9,235
"65401",1065401,124,57,14,195
"65402",1065402,100,74,16,190
"65403",1065403,26,10,1,37
"65404",1065404,34,10,1,45
"65405",1065405,112,208,19,339
"65406",1065406,253,34,5,292
"65407",1065407,163,149,10,322
"65408",1065408,156,82,5,243
"65409",1065409,114,123,13,250
"65410",1065410,162,155,11,328
"65411",1065411,242,58,2,302
"65412",1065412,62,88,13,163
"65413",1065413,116,94,4,214
"65414",1065414,30,25,1,56
"65415",1065415,200,124,16,340
"65416",1065416,208,68,10,286
"65417",1065417,46,259,10,315
"65418",1065418,55,70,3,128
"65419",1065419,181,30,4,215
"65420",1065420,199,72,7,278
"65421",1065421,198,43,3,244
"65422",1065422,177,49,12,238
"65423",1065423,91,13,5,109
"65424",1065424,82,129,8,219
"65425",1065425,280,57,9,346
"65426",1065426,65,13,2,80
"65427",1065427,23,102,0,125
"65428",1065428,150,103,9,262
"65429",1065429,172,42,6,220
"65430",1065430,22,17,0,39
"65431",1065431,33,67,6,106
"65432",1065432,223,27,8,258
"65433",1065433,34,156,5,195
"65434",1065434,43,251,2,296
"65435",1065435,188,81,19,288
"65436",1065436,194,91,12,297
"65437",1065437,160,36,3,199
"65438",1065438,43,234,7,284
"65439",1065439,69,144,6,219
"65440",1065440,23,235,3,261
"65441",1065441,181,78,8,267
"65442",1065442,206,58,18,282
"65443",1065443,171,94,7,272
"65444",1065444,66,160,7,233
"65445",1065445,62,248,4,314
"65446",1065446,140,93,16,249
"65447",1065447,57,138,19,214
"65448",1065448,24,236,7,267
"65449",1065449,132,56,2,190
"65450",1065450,158,94,3,255
"65451",1065451,185,63,5,253
"65452",1065452,210,46,10,266
"65453",1065453,65,38,4,107
"65454",1065454,149,111,11,271
"65455",1065455,72,14,3,89
"65456",1065456,49,86,4,139
"65457",1065457,106,154,24,284
"65458",1065458,126,86,5,217
"65459",1065459,122,24,2,148
"65460",1065460,121,136,10,267
"65461",1065461,63,62,4,129
"65462",1065462,163,53,6,222
"65463",1065463,134,9,6,149
"65464",1065464,114,117,7,238
"65465",1065465,7,4,0,11
"65466",1065466,35,244,6,285
"65467",1065467,166,18,10,194
"65468",1065468,43,205,8,256
"65469",1065469,150,104,9,263
"65470",1065470,147,82,3,232
"65471",1065471,66,205,9,280
"65472",1065472,190,83,12,285
"65473",1065473,32,174,3,209
"65474",1065474,25,287,8,320
"65475",1065475,136,114,4,254
"65476",1065476,60,165,5,230
"65477",1065477,95,166,13,274
"65478",1065478,90,214,4,308
"65479",1065479,96,96,2,194
"65480",1065480,143,120,9,272
"65481",1065481,74,20,10,104
"65482",1065482,97,11,0,108
"65483",1065483,48,45,4,97
"65484",1065484,16,34,3,53
"65485",1065485,182,79,10,271
"65486",1065486,67,48,1,116
"65487",1065487,112,58,4,174
"65488",1065488,135,143,17,295
"65489",1065489,92,199,13,304
"65490",1065490,164,96,2,262
"65491",1065491,96,152,22,270
"65492",1065492,160,48,14,222
"65493",1065493,31,264,3,298
"65494",1065494,68,116,5,189
"65495",1065495,43,18,0,61
"65496",1065496,118,124,18,260
"65497",1065497,118,183,10,311
"65498",1065498,35,199,8,242
"65499",1065499,201,66,17,284
"65500",1065500,144,24,4,172
"65501",1065501,65,119,12,196
"65502",1065502,151,40,9,200
"65503",1065503,14,34,2,50
"65504",1065504,55,176,6,237
"65505",1065505,208,40,11,259
"65506",1065506,144,31,13,188
"65507",1065507,114,96,8,218
"65508",1065508,77,151,11,239
"65509",1065509,19,8,1,28
"65510",1065510,14,11,0,25
"65511",1065511,59,139,3,201
"65512",1065512,218,30,6,254
"65513",1065513,45,159,5,209
"65514",1065514,60,187,16,263
"65515",1065515,167,7,1,175
"65516",1065516,17,7,0,24
"65517",1065517,212,10,8,230
"65518",1065518,91,188,10,289
"65519",1065519,45,12,3,60
"65520",1065520,110,162,22,294
"65521",1065521,231,52,14,297
"65522",1065522,160,138,23,321
"65523",1065523,11,6,0,17
"65524",1065524,222,16,2,240
"65525",1065525,54,225,4,283
"65526",1065526,135,19,0,154
"65527",1065527,54,40,4,98
"65528",1065528,227,64,16,307
"65529",1065529,9,8,2,19
"65530",1065530,206,13,7,226
"65531",1065531,245,39,11,295
"65532",1065532,150,116,8,274
"65533",1065533,177,82,16,275
"65534",1065534,63,53,3,119
"65535",1065535,8,82,0,90
"65536",1065536,120,185,10,315
"65537",1065537,148,118,11,277
"65538",1065538,14,306,3,323
"65539",1065539,160,42,5,207
"65540",1065540,150,17,4,171
"65541",1065541,61,204,0,265
"65542",1065542,176,35,6,217
"65543",1065543,155,67,13,235
"65544",1065544,87,152,3,242
"65545",1065545,30,44,3,77
"65546",1065546,86,185,1,272
"65547",1065547,68,187,7,262
"65548",1065548,74,118,6,198
"65549",1065549,23,123,2,148
"65550",1065550,181,60,18,259
"65551",1065551,128,68,14,210
"65552",1065552,72,70,4,146
"65553",1065553,166,71,13,250
"65554",1065554,37,136,4,177
"65555",1065555,196,82,10,288
"65556",1065556,203,99,19,321
"65557",1065557,57,206,7,270
"65558",1065558,99,80,11,190
"65559",1065559,172,155,5,332
"65560",1065560,191,125,13,329
"65561",1065561,158,32,4,194
"65562",1065562,109,188,13,310
"65563",1065563,102,27,4,133
"65564",1065564,119,14,3,136
"65565",1065565,73,154,8,235
"65566",1065566,60,187,4,251
"65567",1065567,250,33,6,289
"65568",1065568,154,102,9,265
"65569",1065569,96,145,14,255
"65570",1065570,76,159,7,242
"65571",1065571,186,93,3,282
"65572",1065572,210,102,7,319
"65573",1065573,196,21,5,222
"65574",1065574,66,225,6,297
"65575",1065575,121,76,10,207
"65576",1065576,58,149,26,233
"65577",1065577,95,61,1,157
"65578",1065578,26,22,1,49
"65579",1065579,7,96,0,103
"65580",1065580,74,52,3,129
"65581",1065581,233,32,9,274
"65582",1065582,94,143,16,253
"65583",1065583,97,205,2,304
"65584",1065584,9,6,1,16
"65585",1065585,116,22,2,140
"65586",1065586,216,16,5,237
"65587",1065587,101,5,14,120
"65588",1065588,42,107,9,158
"65589",1065589,154,64,12,230
"65590",1065590,64,153,2,219
"65591",1065591,128,55,5,188
"65592",1065592,71,53,3,127
"65593",1065593,92,186,15,293
"65594",1065594,71,136,2,209
"65595",1065595,33,253,1,287
"65596",1065596,86,26,3,115
"65597",1065597,160,102,4,266
"65598",1065598,84,172,10,266
"65599",1065599,112,16,9,137
"65600",1065600,143,117,25,285
"65601",1065601,129,139,18,286
"65602",1065602,119,48,11,178
"65603",1065603,77,39,4,120
"65604",1065604,103,46,10,159
"65605",1065605,69,97,1,167
"65606",1065606,52,105,8,165
"65607",1065607,41,244,3,288
"65608",1065608,154,50,3,207
"65609",1065609,37,259,5,301
"65610",1065610,124,151,8,283
"65611",1065611,100,195,14,309
"65612",1065612,122,31,8,161
"65613",1065613,138,107,11,256
"65614",1065614,83,172,12,267
"65615",1065615,65,55,4,124
"65616",1065616,89,13,3,105
"65617",1065617,58,91,2,151
"65618",1065618,53,225,11,289
"65619",1065619,132,48,3,183
"65620",1065620,105,57,8,170
"65621",1065621,89,190,4,283
"65622",1065622,212,67,19,298
"65623",1065623,156,88,15,259
"65624",1065624,69,32,1,102
"65625",1065625,16,2,1,19
"65626",1065626,91,69,19,179
"65627",1065627,184,37,6,227
"65628",1065628,29,258,8,295
"65629",1065629,84,14,3,101
"65630",1065630,72,180,8,260
"65631",1065631,15,119,2,136
"65632",1065632,64,7,3,74
"65633",1065633,147,138,18,303
"65634",1065634,38,106,4,148
"65635",1065635,91,88,11,190
"65636",1065636,106,17,7,130
"65637",1065637,84,139,9,232
"65638",1065638,58,28,2,88
"65639",1065639,134,51,16,201
"65640",1065640,148,77,7,232
"65641",1065641,99,83,16,198
"65642",1065642,24,197,3,224
"65643",1065643,131,46,9,186
"65644",1065644,46,220,12,278
"65645",1065645,83,185,4,272
"65646",1065646,121,7,0,128
"65647",1065647,107,189,15,311
"65648",1065648,23,196,3,222
"65649",1065649,152,82,8,242
"65650",1065650,150,63,7,220
"65651",1065651,93,29,3,125
"65652",1065652,10,4,0,14
"65653",1065653,30,221,2,253
"65654",1065654,145,10,5,160
"65655",1065655,86,205,12,303
"65656",1065656,57,92,17,166
"65657",1065657,135,8,3,146
"65658",1065658,107,177,7,291
"65659",1065659,31,250,1,282
"65660",1065660,124,23,1,148
"65661",1065661,6,6,0,12
"65662",1065662,139,107,5,251
"65663",1065663,201,86,12,299
"65664",1065664,27,56,2,85
"65665",1065665,183,147,14,344
"65666",1065666,139,63,8,210
"65667",1065667,135,71,9,215
"65668",1065668,52,192,6,250
"65669",1065669,218,66,1,285
"65670",1065670,172,99,11,282
"65671",1065671,29,232,4,265
"65672",1065672,178,44,9,231
"65673",1065673,106,70,14,190
"65674",1065674,50,6,1,57
"65675",1065675,119,141,10,270
"65676",1065676,85,3,0,88
"65677",1065677,54,200,9,263
"65678",1065678,139,145,6,290
"65679",1065679,93,175,16,284
"65680",1065680,45,265,7,317
"65681",1065681,163,58,9,230
"65682",1065682,274,46,14,334
"65683",1065683,163,108,7,278
"65684",1065684,203,22,7,232
"65685",1065685,110,105,5,220
"65686",1065686,168,118,12,298
"65687",1065687,211,40,13,264
"65688",1065688,9,3,0,12
"65689",1065689,72,14,6,92
"65690",1065690,58,256,22,336
"65691",1065691,130,66,5,201
"65692",1065692,114,83,16,213
"65693",1065693,187,59,9,255
"65694",1065694,125,105,19,249
"65695",1065695,71,31,6,108
"65696",1065696,140,104,32,276
"65697",1065697,222,17,4,243
"65698",1065698,74,150,9,233
"65699",1065699,117,129,5,251
"65700",1065700,90,64,7,161
"65701",1065701,81,96,17,194
"65702",1065702,29,143,6,178
"65703",1065703,117,129,7,253
"65704",1065704,185,35,11,231
"65705",1065705,169,62,2,233
"65706",1065706,174,65,9,248
"65707",1065707,41,86,4,131
"65708",1065708,40,161,9,210
"65709",1065709,48,245,8,301
"65710",1065710,36,277,5,318
"65711",1065711,99,141,10,250
"65712",1065712,115,111,24,250
"65713",1065713,160,28,5,193
"65714",1065714,102,186,15,303
"65715",1065715,41,164,7,212
"65716",1065716,112,88,17,217
"65717",1065717,196,85,6,287
"65718",1065718,82,157,13,252
"65719",1065719,167,44,2,213
"65720",1065720,76,127,11,214
"65721",1065721,74,167,14,255
"65722",1065722,59,176,14,249
"65723",1065723,81,159,23,263
"65724",1065724,94,175,13,282
"65725",1065725,133,50,4,187
"65726",1065726,115,31,7,153
"65727",1065727,75,61,13,149
"65728",1065728,80,56,11,147
"65729",1065729,108,96,9,213
"65730",1065730,42,152,9,203
"65731",1065731,160,99,16,275
"65732",1065732,35,23,0,58
"65733",1065733,119,59,5,183
"65734",1065734,53,207,7,267
"65735",1065735,8,7,1,16
"65736",1065736,32,238,4,274
"65737",1065737,138,152,17,307
"65738",1065738,34,38,1,73
"65739",1065739,81,30,3,114
"65740",1065740,139,18,6,163
"65741",1065741,93,161,5,259
"65742",1065742,205,9,5,219
"65743",1065743,53,163,7,223
"65744",1065744,169,33,7,209
"65745",1065745,119,96,14,229
"65746",1065746,27,31,2,60
"65747",1065747,106,131,10,247
"65748",1065748,193,24,4,221
"65749",1065749,31,260,9,300
"65750",1065750,70,155,5,230
"65751",1065751,168,79,10,257
"65752",1065752,143,149,7,299
"65753",1065753,257,51,11,319
"65754",1065754,211,26,4,241
"65755",1065755,187,49,16,252
"65756",1065756,115,144,13,272
"65757",1065757,87,154,5,246
"65758",1065758,179,68,14,261
"65759",1065759,172,130,13,315
"65760",1065760,73,213,12,298
"65761",1065761,157,84,18,259
"65762",1065762,157,69,7,233
"65763",1065763,131,24,1,156
"65764",1065764,63,74,13,150
"65765",1065765,56,163,13,232
"65766",1065766,156,41,4,201
"65767",1065767,29,48,3,80
"65768",1065768,18,235,2,255
"65769",1065769,93,65,9,167
"65770",1065770,130,68,5,203
"65771",1065771,15,163,4,182
"65772",1065772,192,94,10,296
"65773",1065773,148,192,8,348
"65774",1065774,128,148,9,285
"65775",1065775,82,149,10,241
"65776",1065776,173,58,5,236
"65777",1065777,108,196,9,313
"65778",1065778,187,102,15,304
"65779",1065779,191,91,4,286
"65780",1065780,114,148,6,268
"65781",1065781,41,137,0,178
"65782",1065782,245,44,10,299
"65783",1065783,86,240,14,340
"65784",1065784,128,105,16,249
"65785",1065785,105,186,17,308
"65786",1065786,248,10,2,260
"65787",1065787,190,26,5,221
"65788",1065788,191,41,7,239
"65789",1065789,116,108,7,231
"65790",1065790,109,148,6,263
"65791",1065791,137,33,7,177
"65792",1065792,240,23,6,269
"65793",1065793,111,109,12,232
"65794",1065794,97,210,11,318
"65795",1065795,97,84,3,184
"65796",1065796,151,54,8,213
"65797",1065797,89,93,12,194
"65798",1065798,10,54,2,66
"65799",1065799,169,50,12,231
"65800",1065800,168,58,7,233
"65801",1065801,162,116,11,289
"65802",1065802,138,59,5,202
"65803",1065803,221,69,4,294
"65804",1065804,199,159,5,363
"65805",1065805,104,90,9,203
"65806",1065806,127,129,11,267
"65807",1065807,57,251,12,320
"65808",1065808,48,175,4,227
"65809",1065809,132,66,7,205
"65810",1065810,220,42,17,279
"65811",1065811,110,207,1,318
"65812",1065812,151,134,10,295
"65813",1065813,144,51,6,201
"65814",1065814,89,132,6,227
"65815",1065815,166,70,15,251
"65816",1065816,139,154,16,309
"65817",1065817,33,136,1,170
"65818",1065818,197,67,5,269
"65819",1065819,115,107,5,227
"65820",1065820,148,77,8,233
"65821",1065821,189,62,11,262
"65822",1065822,67,94,9,170
"65823",1065823,167,73,13,253
"65824",1065824,9,146,2,157
"65825",1065825,34,14,0,48
"65826",1065826,87,70,3,160
"65827",1065827,60,175,4,239
"65828",1065828,198,75,4,277
"65829",1065829,45,111,0,156
"65830",1065830,196,78,11,285
"65831",1065831,35,109,7,151
"65832",1065832,142,57,4,203
"65833",1065833,79,43,2,124
"65834",1065834,71,38,4,113
"65835",1065835,106,37,8,151
"65836",1065836,165,34,5,204
"65837",1065837,212,10,6,228
"65838",1065838,140,85,4,229
"65839",1065839,212,52,7,271
"65840",1065840,219,22,7,248
"65841",1065841,128,164,10,302
"65842",1065842,88,120,0,208
"65843",1065843,198,63,15,276
"65844",1065844,200,28,3,231
"65845",1065845,0,0,0,0
"65846",1065846,159,62,22,243
"65847",1065847,209,111,14,334
"65848",1065848,4,42,0,46
"65849",1065849,123,119,14,256
"65850",1065850,135,57,4,196
"65851",1065851,192,65,17,274
"65852",1065852,100,129,11,240
"65853",1065853,137,138,9,284
"65854",1065854,90,150,11,251
"65855",1065855,41,153,5,199
"65856",1065856,63,197,12,272
"65857",1065857,140,152,21,313
"65858",1065858,95,79,5,179
"65859",1065859,37,184,1,222
"65860",1065860,203,24,9,236
"65861",1065861,164,35,6,205
"65862",1065862,156,27,2,185
"65863",1065863,166,124,6,296
"65864",1065864,59,196,11,266
"65865",1065865,36,211,5,252
"65866",1065866,76,116,2,194
"65867",1065867,65,162,4,231
"65868",1065868,100,171,7,278
"65869",1065869,66,94,10,170
"65870",1065870,90,182,14,286
"65871",1065871,75,184,15,274
"65872",1065872,7,3,0,10
"65873",1065873,38,261,8,307
"65874",1065874,80,201,6,287
"65875",1065875,107,125,14,246
"65876",1065876,181,63,7,251
"65877",1065877,82,8,0,90
"65878",1065878,118,0,0,118
"65879",1065879,34,211,5,250
"65880",1065880,84,109,10,203
"65881",1065881,118,43,5,166
"65882",1065882,193,59,6,258
"65883",1065883,91,113,8,212
"65884",1065884,77,236,14,327
"65885",1065885,28,76,12,116
"65886",1065886,108,116,20,244
"65887",1065887,28,32,5,65
"65888",1065888,274,29,11,314
"65889",1065889,132,68,4,204
"65890",1065890,93,28,6,127
"65891",1065891,113,178,11,302
"65892",1065892,81,120,4,205
"65893",1065893,184,42,8,234
"65894",1065894,136,97,16,249
"65895",1065895,279,42,10,331
"65896",1065896,139,67,6,212
"65897",1065897,23,225,1,249
"65898",1065898,109,176,12,297
"65899",1065899,100,178,6,284
"65900",1065900,96,146,9,251
"65901",1065901,82,27,6,115
"65902",1065902,28,261,18,307
"65903",1065903,70,158,6,234
"65904",1065904,93,190,14,297
"65905",1065905,38,239,3,280
"65906",1065906,93,76,17,186
"65907",1065907,105,72,11,188
"65908",1065908,189,101,8,298
"65909",1065909,185,89,7,281
"65910",1065910,148,143,21,312
"65911",1065911,152,13,9,174
"65912",1065912,212,63,13,288
"65913",1065913,8,38,0,46
"65914",1065914,55,48,2,105
"65915",1065915,108,69,6,183
"65916",1065916,125,63,5,193
"65917",1065917,19,38,1,58
"65918",1065918,228,45,11,284
"65919",1065919,104,95,12,211
"65920",1065920,105,141,5,251
"65921",1065921,33,281,7,321
"65922",1065922,5,97,2,104
"65923",1065923,45,152,8,205
"65924",1065924,147,62,3,212
"65925",1065925,151,19,6,176
"65926",1065926,212,35,6,253
"65927",1065927,99,71,14,184
"65928",1065928,172,55,3,230
"65929",1065929,164,60,4,228
"65930",1065930,127,86,18,231
"65931",1065931,133,77,9,219
"65932",1065932,31,45,6,82
"65933",1065933,198,50,12,260
"65934",1065934,73,220,11,304
"65935",1065935,235,48,6,289
"65936",1065936,163,85,9,257
"65937",1065937,117,174,17,308
"65938",1065938,144,26,3,173
"65939",1065939,3,43,1,47
"65940",1065940,132,72,18,222
"65941",1065941,33,19,0,52
"65942",1065942,116,76,4,196
"65943",1065943,138,67,9,214
"65944",1065944,165,83,10,258
"65945",1065945,36,133,3,172
"65946",1065946,47,139,8,194
"65947",1065947,61,256,5,322
"65948",1065948,187,65,1,253
"65949",1065949,51,184,9,244
"65950",1065950,62,150,3,215
"65951",1065951,184,25,6,215
"65952",1065952,2,9,0,11
"65953",1065953,145,106,5,256
"65954",1065954,76,142,12,230
"65955",1065955,93,65,16,174
"65956",1065956,42,108,3,153
"65957",1065957,203,29,31,263
"65958",1065958,83,43,2,128
"65959",1065959,72,41,7,120
"65960",1065960,133,156,16,305
"65961",1065961,36,271,5,312
"65962",1065962,134,48,5,187
"65963",1065963,69,152,16,237
"65964",1065964,104,51,4,159
"65965",1065965,74,251,8,333
"65966",1065966,74,148,3,225
"65967",1065967,141,29,5,175
"65968",1065968,172,71,4,247
"65969",1065969,131,69,1,201
"65970",1065970,94,77,10,181
"65971",1065971,75,63,3,141
"65972",1065972,11,9,0,20
"65973",1065973,76,16,2,94
"65974",1065974,17,165,4,186
"65975",1065975,200,80,7,287
"65976",1065976,163,56,9,228
"65977",1065977,92,126,8,226
"65978",1065978,52,172,3,227
"65979",1065979,117,72,3,192
"65980",1065980,195,52,22,269
"65981",1065981,270,39,13,322
"65982",1065982,7,130,2,139
"65983",1065983,43,270,6,319
"65984",1065984,15,189,2,206
"65985",1065985,119,60,5,184
"65986",1065986,145,79,8,232
"65987",1065987,198,30,8,236
"65988",1065988,29,222,4,255
"65989",1065989,115,110,11,236
"65990",1065990,32,48,3,83
"65991",1065991,238,24,9,271
"65992",1065992,90,137,10,237
"65993",1065993,101,135,3,239
"65994",1065994,121,147,9,277
"65995",1065995,157,31,7,195
"65996",1065996,128,137,6,271
"65997",1065997,101,126,6,233
"65998",1065998,73,159,4,236
"65999",1065999,104,96,12,212
"66000",1066000,29,26,3,58
"66001",1066001,143,111,12,266
"66002",1066002,226,91,6,323
"66003",1066003,47,231,3,281
"66004",1066004,138,86,8,232
"66005",1066005,78,178,13,269
"66006",1066006,146,165,16,327
"66007",1066007,183,66,5,254
"66008",1066008,47,75,2,124
"66009",1066009,172,40,4,216
"66010",1066010,168,142,13,323
"66011",1066011,146,88,12,246
"66012",1066012,46,152,6,204
"66013",1066013,45,190,6,241
"66014",1066014,123,136,2,261
"66015",1066015,154,76,21,251
"66016",1066016,64,108,1,173
"66017",1066017,124,66,7,197
"66018",1066018,138,62,8,208
"66019",1066019,193,22,5,220
"66020",1066020,141,17,7,165
"66021",1066021,60,153,3,216
"66022",1066022,54,61,4,119
"66023",1066023,159,102,4,265
"66024",1066024,85,155,5,245
"66025",1066025,154,47,6,207
"66026",1066026,80,197,4,281
"66027",1066027,76,222,1,299
"66028",1066028,24,188,2,214
"66029",1066029,46,113,12,171
"66030",1066030,142,84,4,230
"66031",1066031,49,27,2,78
"66032",1066032,45,240,3,288
"66033",1066033,222,64,9,295
"66034",1066034,79,38,4,121
"66035",1066035,171,97,22,290
"66036",1066036,182,105,13,300
"66037",1066037,107,75,13,195
"66038",1066038,60,96,3,159
"66039",1066039,27,159,4,190
"66040",1066040,172,129,24,325
"66041",1066041,168,7,4,179
"66042",1066042,63,161,4,228
"66043",1066043,96,179,5,280
"66044",1066044,10,122,1,133
"66045",1066045,133,115,8,256
"66046",1066046,35,228,3,266
"66047",1066047,142,76,11,229
"66048",1066048,67,211,2,280
"66049",1066049,91,213,6,310
"66050",1066050,123,42,4,169
"66051",1066051,5,1,0,6
"66052",1066052,47,168,1,216
"66053",1066053,67,115,9,191
"66054",1066054,8,309,6,323
"66055",1066055,133,148,3,284
"66056",1066056,150,36,7,193
"66057",1066057,68,35,2,105
"66058",1066058,146,71,16,233
"66059",1066059,251,20,9,280
"66060",1066060,209,74,11,294
"66061",1066061,2,6,1,9
"66062",1066062,19,0,0,19
"66063",1066063,55,223,10,288
"66064",1066064,167,60,12,239
"66065",1066065,78,129,2,209
"66066",1066066,138,160,21,319
"66067",1066067,187,77,9,273
"66068",1066068,20,303,0,323
"66069",1066069,122,218,17,357
"66070",1066070,158,102,23,283
"66071",1066071,45,5,0,50
"66072",1066072,147,70,2,219
"66073",1066073,70,201,4,275
"66074",1066074,79,187,11,277
"66075",1066075,127,22,9,158
"66076",1066076,162,104,10,276
"66077",1066077,78,77,5,160
"66078",1066078,49,205,19,273
"66079",1066079,186,33,6,225
"66080",1066080,15,231,1,247
"66081",1066081,16,180,6,202
"66082",1066082,162,123,16,301
"66083",1066083,214,45,10,269
"66084",1066084,14,5,1,20
"66085",1066085,75,135,7,217
"66086",1066086,87,183,21,291
"66087",1066087,7,70,4,81
"66088",1066088,200,35,9,244
"66089",1066089,148,71,8,227
"66090",1066090,198,48,7,253
"66091",1066091,172,21,6,199
"66092",1066092,145,153,13,311
"66093",1066093,68,182,6,256
"66094",1066094,9,31,1,41
"66095",1066095,38,65,11,114
"66096",1066096,107,186,10,303
"66097",1066097,220,30,8,258
"66098",1066098,127,111,7,245
"66099",1066099,62,80,8,150
"66100",1066100,158,38,3,199
"66101",1066101,152,156,6,314
"66102",1066102,99,99,7,205
"66103",1066103,165,77,14,256
"66104",1066104,125,102,13,240
"66105",1066105,175,0,0,175
"66106",1066106,130,67,12,209
"66107",1066107,137,64,16,217
"66108",1066108,50,13,3,66
"66109",1066109,151,132,15,298
"66110",1066110,53,216,5,274
"66111",1066111,123,103,14,240
"66112",1066112,134,55,3,192
"66113",1066113,21,259,3,283
"66114",1066114,37,246,6,289
"66115",1066115,148,63,9,220
"66116",1066116,119,41,3,163
"66117",1066117,108,44,3,155
"66118",1066118,173,125,9,307
"66119",1066119,29,174,4,207
"66120",1066120,201,93,25,319
"66121",1066121,95,72,0,167
"66122",1066122,99,99,6,204
"66123",1066123,178,51,6,235
"66124",1066124,60,209,4,273
"66125",1066125,42,45,2,89
"66126",1066126,165,44,1,210
"66127",1066127,76,120,3,199
"66128",1066128,30,261,1,292
"66129",1066129,144,123,16,283
"66130",1066130,109,88,4,201
"66131",1066131,109,20,2,131
"66132",1066132,172,59,6,237
"66133",1066133,47,225,8,280
"66134",1066134,175,30,2,207
"66135",1066135,38,234,5,277
"66136",1066136,128,108,9,245
"66137",1066137,210,99,14,323
"66138",1066138,155,45,2,202
"66139",1066139,115,88,5,208
"66140",1066140,128,146,13,287
"66141",1066141,121,132,10,263
"66142",1066142,64,126,8,198
"66143",1066143,116,95,12,223
"66144",1066144,253,10,3,266
"66145",1066145,103,47,7,157
"66146",1066146,202,62,12,276
"66147",1066147,206,23,3,232
"66148",1066148,208,17,9,234
"66149",1066149,136,51,13,200
"66150",1066150,131,102,13,246
"66151",1066151,75,39,6,120
"66152",1066152,86,67,13,166
"66153",1066153,119,57,4,180
"66154",1066154,70,74,3,147
"66155",1066155,136,133,9,278
"66156",1066156,153,120,11,284
"66157",1066157,133,145,17,295
"66158",1066158,85,47,13,145
"66159",1066159,67,170,4,241
"66160",1066160,215,5,7,227
"66161",1066161,62,169,7,238
"66162",1066162,42,163,6,211
"66163",1066163,131,30,6,167
"66164",1066164,176,102,16,294
"66165",1066165,30,224,8,262
"66166",1066166,135,133,14,282
"66167",1066167,169,24,1,194
"66168",1066168,177,64,5,246
"66169",1066169,134,11,2,147
"66170",1066170,123,267,24,414
"66171",1066171,130,45,4,179
"66172",1066172,70,160,7,237
"66173",1066173,239,48,10,297
"66174",1066174,133,100,17,250
"66175",1066175,193,29,9,231
"66176",1066176,159,77,8,244
"66177",1066177,158,134,21,313
"66178",1066178,222,63,23,308
"66179",1066179,145,174,8,327
"66180",1066180,71,96,2,169
"66181",1066181,146,66,10,222
"66182",1066182,148,12,6,166
"66183",1066183,112,92,11,215
"66184",1066184,124,51,1,176
"66185",1066185,180,96,11,287
"66186",1066186,96,150,9,255
"66187",1066187,91,201,13,305
"66188",1066188,217,67,6,290
"66189",1066189,89,166,11,266
"66190",1066190,122,167,9,298
"66191",1066191,44,242,8,294
"66192",1066192,212,39,9,260
"66193",1066193,113,37,4,154
"66194",1066194,79,158,8,245
"66195",1066195,100,111,10,221
"66196",1066196,89,95,13,197
"66197",1066197,118,22,2,142
"66198",1066198,49,17,4,70
"66199",1066199,22,9,0,31
"66200",1066200,230,53,12,295
"66201",1066201,85,188,12,285
"66202",1066202,53,165,6,224
"66203",1066203,131,149,13,293
"66204",1066204,214,71,9,294
"66205",1066205,104,72,8,184
"66206",1066206,119,168,9,296
"66207",1066207,178,95,11,284
"66208",1066208,60,191,10,261
"66209",1066209,93,233,26,352
"66210",1066210,155,89,17,261
"66211",1066211,43,203,8,254
"66212",1066212,132,38,5,175
"66213",1066213,192,63,10,265
"66214",1066214,77,203,9,289
"66215",1066215,134,105,9,248
"66216",1066216,105,132,15,252
"66217",1066217,83,162,13,258
"66218",1066218,62,117,4,183
"66219",1066219,77,36,8,121
"66220",1066220,59,190,4,253
"66221",1066221,168,57,7,232
"66222",1066222,133,49,8,190
"66223",1066223,73,95,22,190
"66224",1066224,125,70,7,202
"66225",1066225,156,27,1,184
"66226",1066226,233,23,3,259
"66227",1066227,108,137,4,249
"66228",1066228,157,60,0,217
"66229",1066229,86,153,16,255
"66230",1066230,7,20,0,27
"66231",1066231,107,86,7,200
"66232",1066232,82,33,4,119
"66233",1066233,121,102,13,236
"66234",1066234,69,111,8,188
"66235",1066235,112,99,4,215
"66236",1066236,154,85,6,245
"66237",1066237,6,2,3,11
"66238",1066238,62,195,11,268
"66239",1066239,193,65,13,271
"66240",1066240,120,17,10,147
"66241",1066241,159,74,6,239
"66242",1066242,126,71,3,200
"66243",1066243,188,133,15,336
"66244",1066244,126,148,3,277
"66245",1066245,66,137,9,212
"66246",1066246,153,24,7,184
"66247",1066247,143,80,3,226
"66248",1066248,25,240,1,266
"66249",1066249,157,77,4,238
"66250",1066250,189,62,15,266
"66251",1066251,207,82,11,300
"66252",1066252,248,81,8,337
"66253",1066253,152,111,10,273
"66254",1066254,65,171,7,243
"66255",1066255,48,177,0,225
"66256",1066256,159,25,5,189
"66257",1066257,144,76,13,233
"66258",1066258,95,122,9,226
"66259",1066259,105,37,4,146
"66260",1066260,54,92,4,150
"66261",1066261,249,10,7,266
"66262",1066262,95,143,24,262
"66263",1066263,95,68,5,168
"66264",1066264,121,113,7,241
"66265",1066265,120,54,5,179
"66266",1066266,162,36,6,204
"66267",1066267,53,192,9,254
"66268",1066268,149,115,0,264
"66269",1066269,27,221,3,251
"66270",1066270,106,141,11,258
"66271",1066271,139,17,4,160
"66272",1066272,37,302,5,344
"66273",1066273,116,143,6,265
"66274",1066274,195,141,6,342
"66275",1066275,68,145,9,222
"66276",1066276,126,203,1,330
"66277",1066277,110,51,3,164
"66278",1066278,10,3,2,15
"66279",1066279,96,179,5,280
"66280",1066280,17,29,0,46
"66281",1066281,97,91,18,206
"66282",1066282,166,92,39,297
"66283",1066283,147,12,7,166
"66284",1066284,165,49,11,225
"66285",1066285,137,55,2,194
"66286",1066286,191,97,15,303
"66287",1066287,162,32,4,198
"66288",1066288,37,264,10,311
"66289",1066289,77,181,8,266
"66290",1066290,258,40,17,315
"66291",1066291,56,145,6,207
"66292",1066292,146,70,6,222
"66293",1066293,246,51,1,298
"66294",1066294,74,120,3,197
"66295",1066295,136,60,6,202
"66296",1066296,61,253,5,319
"66297",1066297,71,223,14,308
"66298",1066298,212,26,5,243
"66299",1066299,64,125,5,194
"66300",1066300,38,241,8,287
"66301",1066301,69,59,6,134
"66302",1066302,165,101,3,269
"66303",1066303,89,99,12,200
"66304",1066304,106,216,7,329
"66305",1066305,153,54,6,213
"66306",1066306,183,104,5,292
"66307",1066307,242,25,5,272
"66308",1066308,160,47,5,212
"66309",1066309,36,174,4,214
"66310",1066310,68,92,6,166
"66311",1066311,96,184,6,286
"66312",1066312,200,51,7,258
"66313",1066313,88,34,5,127
"66314",1066314,134,49,5,188
"66315",1066315,49,56,8,113
"66316",1066316,104,213,10,327
"66317",1066317,68,45,5,118
"66318",1066318,198,130,6,334
"66319",1066319,47,42,3,92
"66320",1066320,255,12,4,271
"66321",1066321,62,10,6,78
"66322",1066322,75,183,6,264
"66323",1066323,178,36,5,219
"66324",1066324,69,114,5,188
"66325",1066325,159,60,3,222
"66326",1066326,209,18,6,233
"66327",1066327,179,58,10,247
"66328",1066328,35,38,4,77
"66329",1066329,156,82,4,242
"66330",1066330,118,57,9,184
"66331",1066331,174,108,8,290
"66332",1066332,71,86,10,167
"66333",1066333,76,174,13,263
"66334",1066334,122,76,11,209
"66335",1066335,36,48,11,95
"66336",1066336,139,233,14,386
"66337",1066337,109,105,8,222
"66338",1066338,133,146,10,289
"66339",1066339,196,115,13,324
"66340",1066340,175,39,11,225
"66341",1066341,144,47,7,198
"66342",1066342,172,73,7,252
"66343",1066343,37,0,0,37
"66344",1066344,198,48,6,252
"66345",1066345,118,92,6,216
"66346",1066346,157,120,12,289
"66347",1066347,146,55,1,202
"66348",1066348,19,107,8,134
"66349",1066349,120,83,8,211
"66350",1066350,100,81,9,190
"66351",1066351,183,32,8,223
"66352",1066352,218,120,13,351
"66353",1066353,68,148,8,224
"66354",1066354,97,160,9,266
"66355",1066355,77,210,5,292
"66356",1066356,28,199,3,230
"66357",1066357,130,110,4,244
"66358",1066358,6,13,1,20
"66359",1066359,126,95,0,221
"66360",1066360,265,15,4,284
"66361",1066361,150,45,10,205
"66362",1066362,114,124,14,252
"66363",1066363,73,121,10,204
"66364",1066364,43,189,7,239
"66365",1066365,191,35,7,233
"66366",1066366,62,100,5,167
"66367",1066367,71,170,9,250
"66368",1066368,105,129,6,240
"66369",1066369,104,145,7,256
"66370",1066370,157,41,10,208
"66371",1066371,129,59,7,195
"66372",1066372,149,119,5,273
"66373",1066373,59,252,18,329
"66374",1066374,224,16,8,248
"66375",1066375,148,147,9,304
"66376",1066376,153,51,4,208
"66377",1066377,142,98,13,253
"66378",1066378,30,26,1,57
"66379",1066379,93,158,14,265
"66380",1066380,82,120,12,214
"66381",1066381,97,21,6,124
"66382",1066382,49,169,2,220
"66383",1066383,54,30,2,86
"66384",1066384,103,6,1,110
"66385",1066385,54,262,4,320
"66386",1066386,77,214,10,301
"66387",1066387,163,27,5,195
"66388",1066388,56,94,14,164
"66389",1066389,45,4,1,50
"66390",1066390,189,98,11,298
"66391",1066391,39,238,13,290
"66392",1066392,240,31,8,279
"66393",1066393,66,9,1,76
"66394",1066394,130,55,5,190
"66395",1066395,70,5,5,80
"66396",1066396,59,31,0,90
"66397",1066397,111,123,10,244
"66398",1066398,12,9,3,24
"66399",1066399,171,71,8,250
"66400",1066400,149,121,14,284
"66401",1066401,203,102,19,324
"66402",1066402,143,22,2,167
"66403",1066403,138,152,9,299
"66404",1066404,202,12,6,220
"66405",1066405,127,68,13,208
"66406",1066406,73,241,3,317
"66407",1066407,120,192,13,325
"66408",1066408,132,119,4,255
"66409",1066409,187,43,14,244
"66410",1066410,81,140,14,235
"66411",1066411,56,71,6,133
"66412",1066412,132,75,15,222
"66413",1066413,215,44,9,268
"66414",1066414,50,174,8,232
"66415",1066415,0,2,0,2
"66416",1066416,26,159,8,193
"66417",1066417,77,80,4,161
"66418",1066418,108,223,10,341
"66419",1066419,114,57,5,176
"66420",1066420,283,28,11,322
"66421",1066421,41,106,10,157
"66422",1066422,14,20,1,35
"66423",1066423,51,90,0,141
"66424",1066424,75,168,13,256
"66425",1066425,152,74,7,233
"66426",1066426,128,170,12,310
"66427",1066427,169,52,0,221
"66428",1066428,108,101,12,221
"66429",1066429,66,130,9,205
"66430",1066430,134,120,7,261
"66431",1066431,75,172,5,252
"66432",1066432,118,82,11,211
"66433",1066433,123,155,9,287
"66434",1066434,226,55,11,292
"66435",1066435,11,36,2,49
"66436",1066436,166,135,12,313
"66437",1066437,155,58,12,225
"66438",1066438,138,105,6,249
"66439",1066439,199,65,22,286
"66440",1066440,57,232,2,291
"66441",1066441,124,88,4,216
"66442",1066442,93,45,5,143
"66443",1066443,118,97,3,218
"66444",1066444,170,98,15,283
"66445",1066445,153,98,11,262
"66446",1066446,149,37,7,193
"66447",1066447,130,68,16,214
"66448",1066448,170,111,9,290
"66449",1066449,125,31,4,160
"66450",1066450,184,67,7,258
"66451",1066451,143,140,5,288
"66452",1066452,30,8,2,40
"66453",1066453,135,97,5,237
"66454",1066454,151,10,6,167
"66455",1066455,74,123,7,204
"66456",1066456,181,109,10,300
"66457",1066457,88,16,1,105
"66458",1066458,172,64,10,246
"66459",1066459,68,165,10,243
"66460",1066460,27,198,3,228
"66461",1066461,88,202,13,303
"66462",1066462,194,16,4,214
"66463",1066463,44,253,8,305
"66464",1066464,162,70,9,241
"66465",1066465,54,105,7,166
"66466",1066466,86,181,8,275
"66467",1066467,74,124,4,202
"66468",1066468,1,3,1,5
"66469",1066469,53,58,3,114
"66470",1066470,211,70,15,296
"66471",1066471,196,79,3,278
"66472",1066472,102,159,10,271
"66473",1066473,195,82,14,291
"66474",1066474,127,129,10,266
"66475",1066475,117,301,16,434
"66476",1066476,165,34,9,208
"66477",1066477,128,25,2,155
"66478",1066478,175,34,7,216
"66479",1066479,167,60,10,237
"66480",1066480,91,7,4,102
"66481",1066481,78,202,12,292
"66482",1066482,58,98,3,159
"66483",1066483,40,248,14,302
"66484",1066484,123,155,13,291
"66485",1066485,232,44,15,291
"66486",1066486,221,68,4,293
"66487",1066487,56,235,6,297
"66488",1066488,131,19,8,158
"66489",1066489,147,127,5,279
"66490",1066490,129,33,11,173
"66491",1066491,51,239,11,301
"66492",1066492,12,184,1,197
"66493",1066493,30,262,4,296
"66494",1066494,170,44,12,226
"66495",1066495,123,50,8,181
"66496",1066496,18,52,8,78
"66497",1066497,125,151,16,292
"66498",1066498,10,0,1,11
"66499",1066499,101,114,4,219
"66500",1066500,39,232,4,275
"66501",1066501,155,100,3,258
"66502",1066502,74,13,1,88
"66503",1066503,204,14,6,224
"66504",1066504,119,99,9,227
"66505",1066505,18,111,1,130
"66506",1066506,68,186,11,265
"66507",1066507,142,201,5,348
"66508",1066508,70,74,8,152
"66509",1066509,45,231,6,282
"66510",1066510,211,25,10,246
"66511",1066511,123,116,12,251
"66512",1066512,126,99,10,235
"66513",1066513,63,141,17,221
"66514",1066514,97,71,11,179
"66515",1066515,15,63,0,78
"66516",1066516,209,59,14,282
"66517",1066517,112,69,8,189
"66518",1066518,120,47,14,181
"66519",1066519,120,40,4,164
"66520",1066520,13,131,4,148
"66521",1066521,75,35,3,113
"66522",1066522,97,124,19,240
"66523",1066523,167,24,5,196
"66524",1066524,166,138,7,311
"66525",1066525,174,29,3,206
"66526",1066526,110,155,8,273
"66527",1066527,185,81,7,273
"66528",1066528,4,8,0,12
"66529",1066529,150,53,5,208
"66530",1066530,158,55,9,222
"66531",1066531,151,92,10,253
"66532",1066532,112,86,11,209
"66533",1066533,131,120,21,272
"66534",1066534,145,123,10,278
"66535",1066535,63,247,4,314
"66536",1066536,60,184,19,263
"66537",1066537,39,53,4,96
"66538",1066538,56,207,6,269
"66539",1066539,145,115,3,263
"66540",1066540,47,18,2,67
"66541",1066541,161,55,11,227
"66542",1066542,65,105,11,181
"66543",1066543,244,2,5,251
"66544",1066544,38,166,8,212
"66545",1066545,66,181,6,253
"66546",1066546,184,18,1,203
"66547",1066547,161,53,10,224
"66548",1066548,47,99,12,158
"66549",1066549,143,22,3,168
"66550",1066550,180,42,8,230
"66551",1066551,86,190,8,284
"66552",1066552,160,72,5,237
"66553",1066553,112,170,15,297
"66554",1066554,54,105,1,160
"66555",1066555,101,114,21,236
"66556",1066556,202,54,8,264
"66557",1066557,180,76,4,260
"66558",1066558,72,193,8,273
"66559",1066559,118,126,11,255
"66560",1066560,60,234,4,298
"66561",1066561,159,73,5,237
"66562",1066562,29,178,4,211
"66563",1066563,99,18,4,121
"66564",1066564,133,27,2,162
"66565",1066565,61,292,8,361
"66566",1066566,57,179,5,241
"66567",1066567,199,46,9,254
"66568",1066568,38,64,7,109
"66569",1066569,1,4,1,6
"66570",1066570,134,107,3,244
"66571",1066571,190,86,9,285
"66572",1066572,68,210,3,281
"66573",1066573,93,62,1,156
"66574",1066574,29,264,2,295
"66575",1066575,54,196,5,255
"66576",1066576,249,23,7,279
"66577",1066577,184,78,9,271
"66578",1066578,100,157,15,272
"66579",1066579,27,254,4,285
"66580",1066580,74,32,4,110
"66581",1066581,51,172,18,241
"66582",1066582,128,77,21,226
"66583",1066583,136,39,5,180
"66584",1066584,123,86,7,216
"66585",1066585,137,20,4,161
"66586",1066586,109,26,10,145
"66587",1066587,38,172,0,210
"66588",1066588,101,102,9,212
"66589",1066589,46,202,11,259
"66590",1066590,175,52,11,238
"66591",1066591,31,240,6,277
"66592",1066592,177,26,6,209
"66593",1066593,7,218,4,229
"66594",1066594,133,50,3,186
"66595",1066595,46,221,1,268
"66596",1066596,61,10,3,74
"66597",1066597,267,12,11,290
"66598",1066598,178,20,5,203
"66599",1066599,56,124,0,180
"66600",1066600,236,71,22,329
"66601",1066601,132,43,7,182
"66602",1066602,29,159,10,198
"66603",1066603,130,55,12,197
"66604",1066604,141,65,18,224
"66605",1066605,154,38,2,194
"66606",1066606,157,127,6,290
"66607",1066607,5,179,3,187
"66608",1066608,8,44,2,54
"66609",1066609,52,163,6,221
"66610",1066610,180,20,13,213
"66611",1066611,295,10,6,311
"66612",1066612,247,45,19,311
"66613",1066613,24,205,4,233
"66614",1066614,120,80,11,211
"66615",1066615,167,81,8,256
"66616",1066616,185,96,13,294
"66617",1066617,74,86,7,167
"66618",1066618,49,243,1,293
"66619",1066619,46,253,4,303
"66620",1066620,222,3,2,227
"66621",1066621,135,115,12,262
"66622",1066622,95,115,7,217
"66623",1066623,205,22,10,237
"66624",1066624,103,55,2,160
"66625",1066625,9,154,3,166
"66626",1066626,124,10,6,140
"66627",1066627,109,126,12,247
"66628",1066628,26,26,1,53
"66629",1066629,30,50,1,81
"66630",1066630,160,12,3,175
"66631",1066631,138,120,1,259
"66632",1066632,103,161,15,279
"66633",1066633,135,112,11,258
"66634",1066634,33,154,10,197
"66635",1066635,99,140,7,246
"66636",1066636,5,179,1,185
"66637",1066637,94,210,15,319
"66638",1066638,244,71,10,325
"66639",1066639,78,204,1,283
"66640",1066640,156,31,7,194
"66641",1066641,195,36,7,238
"66642",1066642,169,78,6,253
"66643",1066643,84,85,19,188
"66644",1066644,168,88,9,265
"66645",1066645,47,256,3,306
"66646",1066646,71,12,1,84
"66647",1066647,15,137,3,155
"66648",1066648,139,38,8,185
"66649",1066649,105,123,9,237
"66650",1066650,74,67,6,147
"66651",1066651,14,256,1,271
"66652",1066652,3,22,1,26
"66653",1066653,105,11,6,122
"66654",1066654,64,182,1,247
"66655",1066655,142,60,3,205
"66656",1066656,119,30,8,157
"66657",1066657,191,82,10,283
"66658",1066658,141,43,5,189
"66659",1066659,127,121,6,254
"66660",1066660,84,109,1,194
"66661",1066661,43,71,4,118
"66662",1066662,80,180,8,268
"66663",1066663,28,193,6,227
"66664",1066664,122,52,13,187
"66665",1066665,37,233,6,276
"66666",1066666,105,118,12,235
"66667",1066667,102,145,6,253
"66668",1066668,82,194,11,287
"66669",1066669,106,93,10,209
"66670",1066670,90,48,1,139
"66671",1066671,197,44,10,251
"66672",1066672,175,65,16,256
"66673",1066673,114,22,8,144
"66674",1066674,105,10,4,119
"66675",1066675,28,0,1,29
"66676",1066676,73,78,3,154
"66677",1066677,95,103,15,213
"66678",1066678,152,104,4,260
"66679",1066679,171,76,3,250
"66680",1066680,55,170,7,232
"66681",1066681,95,14,2,111
"66682",1066682,143,33,9,185
"66683",1066683,98,225,11,334
"66684",1066684,106,91,6,203
"66685",1066685,9,129,2,140
"66686",1066686,155,43,5,203
"66687",1066687,52,246,6,304
"66688",1066688,86,147,22,255
"66689",1066689,118,86,13,217
"66690",1066690,158,92,8,258
"66691",1066691,68,176,12,256
"66692",1066692,87,53,13,153
"66693",1066693,74,6,3,83
"66694",1066694,185,86,11,282
"66695",1066695,143,126,10,279
"66696",1066696,76,148,17,241
"66697",1066697,218,22,5,245
"66698",1066698,6,275,4,285
"66699",1066699,105,83,3,191
"66700",1066700,171,99,6,276
"66701",1066701,8,13,0,21
"66702",1066702,161,26,5,192
"66703",1066703,83,228,11,322
"66704",1066704,10,13,1,24
"66705",1066705,140,16,6,162
"66706",1066706,29,3,2,34
"66707",1066707,128,82,9,219
"66708",1066708,94,93,12,199
"66709",1066709,89,155,13,257
"66710",1066710,52,140,14,206
"66711",1066711,131,159,10,300
"66712",1066712,114,110,4,228
"66713",1066713,98,86,8,192
"66714",1066714,128,104,13,245
"66715",1066715,76,99,16,191
"66716",1066716,45,25,2,72
"66717",1066717,137,130,4,271
"66718",1066718,154,69,14,237
"66719",1066719,123,52,1,176
"66720",1066720,236,65,9,310
"66721",1066721,24,0,1,25
"66722",1066722,69,113,7,189
"66723",1066723,73,196,5,274
"66724",1066724,8,22,0,30
"66725",1066725,141,102,14,257
"66726",1066726,93,98,5,196
"66727",1066727,151,144,14,309
"66728",1066728,173,111,14,298
"66729",1066729,119,95,10,224
"66730",1066730,138,53,13,204
"66731",1066731,244,8,8,260
"66732",1066732,79,172,29,280
"66733",1066733,120,134,5,259
"66734",1066734,125,33,1,159
"66735",1066735,70,117,11,198
"66736",1066736,183,62,15,260
"66737",1066737,36,220,3,259
"66738",1066738,11,24,0,35
"66739",1066739,177,15,5,197
"66740",1066740,29,237,3,269
"66741",1066741,148,120,24,292
"66742",1066742,13,42,0,55
"66743",1066743,113,140,15,268
"66744",1066744,80,193,11,284
"66745",1066745,16,9,1,26
"66746",1066746,71,119,11,201
"66747",1066747,41,14,2,57
"66748",1066748,94,124,18,236
"66749",1066749,113,163,6,282
"66750",1066750,199,35,9,243
"66751",1066751,67,82,3,152
"66752",1066752,51,94,3,148
"66753",1066753,28,4,0,32
"66754",1066754,49,271,10,330
"66755",1066755,140,134,16,290
"66756",1066756,15,7,5,27
"66757",1066757,74,198,2,274
"66758",1066758,156,83,9,248
"66759",1066759,42,92,6,140
"66760",1066760,67,184,2,253
"66761",1066761,184,87,5,276
"66762",1066762,153,61,14,228
"66763",1066763,163,164,9,336
"66764",1066764,129,145,22,296
"66765",1066765,148,119,13,280
"66766",1066766,129,27,7,163
"66767",1066767,109,164,12,285
"66768",1066768,63,23,0,86
"66769",1066769,70,175,13,258
"66770",1066770,153,123,4,280
"66771",1066771,135,126,2,263
"66772",1066772,193,93,22,308
"66773",1066773,91,110,15,216
"66774",1066774,140,51,8,199
"66775",1066775,102,17,1,120
"66776",1066776,127,130,17,274
"66777",1066777,205,44,8,257
"66778",1066778,104,81,0,185
"66779",1066779,133,141,13,287
"66780",1066780,225,46,10,281
"66781",1066781,188,56,1,245
"66782",1066782,147,117,10,274
"66783",1066783,38,158,0,196
"66784",1066784,144,19,8,171
"66785",1066785,146,100,11,257
"66786",1066786,234,31,8,273
"66787",1066787,26,219,9,254
"66788",1066788,49,258,13,320
"66789",1066789,78,147,6,231
"66790",1066790,235,48,8,291
"66791",1066791,128,91,14,233
"66792",1066792,9,52,1,62
"66793",1066793,41,199,4,244
"66794",1066794,152,166,11,329
"66795",1066795,21,4,0,25
"66796",1066796,119,8,1,128
"66797",1066797,66,243,7,316
"66798",1066798,161,74,7,242
"66799",1066799,20,19,0,39
"66800",1066800,37,46,1,84
"66801",1066801,75,163,13,251
"66802",1066802,82,8,2,92
"66803",1066803,150,96,9,255
"66804",1066804,115,91,10,216
"66805",1066805,149,59,13,221
"66806",1066806,125,133,6,264
"66807",1066807,103,126,11,240
"66808",1066808,33,88,3,124
"66809",1066809,134,34,2,170
"66810",1066810,187,83,8,278
"66811",1066811,32,134,3,169
"66812",1066812,80,7,0,87
"66813",1066813,140,121,4,265
"66814",1066814,82,173,3,258
"66815",1066815,81,38,7,126
"66816",1066816,120,133,11,264
"66817",1066817,83,144,14,241
"66818",1066818,67,168,3,238
"66819",1066819,145,76,11,232
"66820",1066820,123,111,11,245
"66821",1066821,110,92,4,206
"66822",1066822,202,60,21,283
"66823",1066823,213,27,9,249
"66824",1066824,47,211,17,275
"66825",1066825,136,85,11,232
"66826",1066826,56,161,7,224
"66827",1066827,162,96,17,275
"66828",1066828,184,86,11,281
"66829",1066829,99,91,10,200
"66830",1066830,23,19,0,42
"66831",1066831,35,212,1,248
"66832",1066832,34,254,4,292
"66833",1066833,77,117,5,199
"66834",1066834,100,70,7,177
"66835",1066835,89,139,7,235
"66836",1066836,89,178,11,278
"66837",1066837,244,56,5,305
"66838",1066838,90,80,10,180
"66839",1066839,134,88,16,238
"66840",1066840,148,28,20,196
"66841",1066841,117,71,7,195
"66842",1066842,75,183,1,259
"66843",1066843,178,67,7,252
"66844",1066844,155,50,12,217
"66845",1066845,19,11,4,34
"66846",1066846,57,71,9,137
"66847",1066847,142,96,7,245
"66848",1066848,142,59,19,220
"66849",1066849,68,84,13,165
"66850",1066850,65,244,9,318
"66851",1066851,37,61,5,103
"66852",1066852,99,113,3,215
"66853",1066853,155,119,7,281
"66854",1066854,56,116,6,178
"66855",1066855,59,202,10,271
"66856",1066856,83,181,4,268
"66857",1066857,158,22,5,185
"66858",1066858,72,64,3,139
"66859",1066859,138,181,11,330
"66860",1066860,125,111,14,250
"66861",1066861,324,53,15,392
"66862",1066862,48,202,2,252
"66863",1066863,115,95,16,226
"66864",1066864,181,80,12,273
"66865",1066865,5,57,0,62
"66866",1066866,158,53,2,213
"66867",1066867,0,3,0,3
"66868",1066868,12,61,0,73
"66869",1066869,14,197,2,213
"66870",1066870,182,97,24,303
"66871",1066871,158,56,9,223
"66872",1066872,44,112,3,159
"66873",1066873,119,140,15,274
"66874",1066874,228,58,8,294
"66875",1066875,104,165,8,277
"66876",1066876,179,40,9,228
"66877",1066877,229,47,22,298
"66878",1066878,140,62,19,221
"66879",1066879,182,44,2,228
"66880",1066880,136,63,11,210
"66881",1066881,162,50,5,217
"66882",1066882,102,151,10,263
"66883",1066883,81,159,9,249
"66884",1066884,35,40,4,79
"66885",1066885,46,39,4,89
"66886",1066886,142,77,10,229
"66887",1066887,30,3,1,34
"66888",1066888,131,157,16,304
"66889",1066889,91,193,24,308
"66890",1066890,157,158,23,338
"66891",1066891,131,41,3,175
"66892",1066892,263,2,3,268
"66893",1066893,132,163,5,300
"66894",1066894,100,80,14,194
"66895",1066895,140,156,25,321
"66896",1066896,13,180,3,196
"66897",1066897,165,75,12,252
"66898",1066898,23,13,4,40
"66899",1066899,32,284,4,320
"66900",1066900,85,51,1,137
"66901",1066901,95,219,13,327
"66902",1066902,133,178,22,333
"66903",1066903,48,183,4,235
"66904",1066904,66,198,8,272
"66905",1066905,14,4,2,20
"66906",1066906,62,31,3,96
"66907",1066907,138,55,5,198
"66908",1066908,179,45,6,230
"66909",1066909,52,101,2,155
"66910",1066910,78,22,6,106
"66911",1066911,106,111,4,221
"66912",1066912,85,191,17,293
"66913",1066913,124,86,7,217
"66914",1066914,70,122,7,199
"66915",1066915,87,149,11,247
"66916",1066916,210,32,8,250
"66917",1066917,120,67,9,196
"66918",1066918,104,31,8,143
"66919",1066919,104,95,8,207
"66920",1066920,136,38,6,180
"66921",1066921,59,39,0,98
"66922",1066922,61,149,3,213
"66923",1066923,75,176,6,257
"66924",1066924,265,6,22,293
"66925",1066925,32,255,1,288
"66926",1066926,112,143,14,269
"66927",1066927,161,163,12,336
"66928",1066928,54,125,13,192
"66929",1066929,168,67,5,240
"66930",1066930,88,106,8,202
"66931",1066931,123,78,6,207
"66932",1066932,93,175,8,276
"66933",1066933,92,71,8,171
"66934",1066934,244,16,6,266
"66935",1066935,59,205,8,272
"66936",1066936,66,187,3,256
"66937",1066937,147,66,10,223
"66938",1066938,86,114,8,208
"66939",1066939,90,106,5,201
"66940",1066940,184,40,7,231
"66941",1066941,127,124,9,260
"66942",1066942,10,241,3,254
"66943",1066943,23,105,4,132
"66944",1066944,95,167,8,270
"66945",1066945,132,109,5,246
"66946",1066946,84,156,10,250
"66947",1066947,55,7,2,64
"66948",1066948,116,159,5,280
"66949",1066949,203,83,7,293
"66950",1066950,137,25,7,169
"66951",1066951,198,8,0,206
"66952",1066952,39,207,4,250
"66953",1066953,125,56,7,188
"66954",1066954,135,52,5,192
"66955",1066955,221,71,9,301
"66956",1066956,164,78,15,257
"66957",1066957,47,33,2,82
"66958",1066958,26,166,4,196
"66959",1066959,248,55,7,310
"66960",1066960,37,182,6,225
"66961",1066961,72,112,4,188
"66962",1066962,126,174,6,306
"66963",1066963,85,52,15,152
"66964",1066964,176,82,6,264
"66965",1066965,152,72,4,228
"66966",1066966,147,78,3,228
"66967",1066967,34,250,5,289
"66968",1066968,51,241,5,297
"66969",1066969,89,137,8,234
"66970",1066970,121,191,18,330
"66971",1066971,139,68,8,215
"66972",1066972,230,34,9,273
"66973",1066973,58,202,13,273
"66974",1066974,163,51,5,219
"66975",1066975,29,167,5,201
"66976",1066976,122,126,11,259
"66977",1066977,55,198,5,258
"66978",1066978,40,141,10,191
"66979",1066979,103,81,15,199
"66980",1066980,131,62,4,197
"66981",1066981,182,53,6,241
"66982",1066982,56,231,5,292
"66983",1066983,41,249,4,294
"66984",1066984,67,166,8,241
"66985",1066985,132,204,10,346
"66986",1066986,50,36,4,90
"66987",1066987,81,109,3,193
"66988",1066988,143,181,16,340
"66989",1066989,202,80,6,288
"66990",1066990,79,168,24,271
"66991",1066991,67,148,15,230
"66992",1066992,120,128,9,257
"66993",1066993,67,155,8,230
"66994",1066994,174,85,10,269
"66995",1066995,31,180,2,213
"66996",1066996,38,178,6,222
"66997",1066997,66,28,1,95
"66998",1066998,187,45,9,241
"66999",1066999,50,34,8,92
"67000",1067000,214,64,6,284
"67001",1067001,80,135,17,232
"67002",1067002,96,122,4,222
"67003",1067003,274,44,13,331
"67004",1067004,120,120,29,269
"67005",1067005,188,5,6,199
"67006",1067006,160,83,8,251
"67007",1067007,75,185,25,285
"67008",1067008,113,93,19,225
"67009",1067009,35,236,9,280
"67010",1067010,144,40,5,189
"67011",1067011,120,35,5,160
"67012",1067012,14,172,6,192
"67013",1067013,149,138,17,304
"67014",1067014,112,176,9,297
"67015",1067015,162,79,6,247
"67016",1067016,162,168,17,347
"67017",1067017,131,93,18,242
"67018",1067018,83,112,5,200
"67019",1067019,178,31,2,211
"67020",1067020,73,145,8,226
"67021",1067021,106,178,4,288
"67022",1067022,126,168,11,305
"67023",1067023,121,76,10,207
"67024",1067024,143,32,4,179
"67025",1067025,93,144,6,243
"67026",1067026,130,105,1,236
"67027",1067027,49,165,6,220
"67028",1067028,20,181,5,206
"67029",1067029,75,200,20,295
"67030",1067030,38,233,8,279
"67031",1067031,62,152,4,218
"67032",1067032,66,170,6,242
"67033",1067033,105,71,19,195
"67034",1067034,119,111,12,242
"67035",1067035,276,28,12,316
"67036",1067036,183,99,14,296
"67037",1067037,85,91,13,189
"67038",1067038,90,52,7,149
"67039",1067039,88,50,12,150
"67040",1067040,88,190,5,283
"67041",1067041,154,104,5,263
"67042",1067042,104,99,4,207
"67043",1067043,61,198,15,274
"67044",1067044,157,139,24,320
"67045",1067045,129,13,3,145
"67046",1067046,79,83,12,174
"67047",1067047,155,5,1,161
"67048",1067048,226,68,12,306
"67049",1067049,140,163,8,311
"67050",1067050,50,111,20,181
"67051",1067051,100,125,4,229
"67052",1067052,195,76,17,288
"67053",1067053,55,154,12,221
"67054",1067054,145,49,4,198
"67055",1067055,106,49,2,157
"67056",1067056,69,76,9,154
"67057",1067057,53,261,7,321
"67058",1067058,153,50,5,208
"67059",1067059,52,262,7,321
"67060",1067060,171,31,4,206
"67061",1067061,42,229,4,275
"67062",1067062,187,51,9,247
"67063",1067063,181,25,5,211
"67064",1067064,57,49,9,115
"67065",1067065,190,67,19,276
"67066",1067066,63,168,15,246
"67067",1067067,234,24,4,262
"67068",1067068,42,138,10,190
"67069",1067069,101,82,1,184
"67070",1067070,75,187,6,268
"67071",1067071,45,35,8,88
"67072",1067072,110,111,5,226
"67073",1067073,73,59,9,141
"67074",1067074,116,171,15,302
"67075",1067075,77,203,11,291
"67076",1067076,223,40,5,268
"67077",1067077,182,38,2,222
"67078",1067078,197,78,19,294
"67079",1067079,13,2,1,16
"67080",1067080,116,143,18,277
"67081",1067081,51,235,6,292
"67082",1067082,48,113,3,164
"67083",1067083,44,142,5,191
"67084",1067084,126,163,14,303
"67085",1067085,86,134,9,229
"67086",1067086,45,162,2,209
"67087",1067087,144,42,5,191
"67088",1067088,239,27,5,271
"67089",1067089,135,69,9,213
"67090",1067090,140,34,7,181
"67091",1067091,120,39,8,167
"67092",1067092,181,10,5,196
"67093",1067093,63,64,9,136
"67094",1067094,78,118,14,210
"67095",1067095,111,117,14,242
"67096",1067096,169,66,6,241
"67097",1067097,78,79,11,168
"67098",1067098,210,71,12,293
"67099",1067099,54,234,9,297
"67100",1067100,61,155,9,225
"67101",1067101,141,31,2,174
"67102",1067102,49,52,5,106
"67103",1067103,82,92,21,195
"67104",1067104,116,40,8,164
"67105",1067105,58,126,8,192
"67106",1067106,121,206,11,338
"67107",1067107,97,90,5,192
"67108",1067108,5,29,1,35
"67109",1067109,14,199,6,219
"67110",1067110,162,89,6,257
"67111",1067111,71,88,4,163
"67112",1067112,147,110,13,270
"67113",1067113,154,46,4,204
"67114",1067114,100,19,6,125
"67115",1067115,68,196,14,278
"67116",1067116,191,32,3,226
"67117",1067117,54,256,4,314
"67118",1067118,123,36,10,169
"67119",1067119,164,28,6,198
"67120",1067120,41,86,4,131
"67121",1067121,115,127,4,246
"67122",1067122,82,174,13,269
"67123",1067123,37,235,5,277
"67124",1067124,44,191,3,238
"67125",1067125,73,81,2,156
"67126",1067126,152,57,7,216
"67127",1067127,70,118,15,203
"67128",1067128,41,85,1,127
"67129",1067129,249,44,18,311
"67130",1067130,71,88,16,175
"67131",1067131,138,159,11,308
"67132",1067132,171,100,11,282
"67133",1067133,160,63,7,230
"67134",1067134,169,73,6,248
"67135",1067135,150,92,7,249
"67136",1067136,59,170,2,231
"67137",1067137,155,124,13,292
"67138",1067138,134,132,28,294
"67139",1067139,145,121,6,272
"67140",1067140,223,21,7,251
"67141",1067141,353,45,15,413
"67142",1067142,234,44,10,288
"67143",1067143,97,65,2,164
"67144",1067144,52,179,8,239
"67145",1067145,117,111,18,246
"67146",1067146,38,256,8,302
"67147",1067147,129,91,7,227
"67148",1067148,91,111,19,221
"67149",1067149,111,39,4,154
"67150",1067150,98,104,7,209
"67151",1067151,185,41,6,232
"67152",1067152,162,137,14,313
"67153",1067153,116,142,7,265
"67154",1067154,128,170,6,304
"67155",1067155,117,148,18,283
"67156",1067156,76,175,4,255
"67157",1067157,47,222,17,286
"67158",1067158,208,306,47,561
"67159",1067159,50,262,6,318
"67160",1067160,159,88,5,252
"67161",1067161,151,120,14,285
"67162",1067162,57,56,8,121
"67163",1067163,210,67,6,283
"67164",1067164,24,60,4,88
"67165",1067165,140,53,4,197
"67166",1067166,16,152,11,179
"67167",1067167,229,18,4,251
"67168",1067168,43,172,5,220
"67169",1067169,46,165,3,214
"67170",1067170,27,241,0,268
"67171",1067171,86,210,12,308
"67172",1067172,66,52,6,124
"67173",1067173,165,72,9,246
"67174",1067174,121,145,9,275
"67175",1067175,151,92,4,247
"67176",1067176,198,108,13,319
"67177",1067177,148,34,8,190
"67178",1067178,43,139,13,195
"67179",1067179,77,87,5,169
"67180",1067180,75,158,6,239
"67181",1067181,93,38,13,144
"67182",1067182,96,44,4,144
"67183",1067183,29,215,2,246
"67184",1067184,125,35,4,164
"67185",1067185,209,39,6,254
"67186",1067186,30,228,5,263
"67187",1067187,145,7,7,159
"67188",1067188,114,178,9,301
"67189",1067189,249,145,16,410
"67190",1067190,48,69,2,119
"67191",1067191,95,33,11,139
"67192",1067192,60,215,8,283
"67193",1067193,68,148,2,218
"67194",1067194,160,125,7,292
"67195",1067195,14,74,0,88
"67196",1067196,56,182,13,251
"67197",1067197,20,6,0,26
"67198",1067198,119,180,5,304
"67199",1067199,148,84,4,236
"67200",1067200,89,119,5,213
"67201",1067201,186,24,6,216
"67202",1067202,93,124,17,234
"67203",1067203,97,53,3,153
"67204",1067204,156,157,6,319
"67205",1067205,107,64,5,176
"67206",1067206,11,2,0,13
"67207",1067207,297,11,1,309
"67208",1067208,173,97,13,283
"67209",1067209,50,38,3,91
"67210",1067210,154,98,4,256
"67211",1067211,132,70,4,206
"67212",1067212,72,160,4,236
"67213",1067213,139,40,8,187
"67214",1067214,59,87,0,146
"67215",1067215,33,74,4,111
"67216",1067216,73,196,1,270
"67217",1067217,143,59,11,213
"67218",1067218,156,72,10,238
"67219",1067219,169,17,6,192
"67220",1067220,69,205,3,277
"67221",1067221,187,80,9,276
"67222",1067222,136,109,10,255
"67223",1067223,119,128,19,266
"67224",1067224,169,38,10,217
"67225",1067225,161,76,4,241
"67226",1067226,134,122,4,260
"67227",1067227,99,175,15,289
"67228",1067228,168,34,4,206
"67229",1067229,70,89,5,164
"67230",1067230,19,24,1,44
"67231",1067231,198,82,5,285
"67232",1067232,52,233,4,289
"67233",1067233,75,164,15,254
"67234",1067234,78,42,3,123
"67235",1067235,23,243,6,272
"67236",1067236,28,7,2,37
"67237",1067237,90,92,4,186
"67238",1067238,180,50,5,235
"67239",1067239,84,212,13,309
"67240",1067240,75,90,16,181
"67241",1067241,40,185,8,233
"67242",1067242,175,61,22,258
"67243",1067243,148,34,3,185
"67244",1067244,118,98,2,218
"67245",1067245,140,40,9,189
"67246",1067246,172,79,16,267
"67247",1067247,67,188,3,258
"67248",1067248,139,85,12,236
"67249",1067249,99,126,10,235
"67250",1067250,45,93,13,151
"67251",1067251,185,44,7,236
"67252",1067252,252,36,8,296
"67253",1067253,62,50,2,114
"67254",1067254,153,73,15,241
"67255",1067255,139,127,8,274
"67256",1067256,31,194,2,227
"67257",1067257,20,223,5,248
"67258",1067258,178,12,7,197
"67259",1067259,145,33,5,183
"67260",1067260,116,141,4,261
"67261",1067261,146,76,8,230
"67262",1067262,40,181,6,227
"67263",1067263,93,122,10,225
"67264",1067264,78,103,17,198
"67265",1067265,151,65,3,219
"67266",1067266,124,25,10,159
"67267",1067267,35,254,2,291
"67268",1067268,112,55,6,173
"67269",1067269,23,65,3,91
"67270",1067270,29,9,1,39
"67271",1067271,185,92,13,290
"67272",1067272,149,154,10,313
"67273",1067273,139,75,13,227
"67274",1067274,118,56,6,180
"67275",1067275,167,83,15,265
"67276",1067276,99,14,6,119
"67277",1067277,85,145,11,241
"67278",1067278,172,60,2,234
"67279",1067279,49,98,2,149
"67280",1067280,118,161,2,281
"67281",1067281,44,232,3,279
"67282",1067282,39,158,3,200
"67283",1067283,124,159,13,296
"67284",1067284,222,39,12,273
"67285",1067285,100,141,13,254
"67286",1067286,211,24,4,239
"67287",1067287,133,96,8,237
"67288",1067288,158,12,4,174
"67289",1067289,179,97,20,296
"67290",1067290,154,65,15,234
"67291",1067291,144,119,12,275
"67292",1067292,184,88,9,281
"67293",1067293,120,85,9,214
"67294",1067294,93,75,5,173
"67295",1067295,97,142,9,248
"67296",1067296,100,45,5,150
"67297",1067297,5,16,1,22
"67298",1067298,176,48,7,231
"67299",1067299,88,171,12,271
"67300",1067300,115,155,19,289
"67301",1067301,180,43,8,231
"67302",1067302,129,54,9,192
"67303",1067303,117,106,8,231
"67304",1067304,105,53,2,160
"67305",1067305,189,102,11,302
"67306",1067306,57,102,2,161
"67307",1067307,27,220,3,250
"67308",1067308,94,239,3,336
"67309",1067309,156,48,7,211
"67310",1067310,151,40,5,196
"67311",1067311,139,116,7,262
"67312",1067312,68,188,17,273
"67313",1067313,7,13,0,20
"67314",1067314,166,80,8,254
"67315",1067315,53,146,10,209
"67316",1067316,153,38,4,195
"67317",1067317,88,177,6,271
"67318",1067318,173,75,16,264
"67319",1067319,92,180,5,277
"67320",1067320,159,71,7,237
"67321",1067321,158,103,7,268
"67322",1067322,124,139,11,274
"67323",1067323,63,177,19,259
"67324",1067324,37,53,4,94
"67325",1067325,120,24,4,148
"67326",1067326,120,89,6,215
"67327",1067327,204,20,7,231
"67328",1067328,109,170,25,304
"67329",1067329,129,74,5,208
"67330",1067330,120,167,3,290
"67331",1067331,128,8,3,139
"67332",1067332,103,99,7,209
"67333",1067333,89,39,5,133
"67334",1067334,160,79,10,249
"67335",1067335,125,48,14,187
"67336",1067336,186,32,4,222
"67337",1067337,51,46,3,100
"67338",1067338,37,267,4,308
"67339",1067339,151,100,17,268
"67340",1067340,59,89,3,151
"67341",1067341,70,27,2,99
"67342",1067342,123,95,8,226
"67343",1067343,129,23,1,153
"67344",1067344,141,83,6,230
"67345",1067345,80,200,7,287
"67346",1067346,76,133,13,222
"67347",1067347,31,204,13,248
"67348",1067348,9,5,0,14
"67349",1067349,34,26,3,63
"67350",1067350,181,25,2,208
"67351",1067351,70,156,18,244
"67352",1067352,78,148,1,227
"67353",1067353,70,177,4,251
"67354",1067354,229,29,10,268
"67355",1067355,34,0,0,34
"67356",1067356,62,182,7,251
"67357",1067357,217,36,5,258
"67358",1067358,42,261,2,305
"67359",1067359,99,119,10,228
"67360",1067360,88,71,9,168
"67361",1067361,119,54,16,189
"67362",1067362,63,179,5,247
"67363",1067363,48,137,13,198
"67364",1067364,94,50,10,154
"67365",1067365,161,122,7,290
"67366",1067366,111,101,8,220
"67367",1067367,49,185,4,238
"67368",1067368,122,170,6,298
"67369",1067369,228,49,7,284
"67370",1067370,56,217,14,287
"67371",1067371,98,163,20,281
"67372",1067372,62,59,3,124
"67373",1067373,134,128,18,280
"67374",1067374,3,21,0,24
"67375",1067375,133,143,10,286
"67376",1067376,12,350,1,363
"67377",1067377,11,10,0,21
"67378",1067378,248,15,4,267
"67379",1067379,76,15,9,100
"67380",1067380,164,79,18,261
"67381",1067381,206,29,7,242
"67382",1067382,148,58,3,209
"67383",1067383,125,125,11,261
"67384",1067384,102,149,5,256
"67385",1067385,140,177,7,324
"67386",1067386,147,99,15,261
"67387",1067387,45,287,4,336
"67388",1067388,82,85,11,178
"67389",1067389,206,64,21,291
"67390",1067390,89,219,23,331
"67391",1067391,105,101,9,215
"67392",1067392,177,41,7,225
"67393",1067393,89,109,19,217
"67394",1067394,211,65,23,299
"67395",1067395,110,256,31,397
"67396",1067396,71,0,0,71
"67397",1067397,114,11,3,128
"67398",1067398,223,52,5,280
"67399",1067399,85,105,12,202
"67400",1067400,119,105,15,239
"67401",1067401,59,135,7,201
"67402",1067402,159,49,0,208
"67403",1067403,91,201,10,302
"67404",1067404,101,114,10,225
"67405",1067405,130,46,3,179
"67406",1067406,186,45,9,240
"67407",1067407,24,273,3,300
"67408",1067408,52,121,13,186
"67409",1067409,70,131,12,213
"67410",1067410,167,41,13,221
"67411",1067411,27,120,8,155
"67412",1067412,94,181,2,277
"67413",1067413,81,157,4,242
"67414",1067414,2,78,3,83
"67415",1067415,62,156,8,226
"67416",1067416,78,186,6,270
"67417",1067417,35,246,8,289
"67418",1067418,63,112,1,176
"67419",1067419,207,61,5,273
"67420",1067420,205,36,8,249
"67421",1067421,83,100,7,190
"67422",1067422,191,83,11,285
"67423",1067423,46,176,3,225
"67424",1067424,140,95,10,245
"67425",1067425,48,239,10,297
"67426",1067426,142,29,1,172
"67427",1067427,167,77,9,253
"67428",1067428,132,130,12,274
"67429",1067429,102,155,15,272
"67430",1067430,185,87,6,278
"67431",1067431,219,35,7,261
"67432",1067432,99,224,7,330
"67433",1067433,63,182,4,249
"67434",1067434,76,183,5,264
"67435",1067435,54,156,3,213
"67436",1067436,231,123,5,359
"67437",1067437,163,37,9,209
"67438",1067438,149,196,7,352
"67439",1067439,15,9,0,24
"67440",1067440,18,5,0,23
"67441",1067441,215,17,9,241
"67442",1067442,195,56,3,254
"67443",1067443,8,11,0,19
"67444",1067444,79,171,8,258
"67445",1067445,182,56,7,245
"67446",1067446,67,53,9,129
"67447",1067447,88,90,2,180
"67448",1067448,210,72,24,306
"67449",1067449,1,6,1,8
"67450",1067450,198,86,10,294
"67451",1067451,85,44,4,133
"67452",1067452,167,32,6,205
"67453",1067453,13,5,1,19
"67454",1067454,158,80,9,247
"67455",1067455,190,91,13,294
"67456",1067456,85,117,11,213
"67457",1067457,119,142,16,277
"67458",1067458,46,221,7,274
"67459",1067459,132,71,6,209
"67460",1067460,80,120,10,210
"67461",1067461,185,15,8,208
"67462",1067462,56,210,21,287
"67463",1067463,107,152,13,272
"67464",1067464,87,74,11,172
"67465",1067465,147,33,8,188
"67466",1067466,66,197,7,270
"67467",1067467,80,191,3,274
"67468",1067468,126,11,4,141
"67469",1067469,113,113,1,227
"67470",1067470,71,91,5,167
"67471",1067471,101,103,5,209
"67472",1067472,172,36,8,216
"67473",1067473,22,194,1,217
"67474",1067474,109,47,5,161
"67475",1067475,61,80,9,150
"67476",1067476,36,282,4,322
"67477",1067477,60,104,8,172
"67478",1067478,235,87,9,331
"67479",1067479,110,30,10,150
"67480",1067480,49,188,11,248
"67481",1067481,211,83,16,310
"67482",1067482,32,8,2,42
"67483",1067483,54,133,6,193
"67484",1067484,77,47,6,130
"67485",1067485,178,116,4,298
"67486",1067486,85,153,10,248
"67487",1067487,97,19,5,121
"67488",1067488,95,129,5,229
"67489",1067489,152,66,15,233
"67490",1067490,43,5,1,49
"67491",1067491,72,164,7,243
"67492",1067492,78,140,2,220
"67493",1067493,18,217,3,238
"67494",1067494,65,253,9,327
"67495",1067495,66,161,8,235
"67496",1067496,85,110,7,202
"67497",1067497,147,49,9,205
"67498",1067498,130,131,9,270
"67499",1067499,223,49,7,279
"67500",1067500,149,54,5,208
"67501",1067501,135,68,10,213
"67502",1067502,109,135,6,250
"67503",1067503,6,7,0,13
"67504",1067504,80,192,13,285
"67505",1067505,101,107,3,211
"67506",1067506,141,82,9,232
"67507",1067507,106,154,4,264
"67508",1067508,98,222,7,327
"67509",1067509,62,73,11,146
"67510",1067510,211,38,11,260
"67511",1067511,152,110,12,274
"67512",1067512,165,159,5,329
"67513",1067513,117,48,4,169
"67514",1067514,50,142,1,193
"67515",1067515,82,110,1,193
"67516",1067516,211,30,8,249
"67517",1067517,132,131,5,268
"67518",1067518,69,71,5,145
"67519",1067519,228,42,14,284
"67520",1067520,148,25,8,181
"67521",1067521,80,224,4,308
"67522",1067522,222,26,1,249
"67523",1067523,77,256,8,341
"67524",1067524,7,16,2,25
"67525",1067525,114,163,17,294
"67526",1067526,228,20,6,254
"67527",1067527,153,61,8,222
"67528",1067528,18,35,1,54
"67529",1067529,52,195,10,257
"67530",1067530,121,146,8,275
"67531",1067531,8,58,0,66
"67532",1067532,157,42,10,209
"67533",1067533,201,20,9,230
"67534",1067534,153,110,5,268
"67535",1067535,83,98,6,187
"67536",1067536,184,7,6,197
"67537",1067537,175,81,3,259
"67538",1067538,106,92,6,204
"67539",1067539,202,42,7,251
"67540",1067540,116,128,9,253
"67541",1067541,148,64,8,220
"67542",1067542,98,139,16,253
"67543",1067543,76,66,3,145
"67544",1067544,101,30,4,135
"67545",1067545,38,21,6,65
"67546",1067546,114,32,1,147
"67547",1067547,81,106,8,195
"67548",1067548,39,76,2,117
"67549",1067549,150,47,9,206
"67550",1067550,186,26,5,217
"67551",1067551,96,56,5,157
"67552",1067552,71,186,2,259
"67553",1067553,255,30,4,289
"67554",1067554,57,180,9,246
"67555",1067555,144,57,6,207
"67556",1067556,44,153,1,198
"67557",1067557,47,222,12,281
"67558",1067558,96,124,4,224
"67559",1067559,87,68,2,157
"67560",1067560,89,98,3,190
"67561",1067561,164,98,13,275
"67562",1067562,121,44,5,170
"67563",1067563,12,5,1,18
"67564",1067564,202,56,9,267
"67565",1067565,165,89,16,270
"67566",1067566,79,212,7,298
"67567",1067567,123,104,16,243
"67568",1067568,56,204,8,268
"67569",1067569,15,266,6,287
"67570",1067570,127,49,14,190
"67571",1067571,198,14,4,216
"67572",1067572,72,180,2,254
"67573",1067573,53,223,6,282
"67574",1067574,139,130,9,278
"67575",1067575,49,106,7,162
"67576",1067576,114,2,0,116
"67577",1067577,1,21,0,22
"67578",1067578,114,76,8,198
"67579",1067579,173,147,5,325
"67580",1067580,126,34,3,163
"67581",1067581,77,131,2,210
"67582",1067582,2,2,0,4
"67583",1067583,58,59,13,130
"67584",1067584,19,155,2,176
"67585",1067585,74,153,5,232
"67586",1067586,139,153,10,302
"67587",1067587,76,108,12,196
"67588",1067588,99,83,9,191
"67589",1067589,70,246,5,321
"67590",1067590,177,72,9,258
"67591",1067591,122,161,8,291
"67592",1067592,186,73,7,266
"67593",1067593,178,25,9,212
"67594",1067594,98,201,11,310
"67595",1067595,152,88,6,246
"67596",1067596,77,143,1,221
"67597",1067597,193,58,7,258
"67598",1067598,114,47,2,163
"67599",1067599,217,24,7,248
"67600",1067600,140,61,7,208
"67601",1067601,112,94,11,217
"67602",1067602,63,147,6,216
"67603",1067603,75,153,9,237
"67604",1067604,55,8,3,66
"67605",1067605,139,110,3,252
"67606",1067606,43,190,12,245
"67607",1067607,93,397,26,516
"67608",1067608,117,49,4,170
"67609",1067609,134,127,9,270
"67610",1067610,59,210,18,287
"67611",1067611,91,160,13,264
"67612",1067612,19,6,0,25
"67613",1067613,46,210,7,263
"67614",1067614,173,51,3,227
"67615",1067615,0,9,1,10
"67616",1067616,154,131,19,304
"67617",1067617,82,177,3,262
"67618",1067618,52,178,14,244
"67619",1067619,266,27,7,300
"67620",1067620,147,78,5,230
"67621",1067621,50,240,3,293
"67622",1067622,1,17,0,18
"67623",1067623,66,241,9,316
"67624",1067624,92,93,6,191
"67625",1067625,141,127,14,282
"67626",1067626,64,154,6,224
"67627",1067627,69,170,8,247
"67628",1067628,98,112,6,216
"67629",1067629,130,144,7,281
"67630",1067630,176,301,20,497
"67631",1067631,99,38,6,143
"67632",1067632,53,166,5,224
"67633",1067633,88,125,12,225
"67634",1067634,123,128,13,264
"67635",1067635,194,140,6,340
"67636",1067636,200,32,5,237
"67637",1067637,171,71,17,259
"67638",1067638,59,123,4,186
"67639",1067639,207,94,11,312
"67640",1067640,52,191,4,247
"67641",1067641,129,89,6,224
"67642",1067642,33,208,5,246
"67643",1067643,69,222,3,294
"67644",1067644,59,278,9,346
"67645",1067645,217,37,3,257
"67646",1067646,124,194,13,331
"67647",1067647,90,163,13,266
"67648",1067648,22,14,0,36
"67649",1067649,63,29,8,100
"67650",1067650,107,39,11,157
"67651",1067651,83,30,8,121
"67652",1067652,42,23,3,68
"67653",1067653,183,87,2,272
"67654",1067654,167,67,12,246
"67655",1067655,99,71,6,176
"67656",1067656,109,151,8,268
"67657",1067657,196,55,16,267
"67658",1067658,140,28,5,173
"67659",1067659,155,21,6,182
"67660",1067660,67,210,10,287
"67661",1067661,192,65,11,268
"67662",1067662,51,278,8,337
"67663",1067663,73,213,10,296
"67664",1067664,45,134,8,187
"67665",1067665,94,135,9,238
"67666",1067666,39,258,4,301
"67667",1067667,162,98,6,266
"67668",1067668,51,137,16,204
"67669",1067669,32,102,5,139
"67670",1067670,75,82,15,172
"67671",1067671,191,24,8,223
"67672",1067672,51,64,6,121
"67673",1067673,94,117,7,218
"67674",1067674,71,17,3,91
"67675",1067675,227,81,5,313
"67676",1067676,205,10,9,224
"67677",1067677,104,151,14,269
"67678",1067678,124,129,10,263
"67679",1067679,81,211,4,296
"67680",1067680,45,19,3,67
"67681",1067681,48,172,2,222
"67682",1067682,79,195,15,289
"67683",1067683,202,63,11,276
"67684",1067684,77,10,1,88
"67685",1067685,45,10,1,56
"67686",1067686,80,74,5,159
"67687",1067687,55,316,6,377
"67688",1067688,41,31,5,77
"67689",1067689,38,18,4,60
"67690",1067690,221,18,8,247
"67691",1067691,86,155,5,246
"67692",1067692,29,96,5,130
"67693",1067693,141,78,9,228
"67694",1067694,116,171,17,304
"67695",1067695,70,229,1,300
"67696",1067696,8,27,0,35
"67697",1067697,205,105,16,326
"67698",1067698,125,115,0,240
"67699",1067699,63,198,21,282
"67700",1067700,154,100,6,260
"67701",1067701,40,152,15,207
"67702",1067702,2,8,2,12
"67703",1067703,134,21,3,158
"67704",1067704,5,2,0,7
"67705",1067705,113,105,14,232
"67706",1067706,66,183,16,265
"67707",1067707,61,78,8,147
"67708",1067708,56,43,2,101
"67709",1067709,112,34,5,151
"67710",1067710,69,277,2,348
"67711",1067711,43,44,4,91
"67712",1067712,212,60,6,278
"67713",1067713,41,162,5,208
"67714",1067714,211,99,13,323
"67715",1067715,20,106,1,127
"67716",1067716,148,119,19,286
"67717",1067717,236,18,3,257
"67718",1067718,73,160,17,250
"67719",1067719,213,54,13,280
"67720",1067720,38,120,10,168
"67721",1067721,120,80,12,212
"67722",1067722,74,112,4,190
"67723",1067723,106,69,4,179
"67724",1067724,55,215,10,280
"67725",1067725,168,106,8,282
"67726",1067726,94,165,19,278
"67727",1067727,127,38,8,173
"67728",1067728,162,63,4,229
"67729",1067729,47,236,1,284
"67730",1067730,147,52,6,205
"67731",1067731,14,11,0,25
"67732",1067732,46,149,7,202
"67733",1067733,119,80,13,212
"67734",1067734,141,62,10,213
"67735",1067735,67,135,5,207
"67736",1067736,107,50,2,159
"67737",1067737,169,63,2,234
"67738",1067738,72,54,0,126
"67739",1067739,217,52,3,272
"67740",1067740,179,76,11,266
"67741",1067741,33,83,7,123
"67742",1067742,138,43,10,191
"67743",1067743,72,179,8,259
"67744",1067744,187,46,8,241
"67745",1067745,32,112,2,146
"67746",1067746,48,287,12,347
"67747",1067747,112,100,17,229
"67748",1067748,161,144,3,308
"67749",1067749,220,17,5,242
"67750",1067750,31,163,10,204
"67751",1067751,222,50,6,278
"67752",1067752,147,55,5,207
"67753",1067753,166,24,6,196
"67754",1067754,149,41,7,197
"67755",1067755,148,89,3,240
"67756",1067756,20,235,4,259
"67757",1067757,90,48,10,148
"67758",1067758,55,168,7,230
"67759",1067759,42,212,1,255
"67760",1067760,29,175,6,210
"67761",1067761,90,160,16,266
"67762",1067762,160,54,19,233
"67763",1067763,144,36,1,181
"67764",1067764,161,48,5,214
"67765",1067765,44,168,6,218
"67766",1067766,116,127,9,252
"67767",1067767,185,45,7,237
"67768",1067768,121,6,5,132
"67769",1067769,197,64,24,285
"67770",1067770,54,257,5,316
"67771",1067771,197,66,2,265
"67772",1067772,94,20,1,115
"67773",1067773,169,79,6,254
"67774",1067774,15,102,10,127
"67775",1067775,168,46,12,226
"67776",1067776,122,40,12,174
"67777",1067777,116,133,9,258
"67778",1067778,255,62,13,330
"67779",1067779,28,162,5,195
"67780",1067780,131,38,5,174
"67781",1067781,177,73,9,259
"67782",1067782,34,265,5,304
"67783",1067783,40,40,4,84
"67784",1067784,119,143,9,271
"67785",1067785,104,168,10,282
"67786",1067786,31,123,1,155
"67787",1067787,196,29,7,232
"67788",1067788,75,34,3,112
"67789",1067789,130,179,7,316
"67790",1067790,87,230,14,331
"67791",1067791,93,61,4,158
"67792",1067792,146,90,11,247
"67793",1067793,219,14,7,240
"67794",1067794,137,62,5,204
"67795",1067795,100,165,11,276
"67796",1067796,174,77,16,267
"67797",1067797,134,105,10,249
"67798",1067798,22,178,14,214
"67799",1067799,105,74,9,188
"67800",1067800,179,50,4,233
"67801",1067801,144,21,4,169
"67802",1067802,80,169,9,258
"67803",1067803,43,90,2,135
"67804",1067804,67,185,11,263
"67805",1067805,77,32,4,113
"67806",1067806,154,133,7,294
"67807",1067807,130,164,10,304
"67808",1067808,153,68,3,224
"67809",1067809,31,46,0,77
"67810",1067810,95,146,9,250
"67811",1067811,65,175,5,245
"67812",1067812,47,188,9,244
"67813",1067813,135,82,9,226
"67814",1067814,189,98,8,295
"67815",1067815,125,158,4,287
"67816",1067816,151,109,10,270
"67817",1067817,161,79,7,247
"67818",1067818,65,92,7,164
"67819",1067819,168,72,5,245
"67820",1067820,177,92,3,272
"67821",1067821,169,30,10,209
"67822",1067822,31,6,0,37
"67823",1067823,40,249,7,296
"67824",1067824,187,102,10,299
"67825",1067825,70,165,10,245
"67826",1067826,160,68,6,234
"67827",1067827,89,138,15,242
"67828",1067828,194,56,14,264
"67829",1067829,179,127,10,316
"67830",1067830,190,53,18,261
"67831",1067831,182,102,7,291
"67832",1067832,79,267,5,351
"67833",1067833,192,115,17,324
"67834",1067834,19,41,3,63
"67835",1067835,171,16,5,192
"67836",1067836,118,90,14,222
"67837",1067837,114,102,14,230
"67838",1067838,242,40,9,291
"67839",1067839,34,84,5,123
"67840",1067840,93,210,5,308
"67841",1067841,113,204,14,331
"67842",1067842,98,143,16,257
"67843",1067843,154,35,6,195
"67844",1067844,175,112,22,309
"67845",1067845,70,81,11,162
"67846",1067846,169,70,5,244
"67847",1067847,224,23,10,257
"67848",1067848,44,124,10,178
"67849",1067849,166,65,7,238
"67850",1067850,176,96,14,286
"67851",1067851,118,78,3,199
"67852",1067852,129,160,8,297
"67853",1067853,8,3,0,11
"67854",1067854,160,89,5,254
"67855",1067855,104,52,7,163
"67856",1067856,33,141,3,177
"67857",1067857,180,55,12,247
"67858",1067858,146,26,1,173
"67859",1067859,180,84,12,276
"67860",1067860,94,93,6,193
"67861",1067861,82,223,0,305
"67862",1067862,124,37,5,166
"67863",1067863,111,156,10,277
"67864",1067864,106,3,4,113
"67865",1067865,45,198,6,249
"67866",1067866,145,83,10,238
"67867",1067867,136,55,13,204
"67868",1067868,36,162,4,202
"67869",1067869,127,54,5,186
"67870",1067870,163,71,8,242
"67871",1067871,82,232,3,317
"67872",1067872,98,73,15,186
"67873",1067873,141,69,4,214
"67874",1067874,33,15,3,51
"67875",1067875,101,125,29,255
"67876",1067876,75,84,8,167
"67877",1067877,179,61,12,252
"67878",1067878,137,80,12,229
"67879",1067879,39,209,6,254
"67880",1067880,177,120,12,309
"67881",1067881,52,95,10,157
"67882",1067882,11,215,5,231
"67883",1067883,241,29,3,273
"67884",1067884,107,158,13,278
"67885",1067885,3,34,0,37
"67886",1067886,80,176,4,260
"67887",1067887,94,183,6,283
"67888",1067888,142,180,10,332
"67889",1067889,17,338,6,361
"67890",1067890,81,226,7,314
"67891",1067891,216,80,11,307
"67892",1067892,196,92,20,308
"67893",1067893,213,54,11,278
"67894",1067894,145,11,5,161
"67895",1067895,37,220,3,260
"67896",1067896,219,60,23,302
"67897",1067897,44,115,13,172
"67898",1067898,206,47,5,258
"67899",1067899,99,141,8,248
"67900",1067900,70,30,10,110
"67901",1067901,169,122,12,303
"67902",1067902,135,18,4,157
"67903",1067903,75,78,7,160
"67904",1067904,105,64,4,173
"67905",1067905,135,74,12,221
"67906",1067906,10,9,1,20
"67907",1067907,102,36,3,141
"67908",1067908,188,116,21,325
"67909",1067909,18,23,2,43
"67910",1067910,82,216,17,315
"67911",1067911,136,118,4,258
"67912",1067912,68,162,15,245
"67913",1067913,173,21,3,197
"67914",1067914,39,167,5,211
"67915",1067915,209,61,14,284
"67916",1067916,163,97,16,276
"67917",1067917,40,192,5,237
"67918",1067918,60,153,14,227
"67919",1067919,156,99,7,262
"67920",1067920,211,66,5,282
"67921",1067921,28,35,0,63
"67922",1067922,238,24,7,269
"67923",1067923,76,173,16,265
"67924",1067924,187,46,13,246
"67925",1067925,35,10,0,45
"67926",1067926,143,43,6,192
"67927",1067927,69,266,5,340
"67928",1067928,68,190,15,273
"67929",1067929,111,16,2,129
"67930",1067930,117,110,3,230
"67931",1067931,149,155,18,322
"67932",1067932,63,144,10,217
"67933",1067933,73,156,3,232
"67934",1067934,169,81,9,259
"67935",1067935,175,58,11,244
"67936",1067936,140,2,1,143
"67937",1067937,54,82,5,141
"67938",1067938,165,73,10,248
"67939",1067939,17,50,0,67
"67940",1067940,151,41,4,196
"67941",1067941,36,84,0,120
"67942",1067942,20,7,4,31
"67943",1067943,141,9,5,155
"67944",1067944,102,54,11,167
"67945",1067945,47,206,4,257
"67946",1067946,189,111,19,319
"67947",1067947,42,173,8,223
"67948",1067948,108,21,7,136
"67949",1067949,64,128,5,197
"67950",1067950,72,107,3,182
"67951",1067951,154,146,3,303
"67952",1067952,12,7,4,23
"67953",1067953,4,6,2,12
"67954",1067954,182,64,6,252
"67955",1067955,144,150,18,312
"67956",1067956,95,87,2,184
"67957",1067957,115,133,13,261
"67958",1067958,122,115,9,246
"67959",1067959,65,20,1,86
"67960",1067960,73,153,8,234
"67961",1067961,192,91,11,294
"67962",1067962,13,14,0,27
"67963",1067963,28,95,3,126
"67964",1067964,43,149,3,195
"67965",1067965,26,4,0,30
"67966",1067966,42,5,2,49
"67967",1067967,133,179,11,323
"67968",1067968,189,82,1,272
"67969",1067969,128,91,8,227
"67970",1067970,93,70,7,170
"67971",1067971,53,157,4,214
"67972",1067972,41,237,0,278
"67973",1067973,163,84,4,251
"67974",1067974,32,10,2,44
"67975",1067975,72,219,2,293
"67976",1067976,170,137,21,328
"67977",1067977,56,200,10,266
"67978",1067978,91,173,20,284
"67979",1067979,89,120,5,214
"67980",1067980,187,132,3,322
"67981",1067981,150,15,4,169
"67982",1067982,129,89,16,234
"67983",1067983,185,132,13,330
"67984",1067984,150,20,5,175
"67985",1067985,111,28,3,142
"67986",1067986,160,54,9,223
"67987",1067987,111,142,4,257
"67988",1067988,195,78,18,291
"67989",1067989,164,56,14,234
"67990",1067990,174,34,4,212
"67991",1067991,61,26,3,90
"67992",1067992,92,62,4,158
"67993",1067993,132,21,7,160
"67994",1067994,94,74,11,179
"67995",1067995,187,73,8,268
"67996",1067996,113,90,10,213
"67997",1067997,121,12,2,135
"67998",1067998,50,189,15,254
"67999",1067999,69,110,10,189
"68000",1068000,42,224,2,268
"68001",1068001,157,40,3,200
"68002",1068002,80,105,17,202
"68003",1068003,62,31,6,99
"68004",1068004,172,52,6,230
"68005",1068005,45,207,13,265
"68006",1068006,76,42,7,125
"68007",1068007,107,118,9,234
"68008",1068008,209,68,15,292
"68009",1068009,81,183,6,270
"68010",1068010,155,55,16,226
"68011",1068011,9,15,0,24
"68012",1068012,102,159,25,286
"68013",1068013,24,124,10,158
"68014",1068014,113,123,4,240
"68015",1068015,18,78,3,99
"68016",1068016,47,49,7,103
"68017",1068017,104,167,16,287
"68018",1068018,61,20,3,84
"68019",1068019,85,110,6,201
"68020",1068020,174,77,8,259
"68021",1068021,165,91,7,263
"68022",1068022,144,45,26,215
"68023",1068023,77,163,10,250
"68024",1068024,169,76,14,259
"68025",1068025,16,2,1,19
"68026",1068026,216,102,29,347
"68027",1068027,99,150,17,266
"68028",1068028,149,122,6,277
"68029",1068029,159,13,0,172
"68030",1068030,62,101,5,168
"68031",1068031,261,20,5,286
"68032",1068032,46,218,8,272
"68033",1068033,191,63,14,268
"68034",1068034,204,27,4,235
"68035",1068035,199,59,7,265
"68036",1068036,93,42,6,141
"68037",1068037,109,109,15,233
"68038",1068038,285,38,11,334
"68039",1068039,28,8,2,38
"68040",1068040,69,207,6,282
"68041",1068041,147,64,10,221
"68042",1068042,198,72,19,289
"68043",1068043,18,177,1,196
"68044",1068044,132,61,11,204
"68045",1068045,54,117,7,178
"68046",1068046,13,4,1,18
"68047",1068047,111,145,12,268
"68048",1068048,56,54,5,115
"68049",1068049,38,127,8,173
"68050",1068050,72,96,4,172
"68051",1068051,131,109,6,246
"68052",1068052,161,84,10,255
"68053",1068053,41,31,2,74
"68054",1068054,127,24,6,157
"68055",1068055,66,225,6,297
"68056",1068056,164,29,8,201
"68057",1068057,123,131,9,263
"68058",1068058,233,38,12,283
"68059",1068059,88,182,10,280
"68060",1068060,105,34,2,141
"68061",1068061,116,93,15,224
"68062",1068062,113,71,4,188
"68063",1068063,82,127,4,213
"68064",1068064,84,1,0,85
"68065",1068065,102,149,8,259
"68066",1068066,64,14,6,84
"68067",1068067,13,25,1,39
"68068",1068068,121,93,2,216
"68069",1068069,102,166,14,282
"68070",1068070,117,51,6,174
"68071",1068071,129,86,8,223
"68072",1068072,10,11,0,21
"68073",1068073,116,20,3,139
"68074",1068074,54,254,8,316
"68075",1068075,121,90,15,226
"68076",1068076,168,72,6,246
"68077",1068077,89,81,13,183
"68078",1068078,54,102,4,160
"68079",1068079,64,199,4,267
"68080",1068080,74,207,14,295
"68081",1068081,43,204,4,251
"68082",1068082,169,128,8,305
"68083",1068083,129,89,15,233
"68084",1068084,91,152,2,245
"68085",1068085,116,91,11,218
"68086",1068086,6,2,0,8
"68087",1068087,19,149,3,171
"68088",1068088,87,97,3,187
"68089",1068089,137,71,10,218
"68090",1068090,96,207,8,311
"68091",1068091,207,12,6,225
"68092",1068092,124,77,15,216
"68093",1068093,113,140,12,265
"68094",1068094,88,22,4,114
"68095",1068095,111,185,19,315
"68096",1068096,128,19,3,150
"68097",1068097,104,115,4,223
"68098",1068098,218,77,14,309
"68099",1068099,107,135,11,253
"68100",1068100,89,62,9,160
"68101",1068101,151,108,16,275
"68102",1068102,92,77,1,170
"68103",1068103,193,48,3,244
"68104",1068104,76,165,5,246
"68105",1068105,218,19,6,243
"68106",1068106,203,7,8,218
"68107",1068107,90,40,6,136
"68108",1068108,86,30,1,117
"68109",1068109,60,60,7,127
"68110",1068110,165,87,14,266
"68111",1068111,133,70,4,207
"68112",1068112,98,20,4,122
"68113",1068113,42,191,2,235
"68114",1068114,194,92,10,296
"68115",1068115,62,144,10,216
"68116",1068116,178,24,7,209
"68117",1068117,76,184,9,269
"68118",1068118,65,1,0,66
"68119",1068119,108,287,26,421
"68120",1068120,155,34,6,195
"68121",1068121,31,209,2,242
"68122",1068122,221,54,9,284
"68123",1068123,5,51,2,58
"68124",1068124,117,200,6,323
"68125",1068125,248,71,11,330
"68126",1068126,77,34,8,119
"68127",1068127,92,204,13,309
"68128",1068128,69,161,4,234
"68129",1068129,143,91,7,241
"68130",1068130,156,88,11,255
"68131",1068131,149,99,12,260
"68132",1068132,70,123,9,202
"68133",1068133,139,68,13,220
"68134",1068134,146,16,2,164
"68135",1068135,57,186,6,249
"68136",1068136,67,107,2,176
"68137",1068137,127,145,4,276
"68138",1068138,94,96,7,197
"68139",1068139,100,132,28,260
"68140",1068140,26,90,1,117
"68141",1068141,40,216,4,260
"68142",1068142,198,22,4,224
"68143",1068143,63,1,0,64
"68144",1068144,14,251,4,269
"68145",1068145,164,114,5,283
"68146",1068146,129,55,6,190
"68147",1068147,107,105,10,222
"68148",1068148,57,169,19,245
"68149",1068149,162,18,6,186
"68150",1068150,209,52,13,274
"68151",1068151,185,77,7,269
"68152",1068152,55,159,14,228
"68153",1068153,142,30,1,173
"68154",1068154,60,201,19,280
"68155",1068155,273,20,9,302
"68156",1068156,25,219,4,248
"68157",1068157,120,54,3,177
"68158",1068158,64,219,12,295
"68159",1068159,127,68,7,202
"68160",1068160,57,122,4,183
"68161",1068161,60,36,5,101
"68162",1068162,53,249,6,308
"68163",1068163,186,76,13,275
"68164",1068164,54,247,3,304
"68165",1068165,85,114,10,209
"68166",1068166,238,46,15,299
"68167",1068167,136,170,12,318
"68168",1068168,134,70,16,220
"68169",1068169,7,9,1,17
"68170",1068170,136,136,12,284
"68171",1068171,135,1,0,136
"68172",1068172,115,171,10,296
"68173",1068173,25,55,2,82
"68174",1068174,75,166,17,258
"68175",1068175,121,144,7,272
"68176",1068176,138,62,9,209
"68177",1068177,161,23,1,185
"68178",1068178,142,168,18,328
"68179",1068179,14,136,5,155
"68180",1068180,139,72,23,234
"68181",1068181,25,11,2,38
"68182",1068182,34,21,3,58
"68183",1068183,58,252,2,312
"68184",1068184,127,133,16,276
"68185",1068185,153,128,32,313
"68186",1068186,6,4,0,10
"68187",1068187,212,94,16,322
"68188",1068188,70,168,7,245
"68189",1068189,264,0,3,267
"68190",1068190,82,156,7,245
"68191",1068191,107,35,5,147
"68192",1068192,142,57,15,214
"68193",1068193,192,17,10,219
"68194",1068194,41,201,8,250
"68195",1068195,16,83,3,102
"68196",1068196,138,161,11,310
"68197",1068197,83,99,19,201
"68198",1068198,221,17,3,241
"68199",1068199,134,120,7,261
"68200",1068200,181,88,14,283
"68201",1068201,42,143,3,188
"68202",1068202,155,112,6,273
"68203",1068203,185,37,4,226
"68204",1068204,163,95,1,259
"68205",1068205,267,36,11,314
"68206",1068206,35,191,2,228
"68207",1068207,47,40,3,90
"68208",1068208,76,111,6,193
"68209",1068209,88,8,1,97
"68210",1068210,2,41,2,45
"68211",1068211,171,106,16,293
"68212",1068212,215,57,3,275
"68213",1068213,115,104,9,228
"68214",1068214,109,53,5,167
"68215",1068215,105,59,12,176
"68216",1068216,40,6,0,46
"68217",1068217,146,112,8,266
"68218",1068218,8,2,0,10
"68219",1068219,181,40,5,226
"68220",1068220,126,124,7,257
"68221",1068221,71,108,8,187
"68222",1068222,124,200,19,343
"68223",1068223,93,92,9,194
"68224",1068224,144,52,16,212
"68225",1068225,141,41,3,185
"68226",1068226,108,34,6,148
"68227",1068227,145,83,12,240
"68228",1068228,165,49,12,226
"68229",1068229,116,176,14,306
"68230",1068230,139,92,6,237
"68231",1068231,60,166,5,231
"68232",1068232,140,168,22,330
"68233",1068233,180,90,10,280
"68234",1068234,181,101,6,288
"68235",1068235,113,107,13,233
"68236",1068236,145,109,16,270
"68237",1068237,177,140,14,331
"68238",1068238,128,5,7,140
"68239",1068239,137,68,10,215
"68240",1068240,84,106,7,197
"68241",1068241,117,41,5,163
"68242",1068242,55,127,5,187
"68243",1068243,140,49,5,194
"68244",1068244,93,92,26,211
"68245",1068245,135,30,10,175
"68246",1068246,161,176,11,348
"68247",1068247,69,147,18,234
"68248",1068248,212,66,17,295
"68249",1068249,259,24,3,286
"68250",1068250,114,125,7,246
"68251",1068251,30,189,6,225
"68252",1068252,73,77,3,153
"68253",1068253,217,62,21,300
"68254",1068254,38,3,5,46
"68255",1068255,74,201,9,284
"68256",1068256,72,155,17,244
"68257",1068257,7,45,4,56
"68258",1068258,144,17,3,164
"68259",1068259,105,155,9,269
"68260",1068260,96,53,8,157
"68261",1068261,130,120,14,264
"68262",1068262,13,196,4,213
"68263",1068263,52,218,9,279
"68264",1068264,132,27,3,162
"68265",1068265,92,185,9,286
"68266",1068266,90,95,13,198
"68267",1068267,187,68,15,270
"68268",1068268,166,24,2,192
"68269",1068269,56,201,12,269
"68270",1068270,173,123,10,306
"68271",1068271,111,53,9,173
"68272",1068272,132,49,3,184
"68273",1068273,32,15,5,52
"68274",1068274,127,84,1,212
"68275",1068275,82,237,11,330
"68276",1068276,98,238,3,339
"68277",1068277,29,277,7,313
"68278",1068278,46,233,18,297
"68279",1068279,131,104,8,243
"68280",1068280,134,125,9,268
"68281",1068281,87,101,7,195
"68282",1068282,60,4,0,64
"68283",1068283,186,35,3,224
"68284",1068284,64,145,20,229
"68285",1068285,145,55,6,206
"68286",1068286,45,8,0,53
"68287",1068287,108,97,4,209
"68288",1068288,105,89,2,196
"68289",1068289,65,189,4,258
"68290",1068290,80,142,13,235
"68291",1068291,220,78,3,301
"68292",1068292,162,33,14,209
"68293",1068293,21,91,0,112
"68294",1068294,152,44,5,201
"68295",1068295,71,213,5,289
"68296",1068296,53,219,6,278
"68297",1068297,104,201,14,319
"68298",1068298,164,90,10,264
"68299",1068299,190,94,3,287
"68300",1068300,124,129,10,263
"68301",1068301,223,51,11,285
"68302",1068302,190,3,4,197
"68303",1068303,15,173,7,195
"68304",1068304,32,38,2,72
"68305",1068305,196,99,10,305
"68306",1068306,55,254,3,312
"68307",1068307,108,129,29,266
"68308",1068308,131,8,5,144
"68309",1068309,162,79,5,246
"68310",1068310,27,203,3,233
"68311",1068311,147,39,13,199
"68312",1068312,119,155,5,279
"68313",1068313,123,118,5,246
"68314",1068314,134,98,9,241
"68315",1068315,155,57,11,223
"68316",1068316,78,196,12,286
"68317",1068317,101,116,6,223
"68318",1068318,80,105,7,192
"68319",1068319,61,210,4,275
"68320",1068320,104,200,10,314
"68321",1068321,50,230,8,288
"68322",1068322,110,46,7,163
"68323",1068323,49,116,6,171
"68324",1068324,108,76,2,186
"68325",1068325,71,194,5,270
"68326",1068326,52,74,12,138
"68327",1068327,154,32,10,196
"68328",1068328,196,81,6,283
"68329",1068329,188,42,3,233
"68330",1068330,119,136,11,266
"68331",1068331,85,13,2,100
"68332",1068332,238,48,5,291
"68333",1068333,238,58,8,304
"68334",1068334,169,19,9,197
"68335",1068335,49,29,1,79
"68336",1068336,106,21,6,133
"68337",1068337,83,173,5,261
"68338",1068338,108,186,9,303
"68339",1068339,143,72,1,216
"68340",1068340,85,84,10,179
"68341",1068341,117,83,11,211
"68342",1068342,30,270,8,308
"68343",1068343,167,124,24,315
"68344",1068344,45,186,7,238
"68345",1068345,73,124,9,206
"68346",1068346,59,186,9,254
"68347",1068347,170,129,20,319
"68348",1068348,165,27,5,197
"68349",1068349,68,156,11,235
"68350",1068350,134,63,13,210
"68351",1068351,145,152,11,308
"68352",1068352,139,119,2,260
"68353",1068353,252,0,0,252
"68354",1068354,13,214,5,232
"68355",1068355,156,76,5,237
"68356",1068356,228,18,6,252
"68357",1068357,212,29,7,248
"68358",1068358,111,94,9,214
"68359",1068359,125,14,5,144
"68360",1068360,201,21,9,231
"68361",1068361,65,209,9,283
"68362",1068362,192,85,8,285
"68363",1068363,137,67,7,211
"68364",1068364,145,87,8,240
"68365",1068365,119,56,2,177
"68366",1068366,15,66,1,82
"68367",1068367,117,53,16,186
"68368",1068368,136,86,11,233
"68369",1068369,105,183,11,299
"68370",1068370,130,98,9,237
"68371",1068371,90,108,2,200
"68372",1068372,128,126,15,269
"68373",1068373,145,30,9,184
"68374",1068374,125,203,5,333
"68375",1068375,53,164,2,219
"68376",1068376,53,157,5,215
"68377",1068377,70,107,14,191
"68378",1068378,165,103,23,291
"68379",1068379,86,175,2,263
"68380",1068380,154,116,14,284
"68381",1068381,186,112,29,327
"68382",1068382,198,27,5,230
"68383",1068383,159,75,3,237
"68384",1068384,27,285,9,321
"68385",1068385,121,67,6,194
"68386",1068386,190,34,5,229
"68387",1068387,185,7,3,195
"68388",1068388,157,54,8,219
"68389",1068389,44,26,0,70
"68390",1068390,121,149,14,284
"68391",1068391,80,252,8,340
"68392",1068392,77,135,6,218
"68393",1068393,246,5,5,256
"68394",1068394,153,76,5,234
"68395",1068395,42,159,3,204
"68396",1068396,122,175,12,309
"68397",1068397,61,14,2,77
"68398",1068398,149,68,5,222
"68399",1068399,92,0,0,92
"68400",1068400,20,196,2,218
"68401",1068401,35,144,4,183
"68402",1068402,65,119,3,187
"68403",1068403,8,13,2,23
"68404",1068404,214,28,16,258
"68405",1068405,180,18,4,202
"68406",1068406,66,192,10,268
"68407",1068407,41,232,9,282
"68408",1068408,76,234,7,317
"68409",1068409,106,121,2,229
"68410",1068410,95,141,12,248
"68411",1068411,116,50,4,170
"68412",1068412,25,254,2,281
"68413",1068413,82,106,5,193
"68414",1068414,198,85,25,308
"68415",1068415,27,22,4,53
"68416",1068416,139,90,12,241
"68417",1068417,0,0,0,0
"68418",1068418,85,171,9,265
"68419",1068419,42,23,2,67
"68420",1068420,206,34,5,245
"68421",1068421,44,190,12,246
"68422",1068422,79,122,6,207
"68423",1068423,43,99,5,147
"68424",1068424,117,78,8,203
"68425",1068425,169,129,17,315
"68426",1068426,166,88,8,262
"68427",1068427,265,70,10,345
"68428",1068428,264,31,4,299
"68429",1068429,68,129,8,205
"68430",1068430,127,25,5,157
"68431",1068431,61,134,2,197
"68432",1068432,115,158,14,287
"68433",1068433,6,229,4,239
"68434",1068434,59,38,6,103
"68435",1068435,14,37,2,53
"68436",1068436,120,48,2,170
"68437",1068437,75,176,11,262
"68438",1068438,115,60,4,179
"68439",1068439,99,157,5,261
"68440",1068440,202,24,7,233
"68441",1068441,169,10,2,181
"68442",1068442,34,231,1,266
"68443",1068443,50,197,10,257
"68444",1068444,79,114,9,202
"68445",1068445,48,242,8,298
"68446",1068446,106,51,11,168
"68447",1068447,117,26,9,152
"68448",1068448,65,28,10,103
"68449",1068449,136,106,5,247
"68450",1068450,54,185,10,249
"68451",1068451,173,108,6,287
"68452",1068452,26,29,3,58
"68453",1068453,154,80,13,247
"68454",1068454,156,131,25,312
"68455",1068455,84,181,4,269
"68456",1068456,145,128,12,285
"68457",1068457,127,90,5,222
"68458",1068458,169,67,8,244
"68459",1068459,50,156,5,211
"68460",1068460,191,53,7,251
"68461",1068461,150,46,12,208
"68462",1068462,21,37,2,60
"68463",1068463,143,94,9,246
"68464",1068464,165,82,19,266
"68465",1068465,38,49,2,89
"68466",1068466,99,109,17,225
"68467",1068467,12,203,5,220
"68468",1068468,172,82,12,266
"68469",1068469,43,187,4,234
"68470",1068470,172,68,10,250
"68471",1068471,175,60,4,239
"68472",1068472,21,123,4,148
"68473",1068473,131,146,15,292
"68474",1068474,117,47,3,167
"68475",1068475,97,106,5,208
"68476",1068476,63,158,10,231
"68477",1068477,70,183,9,262
"68478",1068478,106,22,3,131
"68479",1068479,13,181,6,200
"68480",1068480,21,54,3,78
"68481",1068481,149,103,9,261
"68482",1068482,104,81,7,192
"68483",1068483,96,131,7,234
"68484",1068484,152,7,3,162
"68485",1068485,94,9,5,108
"68486",1068486,57,241,8,306
"68487",1068487,70,157,4,231
"68488",1068488,206,4,4,214
"68489",1068489,112,61,6,179
"68490",1068490,152,52,7,211
"68491",1068491,164,10,6,180
"68492",1068492,148,155,16,319
"68493",1068493,123,156,12,291
"68494",1068494,2,86,0,88
"68495",1068495,37,162,6,205
"68496",1068496,78,201,3,282
"68497",1068497,151,43,2,196
"68498",1068498,90,184,18,292
"68499",1068499,119,99,21,239
"68500",1068500,128,90,13,231
"68501",1068501,34,206,1,241
"68502",1068502,56,199,8,263
"68503",1068503,72,125,4,201
"68504",1068504,193,64,20,277
"68505",1068505,99,11,6,116
"68506",1068506,82,204,5,291
"68507",1068507,98,118,10,226
"68508",1068508,179,64,7,250
"68509",1068509,96,46,6,148
"68510",1068510,91,176,14,281
"68511",1068511,260,48,9,317
"68512",1068512,52,202,14,268
"68513",1068513,16,181,1,198
"68514",1068514,48,3,3,54
"68515",1068515,173,66,7,246
"68516",1068516,53,3,4,60
"68517",1068517,24,16,6,46
"68518",1068518,111,35,5,151
"68519",1068519,215,58,26,299
"68520",1068520,79,117,14,210
"68521",1068521,74,139,6,219
"68522",1068522,148,21,7,176
"68523",1068523,116,98,3,217
"68524",1068524,167,137,16,320
"68525",1068525,46,210,3,259
"68526",1068526,88,139,11,238
"68527",1068527,202,67,10,279
"68528",1068528,145,81,5,231
"68529",1068529,160,97,10,267
"68530",1068530,4,1,0,5
"68531",1068531,225,43,11,279
"68532",1068532,201,15,5,221
"68533",1068533,104,187,10,301
"68534",1068534,111,133,10,254
"68535",1068535,39,150,6,195
"68536",1068536,104,10,3,117
"68537",1068537,233,30,5,268
"68538",1068538,1,105,1,107
"68539",1068539,66,185,9,260
"68540",1068540,71,182,16,269
"68541",1068541,112,106,15,233
"68542",1068542,43,53,5,101
"68543",1068543,218,59,12,289
"68544",1068544,135,101,11,247
"68545",1068545,115,28,4,147
"68546",1068546,82,101,9,192
"68547",1068547,25,223,9,257
"68548",1068548,223,55,8,286
"68549",1068549,196,89,22,307
"68550",1068550,105,159,14,278
"68551",1068551,91,115,8,214
"68552",1068552,120,156,10,286
"68553",1068553,200,44,4,248
"68554",1068554,47,175,9,231
"68555",1068555,92,42,16,150
"68556",1068556,42,211,17,270
"68557",1068557,210,71,9,290
"68558",1068558,43,168,2,213
"68559",1068559,118,160,5,283
"68560",1068560,247,24,6,277
"68561",1068561,187,9,5,201
"68562",1068562,81,190,11,282
"68563",1068563,167,129,25,321
"68564",1068564,58,54,1,113
"68565",1068565,141,68,18,227
"68566",1068566,158,93,6,257
"68567",1068567,32,26,1,59
"68568",1068568,215,22,3,240
"68569",1068569,97,159,9,265
"68570",1068570,3,0,0,3
"68571",1068571,139,64,8,211
"68572",1068572,170,120,9,299
"68573",1068573,86,219,14,319
"68574",1068574,146,105,4,255
"68575",1068575,167,60,11,238
"68576",1068576,157,31,7,195
"68577",1068577,88,164,8,260
"68578",1068578,8,7,2,17
"68579",1068579,241,23,10,274
"68580",1068580,70,57,0,127
"68581",1068581,180,140,10,330
"68582",1068582,129,84,11,224
"68583",1068583,194,28,6,228
"68584",1068584,172,112,1,285
"68585",1068585,178,133,13,324
"68586",1068586,193,93,14,300
"68587",1068587,84,179,10,273
"68588",1068588,36,45,2,83
"68589",1068589,95,65,11,171
"68590",1068590,63,206,13,282
"68591",1068591,143,65,6,214
"68592",1068592,144,12,4,160
"68593",1068593,102,25,3,130
"68594",1068594,17,1,2,20
"68595",1068595,85,249,15,349
"68596",1068596,133,167,20,320
"68597",1068597,156,43,7,206
"68598",1068598,5,26,1,32
"68599",1068599,76,88,4,168
"68600",1068600,76,146,19,241
"68601",1068601,52,81,3,136
"68602",1068602,148,10,5,163
"68603",1068603,104,57,10,171
"68604",1068604,142,162,13,317
"68605",1068605,96,147,10,253
"68606",1068606,39,197,7,243
"68607",1068607,108,39,19,166
"68608",1068608,78,44,7,129
"68609",1068609,124,140,16,280
"68610",1068610,198,47,5,250
"68611",1068611,259,49,18,326
"68612",1068612,58,283,11,352
"68613",1068613,234,14,2,250
"68614",1068614,43,79,3,125
"68615",1068615,76,245,8,329
"68616",1068616,121,119,3,243
"68617",1068617,58,223,7,288
"68618",1068618,102,50,3,155
"68619",1068619,131,145,6,282
"68620",1068620,109,180,8,297
"68621",1068621,66,171,5,242
"68622",1068622,122,54,6,182
"68623",1068623,35,21,2,58
"68624",1068624,105,58,2,165
"68625",1068625,41,209,6,256
"68626",1068626,70,140,6,216
"68627",1068627,247,70,16,333
"68628",1068628,24,22,0,46
"68629",1068629,127,154,16,297
"68630",1068630,105,197,17,319
"68631",1068631,143,87,8,238
"68632",1068632,186,95,7,288
"68633",1068633,103,63,11,177
"68634",1068634,98,129,5,232
"68635",1068635,108,174,13,295
"68636",1068636,171,10,4,185
"68637",1068637,22,56,2,80
"68638",1068638,144,110,5,259
"68639",1068639,137,24,5,166
"68640",1068640,164,66,4,234
"68641",1068641,205,104,23,332
"68642",1068642,96,62,10,168
"68643",1068643,148,109,5,262
"68644",1068644,81,96,7,184
"68645",1068645,64,181,4,249
"68646",1068646,82,163,0,245
"68647",1068647,152,120,16,288
"68648",1068648,65,148,8,221
"68649",1068649,103,229,7,339
"68650",1068650,37,18,0,55
"68651",1068651,126,116,6,248
"68652",1068652,182,49,13,244
"68653",1068653,59,137,1,197
"68654",1068654,109,128,3,240
"68655",1068655,178,54,7,239
"68656",1068656,264,41,9,314
"68657",1068657,60,154,8,222
"68658",1068658,86,202,17,305
"68659",1068659,66,265,3,334
"68660",1068660,45,169,9,223
"68661",1068661,86,146,7,239
"68662",1068662,44,237,10,291
"68663",1068663,178,52,6,236
"68664",1068664,55,130,4,189
"68665",1068665,164,74,13,251
"68666",1068666,30,44,3,77
"68667",1068667,128,83,9,220
"68668",1068668,146,18,2,166
"68669",1068669,121,141,10,272
"68670",1068670,77,177,6,260
"68671",1068671,140,47,10,197
"68672",1068672,54,138,0,192
"68673",1068673,227,19,4,250
"68674",1068674,70,81,2,153
"68675",1068675,180,51,11,242
"68676",1068676,78,167,17,262
"68677",1068677,127,35,2,164
"68678",1068678,24,12,2,38
"68679",1068679,24,317,8,349
"68680",1068680,62,253,6,321
"68681",1068681,196,39,5,240
"68682",1068682,2,10,0,12
"68683",1068683,102,136,22,260
"68684",1068684,224,27,6,257
"68685",1068685,25,10,2,37
"68686",1068686,67,201,3,271
"68687",1068687,150,67,18,235
"68688",1068688,178,23,4,205
"68689",1068689,246,33,7,286
"68690",1068690,5,167,3,175
"68691",1068691,229,14,12,255
"68692",1068692,83,181,6,270
"68693",1068693,78,186,6,270
"68694",1068694,19,177,0,196
"68695",1068695,121,37,6,164
"68696",1068696,164,75,8,247
"68697",1068697,4,7,0,11
"68698",1068698,167,48,4,219
"68699",1068699,50,143,8,201
"68700",1068700,74,260,2,336
"68701",1068701,166,59,4,229
"68702",1068702,112,149,29,290
"68703",1068703,95,198,7,300
"68704",1068704,158,60,6,224
"68705",1068705,137,75,3,215
"68706",1068706,43,233,3,279
"68707",1068707,65,102,3,170
"68708",1068708,163,81,13,257
"68709",1068709,122,75,17,214
"68710",1068710,165,39,9,213
"68711",1068711,37,141,5,183
"68712",1068712,77,109,0,186
"68713",1068713,86,48,7,141
"68714",1068714,39,83,10,132
"68715",1068715,250,47,12,309
"68716",1068716,120,188,8,316
"68717",1068717,72,162,13,247
"68718",1068718,59,203,8,270
"68719",1068719,117,9,2,128
"68720",1068720,139,108,8,255
"68721",1068721,240,67,10,317
"68722",1068722,75,172,5,252
"68723",1068723,147,21,9,177
"68724",1068724,210,3,2,215
"68725",1068725,51,207,2,260
"68726",1068726,125,80,2,207
"68727",1068727,75,77,4,156
"68728",1068728,158,121,5,284
"68729",1068729,203,29,4,236
"68730",1068730,154,129,22,305
"68731",1068731,129,28,7,164
"68732",1068732,56,214,5,275
"68733",1068733,60,163,10,233
"68734",1068734,119,108,6,233
"68735",1068735,121,91,11,223
"68736",1068736,155,35,9,199
"68737",1068737,168,38,7,213
"68738",1068738,16,3,0,19
"68739",1068739,96,140,6,242
"68740",1068740,150,61,13,224
"68741",1068741,68,9,3,80
"68742",1068742,16,20,3,39
"68743",1068743,20,20,0,40
"68744",1068744,122,109,18,249
"68745",1068745,141,13,3,157
"68746",1068746,65,145,5,215
"68747",1068747,169,133,13,315
"68748",1068748,48,82,1,131
"68749",1068749,116,130,4,250
"68750",1068750,94,30,11,135
"68751",1068751,2,0,2,4
"68752",1068752,141,92,16,249
"68753",1068753,61,118,7,186
"68754",1068754,136,174,12,322
"68755",1068755,60,28,2,90
"68756",1068756,86,162,9,257
"68757",1068757,170,42,22,234
"68758",1068758,90,161,11,262
"68759",1068759,85,134,9,228
"68760",1068760,55,0,0,55
"68761",1068761,100,185,7,292
"68762",1068762,76,215,7,298
"68763",1068763,152,133,18,303
"68764",1068764,41,53,2,96
"68765",1068765,132,81,5,218
"68766",1068766,88,39,5,132
"68767",1068767,181,102,16,299
"68768",1068768,51,222,10,283
"68769",1068769,95,107,5,207
"68770",1068770,202,25,9,236
"68771",1068771,126,104,3,233
"68772",1068772,93,86,10,189
"68773",1068773,126,81,4,211
"68774",1068774,126,4,6,136
"68775",1068775,172,56,1,229
"68776",1068776,49,110,4,163
"68777",1068777,208,77,5,290
"68778",1068778,107,166,9,282
"68779",1068779,111,111,7,229
"68780",1068780,56,78,10,144
"68781",1068781,186,36,9,231
"68782",1068782,40,178,0,218
"68783",1068783,145,56,7,208
"68784",1068784,38,23,5,66
"68785",1068785,99,87,7,193
"68786",1068786,139,112,2,253
"68787",1068787,253,65,9,327
"68788",1068788,3,0,0,3
"68789",1068789,58,146,2,206
"68790",1068790,144,31,12,187
"68791",1068791,143,119,12,274
"68792",1068792,2,9,0,11
"68793",1068793,91,0,3,94
"68794",1068794,29,23,1,53
"68795",1068795,183,12,0,195
"68796",1068796,164,49,15,228
"68797",1068797,267,8,5,280
"68798",1068798,152,169,24,345
"68799",1068799,99,159,17,275
"68800",1068800,35,7,0,42
"68801",1068801,118,98,18,234
"68802",1068802,205,30,16,251
"68803",1068803,49,204,10,263
"68804",1068804,121,137,16,274
"68805",1068805,44,145,7,196
"68806",1068806,170,110,9,289
"68807",1068807,172,13,8,193
"68808",1068808,148,105,3,256
"68809",1068809,143,46,9,198
"68810",1068810,144,81,21,246
"68811",1068811,145,76,7,228
"68812",1068812,7,6,0,13
"68813",1068813,104,34,6,144
"68814",1068814,154,80,18,252
"68815",1068815,188,18,1,207
"68816",1068816,44,207,6,257
"68817",1068817,188,99,16,303
"68818",1068818,146,137,13,296
"68819",1068819,151,32,4,187
"68820",1068820,71,84,9,164
"68821",1068821,221,12,2,235
"68822",1068822,157,50,8,215
"68823",1068823,72,139,12,223
"68824",1068824,135,92,4,231
"68825",1068825,22,203,0,225
"68826",1068826,103,131,13,247
"68827",1068827,97,165,6,268
"68828",1068828,82,19,6,107
"68829",1068829,138,146,7,291
"68830",1068830,187,48,12,247
"68831",1068831,52,183,14,249
"68832",1068832,96,120,2,218
"68833",1068833,151,73,11,235
"68834",1068834,109,71,12,192
"68835",1068835,108,91,5,204
"68836",1068836,97,132,12,241
"68837",1068837,15,69,1,85
"68838",1068838,23,102,1,126
"68839",1068839,103,188,19,310
"68840",1068840,15,83,3,101
"68841",1068841,26,215,13,254
"68842",1068842,92,203,3,298
"68843",1068843,136,109,11,256
"68844",1068844,28,227,8,263
"68845",1068845,151,106,7,264
"68846",1068846,143,14,4,161
"68847",1068847,100,152,5,257
"68848",1068848,203,39,5,247
"68849",1068849,54,23,0,77
"68850",1068850,28,167,5,200
"68851",1068851,18,269,4,291
"68852",1068852,211,70,18,299
"68853",1068853,52,246,10,308
"68854",1068854,66,212,6,284
"68855",1068855,47,13,1,61
"68856",1068856,116,107,10,233
"68857",1068857,98,39,3,140
"68858",1068858,174,77,4,255
"68859",1068859,91,116,4,211
"68860",1068860,169,33,7,209
"68861",1068861,108,214,12,334
"68862",1068862,53,241,13,307
"68863",1068863,77,219,8,304
"68864",1068864,21,222,3,246
"68865",1068865,118,132,12,262
"68866",1068866,26,199,1,226
"68867",1068867,12,34,2,48
"68868",1068868,79,189,5,273
"68869",1068869,126,144,12,282
"68870",1068870,101,126,12,239
"68871",1068871,51,70,14,135
"68872",1068872,248,33,5,286
"68873",1068873,34,233,5,272
"68874",1068874,212,60,18,290
"68875",1068875,64,87,16,167
"68876",1068876,47,213,4,264
"68877",1068877,152,189,6,347
"68878",1068878,84,177,6,267
"68879",1068879,27,180,5,212
"68880",1068880,191,72,13,276
"68881",1068881,80,116,14,210
"68882",1068882,34,160,10,204
"68883",1068883,97,137,8,242
"68884",1068884,125,21,5,151
"68885",1068885,167,23,4,194
"68886",1068886,74,122,8,204
"68887",1068887,165,90,3,258
"68888",1068888,166,78,3,247
"68889",1068889,113,57,5,175
"68890",1068890,132,139,7,278
"68891",1068891,85,198,5,288
"68892",1068892,166,82,7,255
"68893",1068893,158,6,5,169
"68894",1068894,54,168,13,235
"68895",1068895,111,108,8,227
"68896",1068896,178,21,10,209
"68897",1068897,52,242,6,300
"68898",1068898,166,95,14,275
"68899",1068899,58,155,8,221
"68900",1068900,92,172,10,274
"68901",1068901,33,29,2,64
"68902",1068902,74,171,8,253
"68903",1068903,14,96,0,110
"68904",1068904,101,143,4,248
"68905",1068905,253,2,4,259
"68906",1068906,159,85,5,249
"68907",1068907,180,40,5,225
"68908",1068908,129,25,3,157
"68909",1068909,112,86,1,199
"68910",1068910,228,23,7,258
"68911",1068911,157,70,9,236
"68912",1068912,77,192,3,272
"68913",1068913,56,137,2,195
"68914",1068914,45,123,0,168
"68915",1068915,179,109,16,304
"68916",1068916,109,66,12,187
"68917",1068917,71,170,13,254
"68918",1068918,159,71,10,240
"68919",1068919,60,12,1,73
"68920",1068920,77,131,4,212
"68921",1068921,216,20,10,246
"68922",1068922,196,67,11,274
"68923",1068923,61,88,7,156
"68924",1068924,110,152,9,271
"68925",1068925,134,95,11,240
"68926",1068926,142,86,9,237
"68927",1068927,111,57,9,177
"68928",1068928,226,19,6,251
"68929",1068929,124,127,22,273
"68930",1068930,95,129,9,233
"68931",1068931,52,158,3,213
"68932",1068932,192,82,8,282
"68933",1068933,124,6,4,134
"68934",1068934,102,139,8,249
"68935",1068935,59,257,8,324
"68936",1068936,139,134,7,280
"68937",1068937,59,15,3,77
"68938",1068938,208,15,7,230
"68939",1068939,151,45,9,205
"68940",1068940,262,21,4,287
"68941",1068941,92,95,13,200
"68942",1068942,151,179,9,339
"68943",1068943,196,17,9,222
"68944",1068944,267,36,15,318
"68945",1068945,74,105,9,188
"68946",1068946,141,92,3,236
"68947",1068947,42,162,3,207
"68948",1068948,126,170,5,301
"68949",1068949,62,156,14,232
"68950",1068950,126,117,3,246
"68951",1068951,79,139,8,226
"68952",1068952,144,65,2,211
"68953",1068953,83,179,15,277
"68954",1068954,162,86,10,258
"68955",1068955,157,79,16,252
"68956",1068956,3,185,1,189
"68957",1068957,75,36,6,117
"68958",1068958,123,113,6,242
"68959",1068959,145,91,22,258
"68960",1068960,128,109,11,248
"68961",1068961,164,56,9,229
"68962",1068962,112,53,3,168
"68963",1068963,164,87,8,259
"68964",1068964,184,90,7,281
"68965",1068965,75,237,3,315
"68966",1068966,66,89,7,162
"68967",1068967,102,10,7,119
"68968",1068968,185,29,9,223
"68969",1068969,98,79,3,180
"68970",1068970,94,195,5,294
"68971",1068971,178,105,14,297
"68972",1068972,148,73,8,229
"68973",1068973,150,65,15,230
"68974",1068974,193,20,9,222
"68975",1068975,227,13,6,246
"68976",1068976,33,169,7,209
"68977",1068977,188,76,6,270
"68978",1068978,71,98,0,169
"68979",1068979,135,131,13,279
"68980",1068980,121,20,2,143
"68981",1068981,135,124,7,266
"68982",1068982,168,86,9,263
"68983",1068983,127,89,2,218
"68984",1068984,116,11,5,132
"68985",1068985,125,148,2,275
"68986",1068986,55,189,10,254
"68987",1068987,234,31,7,272
"68988",1068988,163,34,6,203
"68989",1068989,216,58,23,297
"68990",1068990,11,127,2,140
"68991",1068991,73,164,13,250
"68992",1068992,199,39,6,244
"68993",1068993,229,31,2,262
"68994",1068994,49,13,4,66
"68995",1068995,144,77,17,238
"68996",1068996,115,116,13,244
"68997",1068997,181,146,7,334
"68998",1068998,129,142,11,282
"68999",1068999,4,16,1,21
"69000",1069000,152,64,8,224
"69001",1069001,321,0,2,323
"69002",1069002,54,129,4,187
"69003",1069003,136,17,2,155
"69004",1069004,71,65,11,147
"69005",1069005,75,18,7,100
"69006",1069006,147,69,15,231
"69007",1069007,145,39,12,196
"69008",1069008,32,39,2,73
"69009",1069009,166,13,9,188
"69010",1069010,51,203,9,263
"69011",1069011,45,191,3,239
"69012",1069012,64,181,15,260
"69013",1069013,77,60,10,147
"69014",1069014,122,47,4,173
"69015",1069015,62,76,6,144
"69016",1069016,150,43,5,198
"69017",1069017,144,78,10,232
"69018",1069018,141,68,7,216
"69019",1069019,73,3,3,79
"69020",1069020,176,48,7,231
"69021",1069021,151,35,4,190
"69022",1069022,73,215,8,296
"69023",1069023,200,69,11,280
"69024",1069024,42,213,6,261
"69025",1069025,23,157,3,183
"69026",1069026,32,238,3,273
"69027",1069027,144,86,1,231
"69028",1069028,159,33,9,201
"69029",1069029,141,93,10,244
"69030",1069030,36,25,1,62
"69031",1069031,99,186,4,289
"69032",1069032,115,130,7,252
"69033",1069033,54,4,2,60
"69034",1069034,186,20,12,218
"69035",1069035,77,206,17,300
"69036",1069036,58,65,1,124
"69037",1069037,133,82,13,228
"69038",1069038,7,0,0,7
"69039",1069039,72,48,5,125
"69040",1069040,71,119,6,196
"69041",1069041,132,10,3,145
"69042",1069042,127,96,7,230
"69043",1069043,25,168,2,195
"69044",1069044,103,152,13,268
"69045",1069045,175,75,10,260
"69046",1069046,109,323,21,453
"69047",1069047,98,103,7,208
"69048",1069048,191,20,5,216
"69049",1069049,59,256,4,319
"69050",1069050,41,308,9,358
"69051",1069051,160,110,2,272
"69052",1069052,64,177,8,249
"69053",1069053,113,57,4,174
"69054",1069054,137,153,14,304
"69055",1069055,200,56,6,262
"69056",1069056,121,95,3,219
"69057",1069057,77,103,4,184
"69058",1069058,123,166,1,290
"69059",1069059,14,30,0,44
"69060",1069060,80,193,4,277
"69061",1069061,154,105,12,271
"69062",1069062,140,83,9,232
"69063",1069063,41,184,14,239
"69064",1069064,77,27,5,109
"69065",1069065,148,163,19,330
"69066",1069066,202,64,11,277
"69067",1069067,21,238,2,261
"69068",1069068,102,57,6,165
"69069",1069069,163,79,10,252
"69070",1069070,41,138,2,181
"69071",1069071,109,118,11,238
"69072",1069072,96,45,8,149
"69073",1069073,214,0,0,214
"69074",1069074,200,85,10,295
"69075",1069075,218,22,3,243
"69076",1069076,178,133,7,318
"69077",1069077,186,19,5,210
"69078",1069078,60,39,6,105
"69079",1069079,158,105,21,284
"69080",1069080,113,209,14,336
"69081",1069081,101,60,5,166
"69082",1069082,109,93,10,212
"69083",1069083,85,244,9,338
"69084",1069084,29,128,2,159
"69085",1069085,59,198,8,265
"69086",1069086,47,186,1,234
"69087",1069087,135,29,4,168
"69088",1069088,132,9,3,144
"69089",1069089,160,32,6,198
"69090",1069090,66,144,10,220
"69091",1069091,85,191,16,292
"69092",1069092,118,152,7,277
"69093",1069093,133,112,3,248
"69094",1069094,181,42,6,229
"69095",1069095,97,214,17,328
"69096",1069096,230,16,1,247
"69097",1069097,193,53,9,255
"69098",1069098,195,45,10,250
"69099",1069099,155,108,9,272
"69100",1069100,166,27,8,201
"69101",1069101,73,111,9,193
"69102",1069102,145,85,7,237
"69103",1069103,98,86,2,186
"69104",1069104,122,110,6,238
"69105",1069105,242,79,8,329
"69106",1069106,275,47,5,327
"69107",1069107,44,224,4,272
"69108",1069108,45,139,1,185
"69109",1069109,117,45,4,166
"69110",1069110,83,152,27,262
"69111",1069111,158,27,4,189
"69112",1069112,73,114,11,198
"69113",1069113,164,113,12,289
"69114",1069114,133,78,12,223
"69115",1069115,139,40,7,186
"69116",1069116,63,138,7,208
"69117",1069117,116,145,6,267
"69118",1069118,146,111,7,264
"69119",1069119,153,105,7,265
"69120",1069120,201,32,9,242
"69121",1069121,36,59,2,97
"69122",1069122,79,100,7,186
"69123",1069123,68,1,3,72
"69124",1069124,36,130,6,172
"69125",1069125,130,161,14,305
"69126",1069126,76,54,14,144
"69127",1069127,236,27,7,270
"69128",1069128,11,172,2,185
"69129",1069129,192,86,13,291
"69130",1069130,127,145,8,280
"69131",1069131,92,171,8,271
"69132",1069132,149,20,7,176
"69133",1069133,100,46,1,147
"69134",1069134,173,21,4,198
"69135",1069135,143,21,6,170
"69136",1069136,55,130,7,192
"69137",1069137,22,30,1,53
"69138",1069138,29,240,6,275
"69139",1069139,177,89,6,272
"69140",1069140,250,26,14,290
"69141",1069141,96,67,5,168
"69142",1069142,19,208,5,232
"69143",1069143,168,64,9,241
"69144",1069144,175,80,17,272
"69145",1069145,175,57,5,237
"69146",1069146,159,71,3,233
"69147",1069147,193,33,10,236
"69148",1069148,19,183,4,206
"69149",1069149,64,250,7,321
"69150",1069150,33,86,5,124
"69151",1069151,129,45,6,180
"69152",1069152,197,24,8,229
"69153",1069153,135,135,17,287
"69154",1069154,191,84,11,286
"69155",1069155,110,72,7,189
"69156",1069156,130,97,4,231
"69157",1069157,92,160,2,254
"69158",1069158,201,50,12,263
"69159",1069159,52,117,14,183
"69160",1069160,127,107,22,256
"69161",1069161,66,98,19,183
"69162",1069162,67,229,13,309
"69163",1069163,92,151,4,247
"69164",1069164,119,112,4,235
"69165",1069165,234,73,27,334
"69166",1069166,137,43,9,189
"69167",1069167,126,52,10,188
"69168",1069168,136,69,6,211
"69169",1069169,128,98,9,235
"69170",1069170,42,150,11,203
"69171",1069171,66,17,4,87
"69172",1069172,155,103,7,265
"69173",1069173,74,158,13,245
"69174",1069174,172,78,12,262
"69175",1069175,49,175,7,231
"69176",1069176,67,247,3,317
"69177",1069177,131,50,2,183
"69178",1069178,123,49,13,185
"69179",1069179,186,38,6,230
"69180",1069180,190,35,6,231
"69181",1069181,116,118,5,239
"69182",1069182,64,108,9,181
"69183",1069183,115,80,9,204
"69184",1069184,399,52,18,469
"69185",1069185,128,99,20,247
"69186",1069186,63,245,11,319
"69187",1069187,224,57,5,286
"69188",1069188,146,88,2,236
"69189",1069189,56,155,11,222
"69190",1069190,162,70,4,236
"69191",1069191,121,133,32,286
"69192",1069192,135,85,12,232
"69193",1069193,89,43,9,141
"69194",1069194,119,22,1,142
"69195",1069195,38,36,1,75
"69196",1069196,106,42,4,152
"69197",1069197,170,92,17,279
"69198",1069198,180,5,5,190
"69199",1069199,140,144,7,291
"69200",1069200,233,81,22,336
"69201",1069201,71,75,6,152
"69202",1069202,77,185,6,268
"69203",1069203,16,320,1,337
"69204",1069204,73,172,4,249
"69205",1069205,183,89,3,275
"69206",1069206,246,215,24,485
"69207",1069207,135,52,3,190
"69208",1069208,27,314,8,349
"69209",1069209,202,42,11,255
"69210",1069210,58,45,8,111
"69211",1069211,86,172,12,270
"69212",1069212,83,147,12,242
"69213",1069213,121,40,2,163
"69214",1069214,233,58,8,299
"69215",1069215,92,169,7,268
"69216",1069216,68,165,14,247
"69217",1069217,107,66,4,177
"69218",1069218,103,27,4,134
"69219",1069219,50,148,16,214
"69220",1069220,181,49,2,232
"69221",1069221,125,88,8,221
"69222",1069222,90,70,9,169
"69223",1069223,29,281,3,313
"69224",1069224,65,177,6,248
"69225",1069225,210,37,6,253
"69226",1069226,169,78,22,269
"69227",1069227,130,114,11,255
"69228",1069228,10,85,0,95
"69229",1069229,64,8,1,73
"69230",1069230,15,326,4,345
"69231",1069231,171,95,31,297
"69232",1069232,193,20,6,219
"69233",1069233,165,105,5,275
"69234",1069234,70,93,9,172
"69235",1069235,64,152,9,225
"69236",1069236,50,242,3,295
"69237",1069237,153,51,3,207
"69238",1069238,57,119,5,181
"69239",1069239,28,123,4,155
"69240",1069240,20,295,8,323
"69241",1069241,122,157,19,298
"69242",1069242,17,2,2,21
"69243",1069243,26,22,2,50
"69244",1069244,91,142,12,245
"69245",1069245,32,0,0,32
"69246",1069246,130,166,11,307
"69247",1069247,166,47,5,218
"69248",1069248,22,221,12,255
"69249",1069249,160,112,6,278
"69250",1069250,80,178,5,263
"69251",1069251,83,253,8,344
"69252",1069252,85,4,1,90
"69253",1069253,300,3,2,305
"69254",1069254,144,39,7,190
"69255",1069255,158,135,10,303
"69256",1069256,106,200,9,315
"69257",1069257,136,107,1,244
"69258",1069258,51,171,13,235
"69259",1069259,84,110,4,198
"69260",1069260,50,169,10,229
"69261",1069261,57,174,4,235
"69262",1069262,182,82,14,278
"69263",1069263,228,56,17,301
"69264",1069264,130,38,11,179
"69265",1069265,55,122,7,184
"69266",1069266,49,170,7,226
"69267",1069267,150,53,11,214
"69268",1069268,71,178,11,260
"69269",1069269,71,202,8,281
"69270",1069270,113,36,11,160
"69271",1069271,157,60,19,236
"69272",1069272,118,25,11,154
"69273",1069273,76,230,9,315
"69274",1069274,85,99,6,190
"69275",1069275,80,58,7,145
"69276",1069276,18,9,0,27
"69277",1069277,64,49,4,117
"69278",1069278,21,158,2,181
"69279",1069279,55,41,3,99
"69280",1069280,239,27,10,276
"69281",1069281,161,41,5,207
"69282",1069282,3,12,0,15
"69283",1069283,140,199,14,353
"69284",1069284,83,221,20,324
"69285",1069285,26,284,4,314
"69286",1069286,102,122,18,242
"69287",1069287,107,51,13,171
"69288",1069288,32,224,7,263
"69289",1069289,17,4,0,21
"69290",1069290,201,35,11,247
"69291",1069291,144,159,9,312
"69292",1069292,106,71,4,181
"69293",1069293,70,177,17,264
"69294",1069294,184,21,5,210
"69295",1069295,90,215,7,312
"69296",1069296,87,108,19,214
"69297",1069297,62,277,3,342
"69298",1069298,88,47,2,137
"69299",1069299,189,55,9,253
"69300",1069300,46,111,3,160
"69301",1069301,114,123,3,240
"69302",1069302,161,33,2,196
"69303",1069303,132,134,19,285
"69304",1069304,164,78,13,255
"69305",1069305,46,120,10,176
"69306",1069306,225,39,10,274
"69307",1069307,193,50,5,248
"69308",1069308,149,48,9,206
"69309",1069309,38,18,3,59
"69310",1069310,100,133,18,251
"69311",1069311,61,181,5,247
"69312",1069312,17,32,0,49
"69313",1069313,114,74,9,197
"69314",1069314,32,161,3,196
"69315",1069315,90,97,10,197
"69316",1069316,204,52,3,259
"69317",1069317,190,41,6,237
"69318",1069318,66,35,0,101
"69319",1069319,17,44,0,61
"69320",1069320,184,155,14,353
"69321",1069321,35,235,3,273
"69322",1069322,26,265,7,298
"69323",1069323,67,226,9,302
"69324",1069324,207,30,6,243
"69325",1069325,176,27,6,209
"69326",1069326,67,157,11,235
"69327",1069327,117,165,3,285
"69328",1069328,65,127,14,206
"69329",1069329,73,5,3,81
"69330",1069330,205,26,4,235
"69331",1069331,0,0,0,0
"69332",1069332,64,184,11,259
"69333",1069333,166,58,3,227
"69334",1069334,161,26,7,194
"69335",1069335,150,101,15,266
"69336",1069336,127,9,4,140
"69337",1069337,60,203,3,266
"69338",1069338,192,71,5,268
"69339",1069339,98,43,2,143
"69340",1069340,78,97,2,177
"69341",1069341,24,213,3,240
"69342",1069342,39,272,4,315
"69343",1069343,135,145,2,282
"69344",1069344,190,82,10,282
"69345",1069345,148,91,10,249
"69346",1069346,192,53,14,259
"69347",1069347,86,99,18,203
"69348",1069348,53,159,9,221
"69349",1069349,101,113,11,225
"69350",1069350,79,174,6,259
"69351",1069351,114,50,1,165
"69352",1069352,9,180,8,197
"69353",1069353,250,57,12,319
"69354",1069354,103,81,5,189
"69355",1069355,141,153,20,314
"69356",1069356,221,5,7,233
"69357",1069357,167,107,4,278
"69358",1069358,120,87,3,210
"69359",1069359,40,11,1,52
"69360",1069360,27,89,11,127
"69361",1069361,137,97,3,237
"69362",1069362,178,93,19,290
"69363",1069363,128,136,8,272
"69364",1069364,251,5,3,259
"69365",1069365,77,122,13,212
"69366",1069366,163,91,16,270
"69367",1069367,95,178,7,280
"69368",1069368,141,136,6,283
"69369",1069369,144,10,6,160
"69370",1069370,75,95,16,186
"69371",1069371,159,51,17,227
"69372",1069372,53,3,0,56
"69373",1069373,65,6,0,71
"69374",1069374,91,153,9,253
"69375",1069375,171,69,9,249
"69376",1069376,21,243,3,267
"69377",1069377,63,122,4,189
"69378",1069378,259,26,6,291
"69379",1069379,138,57,2,197
"69380",1069380,55,182,9,246
"69381",1069381,152,5,3,160
"69382",1069382,118,182,2,302
"69383",1069383,132,91,9,232
"69384",1069384,124,110,15,249
"69385",1069385,151,149,20,320
"69386",1069386,155,118,12,285
"69387",1069387,131,58,19,208
"69388",1069388,164,72,12,248
"69389",1069389,53,144,14,211
"69390",1069390,217,49,12,278
"69391",1069391,67,196,12,275
"69392",1069392,151,45,2,198
"69393",1069393,54,156,4,214
"69394",1069394,216,29,5,250
"69395",1069395,168,38,2,208
"69396",1069396,67,171,6,244
"69397",1069397,79,177,11,267
"69398",1069398,57,215,8,280
"69399",1069399,85,203,8,296
"69400",1069400,53,155,8,216
"69401",1069401,207,93,14,314
"69402",1069402,99,235,1,335
"69403",1069403,27,189,10,226
"69404",1069404,103,144,10,257
"69405",1069405,206,22,8,236
"69406",1069406,149,58,10,217
"69407",1069407,52,206,6,264
"69408",1069408,85,187,16,288
"69409",1069409,135,143,7,285
"69410",1069410,72,166,4,242
"69411",1069411,128,22,2,152
"69412",1069412,130,146,16,292
"69413",1069413,7,30,1,38
"69414",1069414,80,166,21,267
"69415",1069415,64,165,6,235
"69416",1069416,47,34,4,85
"69417",1069417,294,6,5,305
"69418",1069418,27,168,1,196
"69419",1069419,93,185,11,289
"69420",1069420,112,137,5,254
"69421",1069421,12,254,6,272
"69422",1069422,40,251,9,300
"69423",1069423,193,36,3,232
"69424",1069424,9,19,0,28
"69425",1069425,212,30,4,246
"69426",1069426,144,47,4,195
"69427",1069427,87,215,7,309
"69428",1069428,194,57,14,265
"69429",1069429,40,102,5,147
"69430",1069430,146,135,2,283
"69431",1069431,15,140,2,157
"69432",1069432,30,33,2,65
"69433",1069433,26,54,0,80
"69434",1069434,80,166,10,256
"69435",1069435,105,128,7,240
"69436",1069436,72,125,7,204
"69437",1069437,198,21,1,220
"69438",1069438,221,72,22,315
"69439",1069439,133,165,12,310
"69440",1069440,123,151,4,278
"69441",1069441,104,175,12,291
"69442",1069442,111,97,6,214
"69443",1069443,115,44,11,170
"69444",1069444,67,39,3,109
"69445",1069445,71,133,19,223
"69446",1069446,152,56,4,212
"69447",1069447,66,147,11,224
"69448",1069448,171,71,22,264
"69449",1069449,160,106,16,282
"69450",1069450,206,41,12,259
"69451",1069451,106,160,6,272
"69452",1069452,61,249,3,313
"69453",1069453,129,43,8,180
"69454",1069454,161,51,14,226
"69455",1069455,142,118,9,269
"69456",1069456,71,151,9,231
"69457",1069457,226,16,2,244
"69458",1069458,150,96,14,260
"69459",1069459,20,160,7,187
"69460",1069460,134,40,2,176
"69461",1069461,145,99,9,253
"69462",1069462,18,174,4,196
"69463",1069463,169,34,6,209
"69464",1069464,43,287,9,339
"69465",1069465,167,95,6,268
"69466",1069466,51,190,5,246
"69467",1069467,109,185,11,305
"69468",1069468,81,104,1,186
"69469",1069469,288,94,30,412
"69470",1069470,149,67,14,230
"69471",1069471,116,52,16,184
"69472",1069472,158,124,24,306
"69473",1069473,98,44,2,144
"69474",1069474,62,169,16,247
"69475",1069475,102,78,17,197
"69476",1069476,115,16,5,136
"69477",1069477,118,42,7,167
"69478",1069478,224,13,6,243
"69479",1069479,141,107,11,259
"69480",1069480,19,250,2,271
"69481",1069481,145,110,10,265
"69482",1069482,83,132,3,218
"69483",1069483,83,146,12,241
"69484",1069484,20,67,1,88
"69485",1069485,122,113,11,246
"69486",1069486,104,127,15,246
"69487",1069487,107,178,11,296
"69488",1069488,173,112,0,285
"69489",1069489,90,308,1,399
"69490",1069490,29,226,5,260
"69491",1069491,27,156,5,188
"69492",1069492,101,38,2,141
"69493",1069493,87,174,19,280
"69494",1069494,46,224,3,273
"69495",1069495,70,190,8,268
"69496",1069496,20,14,0,34
"69497",1069497,50,258,15,323
"69498",1069498,99,41,8,148
"69499",1069499,180,0,3,183
"69500",1069500,55,9,0,64
"69501",1069501,24,147,10,181
"69502",1069502,9,144,2,155
"69503",1069503,160,98,23,281
"69504",1069504,195,59,13,267
"69505",1069505,224,10,5,239
"69506",1069506,108,115,23,246
"69507",1069507,128,22,6,156
"69508",1069508,101,153,6,260
"69509",1069509,70,128,10,208
"69510",1069510,244,27,12,283
"69511",1069511,84,234,19,337
"69512",1069512,96,20,2,118
"69513",1069513,90,217,14,321
"69514",1069514,72,120,3,195
"69515",1069515,38,185,4,227
"69516",1069516,67,26,0,93
"69517",1069517,98,220,10,328
"69518",1069518,128,76,7,211
"69519",1069519,169,47,9,225
"69520",1069520,191,69,4,264
"69521",1069521,65,239,3,307
"69522",1069522,81,198,18,297
"69523",1069523,153,93,4,250
"69524",1069524,17,5,2,24
"69525",1069525,64,153,12,229
"69526",1069526,194,22,4,220
"69527",1069527,112,66,5,183
"69528",1069528,101,166,6,273
"69529",1069529,107,120,9,236
"69530",1069530,93,178,16,287
"69531",1069531,175,106,5,286
"69532",1069532,128,73,7,208
"69533",1069533,98,16,4,118
"69534",1069534,60,265,7,332
"69535",1069535,161,63,2,226
"69536",1069536,176,42,5,223
"69537",1069537,72,162,7,241
"69538",1069538,84,154,9,247
"69539",1069539,41,43,7,91
"69540",1069540,176,67,12,255
"69541",1069541,48,121,7,176
"69542",1069542,104,56,10,170
"69543",1069543,54,9,16,79
"69544",1069544,115,40,4,159
"69545",1069545,15,12,0,27
"69546",1069546,71,172,8,251
"69547",1069547,140,62,8,210
"69548",1069548,62,83,0,145
"69549",1069549,203,129,14,346
"69550",1069550,145,79,6,230
"69551",1069551,38,257,6,301
"69552",1069552,77,53,8,138
"69553",1069553,133,119,12,264
"69554",1069554,157,67,9,233
"69555",1069555,45,16,2,63
"69556",1069556,35,222,0,257
"69557",1069557,91,58,2,151
"69558",1069558,159,57,7,223
"69559",1069559,4,104,1,109
"69560",1069560,24,203,5,232
"69561",1069561,61,248,16,325
"69562",1069562,120,22,3,145
"69563",1069563,140,98,10,248
"69564",1069564,89,33,1,123
"69565",1069565,104,198,15,317
"69566",1069566,241,50,13,304
"69567",1069567,156,100,9,265
"69568",1069568,264,47,6,317
"69569",1069569,60,248,20,328
"69570",1069570,136,13,4,153
"69571",1069571,53,50,8,111
"69572",1069572,17,13,2,32
"69573",1069573,241,41,11,293
"69574",1069574,117,77,5,199
"69575",1069575,193,19,4,216
"69576",1069576,57,87,8,152
"69577",1069577,146,46,8,200
"69578",1069578,121,141,18,280
"69579",1069579,95,162,1,258
"69580",1069580,27,83,0,110
"69581",1069581,21,14,2,37
"69582",1069582,145,34,6,185
"69583",1069583,232,96,16,344
"69584",1069584,277,20,5,302
"69585",1069585,194,49,7,250
"69586",1069586,116,53,7,176
"69587",1069587,125,91,7,223
"69588",1069588,111,141,11,263
"69589",1069589,114,141,7,262
"69590",1069590,234,76,11,321
"69591",1069591,113,185,4,302
"69592",1069592,253,44,3,300
"69593",1069593,117,52,3,172
"69594",1069594,25,192,5,222
"69595",1069595,191,50,11,252
"69596",1069596,61,33,3,97
"69597",1069597,75,157,11,243
"69598",1069598,70,120,16,206
"69599",1069599,76,175,5,256
"69600",1069600,96,193,14,303
"69601",1069601,113,146,12,271
"69602",1069602,44,341,2,387
"69603",1069603,195,135,6,336
"69604",1069604,185,39,9,233
"69605",1069605,3,97,1,101
"69606",1069606,192,82,22,296
"69607",1069607,12,105,1,118
"69608",1069608,52,70,1,123
"69609",1069609,134,3,1,138
"69610",1069610,29,258,1,288
"69611",1069611,19,7,0,26
"69612",1069612,36,218,7,261
"69613",1069613,130,103,5,238
"69614",1069614,99,31,0,130
"69615",1069615,60,102,5,167
"69616",1069616,132,75,8,215
"69617",1069617,92,102,7,201
"69618",1069618,156,85,17,258
"69619",1069619,161,80,3,244
"69620",1069620,74,212,6,292
"69621",1069621,271,33,7,311
"69622",1069622,111,203,25,339
"69623",1069623,262,14,4,280
"69624",1069624,52,187,9,248
"69625",1069625,184,34,9,227
"69626",1069626,87,92,11,190
"69627",1069627,35,3,2,40
"69628",1069628,61,174,19,254
"69629",1069629,96,48,19,163
"69630",1069630,131,21,2,154
"69631",1069631,150,120,17,287
"69632",1069632,100,180,10,290
"69633",1069633,139,75,10,224
"69634",1069634,124,47,11,182
"69635",1069635,98,215,9,322
"69636",1069636,38,269,3,310
"69637",1069637,168,21,7,196
"69638",1069638,229,15,9,253
"69639",1069639,16,213,4,233
"69640",1069640,22,2,1,25
"69641",1069641,50,13,7,70
"69642",1069642,113,82,9,204
"69643",1069643,48,24,2,74
"69644",1069644,83,53,8,144
"69645",1069645,59,170,6,235
"69646",1069646,118,8,2,128
"69647",1069647,6,18,2,26
"69648",1069648,54,219,6,279
"69649",1069649,41,208,7,256
"69650",1069650,87,149,7,243
"69651",1069651,118,78,16,212
"69652",1069652,139,17,7,163
"69653",1069653,26,141,3,170
"69654",1069654,116,162,8,286
"69655",1069655,54,103,4,161
"69656",1069656,54,32,2,88
"69657",1069657,122,86,8,216
"69658",1069658,110,41,12,163
"69659",1069659,56,185,4,245
"69660",1069660,81,146,6,233
"69661",1069661,57,141,13,211
"69662",1069662,120,86,10,216
"69663",1069663,99,166,9,274
"69664",1069664,268,8,2,278
"69665",1069665,61,85,11,157
"69666",1069666,149,112,5,266
"69667",1069667,29,12,2,43
"69668",1069668,28,20,3,51
"69669",1069669,93,75,5,173
"69670",1069670,164,87,10,261
"69671",1069671,60,231,6,297
"69672",1069672,27,160,3,190
"69673",1069673,60,72,6,138
"69674",1069674,48,218,5,271
"69675",1069675,107,111,7,225
"69676",1069676,5,81,0,86
"69677",1069677,66,57,5,128
"69678",1069678,86,23,2,111
"69679",1069679,111,67,17,195
"69680",1069680,199,59,11,269
"69681",1069681,66,226,5,297
"69682",1069682,71,30,7,108
"69683",1069683,27,202,4,233
"69684",1069684,45,240,4,289
"69685",1069685,74,230,14,318
"69686",1069686,143,108,11,262
"69687",1069687,166,12,6,184
"69688",1069688,151,67,14,232
"69689",1069689,0,0,0,0
"69690",1069690,2,8,1,11
"69691",1069691,135,119,5,259
"69692",1069692,41,162,4,207
"69693",1069693,78,142,7,227
"69694",1069694,262,46,4,312
"69695",1069695,194,34,6,234
"69696",1069696,59,171,1,231
"69697",1069697,185,42,0,227
"69698",1069698,189,11,3,203
"69699",1069699,49,45,4,98
"69700",1069700,151,109,15,275
"69701",1069701,270,35,11,316
"69702",1069702,108,84,13,205
"69703",1069703,44,244,6,294
"69704",1069704,75,105,4,184
"69705",1069705,55,190,4,249
"69706",1069706,124,53,2,179
"69707",1069707,160,116,12,288
"69708",1069708,70,161,10,241
"69709",1069709,179,44,10,233
"69710",1069710,37,48,2,87
"69711",1069711,110,102,2,214
"69712",1069712,24,179,7,210
"69713",1069713,64,217,6,287
"69714",1069714,121,15,0,136
"69715",1069715,21,117,7,145
"69716",1069716,106,110,16,232
"69717",1069717,70,31,4,105
"69718",1069718,33,148,1,182
"69719",1069719,36,20,1,57
"69720",1069720,7,3,0,10
"69721",1069721,133,157,8,298
"69722",1069722,56,215,6,277
"69723",1069723,29,236,0,265
"69724",1069724,179,89,19,287
"69725",1069725,98,211,11,320
"69726",1069726,136,193,17,346
"69727",1069727,163,22,4,189
"69728",1069728,133,104,5,242
"69729",1069729,38,58,1,97
"69730",1069730,134,31,13,178
"69731",1069731,32,61,3,96
"69732",1069732,65,9,2,76
"69733",1069733,150,42,2,194
"69734",1069734,49,163,4,216
"69735",1069735,148,13,8,169
"69736",1069736,127,26,6,159
"69737",1069737,72,151,7,230
"69738",1069738,193,3,0,196
"69739",1069739,45,245,5,295
"69740",1069740,95,192,8,295
"69741",1069741,0,11,1,12
"69742",1069742,192,58,14,264
"69743",1069743,23,279,7,309
"69744",1069744,83,7,3,93
"69745",1069745,82,151,16,249
"69746",1069746,179,109,7,295
"69747",1069747,78,188,6,272
"69748",1069748,223,40,8,271
"69749",1069749,141,187,11,339
"69750",1069750,49,26,3,78
"69751",1069751,5,175,2,182
"69752",1069752,103,51,8,162
"69753",1069753,191,50,10,251
"69754",1069754,72,158,7,237
"69755",1069755,172,52,1,225
"69756",1069756,78,212,12,302
"69757",1069757,62,195,23,280
"69758",1069758,165,81,8,254
"69759",1069759,22,27,1,50
"69760",1069760,146,126,9,281
"69761",1069761,145,39,7,191
"69762",1069762,16,29,0,45
"69763",1069763,146,101,13,260
"69764",1069764,77,124,11,212
"69765",1069765,96,27,1,124
"69766",1069766,48,16,1,65
"69767",1069767,72,168,17,257
"69768",1069768,101,11,1,113
"69769",1069769,74,75,0,149
"69770",1069770,108,189,16,313
"69771",1069771,97,134,4,235
"69772",1069772,152,89,10,251
"69773",1069773,56,169,20,245
"69774",1069774,149,38,16,203
"69775",1069775,171,100,13,284
"69776",1069776,51,85,3,139
"69777",1069777,147,33,8,188
"69778",1069778,122,82,13,217
"69779",1069779,138,70,8,216
"69780",1069780,175,23,4,202
"69781",1069781,160,45,11,216
"69782",1069782,245,18,4,267
"69783",1069783,9,15,0,24
"69784",1069784,136,23,3,162
"69785",1069785,66,138,6,210
"69786",1069786,45,100,5,150
"69787",1069787,68,42,3,113
"69788",1069788,119,117,15,251
"69789",1069789,12,12,0,24
"69790",1069790,100,162,10,272
"69791",1069791,179,55,16,250
"69792",1069792,188,29,8,225
"69793",1069793,126,174,10,310
"69794",1069794,100,137,8,245
"69795",1069795,11,4,1,16
"69796",1069796,56,141,8,205
"69797",1069797,128,99,3,230
"69798",1069798,107,187,18,312
"69799",1069799,42,241,4,287
"69800",1069800,91,100,14,205
"69801",1069801,109,152,8,269
"69802",1069802,96,109,7,212
"69803",1069803,51,186,1,238
"69804",1069804,143,45,4,192
"69805",1069805,69,131,3,203
"69806",1069806,46,194,6,246
"69807",1069807,132,53,2,187
"69808",1069808,46,253,6,305
"69809",1069809,150,26,11,187
"69810",1069810,163,121,16,300
"69811",1069811,46,174,4,224
"69812",1069812,35,168,5,208
"69813",1069813,143,91,12,246
"69814",1069814,146,32,7,185
"69815",1069815,145,80,9,234
"69816",1069816,8,22,1,31
"69817",1069817,124,132,24,280
"69818",1069818,119,32,12,163
"69819",1069819,203,38,3,244
"69820",1069820,230,71,13,314
"69821",1069821,67,33,7,107
"69822",1069822,152,57,6,215
"69823",1069823,46,162,7,215
"69824",1069824,25,28,5,58
"69825",1069825,145,132,6,283
"69826",1069826,129,118,21,268
"69827",1069827,112,189,15,316
"69828",1069828,23,147,10,180
"69829",1069829,72,115,3,190
"69830",1069830,91,133,7,231
"69831",1069831,146,98,12,256
"69832",1069832,188,53,9,250
"69833",1069833,113,96,6,215
"69834",1069834,153,118,7,278
"69835",1069835,100,94,3,197
"69836",1069836,60,73,2,135
"69837",1069837,41,203,12,256
"69838",1069838,41,21,2,64
"69839",1069839,62,176,3,241
"69840",1069840,68,149,3,220
"69841",1069841,100,108,5,213
"69842",1069842,43,236,4,283
"69843",1069843,131,162,14,307
"69844",1069844,179,103,20,302
"69845",1069845,159,45,11,215
"69846",1069846,11,4,2,17
"69847",1069847,113,169,10,292
"69848",1069848,184,98,17,299
"69849",1069849,119,93,2,214
"69850",1069850,111,89,7,207
"69851",1069851,120,41,3,164
"69852",1069852,128,105,18,251
"69853",1069853,205,139,20,364
"69854",1069854,51,266,8,325
"69855",1069855,144,45,7,196
"69856",1069856,136,118,20,274
"69857",1069857,7,14,0,21
"69858",1069858,76,183,14,273
"69859",1069859,194,78,26,298
"69860",1069860,79,87,3,169
"69861",1069861,77,4,1,82
"69862",1069862,230,21,10,261
"69863",1069863,79,203,14,296
"69864",1069864,218,32,4,254
"69865",1069865,173,88,4,265
"69866",1069866,142,7,5,154
"69867",1069867,214,36,9,259
"69868",1069868,418,54,18,490
"69869",1069869,221,17,8,246
"69870",1069870,135,376,15,526
"69871",1069871,187,55,16,258
"69872",1069872,16,174,1,191
"69873",1069873,176,62,8,246
"69874",1069874,247,20,7,274
"69875",1069875,60,94,5,159
"69876",1069876,44,189,13,246
"69877",1069877,63,274,6,343
"69878",1069878,227,41,6,274
"69879",1069879,209,131,11,351
"69880",1069880,98,120,8,226
"69881",1069881,69,146,28,243
"69882",1069882,53,52,6,111
"69883",1069883,77,148,12,237
"69884",1069884,121,121,14,256
"69885",1069885,94,209,6,309
"69886",1069886,95,146,11,252
"69887",1069887,108,160,27,295
"69888",1069888,209,31,7,247
"69889",1069889,68,123,6,197
"69890",1069890,206,24,12,242
"69891",1069891,183,57,7,247
"69892",1069892,238,46,12,296
"69893",1069893,111,23,7,141
"69894",1069894,113,91,15,219
"69895",1069895,168,52,11,231
"69896",1069896,188,33,6,227
"69897",1069897,160,91,15,266
"69898",1069898,146,67,10,223
"69899",1069899,172,106,17,295
"69900",1069900,56,131,7,194
"69901",1069901,64,96,3,163
"69902",1069902,129,53,11,193
"69903",1069903,115,11,0,126
"69904",1069904,135,58,8,201
"69905",1069905,126,45,5,176
"69906",1069906,132,61,8,201
"69907",1069907,133,52,13,198
"69908",1069908,57,187,5,249
"69909",1069909,112,43,16,171
"69910",1069910,174,30,4,208
"69911",1069911,73,105,12,190
"69912",1069912,141,138,10,289
"69913",1069913,52,217,7,276
"69914",1069914,158,260,1,419
"69915",1069915,83,114,5,202
"69916",1069916,177,26,8,211
"69917",1069917,37,125,5,167
"69918",1069918,137,77,5,219
"69919",1069919,242,30,7,279
"69920",1069920,39,216,4,259
"69921",1069921,164,42,2,208
"69922",1069922,76,184,19,279
"69923",1069923,139,45,6,190
"69924",1069924,15,220,6,241
"69925",1069925,183,28,0,211
"69926",1069926,117,84,15,216
"69927",1069927,43,227,14,284
"69928",1069928,219,66,12,297
"69929",1069929,121,70,3,194
"69930",1069930,56,160,6,222
"69931",1069931,119,106,8,233
"69932",1069932,29,130,2,161
"69933",1069933,55,83,10,148
"69934",1069934,47,36,6,89
"69935",1069935,208,33,8,249
"69936",1069936,57,211,9,277
"69937",1069937,169,56,10,235
"69938",1069938,40,190,5,235
"69939",1069939,194,40,13,247
"69940",1069940,226,51,9,286
"69941",1069941,3,17,1,21
"69942",1069942,194,39,11,244
"69943",1069943,50,234,8,292
"69944",1069944,124,157,10,291
"69945",1069945,95,116,0,211
"69946",1069946,65,13,0,78
"69947",1069947,48,231,5,284
"69948",1069948,102,52,2,156
"69949",1069949,94,136,14,244
"69950",1069950,125,89,6,220
"69951",1069951,104,39,5,148
"69952",1069952,118,128,3,249
"69953",1069953,115,107,11,233
"69954",1069954,118,97,12,227
"69955",1069955,111,53,9,173
"69956",1069956,126,55,10,191
"69957",1069957,23,232,6,261
"69958",1069958,23,227,0,250
"69959",1069959,143,46,4,193
"69960",1069960,60,179,16,255
"69961",1069961,15,106,2,123
"69962",1069962,134,38,5,177
"69963",1069963,113,171,8,292
"69964",1069964,127,161,9,297
"69965",1069965,52,124,11,187
"69966",1069966,58,168,11,237
"69967",1069967,157,43,5,205
"69968",1069968,188,77,17,282
"69969",1069969,32,141,2,175
"69970",1069970,1,0,0,1
"69971",1069971,127,116,18,261
"69972",1069972,187,101,13,301
"69973",1069973,182,90,21,293
"69974",1069974,69,253,1,323
"69975",1069975,196,56,8,260
"69976",1069976,27,42,1,70
"69977",1069977,113,61,2,176
"69978",1069978,63,23,3,89
"69979",1069979,107,10,7,124
"69980",1069980,89,136,10,235
"69981",1069981,178,54,6,238
"69982",1069982,8,41,3,52
"69983",1069983,103,180,11,294
"69984",1069984,174,6,5,185
"69985",1069985,133,74,2,209
"69986",1069986,60,115,4,179
"69987",1069987,44,258,3,305
"69988",1069988,24,105,3,132
"69989",1069989,122,137,12,271
"69990",1069990,230,227,21,478
"69991",1069991,68,169,7,244
"69992",1069992,161,121,14,296
"69993",1069993,72,46,8,126
"69994",1069994,58,130,5,193
"69995",1069995,51,206,14,271
"69996",1069996,64,183,7,254
"69997",1069997,5,24,3,32
"69998",1069998,39,230,4,273
"69999",1069999,153,76,13,242
"70000",1070000,67,80,4,151
"70001",1070001,76,73,2,151
"70002",1070002,26,155,3,184
"70003",1070003,5,74,1,80
"70004",1070004,160,94,18,272
"70005",1070005,66,226,5,297
"70006",1070006,120,97,14,231
"70007",1070007,126,101,10,237
"70008",1070008,28,21,13,62
"70009",1070009,182,33,1,216
"70010",1070010,193,25,6,224
"70011",1070011,3,12,0,15
"70012",1070012,99,195,13,307
"70013",1070013,122,100,3,225
"70014",1070014,123,38,9,170
"70015",1070015,60,118,6,184
"70016",1070016,10,65,0,75
"70017",1070017,177,31,9,217
"70018",1070018,156,59,22,237
"70019",1070019,151,108,18,277
"70020",1070020,111,101,13,225
"70021",1070021,171,64,11,246
"70022",1070022,94,146,6,246
"70023",1070023,69,164,3,236
"70024",1070024,112,82,9,203
"70025",1070025,31,5,1,37
"70026",1070026,238,44,3,285
"70027",1070027,167,23,5,195
"70028",1070028,237,19,6,262
"70029",1070029,74,27,12,113
"70030",1070030,70,164,8,242
"70031",1070031,230,37,20,287
"70032",1070032,36,192,3,231
"70033",1070033,126,45,4,175
"70034",1070034,52,162,5,219
"70035",1070035,125,85,2,212
"70036",1070036,69,85,1,155
"70037",1070037,138,131,8,277
"70038",1070038,33,169,1,203
"70039",1070039,139,7,3,149
"70040",1070040,28,225,3,256
"70041",1070041,167,43,2,212
"70042",1070042,63,79,6,148
"70043",1070043,46,202,6,254
"70044",1070044,66,46,1,113
"70045",1070045,31,158,5,194
"70046",1070046,166,91,8,265
"70047",1070047,149,25,3,177
"70048",1070048,143,95,9,247
"70049",1070049,114,115,7,236
"70050",1070050,173,36,5,214
"70051",1070051,116,200,4,320
"70052",1070052,35,26,3,64
"70053",1070053,48,143,6,197
"70054",1070054,36,232,5,273
"70055",1070055,53,47,2,102
"70056",1070056,58,108,9,175
"70057",1070057,22,178,6,206
"70058",1070058,46,108,8,162
"70059",1070059,65,178,12,255
"70060",1070060,162,83,9,254
"70061",1070061,134,94,11,239
"70062",1070062,95,65,8,168
"70063",1070063,59,33,0,92
"70064",1070064,41,187,4,232
"70065",1070065,163,20,6,189
"70066",1070066,112,72,6,190
"70067",1070067,29,232,1,262
"70068",1070068,120,58,1,179
"70069",1070069,67,173,9,249
"70070",1070070,101,157,6,264
"70071",1070071,152,181,2,335
"70072",1070072,135,122,17,274
"70073",1070073,138,95,9,242
"70074",1070074,134,91,8,233
"70075",1070075,203,85,17,305
"70076",1070076,129,106,4,239
"70077",1070077,87,204,21,312
"70078",1070078,66,133,6,205
"70079",1070079,221,44,10,275
"70080",1070080,130,124,14,268
"70081",1070081,170,23,8,201
"70082",1070082,134,39,9,182
"70083",1070083,88,105,4,197
"70084",1070084,55,126,8,189
"70085",1070085,122,69,13,204
"70086",1070086,23,68,4,95
"70087",1070087,73,144,5,222
"70088",1070088,27,201,9,237
"70089",1070089,109,87,6,202
"70090",1070090,293,118,6,417
"70091",1070091,222,49,9,280
"70092",1070092,159,65,11,235
"70093",1070093,65,169,4,238
"70094",1070094,240,209,37,486
"70095",1070095,35,59,5,99
"70096",1070096,107,61,3,171
"70097",1070097,59,221,2,282
"70098",1070098,84,144,8,236
"70099",1070099,91,123,12,226
"70100",1070100,115,65,16,196
"70101",1070101,104,122,11,237
"70102",1070102,109,107,9,225
"70103",1070103,120,148,14,282
"70104",1070104,203,98,19,320
"70105",1070105,218,55,4,277
"70106",1070106,141,47,2,190
"70107",1070107,170,57,5,232
"70108",1070108,78,184,11,273
"70109",1070109,186,68,8,262
"70110",1070110,155,34,8,197
"70111",1070111,132,121,1,254
"70112",1070112,77,23,7,107
"70113",1070113,74,204,7,285
"70114",1070114,181,25,9,215
"70115",1070115,52,151,2,205
"70116",1070116,207,36,14,257
"70117",1070117,88,171,6,265
"70118",1070118,96,20,4,120
"70119",1070119,167,81,4,252
"70120",1070120,4,2,0,6
"70121",1070121,36,256,9,301
"70122",1070122,85,110,12,207
"70123",1070123,120,58,3,181
"70124",1070124,37,200,7,244
"70125",1070125,179,105,17,301
"70126",1070126,121,66,4,191
"70127",1070127,98,58,1,157
"70128",1070128,222,55,11,288
"70129",1070129,71,130,4,205
"70130",1070130,121,142,6,269
"70131",1070131,37,221,8,266
"70132",1070132,123,44,5,172
"70133",1070133,118,24,3,145
"70134",1070134,85,179,5,269
"70135",1070135,99,13,4,116
"70136",1070136,21,247,3,271
"70137",1070137,88,38,4,130
"70138",1070138,143,119,11,273
"70139",1070139,57,242,3,302
"70140",1070140,68,44,4,116
"70141",1070141,61,225,5,291
"70142",1070142,218,50,12,280
"70143",1070143,106,11,4,121
"70144",1070144,87,49,2,138
"70145",1070145,145,78,19,242
"70146",1070146,146,115,11,272
"70147",1070147,69,78,7,154
"70148",1070148,146,129,10,285
"70149",1070149,175,84,9,268
"70150",1070150,210,14,14,238
"70151",1070151,25,181,1,207
"70152",1070152,215,62,8,285
"70153",1070153,33,28,3,64
"70154",1070154,154,137,26,317
"70155",1070155,36,247,7,290
"70156",1070156,90,32,8,130
"70157",1070157,104,114,10,228
"70158",1070158,82,151,2,235
"70159",1070159,38,237,3,278
"70160",1070160,184,61,35,280
"70161",1070161,195,17,10,222
"70162",1070162,208,69,21,298
"70163",1070163,179,60,3,242
"70164",1070164,60,194,3,257
"70165",1070165,75,109,9,193
"70166",1070166,149,73,6,228
"70167",1070167,118,69,4,191
"70168",1070168,22,132,1,155
"70169",1070169,120,156,11,287
"70170",1070170,137,119,4,260
"70171",1070171,13,95,4,112
"70172",1070172,55,206,4,265
"70173",1070173,118,47,9,174
"70174",1070174,90,171,16,277
"70175",1070175,149,125,14,288
"70176",1070176,68,61,5,134
"70177",1070177,74,40,6,120
"70178",1070178,102,52,8,162
"70179",1070179,102,206,8,316
"70180",1070180,144,127,11,282
"70181",1070181,174,51,9,234
"70182",1070182,48,25,2,75
"70183",1070183,49,171,5,225
"70184",1070184,83,249,6,338
"70185",1070185,88,118,5,211
"70186",1070186,156,46,9,211
"70187",1070187,84,162,15,261
"70188",1070188,208,54,8,270
"70189",1070189,126,90,8,224
"70190",1070190,44,99,3,146
"70191",1070191,46,281,1,328
"70192",1070192,92,92,6,190
"70193",1070193,106,89,7,202
"70194",1070194,48,174,2,224
"70195",1070195,137,104,5,246
"70196",1070196,153,131,12,296
"70197",1070197,156,82,12,250
"70198",1070198,111,164,8,283
"70199",1070199,207,74,13,294
"70200",1070200,18,18,1,37
"70201",1070201,160,93,10,263
"70202",1070202,68,153,9,230
"70203",1070203,24,93,2,119
"70204",1070204,49,293,9,351
"70205",1070205,36,150,3,189
"70206",1070206,112,145,7,264
"70207",1070207,4,27,0,31
"70208",1070208,29,244,3,276
"70209",1070209,45,50,4,99
"70210",1070210,145,94,14,253
"70211",1070211,15,294,3,312
"70212",1070212,126,158,4,288
"70213",1070213,113,88,23,224
"70214",1070214,187,18,3,208
"70215",1070215,126,215,15,356
"70216",1070216,248,26,4,278
"70217",1070217,16,3,1,20
"70218",1070218,48,189,7,244
"70219",1070219,209,40,5,254
"70220",1070220,162,7,3,172
"70221",1070221,100,172,8,280
"70222",1070222,31,212,3,246
"70223",1070223,51,159,10,220
"70224",1070224,29,34,4,67
"70225",1070225,43,250,14,307
"70226",1070226,48,196,8,252
"70227",1070227,37,37,2,76
"70228",1070228,63,49,6,118
"70229",1070229,137,53,8,198
"70230",1070230,184,87,10,281
"70231",1070231,53,166,16,235
"70232",1070232,71,16,3,90
"70233",1070233,97,32,4,133
"70234",1070234,72,150,2,224
"70235",1070235,46,29,1,76
"70236",1070236,32,239,3,274
"70237",1070237,140,15,5,160
"70238",1070238,96,150,1,247
"70239",1070239,5,36,1,42
"70240",1070240,171,27,3,201
"70241",1070241,160,67,6,233
"70242",1070242,145,120,13,278
"70243",1070243,202,107,18,327
"70244",1070244,141,52,4,197
"70245",1070245,123,64,13,200
"70246",1070246,124,106,7,237
"70247",1070247,78,157,6,241
"70248",1070248,187,62,16,265
"70249",1070249,272,16,7,295
"70250",1070250,194,57,8,259
"70251",1070251,131,96,4,231
"70252",1070252,49,304,3,356
"70253",1070253,107,89,10,206
"70254",1070254,229,93,6,328
"70255",1070255,166,116,8,290
"70256",1070256,73,168,2,243
"70257",1070257,15,224,4,243
"70258",1070258,144,131,17,292
"70259",1070259,201,44,7,252
"70260",1070260,181,19,9,209
"70261",1070261,81,70,13,164
"70262",1070262,79,137,11,227
"70263",1070263,4,6,0,10
"70264",1070264,56,96,5,157
"70265",1070265,91,133,11,235
"70266",1070266,62,242,6,310
"70267",1070267,142,43,8,193
"70268",1070268,222,38,14,274
"70269",1070269,179,53,7,239
"70270",1070270,171,70,9,250
"70271",1070271,210,14,5,229
"70272",1070272,59,158,4,221
"70273",1070273,189,26,5,220
"70274",1070274,148,122,11,281
"70275",1070275,281,14,11,306
"70276",1070276,90,129,7,226
"70277",1070277,138,84,13,235
"70278",1070278,147,144,19,310
"70279",1070279,185,23,3,211
"70280",1070280,134,165,16,315
"70281",1070281,95,149,6,250
"70282",1070282,100,39,1,140
"70283",1070283,38,14,2,54
"70284",1070284,1,0,0,1
"70285",1070285,166,39,5,210
"70286",1070286,131,118,14,263
"70287",1070287,153,168,14,335
"70288",1070288,88,83,10,181
"70289",1070289,106,78,13,197
"70290",1070290,239,13,7,259
"70291",1070291,177,52,5,234
"70292",1070292,115,83,6,204
"70293",1070293,102,163,5,270
"70294",1070294,105,67,9,181
"70295",1070295,4,69,0,73
"70296",1070296,159,99,11,269
"70297",1070297,178,146,19,343
"70298",1070298,188,120,20,328
"70299",1070299,31,220,5,256
"70300",1070300,56,216,10,282
"70301",1070301,106,195,16,317
"70302",1070302,138,90,5,233
"70303",1070303,42,8,1,51
"70304",1070304,174,58,11,243
"70305",1070305,87,47,3,137
"70306",1070306,191,98,15,304
"70307",1070307,60,169,11,240
"70308",1070308,52,62,2,116
"70309",1070309,90,31,4,125
"70310",1070310,104,34,7,145
"70311",1070311,178,46,12,236
"70312",1070312,106,106,9,221
"70313",1070313,112,137,13,262
"70314",1070314,82,247,5,334
"70315",1070315,135,141,19,295
"70316",1070316,63,140,11,214
"70317",1070317,19,37,6,62
"70318",1070318,112,236,13,361
"70319",1070319,52,228,7,287
"70320",1070320,74,132,1,207
"70321",1070321,289,29,3,321
"70322",1070322,60,184,4,248
"70323",1070323,102,101,9,212
"70324",1070324,44,175,1,220
"70325",1070325,72,88,3,163
"70326",1070326,43,168,3,214
"70327",1070327,136,73,1,210
"70328",1070328,117,94,11,222
"70329",1070329,201,62,17,280
"70330",1070330,42,9,1,52
"70331",1070331,33,260,8,301
"70332",1070332,133,104,3,240
"70333",1070333,59,60,9,128
"70334",1070334,86,69,5,160
"70335",1070335,141,49,9,199
"70336",1070336,12,1,0,13
"70337",1070337,135,73,15,223
"70338",1070338,192,20,7,219
"70339",1070339,29,174,4,207
"70340",1070340,100,77,5,182
"70341",1070341,124,51,7,182
"70342",1070342,213,96,18,327
"70343",1070343,120,98,3,221
"70344",1070344,120,146,22,288
"70345",1070345,102,126,15,243
"70346",1070346,134,81,7,222
"70347",1070347,158,67,8,233
"70348",1070348,75,179,9,263
"70349",1070349,62,130,13,205
"70350",1070350,58,196,3,257
"70351",1070351,226,72,1,299
"70352",1070352,17,26,0,43
"70353",1070353,92,200,4,296
"70354",1070354,192,34,12,238
"70355",1070355,180,137,15,332
"70356",1070356,120,16,2,138
"70357",1070357,225,50,6,281
"70358",1070358,106,118,5,229
"70359",1070359,44,285,11,340
"70360",1070360,70,67,7,144
"70361",1070361,179,34,3,216
"70362",1070362,108,321,7,436
"70363",1070363,120,125,38,283
"70364",1070364,54,193,3,250
"70365",1070365,4,10,0,14
"70366",1070366,27,66,0,93
"70367",1070367,34,2,0,36
"70368",1070368,121,179,6,306
"70369",1070369,98,9,6,113
"70370",1070370,123,93,6,222
"70371",1070371,60,163,11,234
"70372",1070372,195,26,3,224
"70373",1070373,131,113,16,260
"70374",1070374,203,37,17,257
"70375",1070375,30,235,2,267
"70376",1070376,52,222,8,282
"70377",1070377,79,106,6,191
"70378",1070378,48,224,3,275
"70379",1070379,33,179,8,220
"70380",1070380,134,150,15,299
"70381",1070381,12,15,0,27
"70382",1070382,74,163,17,254
"70383",1070383,67,24,0,91
"70384",1070384,120,50,6,176
"70385",1070385,15,175,8,198
"70386",1070386,178,96,10,284
"70387",1070387,136,150,10,296
"70388",1070388,90,115,7,212
"70389",1070389,72,135,10,217
"70390",1070390,103,142,18,263
"70391",1070391,183,40,7,230
"70392",1070392,94,64,7,165
"70393",1070393,154,62,5,221
"70394",1070394,88,132,8,228
"70395",1070395,137,56,9,202
"70396",1070396,57,146,4,207
"70397",1070397,222,80,7,309
"70398",1070398,89,174,12,275
"70399",1070399,30,189,3,222
"70400",1070400,53,176,5,234
"70401",1070401,108,14,1,123
"70402",1070402,66,176,4,246
"70403",1070403,167,75,5,247
"70404",1070404,105,173,9,287
"70405",1070405,149,133,18,300
"70406",1070406,98,22,2,122
"70407",1070407,144,31,5,180
"70408",1070408,92,153,10,255
"70409",1070409,205,12,4,221
"70410",1070410,101,94,15,210
"70411",1070411,212,29,1,242
"70412",1070412,13,118,6,137
"70413",1070413,90,152,7,249
"70414",1070414,93,54,5,152
"70415",1070415,99,123,14,236
"70416",1070416,20,26,2,48
"70417",1070417,90,143,8,241
"70418",1070418,81,9,3,93
"70419",1070419,138,8,14,160
"70420",1070420,40,225,4,269
"70421",1070421,157,125,11,293
"70422",1070422,92,161,15,268
"70423",1070423,54,247,10,311
"70424",1070424,23,223,2,248
"70425",1070425,36,171,3,210
"70426",1070426,79,102,9,190
"70427",1070427,82,123,5,210
"70428",1070428,21,11,4,36
"70429",1070429,127,163,0,290
"70430",1070430,25,198,8,231
"70431",1070431,70,210,7,287
"70432",1070432,62,142,7,211
"70433",1070433,19,106,5,130
"70434",1070434,47,78,2,127
"70435",1070435,24,262,1,287
"70436",1070436,61,158,6,225
"70437",1070437,61,167,9,237
"70438",1070438,197,24,9,230
"70439",1070439,118,149,7,274
"70440",1070440,123,55,11,189
"70441",1070441,70,185,3,258
"70442",1070442,105,58,1,164
"70443",1070443,164,110,17,291
"70444",1070444,121,117,3,241
"70445",1070445,75,107,6,188
"70446",1070446,68,159,17,244
"70447",1070447,147,112,17,276
"70448",1070448,83,40,6,129
"70449",1070449,133,53,5,191
"70450",1070450,115,32,4,151
"70451",1070451,22,33,1,56
"70452",1070452,47,204,6,257
"70453",1070453,136,137,2,275
"70454",1070454,170,70,13,253
"70455",1070455,7,8,2,17
"70456",1070456,67,193,10,270
"70457",1070457,72,186,9,267
"70458",1070458,41,26,3,70
"70459",1070459,36,211,2,249
"70460",1070460,79,73,5,157
"70461",1070461,76,28,7,111
"70462",1070462,52,143,13,208
"70463",1070463,17,44,2,63
"70464",1070464,116,147,10,273
"70465",1070465,32,217,5,254
"70466",1070466,10,152,7,169
"70467",1070467,24,219,3,246
"70468",1070468,57,235,2,294
"70469",1070469,186,38,4,228
"70470",1070470,72,174,10,256
"70471",1070471,97,5,9,111
"70472",1070472,126,152,6,284
"70473",1070473,117,108,7,232
"70474",1070474,156,129,15,300
"70475",1070475,62,38,3,103
"70476",1070476,70,184,10,264
"70477",1070477,230,78,22,330
"70478",1070478,128,65,3,196
"70479",1070479,94,99,7,200
"70480",1070480,34,52,7,93
"70481",1070481,111,158,11,280
"70482",1070482,22,250,7,279
"70483",1070483,183,136,10,329
"70484",1070484,109,79,13,201
"70485",1070485,167,91,11,269
"70486",1070486,32,1,0,33
"70487",1070487,127,57,16,200
"70488",1070488,86,108,9,203
"70489",1070489,50,228,8,286
"70490",1070490,218,32,9,259
"70491",1070491,82,1,1,84
"70492",1070492,192,53,10,255
"70493",1070493,53,130,10,193
"70494",1070494,64,163,2,229
"70495",1070495,173,56,7,236
"70496",1070496,43,44,4,91
"70497",1070497,97,167,7,271
"70498",1070498,61,302,2,365
"70499",1070499,210,29,8,247
"70500",1070500,35,218,2,255
"70501",1070501,100,134,20,254
"70502",1070502,136,83,3,222
"70503",1070503,189,84,10,283
"70504",1070504,54,252,5,311
"70505",1070505,11,11,3,25
"70506",1070506,177,39,13,229
"70507",1070507,57,241,18,316
"70508",1070508,142,56,3,201
"70509",1070509,161,45,8,214
"70510",1070510,35,37,7,79
"70511",1070511,96,60,1,157
"70512",1070512,121,56,12,189
"70513",1070513,118,52,7,177
"70514",1070514,90,195,18,303
"70515",1070515,169,72,8,249
"70516",1070516,111,59,14,184
"70517",1070517,159,90,12,261
"70518",1070518,56,195,3,254
"70519",1070519,187,22,12,221
"70520",1070520,25,256,4,285
"70521",1070521,52,189,6,247
"70522",1070522,212,31,8,251
"70523",1070523,122,80,14,216
"70524",1070524,88,122,3,213
"70525",1070525,88,202,7,297
"70526",1070526,119,163,20,302
"70527",1070527,21,145,4,170
"70528",1070528,121,99,10,230
"70529",1070529,221,37,8,266
"70530",1070530,1,1,1,3
"70531",1070531,149,34,5,188
"70532",1070532,42,16,0,58
"70533",1070533,114,87,9,210
"70534",1070534,71,234,8,313
"70535",1070535,201,59,10,270
"70536",1070536,167,109,5,281
"70537",1070537,63,64,3,130
"70538",1070538,141,95,2,238
"70539",1070539,112,190,10,312
"70540",1070540,123,72,8,203
"70541",1070541,117,71,6,194
"70542",1070542,24,249,8,281
"70543",1070543,157,49,15,221
"70544",1070544,86,139,10,235
"70545",1070545,110,131,3,244
"70546",1070546,162,66,11,239
"70547",1070547,60,156,8,224
"70548",1070548,119,16,3,138
"70549",1070549,43,39,4,86
"70550",1070550,80,68,2,150
"70551",1070551,80,78,5,163
"70552",1070552,123,119,7,249
"70553",1070553,105,51,2,158
"70554",1070554,179,43,9,231
"70555",1070555,100,142,5,247
"70556",1070556,83,183,6,272
"70557",1070557,187,26,8,221
"70558",1070558,65,96,19,180
"70559",1070559,16,12,6,34
"70560",1070560,57,167,10,234
"70561",1070561,166,57,6,229
"70562",1070562,181,26,8,215
"70563",1070563,109,168,16,293
"70564",1070564,140,110,2,252
"70565",1070565,140,133,8,281
"70566",1070566,143,71,11,225
"70567",1070567,135,84,8,227
"70568",1070568,78,186,12,276
"70569",1070569,33,200,8,241
"70570",1070570,115,73,9,197
"70571",1070571,119,28,2,149
"70572",1070572,118,45,4,167
"70573",1070573,47,189,3,239
"70574",1070574,124,103,8,235
"70575",1070575,29,77,2,108
"70576",1070576,148,68,19,235
"70577",1070577,234,27,7,268
"70578",1070578,25,48,0,73
"70579",1070579,65,62,10,137
"70580",1070580,215,56,10,281
"70581",1070581,108,99,10,217
"70582",1070582,23,74,2,99
"70583",1070583,77,150,10,237
"70584",1070584,139,13,9,161
"70585",1070585,29,196,9,234
"70586",1070586,223,80,7,310
"70587",1070587,112,61,14,187
"70588",1070588,28,20,4,52
"70589",1070589,123,15,2,140
"70590",1070590,22,32,0,54
"70591",1070591,147,64,5,216
"70592",1070592,35,285,2,322
"70593",1070593,180,61,12,253
"70594",1070594,50,250,15,315
"70595",1070595,55,156,7,218
"70596",1070596,132,91,3,226
"70597",1070597,128,142,12,282
"70598",1070598,153,112,9,274
"70599",1070599,159,40,6,205
"70600",1070600,89,110,6,205
"70601",1070601,13,143,5,161
"70602",1070602,75,121,28,224
"70603",1070603,189,117,19,325
"70604",1070604,1,103,1,105
"70605",1070605,5,260,2,267
"70606",1070606,174,41,6,221
"70607",1070607,147,195,6,348
"70608",1070608,39,20,1,60
"70609",1070609,83,167,15,265
"70610",1070610,193,53,6,252
"70611",1070611,165,114,8,287
"70612",1070612,180,1,2,183
"70613",1070613,75,126,3,204
"70614",1070614,53,150,12,215
"70615",1070615,153,83,14,250
"70616",1070616,219,13,10,242
"70617",1070617,95,111,7,213
"70618",1070618,62,97,5,164
"70619",1070619,62,190,10,262
"70620",1070620,90,63,10,163
"70621",1070621,132,42,10,184
"70622",1070622,183,114,14,311
"70623",1070623,118,25,4,147
"70624",1070624,150,87,12,249
"70625",1070625,91,129,9,229
"70626",1070626,143,109,6,258
"70627",1070627,128,176,25,329
"70628",1070628,184,55,8,247
"70629",1070629,250,10,4,264
"70630",1070630,105,196,15,316
"70631",1070631,124,154,13,291
"70632",1070632,58,150,2,210
"70633",1070633,146,93,5,244
"70634",1070634,10,76,1,87
"70635",1070635,83,123,13,219
"70636",1070636,154,33,8,195
"70637",1070637,250,31,8,289
"70638",1070638,108,118,14,240
"70639",1070639,93,1,2,96
"70640",1070640,109,121,11,241
"70641",1070641,29,12,1,42
"70642",1070642,45,26,3,74
"70643",1070643,69,165,6,240
"70644",1070644,16,144,0,160
"70645",1070645,64,173,5,242
"70646",1070646,137,118,5,260
"70647",1070647,88,134,4,226
"70648",1070648,92,79,3,174
"70649",1070649,17,46,2,65
"70650",1070650,60,193,25,278
"70651",1070651,44,202,10,256
"70652",1070652,8,2,1,11
"70653",1070653,124,167,15,306
"70654",1070654,179,103,6,288
"70655",1070655,180,86,15,281
"70656",1070656,37,270,10,317
"70657",1070657,118,24,2,144
"70658",1070658,123,36,4,163
"70659",1070659,131,36,3,170
"70660",1070660,23,146,3,172
"70661",1070661,43,165,5,213
"70662",1070662,93,106,7,206
"70663",1070663,164,142,22,328
"70664",1070664,158,67,4,229
"70665",1070665,100,207,4,311
"70666",1070666,224,83,12,319
"70667",1070667,125,122,8,255
"70668",1070668,58,37,6,101
"70669",1070669,223,86,9,318
"70670",1070670,206,70,10,286
"70671",1070671,172,107,5,284
"70672",1070672,54,46,4,104
"70673",1070673,37,176,6,219
"70674",1070674,177,13,6,196
"70675",1070675,69,65,7,141
"70676",1070676,89,116,2,207
"70677",1070677,33,255,6,294
"70678",1070678,123,60,6,189
"70679",1070679,83,108,1,192
"70680",1070680,31,274,13,318
"70681",1070681,91,88,7,186
"70682",1070682,79,101,8,188
"70683",1070683,90,140,4,234
"70684",1070684,145,73,7,225
"70685",1070685,167,62,10,239
"70686",1070686,105,177,13,295
"70687",1070687,165,155,13,333
"70688",1070688,25,149,12,186
"70689",1070689,37,9,3,49
"70690",1070690,225,54,7,286
"70691",1070691,39,11,5,55
"70692",1070692,173,52,10,235
"70693",1070693,127,27,4,158
"70694",1070694,65,174,10,249
"70695",1070695,35,138,4,177
"70696",1070696,36,202,8,246
"70697",1070697,219,45,8,272
"70698",1070698,131,129,7,267
"70699",1070699,181,50,11,242
"70700",1070700,140,48,12,200
"70701",1070701,108,116,3,227
"70702",1070702,142,33,13,188
"70703",1070703,169,121,9,299
"70704",1070704,10,57,7,74
"70705",1070705,36,27,2,65
"70706",1070706,150,13,9,172
"70707",1070707,62,177,14,253
"70708",1070708,39,237,4,280
"70709",1070709,192,27,6,225
"70710",1070710,89,88,3,180
"70711",1070711,90,197,8,295
"70712",1070712,92,71,11,174
"70713",1070713,39,6,2,47
"70714",1070714,126,147,13,286
"70715",1070715,104,110,9,223
"70716",1070716,237,18,5,260
"70717",1070717,55,228,2,285
"70718",1070718,142,41,10,193
"70719",1070719,38,271,7,316
"70720",1070720,150,68,9,227
"70721",1070721,161,96,10,267
"70722",1070722,48,216,7,271
"70723",1070723,62,195,11,268
"70724",1070724,210,69,18,297
"70725",1070725,114,142,15,271
"70726",1070726,148,53,13,214
"70727",1070727,111,210,19,340
"70728",1070728,38,124,9,171
"70729",1070729,52,77,8,137
"70730",1070730,105,45,5,155
"70731",1070731,169,129,13,311
"70732",1070732,32,159,7,198
"70733",1070733,144,94,5,243
"70734",1070734,227,19,1,247
"70735",1070735,81,37,7,125
"70736",1070736,72,176,14,262
"70737",1070737,83,148,7,238
"70738",1070738,50,249,8,307
"70739",1070739,147,128,17,292
"70740",1070740,80,134,8,222
"70741",1070741,100,177,13,290
"70742",1070742,56,183,13,252
"70743",1070743,58,148,6,212
"70744",1070744,159,136,6,301
"70745",1070745,24,137,7,168
"70746",1070746,229,5,5,239
"70747",1070747,190,32,7,229
"70748",1070748,224,31,12,267
"70749",1070749,172,28,11,211
"70750",1070750,149,71,4,224
"70751",1070751,19,219,3,241
"70752",1070752,71,198,9,278
"70753",1070753,221,26,14,261
"70754",1070754,156,92,11,259
"70755",1070755,26,93,5,124
"70756",1070756,136,99,15,250
"70757",1070757,75,203,9,287
"70758",1070758,82,128,7,217
"70759",1070759,117,85,5,207
"70760",1070760,198,66,14,278
"70761",1070761,172,7,5,184
"70762",1070762,53,208,3,264
"70763",1070763,24,53,0,77
"70764",1070764,56,113,2,171
"70765",1070765,71,60,11,142
"70766",1070766,178,130,14,322
"70767",1070767,109,126,14,249
"70768",1070768,35,103,4,142
"70769",1070769,146,201,14,361
"70770",1070770,188,115,14,317
"70771",1070771,233,35,7,275
"70772",1070772,138,119,16,273
"70773",1070773,67,166,7,240
"70774",1070774,109,189,23,321
"70775",1070775,133,49,8,190
"70776",1070776,82,179,6,267
"70777",1070777,193,29,5,227
"70778",1070778,194,26,4,224
"70779",1070779,64,99,7,170
"70780",1070780,46,2,2,50
"70781",1070781,156,38,5,199
"70782",1070782,200,88,11,299
"70783",1070783,163,138,11,312
"70784",1070784,281,36,4,321
"70785",1070785,152,34,5,191
"70786",1070786,135,91,3,229
"70787",1070787,186,69,8,263
"70788",1070788,250,30,7,287
"70789",1070789,145,160,13,318
"70790",1070790,92,176,19,287
"70791",1070791,201,32,13,246
"70792",1070792,226,48,8,282
"70793",1070793,85,46,15,146
"70794",1070794,110,147,25,282
"70795",1070795,63,271,6,340
"70796",1070796,128,17,6,151
"70797",1070797,245,18,7,270
"70798",1070798,34,35,2,71
"70799",1070799,116,33,2,151
"70800",1070800,80,195,6,281
"70801",1070801,173,115,5,293
"70802",1070802,56,53,11,120
"70803",1070803,84,95,4,183
"70804",1070804,103,79,8,190
"70805",1070805,37,87,2,126
"70806",1070806,83,137,6,226
"70807",1070807,129,79,6,214
"70808",1070808,199,63,15,277
"70809",1070809,32,31,1,64
"70810",1070810,137,30,3,170
"70811",1070811,137,25,16,178
"70812",1070812,236,33,8,277
"70813",1070813,152,52,0,204
"70814",1070814,96,186,5,287
"70815",1070815,207,71,11,289
"70816",1070816,259,25,9,293
"70817",1070817,105,130,9,244
"70818",1070818,181,40,4,225
"70819",1070819,56,28,1,85
"70820",1070820,134,88,9,231
"70821",1070821,158,128,11,297
"70822",1070822,155,40,8,203
"70823",1070823,283,227,36,546
"70824",1070824,80,164,4,248
"70825",1070825,117,111,6,234
"70826",1070826,112,75,16,203
"70827",1070827,110,73,5,188
"70828",1070828,64,222,11,297
"70829",1070829,67,165,15,247
"70830",1070830,76,14,4,94
"70831",1070831,32,14,0,46
"70832",1070832,57,142,12,211
"70833",1070833,159,106,12,277
"70834",1070834,169,76,8,253
"70835",1070835,19,37,1,57
"70836",1070836,176,87,22,285
"70837",1070837,59,121,2,182
"70838",1070838,42,247,8,297
"70839",1070839,73,129,7,209
"70840",1070840,19,2,1,22
"70841",1070841,25,264,5,294
"70842",1070842,195,19,6,220
"70843",1070843,101,168,13,282
"70844",1070844,101,171,8,280
"70845",1070845,66,145,2,213
"70846",1070846,69,225,12,306
"70847",1070847,162,97,17,276
"70848",1070848,207,104,20,331
"70849",1070849,144,4,4,152
"70850",1070850,127,160,16,303
"70851",1070851,193,72,10,275
"70852",1070852,153,78,10,241
"70853",1070853,111,127,12,250
"70854",1070854,111,88,23,222
"70855",1070855,109,97,7,213
"70856",1070856,221,30,3,254
"70857",1070857,167,48,14,229
"70858",1070858,55,110,3,168
"70859",1070859,50,151,5,206
"70860",1070860,51,144,3,198
"70861",1070861,36,269,3,308
"70862",1070862,219,21,1,241
"70863",1070863,69,183,5,257
"70864",1070864,183,97,21,301
"70865",1070865,51,136,6,193
"70866",1070866,71,146,4,221
"70867",1070867,86,135,15,236
"70868",1070868,158,72,3,233
"70869",1070869,41,91,12,144
"70870",1070870,105,73,10,188
"70871",1070871,8,17,0,25
"70872",1070872,109,10,1,120
"70873",1070873,125,57,12,194
"70874",1070874,228,43,18,289
"70875",1070875,107,117,11,235
"70876",1070876,154,33,9,196
"70877",1070877,40,58,4,102
"70878",1070878,211,92,16,319
"70879",1070879,181,56,17,254
"70880",1070880,178,74,10,262
"70881",1070881,56,149,6,211
"70882",1070882,136,56,10,202
"70883",1070883,200,77,15,292
"70884",1070884,73,110,2,185
"70885",1070885,86,140,14,240
"70886",1070886,48,213,3,264
"70887",1070887,193,108,9,310
"70888",1070888,85,103,3,191
"70889",1070889,71,198,11,280
"70890",1070890,156,86,14,256
"70891",1070891,113,90,9,212
"70892",1070892,24,256,3,283
"70893",1070893,49,144,7,200
"70894",1070894,236,23,7,266
"70895",1070895,131,58,12,201
"70896",1070896,136,184,20,340
"70897",1070897,40,224,3,267
"70898",1070898,62,193,5,260
"70899",1070899,155,139,17,311
"70900",1070900,212,51,11,274
"70901",1070901,103,134,3,240
"70902",1070902,85,132,7,224
"70903",1070903,44,211,3,258
"70904",1070904,258,41,13,312
"70905",1070905,91,69,5,165
"70906",1070906,79,89,8,176
"70907",1070907,38,109,8,155
"70908",1070908,124,109,8,241
"70909",1070909,151,139,20,310
"70910",1070910,91,135,22,248
"70911",1070911,73,73,3,149
"70912",1070912,99,45,5,149
"70913",1070913,108,160,16,284
"70914",1070914,168,82,13,263
"70915",1070915,156,65,9,230
"70916",1070916,21,19,2,42
"70917",1070917,44,54,8,106
"70918",1070918,82,195,2,279
"70919",1070919,86,232,10,328
"70920",1070920,144,145,12,301
"70921",1070921,149,49,8,206
"70922",1070922,237,8,8,253
"70923",1070923,109,152,4,265
"70924",1070924,176,92,9,277
"70925",1070925,162,120,12,294
"70926",1070926,197,25,8,230
"70927",1070927,128,85,3,216
"70928",1070928,166,62,9,237
"70929",1070929,152,10,9,171
"70930",1070930,91,184,7,282
"70931",1070931,81,43,6,130
"70932",1070932,140,66,0,206
"70933",1070933,331,72,28,431
"70934",1070934,132,69,10,211
"70935",1070935,36,35,4,75
"70936",1070936,111,85,4,200
"70937",1070937,125,123,10,258
"70938",1070938,155,103,6,264
"70939",1070939,74,206,4,284
"70940",1070940,47,223,2,272
"70941",1070941,171,64,6,241
"70942",1070942,128,47,9,184
"70943",1070943,18,72,0,90
"70944",1070944,106,133,12,251
"70945",1070945,138,21,8,167
"70946",1070946,86,197,11,294
"70947",1070947,62,172,14,248
"70948",1070948,159,2,0,161
"70949",1070949,151,111,8,270
"70950",1070950,37,67,3,107
"70951",1070951,43,229,2,274
"70952",1070952,23,214,2,239
"70953",1070953,109,37,2,148
"70954",1070954,197,23,8,228
"70955",1070955,103,55,3,161
"70956",1070956,134,78,10,222
"70957",1070957,89,150,4,243
"70958",1070958,122,9,2,133
"70959",1070959,10,24,1,35
"70960",1070960,96,174,14,284
"70961",1070961,147,69,4,220
"70962",1070962,100,87,0,187
"70963",1070963,36,65,0,101
"70964",1070964,141,51,5,197
"70965",1070965,62,36,3,101
"70966",1070966,143,26,8,177
"70967",1070967,128,67,6,201
"70968",1070968,127,50,6,183
"70969",1070969,47,156,4,207
"70970",1070970,189,45,5,239
"70971",1070971,97,43,8,148
"70972",1070972,214,63,1,278
"70973",1070973,133,52,5,190
"70974",1070974,209,22,10,241
"70975",1070975,42,2,1,45
"70976",1070976,80,58,7,145
"70977",1070977,56,250,1,307
"70978",1070978,47,137,4,188
"70979",1070979,20,47,5,72
"70980",1070980,85,196,8,289
"70981",1070981,155,70,9,234
"70982",1070982,118,193,17,328
"70983",1070983,173,59,13,245
"70984",1070984,191,19,9,219
"70985",1070985,70,182,8,260
"70986",1070986,273,51,7,331
"70987",1070987,69,180,5,254
"70988",1070988,86,215,8,309
"70989",1070989,96,159,6,261
"70990",1070990,73,61,6,140
"70991",1070991,56,12,0,68
"70992",1070992,99,1,7,107
"70993",1070993,61,135,9,205
"70994",1070994,135,51,6,192
"70995",1070995,73,36,5,114
"70996",1070996,179,25,9,213
"70997",1070997,115,34,3,152
"70998",1070998,87,205,11,303
"70999",1070999,70,85,4,159
"71000",1071000,83,74,13,170
"71001",1071001,86,100,5,191
"71002",1071002,13,206,0,219
"71003",1071003,125,103,8,236
"71004",1071004,129,75,20,224
"71005",1071005,12,4,0,16
"71006",1071006,121,71,7,199
"71007",1071007,127,60,5,192
"71008",1071008,196,71,9,276
"71009",1071009,185,51,12,248
"71010",1071010,80,102,8,190
"71011",1071011,87,153,5,245
"71012",1071012,45,31,7,83
"71013",1071013,219,59,9,287
"71014",1071014,143,89,13,245
"71015",1071015,9,7,3,19
"71016",1071016,138,39,9,186
"71017",1071017,64,210,1,275
"71018",1071018,86,132,15,233
"71019",1071019,54,233,8,295
"71020",1071020,100,177,13,290
"71021",1071021,105,80,2,187
"71022",1071022,73,197,2,272
"71023",1071023,81,73,2,156
"71024",1071024,142,64,7,213
"71025",1071025,40,146,1,187
"71026",1071026,63,210,6,279
"71027",1071027,80,201,2,283
"71028",1071028,129,142,13,284
"71029",1071029,195,31,5,231
"71030",1071030,50,247,4,301
"71031",1071031,130,125,25,280
"71032",1071032,121,168,22,311
"71033",1071033,198,33,11,242
"71034",1071034,47,96,2,145
"71035",1071035,62,114,6,182
"71036",1071036,51,41,1,93
"71037",1071037,37,223,9,269
"71038",1071038,46,216,11,273
"71039",1071039,4,17,1,22
"71040",1071040,80,91,6,177
"71041",1071041,19,185,9,213
"71042",1071042,117,44,7,168
"71043",1071043,161,54,8,223
"71044",1071044,121,47,10,178
"71045",1071045,42,207,5,254
"71046",1071046,111,26,1,138
"71047",1071047,121,80,7,208
"71048",1071048,96,165,3,264
"71049",1071049,46,184,1,231
"71050",1071050,140,111,10,261
"71051",1071051,134,95,8,237
"71052",1071052,87,185,11,283
"71053",1071053,61,214,7,282
"71054",1071054,147,174,5,326
"71055",1071055,159,7,6,172
"71056",1071056,153,83,15,251
"71057",1071057,99,130,21,250
"71058",1071058,138,23,3,164
"71059",1071059,76,141,17,234
"71060",1071060,13,11,2,26
"71061",1071061,103,83,7,193
"71062",1071062,120,102,12,234
"71063",1071063,131,109,14,254
"71064",1071064,149,97,17,263
"71065",1071065,32,246,15,293
"71066",1071066,161,48,9,218
"71067",1071067,167,142,7,316
"71068",1071068,108,88,2,198
"71069",1071069,36,133,1,170
"71070",1071070,153,105,7,265
"71071",1071071,124,110,6,240
"71072",1071072,117,127,7,251
"71073",1071073,148,57,14,219
"71074",1071074,128,86,16,230
"71075",1071075,148,60,7,215
"71076",1071076,58,160,6,224
"71077",1071077,94,18,2,114
"71078",1071078,115,155,10,280
"71079",1071079,193,117,17,327
"71080",1071080,52,154,20,226
"71081",1071081,123,37,9,169
"71082",1071082,55,161,8,224
"71083",1071083,18,214,6,238
"71084",1071084,184,33,3,220
"71085",1071085,183,90,4,277
"71086",1071086,142,125,9,276
"71087",1071087,95,159,19,273
"71088",1071088,231,91,6,328
"71089",1071089,263,11,8,282
"71090",1071090,66,218,7,291
"71091",1071091,58,31,1,90
"71092",1071092,124,46,5,175
"71093",1071093,69,37,2,108
"71094",1071094,132,45,6,183
"71095",1071095,179,33,8,220
"71096",1071096,17,167,2,186
"71097",1071097,224,12,7,243
"71098",1071098,29,100,5,134
"71099",1071099,153,23,3,179
"71100",1071100,42,166,9,217
"71101",1071101,192,77,23,292
"71102",1071102,105,16,1,122
"71103",1071103,123,134,20,277
"71104",1071104,33,150,3,186
"71105",1071105,95,26,11,132
"71106",1071106,118,36,7,161
"71107",1071107,64,3,2,69
"71108",1071108,102,156,16,274
"71109",1071109,42,144,5,191
"71110",1071110,171,78,9,258
"71111",1071111,15,12,0,27
"71112",1071112,186,46,9,241
"71113",1071113,110,174,14,298
"71114",1071114,142,37,6,185
"71115",1071115,235,42,7,284
"71116",1071116,195,63,20,278
"71117",1071117,131,208,38,377
"71118",1071118,192,79,4,275
"71119",1071119,3,3,0,6
"71120",1071120,67,166,5,238
"71121",1071121,27,2,2,31
"71122",1071122,31,193,9,233
"71123",1071123,160,30,5,195
"71124",1071124,3,3,0,6
"71125",1071125,200,80,10,290
"71126",1071126,3,141,4,148
"71127",1071127,75,153,10,238
"71128",1071128,158,48,6,212
"71129",1071129,58,195,6,259
"71130",1071130,35,271,2,308
"71131",1071131,55,199,10,264
"71132",1071132,126,94,21,241
"71133",1071133,62,211,20,293
"71134",1071134,83,100,4,187
"71135",1071135,43,34,3,80
"71136",1071136,56,200,3,259
"71137",1071137,178,72,7,257
"71138",1071138,146,144,16,306
"71139",1071139,196,84,14,294
"71140",1071140,27,259,3,289
"71141",1071141,8,5,0,13
"71142",1071142,76,141,6,223
"71143",1071143,89,154,19,262
"71144",1071144,95,208,26,329
"71145",1071145,39,173,8,220
"71146",1071146,218,58,2,278
"71147",1071147,159,100,4,263
"71148",1071148,193,51,4,248
"71149",1071149,17,9,1,27
"71150",1071150,167,135,9,311
"71151",1071151,16,49,2,67
"71152",1071152,193,3,2,198
"71153",1071153,172,72,9,253
"71154",1071154,124,104,13,241
"71155",1071155,104,159,24,287
"71156",1071156,93,87,9,189
"71157",1071157,61,172,10,243
"71158",1071158,82,144,8,234
"71159",1071159,52,83,1,136
"71160",1071160,33,260,0,293
"71161",1071161,202,48,12,262
"71162",1071162,53,221,5,279
"71163",1071163,205,53,6,264
"71164",1071164,54,255,3,312
"71165",1071165,148,35,1,184
"71166",1071166,75,153,3,231
"71167",1071167,134,19,10,163
"71168",1071168,5,24,0,29
"71169",1071169,6,8,1,15
"71170",1071170,144,130,10,284
"71171",1071171,80,151,9,240
"71172",1071172,78,75,2,155
"71173",1071173,184,110,7,301
"71174",1071174,74,9,1,84
"71175",1071175,218,57,11,286
"71176",1071176,75,103,6,184
"71177",1071177,70,228,5,303
"71178",1071178,181,51,17,249
"71179",1071179,87,203,6,296
"71180",1071180,65,169,12,246
"71181",1071181,211,20,5,236
"71182",1071182,57,34,3,94
"71183",1071183,127,120,7,254
"71184",1071184,101,151,3,255
"71185",1071185,172,114,20,306
"71186",1071186,223,42,8,273
"71187",1071187,257,34,11,302
"71188",1071188,68,107,5,180
"71189",1071189,87,32,11,130
"71190",1071190,120,145,7,272
"71191",1071191,120,115,10,245
"71192",1071192,27,113,3,143
"71193",1071193,55,260,6,321
"71194",1071194,57,192,5,254
"71195",1071195,67,249,11,327
"71196",1071196,98,191,22,311
"71197",1071197,144,126,12,282
"71198",1071198,114,97,4,215
"71199",1071199,68,105,12,185
"71200",1071200,217,2,0,219
"71201",1071201,149,97,8,254
"71202",1071202,119,183,21,323
"71203",1071203,171,90,13,274
"71204",1071204,126,46,7,179
"71205",1071205,79,169,8,256
"71206",1071206,139,87,8,234
"71207",1071207,206,26,14,246
"71208",1071208,116,72,8,196
"71209",1071209,133,129,21,283
"71210",1071210,45,196,3,244
"71211",1071211,181,98,11,290
"71212",1071212,46,231,4,281
"71213",1071213,130,280,11,421
"71214",1071214,24,117,3,144
"71215",1071215,154,38,5,197
"71216",1071216,223,13,9,245
"71217",1071217,150,71,16,237
"71218",1071218,24,260,1,285
"71219",1071219,109,47,6,162
"71220",1071220,189,13,3,205
"71221",1071221,90,184,8,282
"71222",1071222,65,140,12,217
"71223",1071223,70,162,10,242
"71224",1071224,176,79,16,271
"71225",1071225,109,65,10,184
"71226",1071226,245,26,9,280
"71227",1071227,86,187,11,284
"71228",1071228,238,19,7,264
"71229",1071229,192,20,6,218
"71230",1071230,82,21,4,107
"71231",1071231,121,147,13,281
"71232",1071232,158,164,12,334
"71233",1071233,57,148,6,211
"71234",1071234,16,1,1,18
"71235",1071235,67,135,3,205
"71236",1071236,79,62,6,147
"71237",1071237,90,142,10,242
"71238",1071238,150,63,17,230
"71239",1071239,84,149,7,240
"71240",1071240,33,74,3,110
"71241",1071241,83,165,21,269
"71242",1071242,61,127,5,193
"71243",1071243,160,87,4,251
"71244",1071244,123,154,29,306
"71245",1071245,35,88,5,128
"71246",1071246,35,105,1,141
"71247",1071247,5,3,1,9
"71248",1071248,149,117,15,281
"71249",1071249,126,186,17,329
"71250",1071250,128,87,8,223
"71251",1071251,24,190,6,220
"71252",1071252,81,138,9,228
"71253",1071253,125,18,2,145
"71254",1071254,92,139,15,246
"71255",1071255,200,22,6,228
"71256",1071256,8,8,1,17
"71257",1071257,110,152,12,274
"71258",1071258,97,178,14,289
"71259",1071259,31,29,1,61
"71260",1071260,80,175,11,266
"71261",1071261,108,7,2,117
"71262",1071262,40,149,9,198
"71263",1071263,129,48,7,184
"71264",1071264,126,129,6,261
"71265",1071265,89,231,5,325
"71266",1071266,68,167,7,242
"71267",1071267,123,103,11,237
"71268",1071268,196,12,3,211
"71269",1071269,150,123,12,285
"71270",1071270,206,28,8,242
"71271",1071271,16,161,4,181
"71272",1071272,154,99,9,262
"71273",1071273,270,19,4,293
"71274",1071274,21,152,3,176
"71275",1071275,148,69,4,221
"71276",1071276,119,66,3,188
"71277",1071277,63,167,6,236
"71278",1071278,134,205,5,344
"71279",1071279,137,101,14,252
"71280",1071280,33,18,2,53
"71281",1071281,25,10,3,38
"71282",1071282,81,183,9,273
"71283",1071283,79,145,15,239
"71284",1071284,99,209,16,324
"71285",1071285,108,131,8,247
"71286",1071286,99,206,10,315
"71287",1071287,190,53,4,247
"71288",1071288,137,105,9,251
"71289",1071289,40,192,6,238
"71290",1071290,19,15,2,36
"71291",1071291,43,40,3,86
"71292",1071292,131,149,18,298
"71293",1071293,11,54,2,67
"71294",1071294,211,8,2,221
"71295",1071295,189,8,4,201
"71296",1071296,72,59,10,141
"71297",1071297,37,12,2,51
"71298",1071298,93,136,7,236
"71299",1071299,183,57,14,254
"71300",1071300,88,154,14,256
"71301",1071301,131,169,16,316
"71302",1071302,118,160,5,283
"71303",1071303,127,54,5,186
"71304",1071304,167,71,12,250
"71305",1071305,51,237,7,295
"71306",1071306,170,165,10,345
"71307",1071307,126,68,20,214
"71308",1071308,158,66,3,227
"71309",1071309,182,52,3,237
"71310",1071310,79,118,12,209
"71311",1071311,148,48,5,201
"71312",1071312,199,60,2,261
"71313",1071313,96,95,4,195
"71314",1071314,167,59,15,241
"71315",1071315,129,141,17,287
"71316",1071316,105,172,6,283
"71317",1071317,63,170,12,245
"71318",1071318,86,59,7,152
"71319",1071319,154,35,3,192
"71320",1071320,30,115,5,150
"71321",1071321,108,76,12,196
"71322",1071322,101,62,4,167
"71323",1071323,121,199,13,333
"71324",1071324,81,201,16,298
"71325",1071325,24,27,3,54
"71326",1071326,81,68,1,150
"71327",1071327,198,68,12,278
"71328",1071328,197,86,8,291
"71329",1071329,175,44,8,227
"71330",1071330,216,33,11,260
"71331",1071331,24,136,5,165
"71332",1071332,76,63,4,143
"71333",1071333,5,8,0,13
"71334",1071334,119,45,7,171
"71335",1071335,23,95,16,134
"71336",1071336,95,109,19,223
"71337",1071337,128,75,3,206
"71338",1071338,215,79,15,309
"71339",1071339,129,137,6,272
"71340",1071340,155,61,7,223
"71341",1071341,173,55,11,239
"71342",1071342,61,150,13,224
"71343",1071343,128,159,9,296
"71344",1071344,78,207,17,302
"71345",1071345,148,52,4,204
"71346",1071346,82,217,10,309
"71347",1071347,35,59,2,96
"71348",1071348,156,62,17,235
"71349",1071349,64,52,1,117
"71350",1071350,135,95,11,241
"71351",1071351,178,59,4,241
"71352",1071352,234,166,8,408
"71353",1071353,110,34,1,145
"71354",1071354,29,213,3,245
"71355",1071355,42,247,8,297
"71356",1071356,70,204,4,278
"71357",1071357,101,63,11,175
"71358",1071358,16,289,4,309
"71359",1071359,72,216,5,293
"71360",1071360,169,131,25,325
"71361",1071361,96,122,14,232
"71362",1071362,126,27,4,157
"71363",1071363,139,55,5,199
"71364",1071364,22,7,0,29
"71365",1071365,154,50,8,212
"71366",1071366,135,43,10,188
"71367",1071367,137,123,4,264
"71368",1071368,54,245,1,300
"71369",1071369,34,222,5,261
"71370",1071370,193,43,3,239
"71371",1071371,152,108,7,267
"71372",1071372,77,139,15,231
"71373",1071373,97,112,4,213
"71374",1071374,95,14,2,111
"71375",1071375,28,96,1,125
"71376",1071376,161,85,14,260
"71377",1071377,179,11,4,194
"71378",1071378,156,50,6,212
"71379",1071379,77,76,3,156
"71380",1071380,175,91,2,268
"71381",1071381,22,157,3,182
"71382",1071382,35,44,2,81
"71383",1071383,164,101,12,277
"71384",1071384,152,134,10,296
"71385",1071385,101,141,9,251
"71386",1071386,132,158,15,305
"71387",1071387,111,162,7,280
"71388",1071388,107,84,1,192
"71389",1071389,70,182,3,255
"71390",1071390,125,201,16,342
"71391",1071391,140,70,11,221
"71392",1071392,102,27,4,133
"71393",1071393,130,82,7,219
"71394",1071394,21,166,7,194
"71395",1071395,113,128,6,247
"71396",1071396,40,240,6,286
"71397",1071397,128,165,6,299
"71398",1071398,133,58,4,195
"71399",1071399,123,66,6,195
"71400",1071400,85,93,8,186
"71401",1071401,192,56,11,259
"71402",1071402,44,22,2,68
"71403",1071403,107,131,8,246
"71404",1071404,117,112,3,232
"71405",1071405,132,161,21,314
"71406",1071406,44,133,17,194
"71407",1071407,102,119,3,224
"71408",1071408,71,190,5,266
"71409",1071409,78,202,7,287
"71410",1071410,37,37,2,76
"71411",1071411,24,29,3,56
"71412",1071412,123,133,19,275
"71413",1071413,254,30,11,295
"71414",1071414,141,0,3,144
"71415",1071415,38,162,2,202
"71416",1071416,47,256,6,309
"71417",1071417,61,154,6,221
"71418",1071418,84,14,10,108
"71419",1071419,136,162,8,306
"71420",1071420,30,115,4,149
"71421",1071421,184,27,5,216
"71422",1071422,133,100,8,241
"71423",1071423,66,152,7,225
"71424",1071424,38,276,5,319
"71425",1071425,159,181,21,361
"71426",1071426,103,37,13,153
"71427",1071427,38,208,6,252
"71428",1071428,56,152,2,210
"71429",1071429,58,229,6,293
"71430",1071430,9,4,1,14
"71431",1071431,187,27,5,219
"71432",1071432,36,208,7,251
"71433",1071433,113,31,10,154
"71434",1071434,151,25,8,184
"71435",1071435,117,153,10,280
"71436",1071436,144,90,4,238
"71437",1071437,36,56,1,93
"71438",1071438,81,140,8,229
"71439",1071439,186,47,12,245
"71440",1071440,35,9,2,46
"71441",1071441,157,34,6,197
"71442",1071442,59,174,8,241
"71443",1071443,49,226,4,279
"71444",1071444,86,147,2,235
"71445",1071445,8,15,2,25
"71446",1071446,109,29,5,143
"71447",1071447,64,184,10,258
"71448",1071448,50,207,16,273
"71449",1071449,51,285,4,340
"71450",1071450,83,73,10,166
"71451",1071451,86,220,32,338
"71452",1071452,81,101,4,186
"71453",1071453,64,65,4,133
"71454",1071454,182,59,8,249
"71455",1071455,165,118,10,293
"71456",1071456,52,263,16,331
"71457",1071457,199,30,6,235
"71458",1071458,162,120,16,298
"71459",1071459,144,58,4,206
"71460",1071460,65,69,7,141
"71461",1071461,57,268,5,330
"71462",1071462,52,157,6,215
"71463",1071463,199,29,20,248
"71464",1071464,81,230,22,333
"71465",1071465,126,57,7,190
"71466",1071466,177,53,4,234
"71467",1071467,197,19,9,225
"71468",1071468,90,89,5,184
"71469",1071469,184,65,10,259
"71470",1071470,118,71,6,195
"71471",1071471,124,86,15,225
"71472",1071472,198,49,14,261
"71473",1071473,89,191,6,286
"71474",1071474,40,33,1,74
"71475",1071475,111,137,5,253
"71476",1071476,27,149,2,178
"71477",1071477,176,15,6,197
"71478",1071478,101,121,28,250
"71479",1071479,108,143,12,263
"71480",1071480,69,50,9,128
"71481",1071481,185,19,7,211
"71482",1071482,40,229,6,275
"71483",1071483,158,76,7,241
"71484",1071484,90,158,3,251
"71485",1071485,72,204,12,288
"71486",1071486,155,119,17,291
"71487",1071487,115,180,11,306
"71488",1071488,127,168,9,304
"71489",1071489,68,30,3,101
"71490",1071490,108,172,7,287
"71491",1071491,224,24,9,257
"71492",1071492,41,202,12,255
"71493",1071493,108,64,8,180
"71494",1071494,182,97,9,288
"71495",1071495,39,134,4,177
"71496",1071496,91,31,5,127
"71497",1071497,120,158,18,296
"71498",1071498,112,20,0,132
"71499",1071499,24,25,1,50
"71500",1071500,136,106,10,252
"71501",1071501,285,20,45,350
"71502",1071502,68,175,13,256
"71503",1071503,122,74,8,204
"71504",1071504,100,170,5,275
"71505",1071505,17,41,2,60
"71506",1071506,197,81,11,289
"71507",1071507,24,107,6,137
"71508",1071508,150,78,5,233
"71509",1071509,62,57,4,123
"71510",1071510,184,52,14,250
"71511",1071511,125,158,14,297
"71512",1071512,160,34,7,201
"71513",1071513,52,202,6,260
"71514",1071514,48,120,11,179
"71515",1071515,125,180,18,323
"71516",1071516,6,12,0,18
"71517",1071517,82,47,8,137
"71518",1071518,136,34,10,180
"71519",1071519,139,21,3,163
"71520",1071520,62,255,16,333
"71521",1071521,212,47,7,266
"71522",1071522,162,118,24,304
"71523",1071523,53,227,2,282
"71524",1071524,269,32,15,316
"71525",1071525,153,83,4,240
"71526",1071526,162,85,11,258
"71527",1071527,187,106,13,306
"71528",1071528,147,81,3,231
"71529",1071529,178,55,11,244
"71530",1071530,84,188,13,285
"71531",1071531,57,163,9,229
"71532",1071532,188,60,4,252
"71533",1071533,69,17,3,89
"71534",1071534,73,200,9,282
"71535",1071535,146,86,9,241
"71536",1071536,65,118,2,185
"71537",1071537,123,31,3,157
"71538",1071538,58,99,0,157
"71539",1071539,129,60,5,194
"71540",1071540,72,149,17,238
"71541",1071541,170,77,21,268
"71542",1071542,76,175,8,259
"71543",1071543,48,79,1,128
"71544",1071544,92,217,10,319
"71545",1071545,105,115,22,242
"71546",1071546,12,312,3,327
"71547",1071547,189,34,9,232
"71548",1071548,22,270,3,295
"71549",1071549,146,74,11,231
"71550",1071550,176,26,8,210
"71551",1071551,234,58,7,299
"71552",1071552,185,58,6,249
"71553",1071553,16,7,1,24
"71554",1071554,143,57,9,209
"71555",1071555,144,93,4,241
"71556",1071556,69,144,12,225
"71557",1071557,132,98,19,249
"71558",1071558,108,32,10,150
"71559",1071559,107,141,9,257
"71560",1071560,118,54,5,177
"71561",1071561,108,125,8,241
"71562",1071562,196,25,9,230
"71563",1071563,51,157,3,211
"71564",1071564,121,126,6,253
"71565",1071565,39,103,2,144
"71566",1071566,210,52,13,275
"71567",1071567,3,47,0,50
"71568",1071568,48,178,7,233
"71569",1071569,198,55,0,253
"71570",1071570,105,99,20,224
"71571",1071571,95,152,5,252
"71572",1071572,136,154,10,300
"71573",1071573,203,71,5,279
"71574",1071574,148,124,14,286
"71575",1071575,143,64,13,220
"71576",1071576,236,31,3,270
"71577",1071577,216,21,8,245
"71578",1071578,228,15,8,251
"71579",1071579,2,25,1,28
"71580",1071580,236,37,2,275
"71581",1071581,242,69,5,316
"71582",1071582,179,59,3,241
"71583",1071583,128,47,4,179
"71584",1071584,186,68,12,266
"71585",1071585,44,54,5,103
"71586",1071586,104,172,13,289
"71587",1071587,31,76,4,111
"71588",1071588,59,138,14,211
"71589",1071589,127,123,5,255
"71590",1071590,72,174,16,262
"71591",1071591,102,79,16,197
"71592",1071592,153,159,6,318
"71593",1071593,59,235,5,299
"71594",1071594,202,25,5,232
"71595",1071595,173,81,11,265
"71596",1071596,60,116,4,180
"71597",1071597,35,92,3,130
"71598",1071598,66,118,12,196
"71599",1071599,44,158,4,206
"71600",1071600,163,171,4,338
"71601",1071601,2,12,0,14
"71602",1071602,64,46,7,117
"71603",1071603,11,2,0,13
"71604",1071604,53,150,4,207
"71605",1071605,9,3,0,12
"71606",1071606,129,86,15,230
"71607",1071607,138,63,9,210
"71608",1071608,65,62,10,137
"71609",1071609,250,65,8,323
"71610",1071610,186,19,6,211
"71611",1071611,30,124,4,158
"71612",1071612,90,61,12,163
"71613",1071613,86,155,5,246
"71614",1071614,105,30,2,137
"71615",1071615,142,148,3,293
"71616",1071616,110,157,12,279
"71617",1071617,75,157,18,250
"71618",1071618,172,161,13,346
"71619",1071619,128,77,6,211
"71620",1071620,81,172,4,257
"71621",1071621,250,65,5,320
"71622",1071622,165,0,1,166
"71623",1071623,162,83,5,250
"71624",1071624,87,184,7,278
"71625",1071625,61,154,9,224
"71626",1071626,205,72,14,291
"71627",1071627,108,143,11,262
"71628",1071628,162,108,17,287
"71629",1071629,83,31,12,126
"71630",1071630,107,100,16,223
"71631",1071631,191,94,5,290
"71632",1071632,180,24,5,209
"71633",1071633,86,180,9,275
"71634",1071634,162,72,4,238
"71635",1071635,80,88,1,169
"71636",1071636,147,43,9,199
"71637",1071637,13,164,10,187
"71638",1071638,93,190,18,301
"71639",1071639,183,68,13,264
"71640",1071640,97,85,12,194
"71641",1071641,102,82,14,198
"71642",1071642,39,165,9,213
"71643",1071643,120,117,13,250
"71644",1071644,47,156,4,207
"71645",1071645,73,62,12,147
"71646",1071646,174,84,17,275
"71647",1071647,115,146,20,281
"71648",1071648,149,90,6,245
"71649",1071649,115,43,12,170
"71650",1071650,147,108,23,278
"71651",1071651,207,63,10,280
"71652",1071652,53,164,14,231
"71653",1071653,107,120,9,236
"71654",1071654,110,169,8,287
"71655",1071655,148,151,20,319
"71656",1071656,168,68,4,240
"71657",1071657,190,24,5,219
"71658",1071658,205,46,8,259
"71659",1071659,111,50,3,164
"71660",1071660,152,35,1,188
"71661",1071661,61,29,9,99
"71662",1071662,156,61,7,224
"71663",1071663,79,222,15,316
"71664",1071664,206,33,9,248
"71665",1071665,12,71,4,87
"71666",1071666,177,40,11,228
"71667",1071667,70,202,12,284
"71668",1071668,118,143,8,269
"71669",1071669,115,138,5,258
"71670",1071670,137,95,5,237
"71671",1071671,154,119,13,286
"71672",1071672,119,92,11,222
"71673",1071673,33,182,2,217
"71674",1071674,97,136,9,242
"71675",1071675,36,160,2,198
"71676",1071676,102,155,14,271
"71677",1071677,131,78,8,217
"71678",1071678,176,55,6,237
"71679",1071679,148,60,2,210
"71680",1071680,66,156,9,231
"71681",1071681,11,97,3,111
"71682",1071682,186,44,15,245
"71683",1071683,18,16,0,34
"71684",1071684,138,35,4,177
"71685",1071685,158,97,8,263
"71686",1071686,48,253,12,313
"71687",1071687,159,7,6,172
"71688",1071688,151,72,13,236
"71689",1071689,149,108,5,262
"71690",1071690,38,61,8,107
"71691",1071691,215,82,6,303
"71692",1071692,175,37,7,219
"71693",1071693,37,243,5,285
"71694",1071694,65,222,0,287
"71695",1071695,187,81,12,280
"71696",1071696,82,118,4,204
"71697",1071697,76,156,9,241
"71698",1071698,56,206,15,277
"71699",1071699,208,35,9,252
"71700",1071700,255,14,6,275
"71701",1071701,148,71,8,227
"71702",1071702,120,32,1,153
"71703",1071703,88,84,7,179
"71704",1071704,224,23,3,250
"71705",1071705,47,113,4,164
"71706",1071706,207,100,1,308
"71707",1071707,19,38,1,58
"71708",1071708,112,44,6,162
"71709",1071709,167,63,10,240
"71710",1071710,187,96,15,298
"71711",1071711,111,117,2,230
"71712",1071712,74,86,1,161
"71713",1071713,100,140,22,262
"71714",1071714,109,4,6,119
"71715",1071715,86,186,9,281
"71716",1071716,26,183,2,211
"71717",1071717,112,80,10,202
"71718",1071718,119,16,3,138
"71719",1071719,17,141,1,159
"71720",1071720,78,86,3,167
"71721",1071721,6,4,0,10
"71722",1071722,114,30,3,147
"71723",1071723,235,29,7,271
"71724",1071724,72,28,3,103
"71725",1071725,50,169,7,226
"71726",1071726,90,164,16,270
"71727",1071727,154,74,2,230
"71728",1071728,104,188,16,308
"71729",1071729,39,265,15,319
"71730",1071730,31,9,1,41
"71731",1071731,56,131,5,192
"71732",1071732,81,88,15,184
"71733",1071733,62,195,19,276
"71734",1071734,217,66,13,296
"71735",1071735,98,99,2,199
"71736",1071736,42,115,7,164
"71737",1071737,58,150,13,221
"71738",1071738,46,269,3,318
"71739",1071739,69,40,5,114
"71740",1071740,131,9,1,141
"71741",1071741,202,102,13,317
"71742",1071742,169,85,4,258
"71743",1071743,15,242,5,262
"71744",1071744,121,100,9,230
"71745",1071745,129,148,6,283
"71746",1071746,102,112,11,225
"71747",1071747,91,169,3,263
"71748",1071748,112,26,5,143
"71749",1071749,57,141,6,204
"71750",1071750,62,177,1,240
"71751",1071751,67,167,4,238
"71752",1071752,180,57,11,248
"71753",1071753,61,179,3,243
"71754",1071754,179,72,1,252
"71755",1071755,163,117,15,295
"71756",1071756,87,32,3,122
"71757",1071757,90,40,6,136
"71758",1071758,63,180,14,257
"71759",1071759,72,4,0,76
"71760",1071760,56,8,2,66
"71761",1071761,100,234,13,347
"71762",1071762,178,36,8,222
"71763",1071763,15,26,1,42
"71764",1071764,161,61,5,227
"71765",1071765,41,261,1,303
"71766",1071766,99,131,11,241
"71767",1071767,30,146,7,183
"71768",1071768,275,56,12,343
"71769",1071769,109,117,13,239
"71770",1071770,124,110,12,246
"71771",1071771,173,75,0,248
"71772",1071772,95,166,21,282
"71773",1071773,31,134,14,179
"71774",1071774,121,63,16,200
"71775",1071775,120,105,6,231
"71776",1071776,103,59,4,166
"71777",1071777,47,163,6,216
"71778",1071778,23,11,4,38
"71779",1071779,65,209,6,280
"71780",1071780,193,64,6,263
"71781",1071781,47,276,8,331
"71782",1071782,86,154,22,262
"71783",1071783,50,252,10,312
"71784",1071784,66,172,7,245
"71785",1071785,148,34,2,184
"71786",1071786,145,38,0,183
"71787",1071787,74,219,5,298
"71788",1071788,147,39,9,195
"71789",1071789,96,183,21,300
"71790",1071790,58,8,2,68
"71791",1071791,68,150,25,243
"71792",1071792,144,54,12,210
"71793",1071793,73,150,7,230
"71794",1071794,139,88,15,242
"71795",1071795,15,110,3,128
"71796",1071796,99,52,2,153
"71797",1071797,101,15,2,118
"71798",1071798,82,139,15,236
"71799",1071799,147,99,22,268
"71800",1071800,69,153,10,232
"71801",1071801,55,180,9,244
"71802",1071802,9,36,3,48
"71803",1071803,7,157,1,165
"71804",1071804,83,216,2,301
"71805",1071805,104,43,8,155
"71806",1071806,23,132,2,157
"71807",1071807,29,152,9,190
"71808",1071808,108,85,5,198
"71809",1071809,116,107,6,229
"71810",1071810,33,265,4,302
"71811",1071811,49,119,2,170
"71812",1071812,162,14,3,179
"71813",1071813,89,143,3,235
"71814",1071814,72,118,11,201
"71815",1071815,80,140,13,233
"71816",1071816,105,150,17,272
"71817",1071817,163,62,2,227
"71818",1071818,71,9,5,85
"71819",1071819,97,44,6,147
"71820",1071820,68,24,7,99
"71821",1071821,165,128,3,296
"71822",1071822,194,25,6,225
"71823",1071823,233,45,5,283
"71824",1071824,104,81,8,193
"71825",1071825,45,68,7,120
"71826",1071826,190,45,11,246
"71827",1071827,54,23,0,77
"71828",1071828,77,180,5,262
"71829",1071829,4,4,0,8
"71830",1071830,17,4,0,21
"71831",1071831,85,106,12,203
"71832",1071832,90,76,8,174
"71833",1071833,113,152,10,275
"71834",1071834,84,142,9,235
"71835",1071835,49,234,8,291
"71836",1071836,13,58,0,71
"71837",1071837,176,15,1,192
"71838",1071838,87,117,1,205
"71839",1071839,131,103,16,250
"71840",1071840,233,71,18,322
"71841",1071841,110,56,10,176
"71842",1071842,98,69,2,169
"71843",1071843,224,41,7,272
"71844",1071844,14,81,1,96
"71845",1071845,163,119,6,288
"71846",1071846,106,92,9,207
"71847",1071847,198,44,3,245
"71848",1071848,152,16,3,171
"71849",1071849,31,393,4,428
"71850",1071850,62,186,8,256
"71851",1071851,191,67,15,273
"71852",1071852,63,21,3,87
"71853",1071853,29,114,8,151
"71854",1071854,107,40,6,153
"71855",1071855,7,42,1,50
"71856",1071856,29,56,7,92
"71857",1071857,106,110,5,221
"71858",1071858,107,126,13,246
"71859",1071859,84,13,3,100
"71860",1071860,51,177,8,236
"71861",1071861,182,20,4,206
"71862",1071862,65,144,5,214
"71863",1071863,30,268,2,300
"71864",1071864,56,266,2,324
"71865",1071865,55,42,13,110
"71866",1071866,67,203,12,282
"71867",1071867,104,216,10,330
"71868",1071868,155,35,6,196
"71869",1071869,52,187,10,249
"71870",1071870,226,25,11,262
"71871",1071871,56,234,7,297
"71872",1071872,98,138,14,250
"71873",1071873,135,55,8,198
"71874",1071874,211,28,6,245
"71875",1071875,220,54,15,289
"71876",1071876,113,88,15,216
"71877",1071877,59,208,12,279
"71878",1071878,90,140,1,231
"71879",1071879,196,114,13,323
"71880",1071880,170,39,10,219
"71881",1071881,294,54,4,352
"71882",1071882,97,105,6,208
"71883",1071883,76,220,6,302
"71884",1071884,79,169,4,252
"71885",1071885,231,24,9,264
"71886",1071886,126,23,4,153
"71887",1071887,76,148,8,232
"71888",1071888,63,144,21,228
"71889",1071889,58,72,1,131
"71890",1071890,123,155,5,283
"71891",1071891,147,48,8,203
"71892",1071892,74,221,6,301
"71893",1071893,94,79,2,175
"71894",1071894,180,34,10,224
"71895",1071895,136,48,9,193
"71896",1071896,102,99,7,208
"71897",1071897,41,273,8,322
"71898",1071898,201,27,5,233
"71899",1071899,43,96,7,146
"71900",1071900,129,33,5,167
"71901",1071901,132,31,2,165
"71902",1071902,110,66,6,182
"71903",1071903,193,105,5,303
"71904",1071904,166,43,1,210
"71905",1071905,13,25,1,39
"71906",1071906,109,20,2,131
"71907",1071907,143,77,4,224
"71908",1071908,53,146,4,203
"71909",1071909,111,107,14,232
"71910",1071910,198,97,15,310
"71911",1071911,134,14,4,152
"71912",1071912,45,134,3,182
"71913",1071913,135,55,6,196
"71914",1071914,63,239,6,308
"71915",1071915,5,2,0,7
"71916",1071916,24,164,4,192
"71917",1071917,74,18,5,97
"71918",1071918,133,116,18,267
"71919",1071919,58,18,0,76
"71920",1071920,33,245,2,280
"71921",1071921,175,51,7,233
"71922",1071922,81,127,5,213
"71923",1071923,34,21,5,60
"71924",1071924,137,23,10,170
"71925",1071925,115,176,15,306
"71926",1071926,194,38,2,234
"71927",1071927,32,75,4,111
"71928",1071928,53,42,6,101
"71929",1071929,137,28,1,166
"71930",1071930,120,56,7,183
"71931",1071931,31,5,5,41
"71932",1071932,12,2,1,15
"71933",1071933,187,50,5,242
"71934",1071934,95,164,8,267
"71935",1071935,105,109,7,221
"71936",1071936,157,58,7,222
"71937",1071937,172,13,5,190
"71938",1071938,26,149,4,179
"71939",1071939,50,212,6,268
"71940",1071940,121,81,15,217
"71941",1071941,65,136,10,211
"71942",1071942,180,54,3,237
"71943",1071943,37,26,0,63
"71944",1071944,66,133,3,202
"71945",1071945,167,118,5,290
"71946",1071946,111,167,10,288
"71947",1071947,199,10,4,213
"71948",1071948,104,21,7,132
"71949",1071949,111,79,3,193
"71950",1071950,55,159,17,231
"71951",1071951,182,145,10,337
"71952",1071952,148,52,6,206
"71953",1071953,147,143,5,295
"71954",1071954,78,73,22,173
"71955",1071955,152,105,14,271
"71956",1071956,41,0,0,41
"71957",1071957,192,48,9,249
"71958",1071958,165,149,18,332
"71959",1071959,193,43,9,245
"71960",1071960,219,61,7,287
"71961",1071961,140,67,10,217
"71962",1071962,244,97,17,358
"71963",1071963,203,16,7,226
"71964",1071964,121,172,7,300
"71965",1071965,112,117,2,231
"71966",1071966,107,96,11,214
"71967",1071967,120,107,17,244
"71968",1071968,113,33,6,152
"71969",1071969,94,55,10,159
"71970",1071970,198,115,13,326
"71971",1071971,131,110,6,247
"71972",1071972,212,68,16,296
"71973",1071973,77,157,5,239
"71974",1071974,179,68,9,256
"71975",1071975,78,165,17,260
"71976",1071976,47,221,11,279
"71977",1071977,223,69,5,297
"71978",1071978,97,81,8,186
"71979",1071979,9,145,0,154
"71980",1071980,72,139,8,219
"71981",1071981,239,17,4,260
"71982",1071982,165,115,13,293
"71983",1071983,119,90,7,216
"71984",1071984,35,209,6,250
"71985",1071985,160,27,6,193
"71986",1071986,38,91,10,139
"71987",1071987,175,59,2,236
"71988",1071988,199,28,9,236
"71989",1071989,132,45,3,180
"71990",1071990,108,133,20,261
"71991",1071991,43,197,3,243
"71992",1071992,63,154,18,235
"71993",1071993,218,38,7,263
"71994",1071994,73,0,0,73
"71995",1071995,186,63,10,259
"71996",1071996,160,35,6,201
"71997",1071997,209,37,4,250
"71998",1071998,80,217,9,306
"71999",1071999,135,71,13,219
"72000",1072000,146,99,7,252
"72001",1072001,173,69,7,249
"72002",1072002,190,47,16,253
"72003",1072003,111,156,13,280
"72004",1072004,132,79,5,216
"72005",1072005,7,29,2,38
"72006",1072006,123,118,14,255
"72007",1072007,89,197,3,289
"72008",1072008,240,75,13,328
"72009",1072009,162,70,6,238
"72010",1072010,95,128,1,224
"72011",1072011,70,133,3,206
"72012",1072012,163,55,10,228
"72013",1072013,54,56,6,116
"72014",1072014,78,103,4,185
"72015",1072015,150,62,13,225
"72016",1072016,152,110,15,277
"72017",1072017,9,84,4,97
"72018",1072018,93,154,10,257
"72019",1072019,74,103,9,186
"72020",1072020,114,163,3,280
"72021",1072021,88,149,6,243
"72022",1072022,140,175,12,327
"72023",1072023,118,39,7,164
"72024",1072024,225,31,8,264
"72025",1072025,105,126,28,259
"72026",1072026,177,35,14,226
"72027",1072027,85,198,12,295
"72028",1072028,199,56,0,255
"72029",1072029,118,184,3,305
"72030",1072030,101,44,8,153
"72031",1072031,240,28,7,275
"72032",1072032,172,145,8,325
"72033",1072033,179,38,7,224
"72034",1072034,30,209,4,243
"72035",1072035,153,22,4,179
"72036",1072036,34,7,3,44
"72037",1072037,217,47,13,277
"72038",1072038,182,51,2,235
"72039",1072039,110,75,11,196
"72040",1072040,99,57,12,168
"72041",1072041,65,198,12,275
"72042",1072042,208,82,14,304
"72043",1072043,147,26,1,174
"72044",1072044,165,34,6,205
"72045",1072045,194,31,8,233
"72046",1072046,171,92,7,270
"72047",1072047,108,105,10,223
"72048",1072048,142,39,11,192
"72049",1072049,74,244,4,322
"72050",1072050,156,106,12,274
"72051",1072051,148,46,8,202
"72052",1072052,60,67,4,131
"72053",1072053,85,83,5,173
"72054",1072054,46,225,4,275
"72055",1072055,107,80,7,194
"72056",1072056,133,88,9,230
"72057",1072057,184,8,2,194
"72058",1072058,164,36,7,207
"72059",1072059,125,113,10,248
"72060",1072060,140,109,8,257
"72061",1072061,68,1,0,69
"72062",1072062,218,95,5,318
"72063",1072063,87,94,3,184
"72064",1072064,134,53,4,191
"72065",1072065,152,99,11,262
"72066",1072066,117,147,12,276
"72067",1072067,175,30,10,215
"72068",1072068,58,169,9,236
"72069",1072069,90,143,15,248
"72070",1072070,99,74,8,181
"72071",1072071,106,177,9,292
"72072",1072072,44,17,1,62
"72073",1072073,149,129,9,287
"72074",1072074,181,67,7,255
"72075",1072075,96,164,21,281
"72076",1072076,79,115,5,199
"72077",1072077,127,81,6,214
"72078",1072078,176,32,8,216
"72079",1072079,104,99,10,213
"72080",1072080,128,61,6,195
"72081",1072081,183,35,18,236
"72082",1072082,131,105,15,251
"72083",1072083,18,2,3,23
"72084",1072084,142,116,4,262
"72085",1072085,86,199,15,300
"72086",1072086,151,82,13,246
"72087",1072087,195,94,12,301
"72088",1072088,124,60,3,187
"72089",1072089,97,12,6,115
"72090",1072090,90,181,16,287
"72091",1072091,131,88,5,224
"72092",1072092,101,185,9,295
"72093",1072093,80,175,10,265
"72094",1072094,15,11,1,27
"72095",1072095,43,79,4,126
"72096",1072096,193,81,8,282
"72097",1072097,129,77,4,210
"72098",1072098,124,136,8,268
"72099",1072099,165,120,7,292
"72100",1072100,90,63,6,159
"72101",1072101,83,195,3,281
"72102",1072102,114,59,4,177
"72103",1072103,140,69,7,216
"72104",1072104,98,48,5,151
"72105",1072105,193,34,7,234
"72106",1072106,20,269,4,293
"72107",1072107,133,121,11,265
"72108",1072108,149,59,15,223
"72109",1072109,100,104,7,211
"72110",1072110,50,192,11,253
"72111",1072111,115,150,13,278
"72112",1072112,188,83,4,275
"72113",1072113,33,218,2,253
"72114",1072114,44,1,0,45
"72115",1072115,54,207,2,263
"72116",1072116,41,182,5,228
"72117",1072117,59,240,4,303
"72118",1072118,75,83,16,174
"72119",1072119,144,92,11,247
"72120",1072120,43,114,6,163
"72121",1072121,42,184,3,229
"72122",1072122,71,81,5,157
"72123",1072123,169,103,21,293
"72124",1072124,23,27,3,53
"72125",1072125,112,140,8,260
"72126",1072126,71,245,4,320
"72127",1072127,155,128,29,312
"72128",1072128,191,55,3,249
"72129",1072129,129,164,8,301
"72130",1072130,310,19,0,329
"72131",1072131,115,104,7,226
"72132",1072132,103,46,3,152
"72133",1072133,104,77,14,195
"72134",1072134,71,85,12,168
"72135",1072135,88,236,10,334
"72136",1072136,115,26,3,144
"72137",1072137,38,147,4,189
"72138",1072138,137,83,9,229
"72139",1072139,57,73,4,134
"72140",1072140,4,4,0,8
"72141",1072141,157,26,5,188
"72142",1072142,232,35,12,279
"72143",1072143,68,118,5,191
"72144",1072144,145,30,9,184
"72145",1072145,100,87,1,188
"72146",1072146,110,58,3,171
"72147",1072147,118,95,3,216
"72148",1072148,14,40,1,55
"72149",1072149,177,63,5,245
"72150",1072150,89,67,0,156
"72151",1072151,25,78,1,104
"72152",1072152,35,304,5,344
"72153",1072153,145,18,8,171
"72154",1072154,100,127,2,229
"72155",1072155,19,165,3,187
"72156",1072156,176,76,6,258
"72157",1072157,52,252,9,313
"72158",1072158,84,172,18,274
"72159",1072159,70,167,15,252
"72160",1072160,100,210,15,325
"72161",1072161,86,231,5,322
"72162",1072162,92,103,23,218
"72163",1072163,102,55,4,161
"72164",1072164,104,71,1,176
"72165",1072165,279,16,7,302
"72166",1072166,143,133,25,301
"72167",1072167,106,161,8,275
"72168",1072168,144,83,0,227
"72169",1072169,93,76,3,172
"72170",1072170,3,14,2,19
"72171",1072171,135,133,7,275
"72172",1072172,31,159,0,190
"72173",1072173,237,50,8,295
"72174",1072174,100,153,16,269
"72175",1072175,98,113,6,217
"72176",1072176,82,110,5,197
"72177",1072177,106,80,10,196
"72178",1072178,73,219,13,305
"72179",1072179,25,7,0,32
"72180",1072180,134,139,14,287
"72181",1072181,65,40,2,107
"72182",1072182,51,223,2,276
"72183",1072183,57,206,10,273
"72184",1072184,137,56,1,194
"72185",1072185,276,35,13,324
"72186",1072186,175,29,11,215
"72187",1072187,163,50,5,218
"72188",1072188,153,79,2,234
"72189",1072189,198,29,7,234
"72190",1072190,237,22,5,264
"72191",1072191,112,50,10,172
"72192",1072192,41,8,3,52
"72193",1072193,51,245,4,300
"72194",1072194,121,78,9,208
"72195",1072195,149,66,12,227
"72196",1072196,44,2,15,61
"72197",1072197,31,169,6,206
"72198",1072198,14,72,2,88
"72199",1072199,79,214,7,300
"72200",1072200,99,22,4,125
"72201",1072201,89,89,4,182
"72202",1072202,100,35,5,140
"72203",1072203,124,134,12,270
"72204",1072204,103,130,6,239
"72205",1072205,38,68,4,110
"72206",1072206,219,23,6,248
"72207",1072207,3,5,1,9
"72208",1072208,126,117,8,251
"72209",1072209,197,32,3,232
"72210",1072210,139,105,11,255
"72211",1072211,147,42,3,192
"72212",1072212,165,88,9,262
"72213",1072213,137,58,12,207
"72214",1072214,106,170,7,283
"72215",1072215,54,187,2,243
"72216",1072216,41,210,4,255
"72217",1072217,121,24,5,150
"72218",1072218,143,69,13,225
"72219",1072219,153,20,4,177
"72220",1072220,54,245,5,304
"72221",1072221,162,66,9,237
"72222",1072222,125,97,5,227
"72223",1072223,78,195,6,279
"72224",1072224,80,172,27,279
"72225",1072225,156,124,10,290
"72226",1072226,139,46,6,191
"72227",1072227,27,160,0,187
"72228",1072228,142,57,13,212
"72229",1072229,115,97,8,220
"72230",1072230,169,49,6,224
"72231",1072231,54,239,3,296
"72232",1072232,152,138,8,298
"72233",1072233,60,225,7,292
"72234",1072234,57,205,5,267
"72235",1072235,89,140,32,261
"72236",1072236,148,129,5,282
"72237",1072237,37,254,3,294
"72238",1072238,44,226,12,282
"72239",1072239,133,123,1,257
"72240",1072240,89,27,3,119
"72241",1072241,19,213,3,235
"72242",1072242,106,87,25,218
"72243",1072243,85,6,0,91
"72244",1072244,54,186,19,259
"72245",1072245,1,3,0,4
"72246",1072246,21,189,7,217
"72247",1072247,142,68,12,222
"72248",1072248,206,103,18,327
"72249",1072249,147,40,6,193
"72250",1072250,157,110,3,270
"72251",1072251,85,28,1,114
"72252",1072252,136,93,16,245
"72253",1072253,45,176,12,233
"72254",1072254,164,64,3,231
"72255",1072255,219,36,8,263
"72256",1072256,173,52,4,229
"72257",1072257,126,73,15,214
"72258",1072258,139,113,23,275
"72259",1072259,143,54,10,207
"72260",1072260,150,22,4,176
"72261",1072261,130,94,22,246
"72262",1072262,168,32,9,209
"72263",1072263,35,33,1,69
"72264",1072264,7,77,2,86
"72265",1072265,44,86,4,134
"72266",1072266,199,96,4,299
"72267",1072267,178,28,4,210
"72268",1072268,51,239,5,295
"72269",1072269,178,75,10,263
"72270",1072270,98,159,8,265
"72271",1072271,234,17,14,265
"72272",1072272,197,56,8,261
"72273",1072273,37,11,0,48
"72274",1072274,190,48,10,248
"72275",1072275,68,17,6,91
"72276",1072276,56,195,13,264
"72277",1072277,157,143,7,307
"72278",1072278,192,114,10,316
"72279",1072279,102,73,21,196
"72280",1072280,59,209,6,274
"72281",1072281,142,33,1,176
"72282",1072282,39,254,9,302
"72283",1072283,124,89,4,217
"72284",1072284,28,172,15,215
"72285",1072285,59,29,2,90
"72286",1072286,47,110,1,158
"72287",1072287,40,198,8,246
"72288",1072288,60,79,1,140
"72289",1072289,143,123,11,277
"72290",1072290,10,34,1,45
"72291",1072291,57,232,8,297
"72292",1072292,108,25,5,138
"72293",1072293,91,128,19,238
"72294",1072294,76,117,5,198
"72295",1072295,138,90,9,237
"72296",1072296,204,39,14,257
"72297",1072297,120,72,7,199
"72298",1072298,158,136,19,313
"72299",1072299,95,106,4,205
"72300",1072300,122,98,5,225
"72301",1072301,94,137,9,240
"72302",1072302,24,150,18,192
"72303",1072303,98,106,9,213
"72304",1072304,35,110,2,147
"72305",1072305,156,76,5,237
"72306",1072306,100,44,11,155
"72307",1072307,108,82,13,203
"72308",1072308,153,69,7,229
"72309",1072309,102,146,8,256
"72310",1072310,41,215,7,263
"72311",1072311,163,135,16,314
"72312",1072312,121,112,7,240
"72313",1072313,122,35,2,159
"72314",1072314,58,32,4,94
"72315",1072315,194,22,5,221
"72316",1072316,91,71,1,163
"72317",1072317,28,201,3,232
"72318",1072318,57,186,7,250
"72319",1072319,41,217,4,262
"72320",1072320,146,43,5,194
"72321",1072321,130,61,5,196
"72322",1072322,126,190,15,331
"72323",1072323,59,224,6,289
"72324",1072324,16,139,1,156
"72325",1072325,101,133,7,241
"72326",1072326,73,95,7,175
"72327",1072327,121,72,5,198
"72328",1072328,78,190,6,274
"72329",1072329,44,25,2,71
"72330",1072330,262,39,5,306
"72331",1072331,181,33,6,220
"72332",1072332,28,206,9,243
"72333",1072333,25,209,1,235
"72334",1072334,148,97,10,255
"72335",1072335,128,150,13,291
"72336",1072336,163,67,8,238
"72337",1072337,182,45,12,239
"72338",1072338,99,112,10,221
"72339",1072339,130,23,5,158
"72340",1072340,63,182,7,252
"72341",1072341,130,68,12,210
"72342",1072342,120,164,15,299
"72343",1072343,185,37,13,235
"72344",1072344,63,173,18,254
"72345",1072345,79,10,8,97
"72346",1072346,79,113,8,200
"72347",1072347,42,222,6,270
"72348",1072348,112,144,15,271
"72349",1072349,117,57,8,182
"72350",1072350,129,61,7,197
"72351",1072351,57,221,22,300
"72352",1072352,229,41,5,275
"72353",1072353,135,57,6,198
"72354",1072354,145,27,4,176
"72355",1072355,136,58,7,201
"72356",1072356,34,253,7,294
"72357",1072357,167,17,3,187
"72358",1072358,83,183,15,281
"72359",1072359,71,82,11,164
"72360",1072360,33,6,2,41
"72361",1072361,56,208,7,271
"72362",1072362,236,35,9,280
"72363",1072363,91,61,12,164
"72364",1072364,10,3,1,14
"72365",1072365,136,122,10,268
"72366",1072366,14,3,4,21
"72367",1072367,8,114,0,122
"72368",1072368,98,221,7,326
"72369",1072369,153,140,10,303
"72370",1072370,80,76,3,159
"72371",1072371,74,83,4,161
"72372",1072372,41,193,4,238
"72373",1072373,55,78,7,140
"72374",1072374,14,294,1,309
"72375",1072375,159,21,3,183
"72376",1072376,99,68,8,175
"72377",1072377,111,158,5,274
"72378",1072378,103,53,7,163
"72379",1072379,88,129,13,230
"72380",1072380,62,198,3,263
"72381",1072381,152,119,22,293
"72382",1072382,73,88,3,164
"72383",1072383,173,58,4,235
"72384",1072384,158,137,26,321
"72385",1072385,131,201,12,344
"72386",1072386,132,125,6,263
"72387",1072387,29,84,0,113
"72388",1072388,58,169,24,251
"72389",1072389,155,26,1,182
"72390",1072390,43,165,9,217
"72391",1072391,116,169,22,307
"72392",1072392,110,182,11,303
"72393",1072393,91,35,7,133
"72394",1072394,195,24,18,237
"72395",1072395,33,12,3,48
"72396",1072396,188,7,8,203
"72397",1072397,59,120,1,180
"72398",1072398,21,10,1,32
"72399",1072399,48,107,12,167
"72400",1072400,120,31,6,157
"72401",1072401,90,167,10,267
"72402",1072402,90,134,3,227
"72403",1072403,104,116,4,224
"72404",1072404,137,111,11,259
"72405",1072405,84,144,15,243
"72406",1072406,173,61,8,242
"72407",1072407,164,28,8,200
"72408",1072408,60,58,2,120
"72409",1072409,166,50,13,229
"72410",1072410,54,194,6,254
"72411",1072411,101,34,4,139
"72412",1072412,241,13,6,260
"72413",1072413,204,63,9,276
"72414",1072414,44,217,9,270
"72415",1072415,244,15,4,263
"72416",1072416,104,16,5,125
"72417",1072417,4,13,1,18
"72418",1072418,79,116,8,203
"72419",1072419,71,119,13,203
"72420",1072420,136,55,3,194
"72421",1072421,203,111,21,335
"72422",1072422,207,28,5,240
"72423",1072423,76,157,8,241
"72424",1072424,64,1,3,68
"72425",1072425,93,137,6,236
"72426",1072426,17,87,4,108
"72427",1072427,173,58,5,236
"72428",1072428,63,123,9,195
"72429",1072429,144,40,7,191
"72430",1072430,120,62,11,193
"72431",1072431,146,153,11,310
"72432",1072432,250,43,14,307
"72433",1072433,178,48,12,238
"72434",1072434,151,86,4,241
"72435",1072435,49,82,5,136
"72436",1072436,175,69,9,253
"72437",1072437,151,111,14,276
"72438",1072438,140,92,4,236
"72439",1072439,272,44,11,327
"72440",1072440,115,103,4,222
"72441",1072441,199,85,8,292
"72442",1072442,101,153,9,263
"72443",1072443,104,149,1,254
"72444",1072444,163,37,9,209
"72445",1072445,143,56,6,205
"72446",1072446,47,59,7,113
"72447",1072447,61,141,15,217
"72448",1072448,85,24,6,115
"72449",1072449,71,133,9,213
"72450",1072450,68,137,11,216
"72451",1072451,128,92,1,221
"72452",1072452,145,96,12,253
"72453",1072453,21,265,2,288
"72454",1072454,149,46,7,202
"72455",1072455,18,25,3,46
"72456",1072456,140,53,11,204
"72457",1072457,49,118,1,168
"72458",1072458,59,133,3,195
"72459",1072459,63,138,9,210
"72460",1072460,179,118,19,316
"72461",1072461,120,121,7,248
"72462",1072462,121,142,12,275
"72463",1072463,194,25,4,223
"72464",1072464,46,140,4,190
"72465",1072465,190,67,27,284
"72466",1072466,98,83,2,183
"72467",1072467,119,155,20,294
"72468",1072468,169,88,2,259
"72469",1072469,136,67,7,210
"72470",1072470,39,109,4,152
"72471",1072471,174,91,14,279
"72472",1072472,135,63,5,203
"72473",1072473,4,4,1,9
"72474",1072474,144,13,12,169
"72475",1072475,38,244,3,285
"72476",1072476,40,123,8,171
"72477",1072477,28,261,7,296
"72478",1072478,155,89,14,258
"72479",1072479,9,9,2,20
"72480",1072480,226,20,4,250
"72481",1072481,5,9,1,15
"72482",1072482,177,123,8,308
"72483",1072483,140,88,13,241
"72484",1072484,47,232,11,290
"72485",1072485,118,148,16,282
"72486",1072486,226,38,12,276
"72487",1072487,79,190,11,280
"72488",1072488,128,170,15,313
"72489",1072489,150,78,8,236
"72490",1072490,145,124,19,288
"72491",1072491,203,60,6,269
"72492",1072492,151,92,11,254
"72493",1072493,169,121,6,296
"72494",1072494,188,49,6,243
"72495",1072495,68,160,8,236
"72496",1072496,15,18,4,37
"72497",1072497,196,2,0,198
"72498",1072498,134,155,14,303
"72499",1072499,157,57,20,234
"72500",1072500,45,219,5,269
"72501",1072501,29,212,3,244
"72502",1072502,157,56,14,227
"72503",1072503,81,170,14,265
"72504",1072504,129,77,0,206
"72505",1072505,13,33,5,51
"72506",1072506,139,43,4,186
"72507",1072507,84,222,15,321
"72508",1072508,89,177,21,287
"72509",1072509,182,75,6,263
"72510",1072510,109,84,3,196
"72511",1072511,174,37,11,222
"72512",1072512,88,148,11,247
"72513",1072513,108,84,3,195
"72514",1072514,122,98,51,271
"72515",1072515,102,59,11,172
"72516",1072516,95,124,6,225
"72517",1072517,121,87,7,215
"72518",1072518,133,122,10,265
"72519",1072519,42,52,2,96
"72520",1072520,53,164,6,223
"72521",1072521,149,66,1,216
"72522",1072522,206,61,8,275
"72523",1072523,187,60,13,260
"72524",1072524,72,86,2,160
"72525",1072525,109,195,13,317
"72526",1072526,104,31,7,142
"72527",1072527,168,105,9,282
"72528",1072528,70,187,6,263
"72529",1072529,35,56,9,100
"72530",1072530,40,135,3,178
"72531",1072531,117,55,5,177
"72532",1072532,161,69,8,238
"72533",1072533,77,199,7,283
"72534",1072534,73,54,2,129
"72535",1072535,159,52,1,212
"72536",1072536,11,17,1,29
"72537",1072537,153,38,7,198
"72538",1072538,131,84,8,223
"72539",1072539,175,148,18,341
"72540",1072540,142,58,4,204
"72541",1072541,167,136,18,321
"72542",1072542,98,114,17,229
"72543",1072543,59,45,2,106
"72544",1072544,107,109,9,225
"72545",1072545,26,42,2,70
"72546",1072546,132,126,6,264
"72547",1072547,265,0,1,266
"72548",1072548,191,45,3,239
"72549",1072549,189,61,19,269
"72550",1072550,192,34,7,233
"72551",1072551,131,75,4,210
"72552",1072552,91,234,15,340
"72553",1072553,50,281,1,332
"72554",1072554,147,241,12,400
"72555",1072555,117,171,14,302
"72556",1072556,49,96,3,148
"72557",1072557,229,31,5,265
"72558",1072558,65,153,16,234
"72559",1072559,183,47,2,232
"72560",1072560,101,74,4,179
"72561",1072561,91,17,7,115
"72562",1072562,211,82,7,300
"72563",1072563,65,32,3,100
"72564",1072564,60,91,7,158
"72565",1072565,7,44,1,52
"72566",1072566,47,35,4,86
"72567",1072567,197,26,7,230
"72568",1072568,79,138,4,221
"72569",1072569,169,93,13,275
"72570",1072570,45,16,2,63
"72571",1072571,79,115,6,200
"72572",1072572,50,271,1,322
"72573",1072573,157,103,10,270
"72574",1072574,96,163,6,265
"72575",1072575,164,37,15,216
"72576",1072576,11,16,4,31
"72577",1072577,198,68,6,272
"72578",1072578,44,265,4,313
"72579",1072579,86,64,11,161
"72580",1072580,67,59,5,131
"72581",1072581,206,82,11,299
"72582",1072582,216,60,22,298
"72583",1072583,88,166,6,260
"72584",1072584,108,47,8,163
"72585",1072585,17,19,6,42
"72586",1072586,106,68,8,182
"72587",1072587,220,12,4,236
"72588",1072588,231,34,8,273
"72589",1072589,62,179,2,243
"72590",1072590,80,180,4,264
"72591",1072591,98,68,3,169
"72592",1072592,140,55,2,197
"72593",1072593,29,270,5,304
"72594",1072594,131,50,6,187
"72595",1072595,129,134,1,264
"72596",1072596,93,208,10,311
"72597",1072597,16,21,0,37
"72598",1072598,173,40,0,213
"72599",1072599,135,159,21,315
"72600",1072600,185,56,10,251
"72601",1072601,65,186,17,268
"72602",1072602,24,216,10,250
"72603",1072603,105,91,12,208
"72604",1072604,36,179,8,223
"72605",1072605,142,182,12,336
"72606",1072606,197,28,10,235
"72607",1072607,26,230,3,259
"72608",1072608,142,87,11,240
"72609",1072609,135,85,11,231
"72610",1072610,47,203,12,262
"72611",1072611,167,96,21,284
"72612",1072612,110,146,14,270
"72613",1072613,101,111,10,222
"72614",1072614,95,155,14,264
"72615",1072615,130,43,5,178
"72616",1072616,95,108,14,217
"72617",1072617,160,38,1,199
"72618",1072618,133,70,2,205
"72619",1072619,51,153,1,205
"72620",1072620,188,83,16,287
"72621",1072621,141,9,2,152
"72622",1072622,182,70,13,265
"72623",1072623,134,37,7,178
"72624",1072624,142,106,12,260
"72625",1072625,78,1,2,81
"72626",1072626,36,216,13,265
"72627",1072627,120,37,14,171
"72628",1072628,63,15,1,79
"72629",1072629,142,83,14,239
"72630",1072630,225,45,8,278
"72631",1072631,178,66,4,248
"72632",1072632,170,168,9,347
"72633",1072633,96,148,12,256
"72634",1072634,20,216,1,237
"72635",1072635,22,127,1,150
"72636",1072636,110,93,16,219
"72637",1072637,43,216,2,261
"72638",1072638,118,94,7,219
"72639",1072639,103,121,3,227
"72640",1072640,214,111,15,340
"72641",1072641,43,47,6,96
"72642",1072642,178,91,12,281
"72643",1072643,146,142,4,292
"72644",1072644,24,188,6,218
"72645",1072645,148,54,11,213
"72646",1072646,118,100,7,225
"72647",1072647,103,120,15,238
"72648",1072648,154,57,5,216
"72649",1072649,51,45,11,107
"72650",1072650,95,87,5,187
"72651",1072651,102,158,11,271
"72652",1072652,106,136,11,253
"72653",1072653,102,58,7,167
"72654",1072654,51,140,7,198
"72655",1072655,139,99,8,246
"72656",1072656,176,46,5,227
"72657",1072657,78,185,7,270
"72658",1072658,54,179,14,247
"72659",1072659,34,187,2,223
"72660",1072660,107,88,5,200
"72661",1072661,57,211,9,277
"72662",1072662,49,22,1,72
"72663",1072663,59,4,0,63
"72664",1072664,13,45,1,59
"72665",1072665,171,21,9,201
"72666",1072666,136,60,2,198
"72667",1072667,66,185,8,259
"72668",1072668,85,199,7,291
"72669",1072669,165,42,0,207
"72670",1072670,102,127,14,243
"72671",1072671,150,78,6,234
"72672",1072672,28,175,9,212
"72673",1072673,35,32,5,72
"72674",1072674,97,79,8,184
"72675",1072675,19,94,2,115
"72676",1072676,90,33,0,123
"72677",1072677,215,47,14,276
"72678",1072678,133,45,11,189
"72679",1072679,33,199,3,235
"72680",1072680,82,124,8,214
"72681",1072681,82,3,0,85
"72682",1072682,158,66,9,233
"72683",1072683,60,154,5,219
"72684",1072684,145,111,7,263
"72685",1072685,84,202,9,295
"72686",1072686,150,56,6,212
"72687",1072687,10,95,0,105
"72688",1072688,146,64,7,217
"72689",1072689,152,179,20,351
"72690",1072690,145,10,3,158
"72691",1072691,144,70,6,220
"72692",1072692,96,170,9,275
"72693",1072693,120,51,8,179
"72694",1072694,97,185,11,293
"72695",1072695,136,104,1,241
"72696",1072696,81,135,5,221
"72697",1072697,146,85,8,239
"72698",1072698,86,74,18,178
"72699",1072699,82,17,5,104
"72700",1072700,90,178,10,278
"72701",1072701,14,196,1,211
"72702",1072702,171,22,4,197
"72703",1072703,129,36,5,170
"72704",1072704,12,187,2,201
"72705",1072705,101,185,11,297
"72706",1072706,136,135,24,295
"72707",1072707,90,147,8,245
"72708",1072708,189,98,7,294
"72709",1072709,46,49,8,103
"72710",1072710,125,78,8,211
"72711",1072711,103,175,11,289
"72712",1072712,41,182,4,227
"72713",1072713,161,62,9,232
"72714",1072714,89,156,13,258
"72715",1072715,64,172,2,238
"72716",1072716,162,41,3,206
"72717",1072717,148,150,18,316
"72718",1072718,9,66,1,76
"72719",1072719,221,28,8,257
"72720",1072720,52,245,3,300
"72721",1072721,183,76,7,266
"72722",1072722,160,31,11,202
"72723",1072723,40,169,4,213
"72724",1072724,101,167,10,278
"72725",1072725,7,16,1,24
"72726",1072726,204,64,11,279
"72727",1072727,139,144,16,299
"72728",1072728,203,50,4,257
"72729",1072729,212,70,27,309
"72730",1072730,116,162,7,285
"72731",1072731,195,78,12,285
"72732",1072732,49,216,4,269
"72733",1072733,52,175,16,243
"72734",1072734,160,107,12,279
"72735",1072735,111,179,4,294
"72736",1072736,81,164,18,263
"72737",1072737,44,240,12,296
"72738",1072738,225,42,13,280
"72739",1072739,84,11,2,97
"72740",1072740,102,135,12,249
"72741",1072741,189,30,13,232
"72742",1072742,71,162,14,247
"72743",1072743,24,264,2,290
"72744",1072744,139,114,8,261
"72745",1072745,46,150,13,209
"72746",1072746,53,131,10,194
"72747",1072747,121,70,9,200
"72748",1072748,46,227,5,278
"72749",1072749,144,94,14,252
"72750",1072750,48,239,4,291
"72751",1072751,139,128,5,272
"72752",1072752,38,84,1,123
"72753",1072753,162,69,10,241
"72754",1072754,148,93,3,244
"72755",1072755,36,48,3,87
"72756",1072756,68,241,18,327
"72757",1072757,125,31,9,165
"72758",1072758,159,125,17,301
"72759",1072759,28,47,2,77
"72760",1072760,34,175,4,213
"72761",1072761,70,124,11,205
"72762",1072762,65,96,2,163
"72763",1072763,223,88,7,318
"72764",1072764,96,150,14,260
"72765",1072765,187,82,9,278
"72766",1072766,84,172,20,276
"72767",1072767,25,231,0,256
"72768",1072768,1,0,1,2
"72769",1072769,152,110,14,276
"72770",1072770,86,180,10,276
"72771",1072771,174,149,15,338
"72772",1072772,116,126,3,245
"72773",1072773,90,128,8,226
"72774",1072774,178,22,3,203
"72775",1072775,54,180,5,239
"72776",1072776,120,113,18,251
"72777",1072777,89,76,6,171
"72778",1072778,98,246,7,351
"72779",1072779,3,2,2,7
"72780",1072780,74,65,0,139
"72781",1072781,201,94,16,311
"72782",1072782,145,48,6,199
"72783",1072783,182,68,8,258
"72784",1072784,179,48,13,240
"72785",1072785,174,59,16,249
"72786",1072786,96,167,9,272
"72787",1072787,96,36,5,137
"72788",1072788,22,75,1,98
"72789",1072789,81,178,5,264
"72790",1072790,101,127,17,245
"72791",1072791,5,7,1,13
"72792",1072792,132,89,8,229
"72793",1072793,91,138,3,232
"72794",1072794,58,148,1,207
"72795",1072795,73,125,6,204
"72796",1072796,145,77,13,235
"72797",1072797,248,31,2,281
"72798",1072798,8,313,0,321
"72799",1072799,25,95,3,123
"72800",1072800,52,73,12,137
"72801",1072801,70,64,4,138
"72802",1072802,185,45,15,245
"72803",1072803,55,206,7,268
"72804",1072804,58,74,6,138
"72805",1072805,128,90,4,222
"72806",1072806,144,20,0,164
"72807",1072807,138,49,12,199
"72808",1072808,29,232,8,269
"72809",1072809,130,112,12,254
"72810",1072810,183,39,4,226
"72811",1072811,134,66,9,209
"72812",1072812,119,105,5,229
"72813",1072813,172,95,12,279
"72814",1072814,40,252,3,295
"72815",1072815,70,226,3,299
"72816",1072816,97,109,10,216
"72817",1072817,48,200,5,253
"72818",1072818,139,38,3,180
"72819",1072819,186,154,3,343
"72820",1072820,196,20,4,220
"72821",1072821,101,65,4,170
"72822",1072822,21,286,6,313
"72823",1072823,9,1,1,11
"72824",1072824,150,167,12,329
"72825",1072825,155,128,19,302
"72826",1072826,180,24,9,213
"72827",1072827,105,77,11,193
"72828",1072828,48,199,2,249
"72829",1072829,185,45,10,240
"72830",1072830,106,44,4,154
"72831",1072831,66,131,5,202
"72832",1072832,177,67,2,246
"72833",1072833,205,41,11,257
"72834",1072834,150,118,16,284
"72835",1072835,119,115,11,245
"72836",1072836,34,28,2,64
"72837",1072837,181,47,13,241
"72838",1072838,139,36,2,177
"72839",1072839,61,101,4,166
"72840",1072840,138,84,13,235
"72841",1072841,151,7,1,159
"72842",1072842,97,147,6,250
"72843",1072843,220,90,21,331
"72844",1072844,184,43,5,232
"72845",1072845,48,274,5,327
"72846",1072846,87,258,12,357
"72847",1072847,189,80,8,277
"72848",1072848,82,238,17,337
"72849",1072849,165,63,9,237
"72850",1072850,188,104,7,299
"72851",1072851,39,216,5,260
"72852",1072852,63,283,4,350
"72853",1072853,124,100,8,232
"72854",1072854,102,130,10,242
"72855",1072855,159,100,17,276
"72856",1072856,30,46,3,79
"72857",1072857,193,53,10,256
"72858",1072858,157,70,1,228
"72859",1072859,66,8,0,74
"72860",1072860,193,73,4,270
"72861",1072861,22,165,4,191
"72862",1072862,78,191,8,277
"72863",1072863,141,63,4,208
"72864",1072864,117,106,11,234
"72865",1072865,120,138,6,264
"72866",1072866,79,248,4,331
"72867",1072867,65,167,11,243
"72868",1072868,52,173,6,231
"72869",1072869,80,220,14,314
"72870",1072870,25,231,2,258
"72871",1072871,23,35,5,63
"72872",1072872,172,22,11,205
"72873",1072873,158,53,3,214
"72874",1072874,84,218,10,312
"72875",1072875,132,163,7,302
"72876",1072876,97,110,16,223
"72877",1072877,24,29,4,57
"72878",1072878,9,3,0,12
"72879",1072879,60,183,6,249
"72880",1072880,112,172,6,290
"72881",1072881,47,1,2,50
"72882",1072882,289,9,5,303
"72883",1072883,3,9,0,12
"72884",1072884,171,65,4,240
"72885",1072885,246,16,5,267
"72886",1072886,51,226,5,282
"72887",1072887,212,101,13,326
"72888",1072888,46,173,10,229
"72889",1072889,108,44,13,165
"72890",1072890,55,187,2,244
"72891",1072891,153,65,5,223
"72892",1072892,65,116,9,190
"72893",1072893,182,127,12,321
"72894",1072894,99,12,1,112
"72895",1072895,204,45,12,261
"72896",1072896,59,72,6,137
"72897",1072897,134,4,2,140
"72898",1072898,171,75,8,254
"72899",1072899,28,233,10,271
"72900",1072900,98,208,14,320
"72901",1072901,131,33,6,170
"72902",1072902,180,81,19,280
"72903",1072903,206,30,2,238
"72904",1072904,50,159,14,223
"72905",1072905,59,82,8,149
"72906",1072906,130,77,4,211
"72907",1072907,15,66,1,82
"72908",1072908,82,96,22,200
"72909",1072909,48,167,14,229
"72910",1072910,178,100,9,287
"72911",1072911,101,166,4,271
"72912",1072912,25,52,8,85
"72913",1072913,24,196,2,222
"72914",1072914,35,193,8,236
"72915",1072915,70,127,11,208
"72916",1072916,27,134,1,162
"72917",1072917,183,77,19,279
"72918",1072918,230,42,8,280
"72919",1072919,26,198,3,227
"72920",1072920,33,57,3,93
"72921",1072921,126,149,9,284
"72922",1072922,104,106,8,218
"72923",1072923,96,54,5,155
"72924",1072924,123,162,9,294
"72925",1072925,142,20,4,166
"72926",1072926,62,164,12,238
"72927",1072927,161,50,8,219
"72928",1072928,131,77,13,221
"72929",1072929,101,85,8,194
"72930",1072930,112,58,7,177
"72931",1072931,130,61,20,211
"72932",1072932,66,106,17,189
"72933",1072933,44,171,6,221
"72934",1072934,88,182,15,285
"72935",1072935,102,188,8,298
"72936",1072936,31,254,3,288
"72937",1072937,51,197,10,258
"72938",1072938,182,40,11,233
"72939",1072939,184,70,1,255
"72940",1072940,12,8,1,21
"72941",1072941,172,31,6,209
"72942",1072942,124,192,8,324
"72943",1072943,50,206,6,262
"72944",1072944,0,84,1,85
"72945",1072945,45,8,4,57
"72946",1072946,65,250,3,318
"72947",1072947,5,30,1,36
"72948",1072948,114,193,13,320
"72949",1072949,125,32,10,167
"72950",1072950,93,118,11,222
"72951",1072951,74,79,14,167
"72952",1072952,87,145,18,250
"72953",1072953,199,61,19,279
"72954",1072954,1,110,0,111
"72955",1072955,181,73,3,257
"72956",1072956,61,47,1,109
"72957",1072957,149,119,9,277
"72958",1072958,133,34,9,176
"72959",1072959,76,102,1,179
"72960",1072960,56,269,5,330
"72961",1072961,196,28,10,234
"72962",1072962,62,165,5,232
"72963",1072963,129,115,6,250
"72964",1072964,140,104,6,250
"72965",1072965,162,84,8,254
"72966",1072966,39,199,11,249
"72967",1072967,58,74,3,135
"72968",1072968,54,182,21,257
"72969",1072969,184,37,4,225
"72970",1072970,88,60,6,154
"72971",1072971,48,188,7,243
"72972",1072972,79,55,7,141
"72973",1072973,90,173,17,280
"72974",1072974,200,109,7,316
"72975",1072975,99,92,21,212
"72976",1072976,168,26,5,199
"72977",1072977,183,102,17,302
"72978",1072978,8,1,0,9
"72979",1072979,92,227,3,322
"72980",1072980,104,154,10,268
"72981",1072981,69,10,2,81
"72982",1072982,82,62,8,152
"72983",1072983,222,15,2,239
"72984",1072984,137,47,7,191
"72985",1072985,139,85,8,232
"72986",1072986,237,56,7,300
"72987",1072987,135,124,2,261
"72988",1072988,273,17,8,298
"72989",1072989,46,221,4,271
"72990",1072990,157,64,7,228
"72991",1072991,166,137,3,306
"72992",1072992,173,40,9,222
"72993",1072993,31,230,11,272
"72994",1072994,136,95,0,231
"72995",1072995,41,124,4,169
"72996",1072996,273,34,9,316
"72997",1072997,199,51,8,258
"72998",1072998,190,63,14,267
"72999",1072999,2,2,0,4
"73000",1073000,107,161,8,276
"73001",1073001,192,122,18,332
"73002",1073002,79,111,11,201
"73003",1073003,121,38,3,162
"73004",1073004,125,107,4,236
"73005",1073005,103,233,11,347
"73006",1073006,89,175,3,267
"73007",1073007,243,20,7,270
"73008",1073008,103,56,9,168
"73009",1073009,85,110,13,208
"73010",1073010,114,195,12,321
"73011",1073011,41,251,14,306
"73012",1073012,25,204,9,238
"73013",1073013,237,41,16,294
"73014",1073014,138,84,8,230
"73015",1073015,39,50,4,93
"73016",1073016,139,42,9,190
"73017",1073017,126,60,11,197
"73018",1073018,244,52,12,308
"73019",1073019,98,187,13,298
"73020",1073020,267,38,8,313
"73021",1073021,95,70,6,171
"73022",1073022,104,135,7,246
"73023",1073023,24,0,0,24
"73024",1073024,105,81,13,199
"73025",1073025,123,122,8,253
"73026",1073026,75,170,14,259
"73027",1073027,161,59,8,228
"73028",1073028,209,2,0,211
"73029",1073029,200,59,8,267
"73030",1073030,186,13,7,206
"73031",1073031,163,91,14,268
"73032",1073032,142,133,16,291
"73033",1073033,53,193,8,254
"73034",1073034,58,242,1,301
"73035",1073035,142,120,8,270
"73036",1073036,76,162,23,261
"73037",1073037,64,52,5,121
"73038",1073038,99,34,6,139
"73039",1073039,109,115,5,229
"73040",1073040,68,238,19,325
"73041",1073041,111,173,11,295
"73042",1073042,110,127,3,240
"73043",1073043,107,184,3,294
"73044",1073044,191,85,6,282
"73045",1073045,142,86,4,232
"73046",1073046,28,183,3,214
"73047",1073047,84,5,1,90
"73048",1073048,241,40,14,295
"73049",1073049,70,181,13,264
"73050",1073050,88,209,6,303
"73051",1073051,201,81,10,292
"73052",1073052,7,11,1,19
"73053",1073053,149,135,18,302
"73054",1073054,52,35,1,88
"73055",1073055,99,66,17,182
"73056",1073056,76,51,2,129
"73057",1073057,31,46,0,77
"73058",1073058,94,131,4,229
"73059",1073059,53,163,5,221
"73060",1073060,100,40,6,146
"73061",1073061,109,136,17,262
"73062",1073062,65,241,12,318
"73063",1073063,70,146,11,227
"73064",1073064,160,102,10,272
"73065",1073065,243,39,3,285
"73066",1073066,41,58,4,103
"73067",1073067,189,36,8,233
"73068",1073068,66,166,1,233
"73069",1073069,6,167,2,175
"73070",1073070,219,14,8,241
"73071",1073071,38,405,6,449
"73072",1073072,188,34,9,231
"73073",1073073,52,197,11,260
"73074",1073074,106,40,1,147
"73075",1073075,239,25,13,277
"73076",1073076,235,7,9,251
"73077",1073077,56,164,8,228
"73078",1073078,174,71,5,250
"73079",1073079,118,63,4,185
"73080",1073080,154,85,9,248
"73081",1073081,217,25,0,242
"73082",1073082,98,20,6,124
"73083",1073083,151,74,7,232
"73084",1073084,157,42,4,203
"73085",1073085,48,197,0,245
"73086",1073086,32,62,1,95
"73087",1073087,183,70,16,269
"73088",1073088,22,6,5,33
"73089",1073089,191,44,16,251
"73090",1073090,46,290,4,340
"73091",1073091,311,1,2,314
"73092",1073092,45,19,1,65
"73093",1073093,34,243,9,286
"73094",1073094,51,246,7,304
"73095",1073095,183,71,4,258
"73096",1073096,80,143,2,225
"73097",1073097,49,115,13,177
"73098",1073098,54,108,2,164
"73099",1073099,17,267,3,287
"73100",1073100,34,242,5,281
"73101",1073101,155,83,12,250
"73102",1073102,55,164,6,225
"73103",1073103,192,11,2,205
"73104",1073104,130,119,17,266
"73105",1073105,52,195,15,262
"73106",1073106,32,60,2,94
"73107",1073107,63,23,5,91
"73108",1073108,103,107,11,221
"73109",1073109,98,189,11,298
"73110",1073110,145,69,2,216
"73111",1073111,190,32,10,232
"73112",1073112,143,66,6,215
"73113",1073113,12,19,2,33
"73114",1073114,77,218,5,300
"73115",1073115,17,254,5,276
"73116",1073116,57,84,5,146
"73117",1073117,71,254,11,336
"73118",1073118,148,35,4,187
"73119",1073119,274,9,6,289
"73120",1073120,73,112,7,192
"73121",1073121,62,99,6,167
"73122",1073122,116,47,3,166
"73123",1073123,192,13,1,206
"73124",1073124,52,254,7,313
"73125",1073125,207,103,23,333
"73126",1073126,2,2,0,4
"73127",1073127,144,92,7,243
"73128",1073128,29,240,6,275
"73129",1073129,138,67,12,217
"73130",1073130,192,80,13,285
"73131",1073131,152,80,16,248
"73132",1073132,33,219,3,255
"73133",1073133,6,8,1,15
"73134",1073134,50,139,2,191
"73135",1073135,100,93,11,204
"73136",1073136,219,21,4,244
"73137",1073137,111,76,3,190
"73138",1073138,182,15,9,206
"73139",1073139,213,51,4,268
"73140",1073140,50,234,3,287
"73141",1073141,125,139,23,287
"73142",1073142,71,150,8,229
"73143",1073143,150,12,3,165
"73144",1073144,169,110,8,287
"73145",1073145,82,248,18,348
"73146",1073146,27,48,5,80
"73147",1073147,172,19,5,196
"73148",1073148,204,34,25,263
"73149",1073149,173,58,6,237
"73150",1073150,164,55,6,225
"73151",1073151,186,77,1,264
"73152",1073152,10,2,1,13
"73153",1073153,225,100,15,340
"73154",1073154,175,50,7,232
"73155",1073155,64,20,3,87
"73156",1073156,14,87,5,106
"73157",1073157,15,228,3,246
"73158",1073158,75,58,6,139
"73159",1073159,202,64,12,278
"73160",1073160,39,243,6,288
"73161",1073161,130,195,10,335
"73162",1073162,45,283,6,334
"73163",1073163,179,22,5,206
"73164",1073164,200,115,19,334
"73165",1073165,89,133,12,234
"73166",1073166,284,15,5,304
"73167",1073167,92,77,7,176
"73168",1073168,186,93,26,305
"73169",1073169,28,267,3,298
"73170",1073170,195,70,19,284
"73171",1073171,140,77,9,226
"73172",1073172,138,156,12,306
"73173",1073173,262,46,10,318
"73174",1073174,110,100,10,220
"73175",1073175,6,52,0,58
"73176",1073176,194,39,2,235
"73177",1073177,146,91,8,245
"73178",1073178,91,151,20,262
"73179",1073179,203,69,28,300
"73180",1073180,156,69,2,227
"73181",1073181,121,52,2,175
"73182",1073182,170,32,4,206
"73183",1073183,220,42,13,275
"73184",1073184,169,58,7,234
"73185",1073185,206,55,9,270
"73186",1073186,146,136,21,303
"73187",1073187,99,196,9,304
"73188",1073188,149,18,9,176
"73189",1073189,97,131,17,245
"73190",1073190,31,70,5,106
"73191",1073191,60,150,3,213
"73192",1073192,19,3,1,23
"73193",1073193,29,209,22,260
"73194",1073194,26,13,1,40
"73195",1073195,191,61,6,258
"73196",1073196,139,123,17,279
"73197",1073197,98,142,8,248
"73198",1073198,72,89,3,164
"73199",1073199,118,156,6,280
"73200",1073200,72,220,16,308
"73201",1073201,94,72,8,174
"73202",1073202,85,117,12,214
"73203",1073203,169,65,6,240
"73204",1073204,180,36,8,224
"73205",1073205,214,75,17,306
"73206",1073206,181,52,2,235
"73207",1073207,123,90,12,225
"73208",1073208,180,84,16,280
"73209",1073209,96,30,3,129
"73210",1073210,54,31,9,94
"73211",1073211,183,36,13,232
"73212",1073212,119,131,12,262
"73213",1073213,70,170,7,247
"73214",1073214,87,123,4,214
"73215",1073215,27,211,7,245
"73216",1073216,77,255,6,338
"73217",1073217,118,97,13,228
"73218",1073218,61,149,5,215
"73219",1073219,32,147,8,187
"73220",1073220,45,211,3,259
"73221",1073221,179,69,4,252
"73222",1073222,191,83,18,292
"73223",1073223,66,164,6,236
"73224",1073224,96,182,4,282
"73225",1073225,183,63,2,248
"73226",1073226,15,33,1,49
"73227",1073227,63,124,1,188
"73228",1073228,273,14,3,290
"73229",1073229,105,41,6,152
"73230",1073230,19,166,4,189
"73231",1073231,133,104,8,245
"73232",1073232,67,183,6,256
"73233",1073233,0,12,0,12
"73234",1073234,152,67,10,229
"73235",1073235,145,134,22,301
"73236",1073236,66,243,22,331
"73237",1073237,167,74,13,254
"73238",1073238,169,75,11,255
"73239",1073239,156,69,8,233
"73240",1073240,69,176,7,252
"73241",1073241,116,109,5,230
"73242",1073242,5,65,1,71
"73243",1073243,51,102,3,156
"73244",1073244,43,300,7,350
"73245",1073245,170,99,9,278
"73246",1073246,69,261,11,341
"73247",1073247,15,186,3,204
"73248",1073248,78,24,3,105
"73249",1073249,222,80,11,313
"73250",1073250,55,20,0,75
"73251",1073251,42,64,2,108
"73252",1073252,93,119,14,226
"73253",1073253,103,212,11,326
"73254",1073254,152,92,10,254
"73255",1073255,137,95,14,246
"73256",1073256,71,148,12,231
"73257",1073257,81,125,6,212
"73258",1073258,97,245,10,352
"73259",1073259,121,81,4,206
"73260",1073260,10,63,2,75
"73261",1073261,86,20,1,107
"73262",1073262,112,123,8,243
"73263",1073263,211,22,3,236
"73264",1073264,167,71,12,250
"73265",1073265,59,236,2,297
"73266",1073266,44,180,4,228
"73267",1073267,117,142,15,274
"73268",1073268,152,86,6,244
"73269",1073269,195,46,9,250
"73270",1073270,120,149,10,279
"73271",1073271,35,255,1,291
"73272",1073272,180,31,3,214
"73273",1073273,130,105,24,259
"73274",1073274,115,142,0,257
"73275",1073275,173,47,11,231
"73276",1073276,18,40,1,59
"73277",1073277,66,75,4,145
"73278",1073278,123,140,7,270
"73279",1073279,19,258,1,278
"73280",1073280,86,76,6,168
"73281",1073281,27,324,4,355
"73282",1073282,156,64,4,224
"73283",1073283,136,92,12,240
"73284",1073284,157,23,9,189
"73285",1073285,179,63,16,258
"73286",1073286,115,91,2,208
"73287",1073287,114,95,10,219
"73288",1073288,92,42,1,135
"73289",1073289,100,113,3,216
"73290",1073290,138,28,3,169
"73291",1073291,46,92,5,143
"73292",1073292,113,139,10,262
"73293",1073293,151,129,5,285
"73294",1073294,13,231,2,246
"73295",1073295,97,173,11,281
"73296",1073296,30,268,2,300
"73297",1073297,87,170,8,265
"73298",1073298,142,131,20,293
"73299",1073299,30,42,4,76
"73300",1073300,48,71,2,121
"73301",1073301,201,51,18,270
"73302",1073302,30,91,3,124
"73303",1073303,81,228,3,312
"73304",1073304,172,120,14,306
"73305",1073305,229,17,7,253
"73306",1073306,122,90,1,213
"73307",1073307,114,170,11,295
"73308",1073308,119,64,1,184
"73309",1073309,120,99,4,223
"73310",1073310,4,65,0,69
"73311",1073311,165,26,9,200
"73312",1073312,14,12,2,28
"73313",1073313,33,236,5,274
"73314",1073314,115,38,16,169
"73315",1073315,139,154,17,310
"73316",1073316,64,253,13,330
"73317",1073317,132,87,3,222
"73318",1073318,157,19,6,182
"73319",1073319,170,78,15,263
"73320",1073320,166,81,9,256
"73321",1073321,124,56,9,189
"73322",1073322,103,198,4,305
"73323",1073323,150,84,5,239
"73324",1073324,69,118,11,198
"73325",1073325,211,94,17,322
"73326",1073326,57,232,5,294
"73327",1073327,60,56,11,127
"73328",1073328,59,188,15,262
"73329",1073329,145,66,5,216
"73330",1073330,157,28,5,190
"73331",1073331,109,218,12,339
"73332",1073332,98,100,13,211
"73333",1073333,28,53,3,84
"73334",1073334,113,186,7,306
"73335",1073335,63,218,9,290
"73336",1073336,56,253,18,327
"73337",1073337,147,130,7,284
"73338",1073338,133,111,5,249
"73339",1073339,13,96,1,110
"73340",1073340,128,168,8,304
"73341",1073341,102,29,3,134
"73342",1073342,177,7,3,187
"73343",1073343,91,11,1,103
"73344",1073344,146,91,7,244
"73345",1073345,43,205,5,253
"73346",1073346,103,93,1,197
"73347",1073347,81,75,6,162
"73348",1073348,138,101,6,245
"73349",1073349,193,97,11,301
"73350",1073350,58,4,2,64
"73351",1073351,176,128,11,315
"73352",1073352,162,60,7,229
"73353",1073353,134,114,9,257
"73354",1073354,121,17,2,140
"73355",1073355,68,206,9,283
"73356",1073356,61,113,6,180
"73357",1073357,54,172,3,229
"73358",1073358,22,170,5,197
"73359",1073359,109,139,4,252
"73360",1073360,91,117,17,225
"73361",1073361,94,34,8,136
"73362",1073362,156,93,12,261
"73363",1073363,90,142,11,243
"73364",1073364,37,172,4,213
"73365",1073365,72,193,2,267
"73366",1073366,49,92,7,148
"73367",1073367,162,97,8,267
"73368",1073368,138,35,13,186
"73369",1073369,63,187,12,262
"73370",1073370,60,22,2,84
"73371",1073371,140,32,6,178
"73372",1073372,73,194,4,271
"73373",1073373,83,188,13,284
"73374",1073374,73,122,9,204
"73375",1073375,22,46,1,69
"73376",1073376,187,50,9,246
"73377",1073377,201,11,6,218
"73378",1073378,167,36,1,204
"73379",1073379,116,189,19,324
"73380",1073380,46,157,4,207
"73381",1073381,168,17,3,188
"73382",1073382,32,197,6,235
"73383",1073383,68,162,6,236
"73384",1073384,15,5,0,20
"73385",1073385,69,231,9,309
"73386",1073386,131,67,13,211
"73387",1073387,98,12,12,122
"73388",1073388,73,2,1,76
"73389",1073389,175,42,7,224
"73390",1073390,107,18,11,136
"73391",1073391,108,169,10,287
"73392",1073392,27,47,3,77
"73393",1073393,164,95,12,271
"73394",1073394,116,123,15,254
"73395",1073395,193,88,19,300
"73396",1073396,71,34,1,106
"73397",1073397,57,71,3,131
"73398",1073398,135,68,11,214
"73399",1073399,141,56,8,205
"73400",1073400,116,92,2,210
"73401",1073401,2,100,1,103
"73402",1073402,60,90,8,158
"73403",1073403,33,188,4,225
"73404",1073404,187,19,9,215
"73405",1073405,200,33,9,242
"73406",1073406,233,19,7,259
"73407",1073407,3,21,0,24
"73408",1073408,75,181,15,271
"73409",1073409,101,117,2,220
"73410",1073410,200,51,11,262
"73411",1073411,210,36,9,255
"73412",1073412,158,92,12,262
"73413",1073413,233,42,15,290
"73414",1073414,123,62,9,194
"73415",1073415,121,36,1,158
"73416",1073416,59,12,2,73
"73417",1073417,31,141,2,174
"73418",1073418,100,224,7,331
"73419",1073419,100,190,21,311
"73420",1073420,136,89,24,249
"73421",1073421,135,46,11,192
"73422",1073422,76,183,1,260
"73423",1073423,120,22,5,147
"73424",1073424,83,144,24,251
"73425",1073425,88,157,7,252
"73426",1073426,49,173,8,230
"73427",1073427,34,86,7,127
"73428",1073428,164,42,6,212
"73429",1073429,157,145,13,315
"73430",1073430,23,230,4,257
"73431",1073431,53,259,7,319
"73432",1073432,36,153,11,200
"73433",1073433,83,29,5,117
"73434",1073434,42,106,1,149
"73435",1073435,31,5,1,37
"73436",1073436,219,104,5,328
"73437",1073437,171,99,15,285
"73438",1073438,94,184,12,290
"73439",1073439,185,28,14,227
"73440",1073440,167,65,9,241
"73441",1073441,166,24,6,196
"73442",1073442,201,71,19,291
"73443",1073443,59,117,6,182
"73444",1073444,144,104,4,252
"73445",1073445,32,15,2,49
"73446",1073446,223,60,21,304
"73447",1073447,161,31,10,202
"73448",1073448,221,76,10,307
"73449",1073449,152,92,7,251
"73450",1073450,115,109,11,235
"73451",1073451,85,119,8,212
"73452",1073452,29,218,2,249
"73453",1073453,186,124,11,321
"73454",1073454,128,159,8,295
"73455",1073455,36,42,3,81
"73456",1073456,176,95,12,283
"73457",1073457,87,132,5,224
"73458",1073458,213,75,11,299
"73459",1073459,41,154,4,199
"73460",1073460,145,82,4,231
"73461",1073461,143,36,12,191
"73462",1073462,73,199,10,282
"73463",1073463,143,177,11,331
"73464",1073464,77,72,6,155
"73465",1073465,160,55,8,223
"73466",1073466,104,13,6,123
"73467",1073467,67,164,5,236
"73468",1073468,61,219,3,283
"73469",1073469,41,162,3,206
"73470",1073470,22,90,2,114
"73471",1073471,109,114,6,229
"73472",1073472,133,66,7,206
"73473",1073473,55,132,6,193
"73474",1073474,64,141,4,209
"73475",1073475,62,237,6,305
"73476",1073476,164,57,10,231
"73477",1073477,87,168,1,256
"73478",1073478,54,47,1,102
"73479",1073479,147,173,12,332
"73480",1073480,60,105,6,171
"73481",1073481,82,148,3,233
"73482",1073482,1,92,0,93
"73483",1073483,194,32,12,238
"73484",1073484,185,115,8,308
"73485",1073485,59,172,7,238
"73486",1073486,97,179,13,289
"73487",1073487,50,42,1,93
"73488",1073488,198,33,11,242
"73489",1073489,158,31,6,195
"73490",1073490,28,77,4,109
"73491",1073491,114,143,8,265
"73492",1073492,213,51,6,270
"73493",1073493,212,12,1,225
"73494",1073494,120,97,12,229
"73495",1073495,56,130,6,192
"73496",1073496,168,108,12,288
"73497",1073497,80,13,1,94
"73498",1073498,57,246,5,308
"73499",1073499,185,67,1,253
"73500",1073500,107,136,15,258
"73501",1073501,105,38,4,147
"73502",1073502,7,7,3,17
"73503",1073503,51,244,4,299
"73504",1073504,59,54,8,121
"73505",1073505,160,78,6,244
"73506",1073506,117,83,4,204
"73507",1073507,119,96,14,229
"73508",1073508,81,63,6,150
"73509",1073509,189,117,11,317
"73510",1073510,33,118,3,154
"73511",1073511,67,11,0,78
"73512",1073512,15,4,0,19
"73513",1073513,73,219,2,294
"73514",1073514,84,28,14,126
"73515",1073515,109,64,10,183
"73516",1073516,169,86,12,267
"73517",1073517,158,69,5,232
"73518",1073518,166,20,9,195
"73519",1073519,144,55,6,205
"73520",1073520,105,99,6,210
"73521",1073521,104,145,15,264
"73522",1073522,34,265,17,316
"73523",1073523,227,5,0,232
"73524",1073524,139,102,13,254
"73525",1073525,222,72,17,311
"73526",1073526,56,302,6,364
"73527",1073527,210,54,10,274
"73528",1073528,150,39,8,197
"73529",1073529,71,14,0,85
"73530",1073530,60,46,0,106
"73531",1073531,118,94,9,221
"73532",1073532,65,100,18,183
"73533",1073533,119,120,3,242
"73534",1073534,66,187,2,255
"73535",1073535,172,90,7,269
"73536",1073536,88,97,6,191
"73537",1073537,47,131,19,197
"73538",1073538,160,88,11,259
"73539",1073539,65,228,13,306
"73540",1073540,164,52,9,225
"73541",1073541,145,117,13,275
"73542",1073542,50,241,6,297
"73543",1073543,143,25,8,176
"73544",1073544,17,46,2,65
"73545",1073545,61,25,2,88
"73546",1073546,127,130,5,262
"73547",1073547,149,134,2,285
"73548",1073548,147,88,10,245
"73549",1073549,143,39,12,194
"73550",1073550,146,118,15,279
"73551",1073551,36,0,2,38
"73552",1073552,66,162,16,244
"73553",1073553,105,155,10,270
"73554",1073554,136,39,7,182
"73555",1073555,291,17,6,314
"73556",1073556,192,43,6,241
"73557",1073557,121,159,4,284
"73558",1073558,62,18,5,85
"73559",1073559,251,24,8,283
"73560",1073560,74,155,9,238
"73561",1073561,92,3,4,99
"73562",1073562,107,58,5,170
"73563",1073563,118,127,11,256
"73564",1073564,106,78,8,192
"73565",1073565,74,199,7,280
"73566",1073566,113,218,9,340
"73567",1073567,115,153,21,289
"73568",1073568,92,133,9,234
"73569",1073569,84,396,30,510
"73570",1073570,80,200,11,291
"73571",1073571,148,88,7,243
"73572",1073572,197,83,3,283
"73573",1073573,147,154,9,310
"73574",1073574,45,58,2,105
"73575",1073575,66,266,5,337
"73576",1073576,133,35,3,171
"73577",1073577,83,222,6,311
"73578",1073578,149,32,8,189
"73579",1073579,94,6,4,104
"73580",1073580,79,205,6,290
"73581",1073581,94,201,10,305
"73582",1073582,166,21,6,193
"73583",1073583,231,30,2,263
"73584",1073584,138,87,8,233
"73585",1073585,41,224,5,270
"73586",1073586,79,175,7,261
"73587",1073587,46,31,4,81
"73588",1073588,27,9,1,37
"73589",1073589,48,84,2,134
"73590",1073590,48,82,6,136
"73591",1073591,117,116,10,243
"73592",1073592,149,60,14,223
"73593",1073593,149,96,3,248
"73594",1073594,20,22,1,43
"73595",1073595,46,136,5,187
"73596",1073596,69,45,5,119
"73597",1073597,68,221,14,303
"73598",1073598,41,202,6,249
"73599",1073599,194,22,3,219
"73600",1073600,26,0,0,26
"73601",1073601,77,130,11,218
"73602",1073602,144,123,9,276
"73603",1073603,61,157,12,230
"73604",1073604,216,31,5,252
"73605",1073605,54,89,7,150
"73606",1073606,173,69,12,254
"73607",1073607,157,99,11,267
"73608",1073608,123,66,2,191
"73609",1073609,153,198,14,365
"73610",1073610,113,68,10,191
"73611",1073611,105,141,7,253
"73612",1073612,74,209,11,294
"73613",1073613,71,249,4,324
"73614",1073614,39,263,5,307
"73615",1073615,135,122,16,273
"73616",1073616,22,87,2,111
"73617",1073617,139,58,13,210
"73618",1073618,79,91,15,185
"73619",1073619,75,192,15,282
"73620",1073620,188,31,6,225
"73621",1073621,45,239,2,286
"73622",1073622,151,113,5,269
"73623",1073623,39,215,1,255
"73624",1073624,100,167,16,283
"73625",1073625,55,200,17,272
"73626",1073626,142,23,15,180
"73627",1073627,122,154,7,283
"73628",1073628,182,82,13,277
"73629",1073629,170,74,5,249
"73630",1073630,192,18,3,213
"73631",1073631,170,16,6,192
"73632",1073632,121,89,13,223
"73633",1073633,150,124,5,279
"73634",1073634,236,57,12,305
"73635",1073635,177,93,16,286
"73636",1073636,101,33,3,137
"73637",1073637,122,18,2,142
"73638",1073638,109,114,0,223
"73639",1073639,166,20,3,189
"73640",1073640,180,123,7,310
"73641",1073641,147,78,6,231
"73642",1073642,75,206,5,286
"73643",1073643,101,55,8,164
"73644",1073644,73,80,6,159
"73645",1073645,70,157,18,245
"73646",1073646,180,61,12,253
"73647",1073647,119,12,2,133
"73648",1073648,5,36,2,43
"73649",1073649,49,190,5,244
"73650",1073650,81,13,1,95
"73651",1073651,137,51,4,192
"73652",1073652,164,140,20,324
"73653",1073653,230,20,7,257
"73654",1073654,183,77,14,274
"73655",1073655,43,300,2,345
"73656",1073656,60,156,9,225
"73657",1073657,95,67,12,174
"73658",1073658,112,13,7,132
"73659",1073659,183,145,11,339
"73660",1073660,102,142,12,256
"73661",1073661,59,195,2,256
"73662",1073662,43,200,15,258
"73663",1073663,21,168,4,193
"73664",1073664,125,104,4,233
"73665",1073665,5,104,2,111
"73666",1073666,131,52,9,192
"73667",1073667,57,184,10,251
"73668",1073668,205,66,11,282
"73669",1073669,163,89,11,263
"73670",1073670,60,206,1,267
"73671",1073671,170,12,4,186
"73672",1073672,86,199,5,290
"73673",1073673,161,91,12,264
"73674",1073674,48,25,6,79
"73675",1073675,93,151,4,248
"73676",1073676,101,106,19,226
"73677",1073677,7,2,0,9
"73678",1073678,316,69,9,394
"73679",1073679,46,235,20,301
"73680",1073680,82,26,9,117
"73681",1073681,12,36,6,54
"73682",1073682,74,205,14,293
"73683",1073683,171,97,12,280
"73684",1073684,185,64,9,258
"73685",1073685,80,66,7,153
"73686",1073686,85,163,7,255
"73687",1073687,60,131,7,198
"73688",1073688,67,14,2,83
"73689",1073689,68,90,10,168
"73690",1073690,18,109,1,128
"73691",1073691,190,66,8,264
"73692",1073692,162,149,19,330
"73693",1073693,188,29,8,225
"73694",1073694,183,21,5,209
"73695",1073695,161,136,17,314
"73696",1073696,177,27,5,209
"73697",1073697,100,11,2,113
"73698",1073698,97,179,4,280
"73699",1073699,93,242,15,350
"73700",1073700,72,28,4,104
"73701",1073701,161,139,8,308
"73702",1073702,84,235,5,324
"73703",1073703,130,1,4,135
"73704",1073704,104,142,10,256
"73705",1073705,45,55,4,104
"73706",1073706,191,53,3,247
"73707",1073707,33,19,2,54
"73708",1073708,146,26,2,174
"73709",1073709,101,197,16,314
"73710",1073710,95,141,12,248
"73711",1073711,163,61,0,224
"73712",1073712,42,65,3,110
"73713",1073713,167,32,6,205
"73714",1073714,181,83,17,281
"73715",1073715,175,31,10,216
"73716",1073716,59,153,6,218
"73717",1073717,14,32,2,48
"73718",1073718,132,124,12,268
"73719",1073719,203,28,7,238
"73720",1073720,116,186,4,306
"73721",1073721,101,194,6,301
"73722",1073722,109,43,10,162
"73723",1073723,75,95,9,179
"73724",1073724,146,125,17,288
"73725",1073725,120,159,10,289
"73726",1073726,49,170,8,227
"73727",1073727,231,2,3,236
"73728",1073728,157,149,24,330
"73729",1073729,134,81,7,222
"73730",1073730,63,168,13,244
"73731",1073731,175,51,12,238
"73732",1073732,32,172,15,219
"73733",1073733,63,130,10,203
"73734",1073734,17,3,0,20
"73735",1073735,105,156,7,268
"73736",1073736,202,8,4,214
"73737",1073737,108,13,2,123
"73738",1073738,146,30,7,183
"73739",1073739,122,101,11,234
"73740",1073740,52,158,6,216
"73741",1073741,92,204,13,309
"73742",1073742,48,185,5,238
"73743",1073743,59,17,1,77
"73744",1073744,74,180,8,262
"73745",1073745,69,185,8,262
"73746",1073746,50,138,6,194
"73747",1073747,104,130,10,244
"73748",1073748,141,63,2,206
"73749",1073749,51,135,4,190
"73750",1073750,123,192,9,324
"73751",1073751,26,203,1,230
"73752",1073752,72,100,1,173
"73753",1073753,159,42,9,210
"73754",1073754,158,29,11,198
"73755",1073755,101,95,24,220
"73756",1073756,160,128,18,306
"73757",1073757,46,213,21,280
"73758",1073758,81,143,6,230
"73759",1073759,59,129,6,194
"73760",1073760,118,169,7,294
"73761",1073761,62,388,6,456
"73762",1073762,155,67,11,233
"73763",1073763,97,119,8,224
"73764",1073764,193,59,11,263
"73765",1073765,43,27,2,72
"73766",1073766,95,116,8,219
"73767",1073767,40,209,7,256
"73768",1073768,36,229,5,270
"73769",1073769,30,6,2,38
"73770",1073770,42,127,6,175
"73771",1073771,63,72,6,141
"73772",1073772,20,238,2,260
"73773",1073773,192,13,4,209
"73774",1073774,195,56,13,264
"73775",1073775,59,189,6,254
"73776",1073776,22,32,2,56
"73777",1073777,103,191,13,307
"73778",1073778,74,161,11,246
"73779",1073779,142,68,5,215
"73780",1073780,128,104,6,238
"73781",1073781,73,104,0,177
"73782",1073782,140,86,9,235
"73783",1073783,205,23,5,233
"73784",1073784,121,106,11,238
"73785",1073785,115,148,9,272
"73786",1073786,238,32,6,276
"73787",1073787,206,31,8,245
"73788",1073788,32,22,1,55
"73789",1073789,60,156,6,222
"73790",1073790,253,36,17,306
"73791",1073791,214,60,11,285
"73792",1073792,75,68,6,149
"73793",1073793,78,152,3,233
"73794",1073794,20,300,10,330
"73795",1073795,136,83,11,230
"73796",1073796,259,5,8,272
"73797",1073797,37,269,6,312
"73798",1073798,48,98,3,149
"73799",1073799,143,71,8,222
"73800",1073800,60,110,8,178
"73801",1073801,192,9,3,204
"73802",1073802,123,26,1,150
"73803",1073803,23,223,1,247
"73804",1073804,205,22,10,237
"73805",1073805,12,28,1,41
"73806",1073806,149,60,13,222
"73807",1073807,99,116,7,222
"73808",1073808,82,252,7,341
"73809",1073809,49,191,7,247
"73810",1073810,81,104,7,192
"73811",1073811,75,159,3,237
"73812",1073812,143,99,2,244
"73813",1073813,71,139,11,221
"73814",1073814,6,269,3,278
"73815",1073815,137,44,9,190
"73816",1073816,141,51,5,197
"73817",1073817,149,75,10,234
"73818",1073818,33,233,5,271
"73819",1073819,79,229,11,319
"73820",1073820,109,55,13,177
"73821",1073821,156,69,17,242
"73822",1073822,70,221,15,306
"73823",1073823,187,94,20,301
"73824",1073824,87,50,4,141
"73825",1073825,164,79,9,252
"73826",1073826,94,176,11,281
"73827",1073827,21,213,4,238
"73828",1073828,161,77,2,240
"73829",1073829,102,47,5,154
"73830",1073830,75,193,14,282
"73831",1073831,191,30,12,233
"73832",1073832,52,140,4,196
"73833",1073833,24,186,7,217
"73834",1073834,152,106,15,273
"73835",1073835,165,21,8,194
"73836",1073836,134,59,5,198
"73837",1073837,88,86,2,176
"73838",1073838,42,214,4,260
"73839",1073839,39,204,4,247
"73840",1073840,99,5,3,107
"73841",1073841,2,8,1,11
"73842",1073842,104,58,7,169
"73843",1073843,102,108,10,220
"73844",1073844,126,95,3,224
"73845",1073845,131,148,11,290
"73846",1073846,58,38,5,101
"73847",1073847,16,6,2,24
"73848",1073848,114,54,8,176
"73849",1073849,70,187,5,262
"73850",1073850,21,146,3,170
"73851",1073851,142,29,10,181
"73852",1073852,70,120,3,193
"73853",1073853,92,52,7,151
"73854",1073854,106,80,4,190
"73855",1073855,25,269,10,304
"73856",1073856,109,141,4,254
"73857",1073857,198,21,2,221
"73858",1073858,33,196,5,234
"73859",1073859,116,144,6,266
"73860",1073860,47,251,8,306
"73861",1073861,73,224,3,300
"73862",1073862,121,110,4,235
"73863",1073863,51,0,1,52
"73864",1073864,128,124,11,263
"73865",1073865,113,100,3,216
"73866",1073866,41,25,2,68
"73867",1073867,117,162,6,285
"73868",1073868,171,13,3,187
"73869",1073869,170,35,5,210
"73870",1073870,137,6,5,148
"73871",1073871,104,87,7,198
"73872",1073872,133,118,19,270
"73873",1073873,84,89,4,177
"73874",1073874,96,70,17,183
"73875",1073875,145,46,1,192
"73876",1073876,151,82,9,242
"73877",1073877,252,15,12,279
"73878",1073878,141,35,6,182
"73879",1073879,76,145,3,224
"73880",1073880,58,170,18,246
"73881",1073881,88,19,5,112
"73882",1073882,43,120,2,165
"73883",1073883,93,135,3,231
"73884",1073884,118,24,4,146
"73885",1073885,115,49,15,179
"73886",1073886,124,81,6,211
"73887",1073887,120,52,5,177
"73888",1073888,138,83,4,225
"73889",1073889,103,16,0,119
"73890",1073890,72,190,4,266
"73891",1073891,118,209,8,335
"73892",1073892,59,125,12,196
"73893",1073893,106,94,3,203
"73894",1073894,222,22,8,252
"73895",1073895,110,75,23,208
"73896",1073896,65,164,15,244
"73897",1073897,131,125,19,275
"73898",1073898,278,9,4,291
"73899",1073899,166,33,4,203
"73900",1073900,139,60,11,210
"73901",1073901,107,112,11,230
"73902",1073902,20,257,2,279
"73903",1073903,152,116,5,273
"73904",1073904,42,149,6,197
"73905",1073905,145,131,14,290
"73906",1073906,69,185,6,260
"73907",1073907,14,35,2,51
"73908",1073908,119,40,4,163
"73909",1073909,176,65,7,248
"73910",1073910,142,11,6,159
"73911",1073911,132,148,7,287
"73912",1073912,61,225,3,289
"73913",1073913,82,111,11,204
"73914",1073914,147,23,2,172
"73915",1073915,140,140,14,294
"73916",1073916,80,142,20,242
"73917",1073917,98,154,10,262
"73918",1073918,14,4,0,18
"73919",1073919,177,96,7,280
"73920",1073920,69,117,5,191
"73921",1073921,28,21,3,52
"73922",1073922,220,55,14,289
"73923",1073923,50,41,4,95
"73924",1073924,93,116,20,229
"73925",1073925,88,173,11,272
"73926",1073926,117,73,7,197
"73927",1073927,66,174,10,250
"73928",1073928,96,87,23,206
"73929",1073929,177,125,19,321
"73930",1073930,121,121,3,245
"73931",1073931,116,160,13,289
"73932",1073932,79,67,5,151
"73933",1073933,127,88,5,220
"73934",1073934,74,151,5,230
"73935",1073935,41,141,3,185
"73936",1073936,104,86,5,195
"73937",1073937,80,232,9,321
"73938",1073938,31,221,1,253
"73939",1073939,101,160,2,263
"73940",1073940,56,195,3,254
"73941",1073941,154,67,13,234
"73942",1073942,194,56,5,255
"73943",1073943,49,62,3,114
"73944",1073944,69,187,4,260
"73945",1073945,124,101,11,236
"73946",1073946,80,58,8,146
"73947",1073947,73,149,4,226
"73948",1073948,8,58,2,68
"73949",1073949,13,238,4,255
"73950",1073950,152,40,7,199
"73951",1073951,114,201,21,336
"73952",1073952,103,19,2,124
"73953",1073953,93,145,9,247
"73954",1073954,47,158,5,210
"73955",1073955,155,69,7,231
"73956",1073956,65,98,10,173
"73957",1073957,173,18,4,195
"73958",1073958,80,150,14,244
"73959",1073959,116,95,8,219
"73960",1073960,102,208,5,315
"73961",1073961,147,12,4,163
"73962",1073962,149,63,6,218
"73963",1073963,94,50,4,148
"73964",1073964,232,15,7,254
"73965",1073965,177,45,9,231
"73966",1073966,218,34,6,258
"73967",1073967,100,141,4,245
"73968",1073968,9,181,5,195
"73969",1073969,207,26,6,239
"73970",1073970,121,70,11,202
"73971",1073971,23,278,3,304
"73972",1073972,31,195,1,227
"73973",1073973,5,19,1,25
"73974",1073974,38,132,4,174
"73975",1073975,47,173,6,226
"73976",1073976,61,266,3,330
"73977",1073977,66,142,14,222
"73978",1073978,83,134,13,230
"73979",1073979,73,180,8,261
"73980",1073980,153,107,15,275
"73981",1073981,57,6,3,66
"73982",1073982,181,9,5,195
"73983",1073983,33,74,5,112
"73984",1073984,132,48,7,187
"73985",1073985,127,101,3,231
"73986",1073986,211,37,3,251
"73987",1073987,45,32,1,78
"73988",1073988,86,190,20,296
"73989",1073989,46,141,6,193
"73990",1073990,132,145,20,297
"73991",1073991,157,11,1,169
"73992",1073992,17,151,5,173
"73993",1073993,51,58,9,118
"73994",1073994,24,210,5,239
"73995",1073995,218,91,12,321
"73996",1073996,54,280,20,354
"73997",1073997,46,44,7,97
"73998",1073998,179,88,3,270
"73999",1073999,50,47,5,102
"74000",1074000,239,15,5,259
"74001",1074001,147,25,9,181
"74002",1074002,92,184,13,289
"74003",1074003,90,141,2,233
"74004",1074004,154,90,12,256
"74005",1074005,67,63,6,136
"74006",1074006,153,47,5,205
"74007",1074007,86,63,6,155
"74008",1074008,11,221,7,239
"74009",1074009,119,73,2,194
"74010",1074010,126,99,3,228
"74011",1074011,145,48,6,199
"74012",1074012,17,285,3,305
"74013",1074013,106,112,5,223
"74014",1074014,98,64,1,163
"74015",1074015,172,102,16,290
"74016",1074016,38,241,1,280
"74017",1074017,203,105,14,322
"74018",1074018,13,53,0,66
"74019",1074019,20,50,1,71
"74020",1074020,175,107,4,286
"74021",1074021,25,6,2,33
"74022",1074022,201,46,4,251
"74023",1074023,66,71,4,141
"74024",1074024,66,113,16,195
"74025",1074025,45,176,13,234
"74026",1074026,92,171,17,280
"74027",1074027,71,127,14,212
"74028",1074028,122,138,7,267
"74029",1074029,176,81,18,275
"74030",1074030,91,163,14,268
"74031",1074031,85,191,10,286
"74032",1074032,49,14,2,65
"74033",1074033,117,85,12,214
"74034",1074034,73,53,9,135
"74035",1074035,58,250,1,309
"74036",1074036,72,76,4,152
"74037",1074037,138,106,9,253
"74038",1074038,123,118,5,246
"74039",1074039,74,89,3,166
"74040",1074040,146,53,12,211
"74041",1074041,34,44,5,83
"74042",1074042,164,75,4,243
"74043",1074043,226,40,5,271
"74044",1074044,131,74,4,209
"74045",1074045,53,186,9,248
"74046",1074046,61,153,13,227
"74047",1074047,163,103,12,278
"74048",1074048,152,101,4,257
"74049",1074049,34,76,2,112
"74050",1074050,136,70,8,214
"74051",1074051,195,110,13,318
"74052",1074052,40,167,8,215
"74053",1074053,140,35,11,186
"74054",1074054,163,75,9,247
"74055",1074055,184,44,6,234
"74056",1074056,60,85,5,150
"74057",1074057,124,158,9,291
"74058",1074058,88,140,10,238
"74059",1074059,103,83,20,206
"74060",1074060,73,99,7,179
"74061",1074061,44,233,12,289
"74062",1074062,173,45,9,227
"74063",1074063,217,10,11,238
"74064",1074064,106,122,12,240
"74065",1074065,16,16,1,33
"74066",1074066,15,4,2,21
"74067",1074067,77,94,15,186
"74068",1074068,152,86,13,251
"74069",1074069,119,95,14,228
"74070",1074070,30,256,3,289
"74071",1074071,180,45,15,240
"74072",1074072,49,228,4,281
"74073",1074073,10,111,2,123
"74074",1074074,155,70,8,233
"74075",1074075,232,38,5,275
"74076",1074076,82,164,0,246
"74077",1074077,156,23,7,186
"74078",1074078,66,8,3,77
"74079",1074079,28,180,0,208
"74080",1074080,93,45,6,144
"74081",1074081,121,41,4,166
"74082",1074082,148,87,5,240
"74083",1074083,159,39,11,209
"74084",1074084,176,70,3,249
"74085",1074085,120,90,14,224
"74086",1074086,53,165,6,224
"74087",1074087,94,26,2,122
"74088",1074088,109,0,0,109
"74089",1074089,162,61,7,230
"74090",1074090,155,199,26,380
"74091",1074091,159,126,11,296
"74092",1074092,146,125,5,276
"74093",1074093,265,0,7,272
"74094",1074094,93,59,9,161
"74095",1074095,144,170,20,334
"74096",1074096,71,216,10,297
"74097",1074097,133,122,5,260
"74098",1074098,47,250,8,305
"74099",1074099,171,57,8,236
"74100",1074100,83,179,7,269
"74101",1074101,91,187,13,291
"74102",1074102,64,231,3,298
"74103",1074103,91,112,12,215
"74104",1074104,135,136,9,280
"74105",1074105,108,160,3,271
"74106",1074106,101,189,16,306
"74107",1074107,170,56,5,231
"74108",1074108,45,41,2,88
"74109",1074109,67,54,3,124
"74110",1074110,95,122,7,224
"74111",1074111,167,19,8,194
"74112",1074112,127,187,8,322
"74113",1074113,129,69,8,206
"74114",1074114,101,146,10,257
"74115",1074115,64,184,12,260
"74116",1074116,165,50,4,219
"74117",1074117,98,220,7,325
"74118",1074118,107,19,9,135
"74119",1074119,74,142,3,219
"74120",1074120,168,18,5,191
"74121",1074121,158,65,12,235
"74122",1074122,25,253,3,281
"74123",1074123,116,0,0,116
"74124",1074124,22,51,6,79
"74125",1074125,156,116,12,284
"74126",1074126,112,75,4,191
"74127",1074127,211,67,8,286
"74128",1074128,21,27,2,50
"74129",1074129,191,88,5,284
"74130",1074130,96,96,14,206
"74131",1074131,127,89,2,218
"74132",1074132,111,24,4,139
"74133",1074133,145,152,15,312
"74134",1074134,144,64,5,213
"74135",1074135,57,180,3,240
"74136",1074136,85,206,3,294
"74137",1074137,68,207,16,291
"74138",1074138,146,46,5,197
"74139",1074139,31,201,3,235
"74140",1074140,188,124,10,322
"74141",1074141,145,78,14,237
"74142",1074142,211,25,9,245
"74143",1074143,94,83,3,180
"74144",1074144,77,175,6,258
"74145",1074145,102,47,2,151
"74146",1074146,183,108,5,296
"74147",1074147,137,44,22,203
"74148",1074148,36,260,4,300
"74149",1074149,64,37,7,108
"74150",1074150,168,102,13,283
"74151",1074151,155,120,9,284
"74152",1074152,201,65,9,275
"74153",1074153,97,159,6,262
"74154",1074154,80,171,11,262
"74155",1074155,178,35,9,222
"74156",1074156,67,213,9,289
"74157",1074157,139,190,15,344
"74158",1074158,88,22,6,116
"74159",1074159,117,20,4,141
"74160",1074160,72,145,14,231
"74161",1074161,161,8,12,181
"74162",1074162,189,39,9,237
"74163",1074163,180,44,16,240
"74164",1074164,73,222,2,297
"74165",1074165,147,86,4,237
"74166",1074166,165,39,8,212
"74167",1074167,93,64,4,161
"74168",1074168,89,66,1,156
"74169",1074169,4,61,1,66
"74170",1074170,236,15,3,254
"74171",1074171,182,50,13,245
"74172",1074172,71,145,11,227
"74173",1074173,225,48,13,286
"74174",1074174,235,8,3,246
"74175",1074175,87,188,13,288
"74176",1074176,162,35,11,208
"74177",1074177,169,39,6,214
"74178",1074178,121,97,7,225
"74179",1074179,174,78,15,267
"74180",1074180,117,35,8,160
"74181",1074181,102,117,11,230
"74182",1074182,17,5,2,24
"74183",1074183,15,76,3,94
"74184",1074184,39,153,3,195
"74185",1074185,82,84,8,174
"74186",1074186,100,201,8,309
"74187",1074187,21,101,8,130
"74188",1074188,79,193,10,282
"74189",1074189,77,23,0,100
"74190",1074190,147,133,5,285
"74191",1074191,74,171,5,250
"74192",1074192,106,117,8,231
"74193",1074193,70,123,6,199
"74194",1074194,73,129,11,213
"74195",1074195,126,73,16,215
"74196",1074196,34,15,2,51
"74197",1074197,39,109,4,152
"74198",1074198,197,96,8,301
"74199",1074199,136,111,9,256
"74200",1074200,74,112,19,205
"74201",1074201,167,42,8,217
"74202",1074202,97,138,9,244
"74203",1074203,157,37,4,198
"74204",1074204,46,92,10,148
"74205",1074205,159,157,13,329
"74206",1074206,189,45,7,241
"74207",1074207,116,145,9,270
"74208",1074208,38,154,9,201
"74209",1074209,218,100,14,332
"74210",1074210,59,230,2,291
"74211",1074211,39,129,19,187
"74212",1074212,55,263,5,323
"74213",1074213,172,122,14,308
"74214",1074214,75,196,11,282
"74215",1074215,32,202,7,241
"74216",1074216,188,18,35,241
"74217",1074217,102,208,7,317
"74218",1074218,187,51,1,239
"74219",1074219,35,96,8,139
"74220",1074220,122,106,5,233
"74221",1074221,117,6,7,130
"74222",1074222,106,162,21,289
"74223",1074223,135,145,11,291
"74224",1074224,93,125,3,221
"74225",1074225,154,34,5,193
"74226",1074226,7,3,1,11
"74227",1074227,155,35,4,194
"74228",1074228,39,180,12,231
"74229",1074229,170,77,7,254
"74230",1074230,66,257,4,327
"74231",1074231,27,166,6,199
"74232",1074232,9,31,1,41
"74233",1074233,54,37,5,96
"74234",1074234,138,154,3,295
"74235",1074235,165,80,9,254
"74236",1074236,130,128,18,276
"74237",1074237,93,159,14,266
"74238",1074238,251,16,3,270
"74239",1074239,66,175,9,250
"74240",1074240,34,171,10,215
"74241",1074241,108,148,18,274
"74242",1074242,124,82,8,214
"74243",1074243,174,77,26,277
"74244",1074244,94,220,6,320
"74245",1074245,51,5,0,56
"74246",1074246,217,21,5,243
"74247",1074247,181,19,7,207
"74248",1074248,118,111,8,237
"74249",1074249,33,262,4,299
"74250",1074250,127,144,17,288
"74251",1074251,55,119,6,180
"74252",1074252,32,141,4,177
"74253",1074253,96,110,14,220
"74254",1074254,24,82,1,107
"74255",1074255,52,170,10,232
"74256",1074256,11,4,0,15
"74257",1074257,71,121,18,210
"74258",1074258,82,209,11,302
"74259",1074259,192,99,12,303
"74260",1074260,126,55,9,190
"74261",1074261,217,10,5,232
"74262",1074262,90,61,9,160
"74263",1074263,51,164,5,220
"74264",1074264,93,203,16,312
"74265",1074265,142,186,11,339
"74266",1074266,33,21,5,59
"74267",1074267,226,80,10,316
"74268",1074268,95,89,14,198
"74269",1074269,58,237,8,303
"74270",1074270,142,9,5,156
"74271",1074271,21,33,6,60
"74272",1074272,46,236,3,285
"74273",1074273,10,7,0,17
"74274",1074274,133,119,6,258
"74275",1074275,166,44,12,222
"74276",1074276,142,180,13,335
"74277",1074277,230,68,11,309
"74278",1074278,165,75,16,256
"74279",1074279,173,45,12,230
"74280",1074280,62,23,5,90
"74281",1074281,88,150,3,241
"74282",1074282,61,139,9,209
"74283",1074283,249,70,10,329
"74284",1074284,83,147,12,242
"74285",1074285,31,113,7,151
"74286",1074286,88,190,13,291
"74287",1074287,106,3,3,112
"74288",1074288,211,87,4,302
"74289",1074289,237,24,8,269
"74290",1074290,139,85,10,234
"74291",1074291,36,144,5,185
"74292",1074292,136,71,16,223
"74293",1074293,145,23,1,169
"74294",1074294,80,32,4,116
"74295",1074295,45,277,7,329
"74296",1074296,10,4,0,14
"74297",1074297,80,191,14,285
"74298",1074298,98,70,0,168
"74299",1074299,118,44,16,178
"74300",1074300,80,135,7,222
"74301",1074301,38,263,8,309
"74302",1074302,92,87,11,190
"74303",1074303,141,11,2,154
"74304",1074304,151,140,21,312
"74305",1074305,156,119,25,300
"74306",1074306,202,73,22,297
"74307",1074307,219,18,3,240
"74308",1074308,140,62,12,214
"74309",1074309,74,237,5,316
"74310",1074310,16,79,7,102
"74311",1074311,114,90,4,208
"74312",1074312,115,26,3,144
"74313",1074313,183,86,9,278
"74314",1074314,129,118,3,250
"74315",1074315,261,3,17,281
"74316",1074316,145,136,14,295
"74317",1074317,65,51,1,117
"74318",1074318,115,57,5,177
"74319",1074319,107,165,2,274
"74320",1074320,75,221,6,302
"74321",1074321,75,182,31,288
"74322",1074322,45,184,6,235
"74323",1074323,180,28,4,212
"74324",1074324,181,70,10,261
"74325",1074325,112,142,2,256
"74326",1074326,146,44,10,200
"74327",1074327,203,66,5,274
"74328",1074328,69,205,5,279
"74329",1074329,160,27,10,197
"74330",1074330,283,5,4,292
"74331",1074331,171,51,10,232
"74332",1074332,54,214,23,291
"74333",1074333,49,142,1,192
"74334",1074334,21,116,10,147
"74335",1074335,133,238,5,376
"74336",1074336,161,16,12,189
"74337",1074337,13,228,4,245
"74338",1074338,29,13,1,43
"74339",1074339,192,75,5,272
"74340",1074340,266,50,12,328
"74341",1074341,118,137,7,262
"74342",1074342,183,42,15,240
"74343",1074343,95,105,1,201
"74344",1074344,30,157,10,197
"74345",1074345,205,61,17,283
"74346",1074346,245,18,11,274
"74347",1074347,266,65,7,338
"74348",1074348,17,221,3,241
"74349",1074349,319,55,34,408
"74350",1074350,12,260,5,277
"74351",1074351,175,45,3,223
"74352",1074352,35,175,2,212
"74353",1074353,85,189,22,296
"74354",1074354,79,128,7,214
"74355",1074355,17,175,4,196
"74356",1074356,174,101,3,278
"74357",1074357,111,76,13,200
"74358",1074358,13,14,4,31
"74359",1074359,87,174,12,273
"74360",1074360,88,72,8,168
"74361",1074361,17,25,0,42
"74362",1074362,141,88,4,233
"74363",1074363,156,126,23,305
"74364",1074364,19,245,4,268
"74365",1074365,66,299,15,380
"74366",1074366,52,246,12,310
"74367",1074367,143,98,15,256
"74368",1074368,30,134,10,174
"74369",1074369,58,137,8,203
"74370",1074370,253,55,3,311
"74371",1074371,74,54,4,132
"74372",1074372,81,172,3,256
"74373",1074373,192,60,12,264
"74374",1074374,85,151,18,254
"74375",1074375,40,78,5,123
"74376",1074376,59,125,9,193
"74377",1074377,22,228,1,251
"74378",1074378,161,49,3,213
"74379",1074379,72,75,5,152
"74380",1074380,39,18,0,57
"74381",1074381,75,136,3,214
"74382",1074382,130,104,4,238
"74383",1074383,170,55,10,235
"74384",1074384,149,97,10,256
"74385",1074385,156,53,4,213
"74386",1074386,183,48,11,242
"74387",1074387,152,135,24,311
"74388",1074388,98,154,6,258
"74389",1074389,31,192,10,233
"74390",1074390,130,121,11,262
"74391",1074391,84,124,5,213
"74392",1074392,125,127,10,262
"74393",1074393,136,162,19,317
"74394",1074394,88,89,7,184
"74395",1074395,168,84,14,266
"74396",1074396,184,39,9,232
"74397",1074397,39,160,10,209
"74398",1074398,68,259,11,338
"74399",1074399,128,52,10,190
"74400",1074400,123,138,18,279
"74401",1074401,27,268,3,298
"74402",1074402,139,68,12,219
"74403",1074403,84,191,15,290
"74404",1074404,111,67,19,197
"74405",1074405,70,39,4,113
"74406",1074406,206,17,6,229
"74407",1074407,194,95,4,293
"74408",1074408,192,27,6,225
"74409",1074409,57,161,2,220
"74410",1074410,25,182,2,209
"74411",1074411,34,212,2,248
"74412",1074412,96,112,6,214
"74413",1074413,18,156,8,182
"74414",1074414,147,110,4,261
"74415",1074415,32,119,5,156
"74416",1074416,133,34,7,174
"74417",1074417,89,172,26,287
"74418",1074418,144,43,5,192
"74419",1074419,41,126,5,172
"74420",1074420,103,73,4,180
"74421",1074421,141,41,6,188
"74422",1074422,71,157,7,235
"74423",1074423,86,85,16,187
"74424",1074424,166,89,20,275
"74425",1074425,112,154,12,278
"74426",1074426,47,226,9,282
"74427",1074427,143,7,3,153
"74428",1074428,61,43,2,106
"74429",1074429,84,153,25,262
"74430",1074430,202,69,12,283
"74431",1074431,21,133,11,165
"74432",1074432,75,122,4,201
"74433",1074433,162,143,6,311
"74434",1074434,67,203,5,275
"74435",1074435,56,2,2,60
"74436",1074436,90,150,4,244
"74437",1074437,166,102,9,277
"74438",1074438,123,190,21,334
"74439",1074439,57,100,2,159
"74440",1074440,152,35,8,195
"74441",1074441,51,94,1,146
"74442",1074442,128,51,13,192
"74443",1074443,148,121,14,283
"74444",1074444,140,97,11,248
"74445",1074445,96,94,1,191
"74446",1074446,127,110,1,238
"74447",1074447,110,126,7,243
"74448",1074448,108,70,8,186
"74449",1074449,114,97,3,214
"74450",1074450,12,286,0,298
"74451",1074451,195,92,16,303
"74452",1074452,108,115,5,228
"74453",1074453,64,208,14,286
"74454",1074454,151,44,14,209
"74455",1074455,130,79,8,217
"74456",1074456,117,38,1,156
"74457",1074457,45,156,3,204
"74458",1074458,34,76,2,112
"74459",1074459,28,6,1,35
"74460",1074460,44,50,2,96
"74461",1074461,149,78,6,233
"74462",1074462,74,189,25,288
"74463",1074463,84,150,6,240
"74464",1074464,70,82,6,158
"74465",1074465,103,171,6,280
"74466",1074466,274,255,36,565
"74467",1074467,227,81,29,337
"74468",1074468,217,69,14,300
"74469",1074469,87,109,5,201
"74470",1074470,126,87,10,223
"74471",1074471,192,13,9,214
"74472",1074472,110,152,9,271
"74473",1074473,199,75,10,284
"74474",1074474,118,71,2,191
"74475",1074475,60,198,6,264
"74476",1074476,140,113,7,260
"74477",1074477,147,142,18,307
"74478",1074478,171,113,14,298
"74479",1074479,158,113,5,276
"74480",1074480,164,120,6,290
"74481",1074481,71,246,20,337
"74482",1074482,124,134,8,266
"74483",1074483,109,153,5,267
"74484",1074484,202,25,5,232
"74485",1074485,54,189,10,253
"74486",1074486,88,100,2,190
"74487",1074487,196,78,8,282
"74488",1074488,59,202,10,271
"74489",1074489,93,73,2,168
"74490",1074490,86,85,10,181
"74491",1074491,125,193,25,343
"74492",1074492,23,14,2,39
"74493",1074493,77,173,22,272
"74494",1074494,103,78,6,187
"74495",1074495,62,46,0,108
"74496",1074496,93,43,4,140
"74497",1074497,47,209,10,266
"74498",1074498,13,31,2,46
"74499",1074499,72,224,5,301
"74500",1074500,187,54,4,245
"74501",1074501,139,165,9,313
"74502",1074502,4,18,1,23
"74503",1074503,64,117,11,192
"74504",1074504,191,20,13,224
"74505",1074505,121,159,15,295
"74506",1074506,185,90,14,289
"74507",1074507,162,89,13,264
"74508",1074508,176,106,7,289
"74509",1074509,10,18,1,29
"74510",1074510,142,75,21,238
"74511",1074511,189,33,6,228
"74512",1074512,124,48,6,178
"74513",1074513,88,30,1,119
"74514",1074514,189,123,12,324
"74515",1074515,91,83,12,186
"74516",1074516,72,161,8,241
"74517",1074517,93,168,9,270
"74518",1074518,53,63,10,126
"74519",1074519,52,217,5,274
"74520",1074520,219,33,9,261
"74521",1074521,51,147,22,220
"74522",1074522,26,224,5,255
"74523",1074523,51,245,5,301
"74524",1074524,182,42,12,236
"74525",1074525,125,69,6,200
"74526",1074526,64,177,5,246
"74527",1074527,178,18,5,201
"74528",1074528,91,46,9,146
"74529",1074529,159,151,3,313
"74530",1074530,157,106,6,269
"74531",1074531,52,56,0,108
"74532",1074532,93,158,8,259
"74533",1074533,137,97,20,254
"74534",1074534,129,149,6,284
"74535",1074535,64,176,4,244
"74536",1074536,6,6,0,12
"74537",1074537,152,103,8,263
"74538",1074538,67,181,18,266
"74539",1074539,111,72,3,186
"74540",1074540,47,173,7,227
"74541",1074541,41,138,5,184
"74542",1074542,73,227,8,308
"74543",1074543,112,54,3,169
"74544",1074544,161,22,5,188
"74545",1074545,22,110,0,132
"74546",1074546,162,88,16,266
"74547",1074547,166,83,9,258
"74548",1074548,191,37,8,236
"74549",1074549,73,60,7,140
"74550",1074550,128,158,12,298
"74551",1074551,98,165,5,268
"74552",1074552,32,168,1,201
"74553",1074553,107,43,2,152
"74554",1074554,101,120,13,234
"74555",1074555,79,179,10,268
"74556",1074556,104,76,25,205
"74557",1074557,130,156,7,293
"74558",1074558,113,114,13,240
"74559",1074559,147,80,8,235
"74560",1074560,145,54,10,209
"74561",1074561,81,40,0,121
"74562",1074562,20,50,0,70
"74563",1074563,87,195,8,290
"74564",1074564,249,73,6,328
"74565",1074565,292,97,6,395
"74566",1074566,182,95,14,291
"74567",1074567,132,37,5,174
"74568",1074568,173,51,2,226
"74569",1074569,116,21,3,140
"74570",1074570,186,28,7,221
"74571",1074571,38,28,4,70
"74572",1074572,30,238,3,271
"74573",1074573,64,74,3,141
"74574",1074574,145,109,7,261
"74575",1074575,122,205,9,336
"74576",1074576,56,281,11,348
"74577",1074577,187,31,10,228
"74578",1074578,43,131,2,176
"74579",1074579,199,35,7,241
"74580",1074580,215,78,26,319
"74581",1074581,115,39,8,162
"74582",1074582,63,105,4,172
"74583",1074583,111,24,1,136
"74584",1074584,61,51,5,117
"74585",1074585,82,163,1,246
"74586",1074586,95,192,9,296
"74587",1074587,169,14,8,191
"74588",1074588,100,175,4,279
"74589",1074589,245,34,6,285
"74590",1074590,80,111,17,208
"74591",1074591,178,72,9,259
"74592",1074592,95,94,9,198
"74593",1074593,39,211,7,257
"74594",1074594,206,25,12,243
"74595",1074595,54,168,13,235
"74596",1074596,131,21,6,158
"74597",1074597,165,40,4,209
"74598",1074598,41,247,3,291
"74599",1074599,98,181,9,288
"74600",1074600,107,24,2,133
"74601",1074601,77,186,2,265
"74602",1074602,94,209,10,313
"74603",1074603,158,152,12,322
"74604",1074604,79,124,8,211
"74605",1074605,141,39,11,191
"74606",1074606,197,21,10,228
"74607",1074607,68,152,4,224
"74608",1074608,114,1,0,115
"74609",1074609,120,136,13,269
"74610",1074610,127,85,10,222
"74611",1074611,92,188,12,292
"74612",1074612,152,120,5,277
"74613",1074613,106,40,6,152
"74614",1074614,86,132,4,222
"74615",1074615,159,98,9,266
"74616",1074616,183,26,9,218
"74617",1074617,77,119,6,202
"74618",1074618,61,73,2,136
"74619",1074619,125,187,16,328
"74620",1074620,75,392,24,491
"74621",1074621,114,45,9,168
"74622",1074622,109,66,10,185
"74623",1074623,82,148,6,236
"74624",1074624,35,264,15,314
"74625",1074625,178,2,4,184
"74626",1074626,123,103,15,241
"74627",1074627,164,94,7,265
"74628",1074628,125,116,16,257
"74629",1074629,46,2,0,48
"74630",1074630,126,23,9,158
"74631",1074631,32,257,13,302
"74632",1074632,47,262,10,319
"74633",1074633,71,173,16,260
"74634",1074634,49,33,4,86
"74635",1074635,113,163,8,284
"74636",1074636,83,87,6,176
"74637",1074637,40,31,6,77
"74638",1074638,91,24,9,124
"74639",1074639,143,129,7,279
"74640",1074640,148,94,2,244
"74641",1074641,176,41,9,226
"74642",1074642,43,236,5,284
"74643",1074643,59,247,5,311
"74644",1074644,92,108,5,205
"74645",1074645,38,0,0,38
"74646",1074646,91,357,9,457
"74647",1074647,158,100,15,273
"74648",1074648,76,162,22,260
"74649",1074649,104,145,5,254
"74650",1074650,90,45,5,140
"74651",1074651,210,18,9,237
"74652",1074652,41,148,8,197
"74653",1074653,86,44,6,136
"74654",1074654,75,174,5,254
"74655",1074655,20,3,2,25
"74656",1074656,137,18,3,158
"74657",1074657,35,37,0,72
"74658",1074658,162,57,9,228
"74659",1074659,142,144,24,310
"74660",1074660,144,135,6,285
"74661",1074661,62,201,17,280
"74662",1074662,81,19,3,103
"74663",1074663,27,18,0,45
"74664",1074664,164,50,5,219
"74665",1074665,41,140,5,186
"74666",1074666,144,98,6,248
"74667",1074667,10,13,0,23
"74668",1074668,73,205,9,287
"74669",1074669,148,25,1,174
"74670",1074670,167,54,16,237
"74671",1074671,73,134,4,211
"74672",1074672,115,98,9,222
"74673",1074673,231,38,7,276
"74674",1074674,195,87,9,291
"74675",1074675,99,162,5,266
"74676",1074676,73,157,17,247
"74677",1074677,63,100,1,164
"74678",1074678,75,35,2,112
"74679",1074679,89,12,2,103
"74680",1074680,104,37,1,142
"74681",1074681,10,44,0,54
"74682",1074682,21,211,7,239
"74683",1074683,3,30,2,35
"74684",1074684,145,36,8,189
"74685",1074685,207,38,12,257
"74686",1074686,115,14,2,131
"74687",1074687,173,99,3,275
"74688",1074688,103,89,13,205
"74689",1074689,145,50,11,206
"74690",1074690,16,168,1,185
"74691",1074691,127,84,5,216
"74692",1074692,144,70,9,223
"74693",1074693,150,23,5,178
"74694",1074694,127,94,9,230
"74695",1074695,138,131,16,285
"74696",1074696,34,210,8,252
"74697",1074697,100,13,2,115
"74698",1074698,18,34,1,53
"74699",1074699,14,41,2,57
"74700",1074700,212,100,13,325
"74701",1074701,184,81,9,274
"74702",1074702,145,99,15,259
"74703",1074703,208,18,7,233
"74704",1074704,148,63,9,220
"74705",1074705,105,102,23,230
"74706",1074706,49,171,13,233
"74707",1074707,24,32,1,57
"74708",1074708,107,14,3,124
"74709",1074709,172,73,7,252
"74710",1074710,109,122,10,241
"74711",1074711,306,14,5,325
"74712",1074712,105,121,7,233
"74713",1074713,124,71,2,197
"74714",1074714,39,266,2,307
"74715",1074715,209,33,7,249
"74716",1074716,88,136,1,225
"74717",1074717,91,135,3,229
"74718",1074718,123,85,7,215
"74719",1074719,92,59,7,158
"74720",1074720,84,173,3,260
"74721",1074721,52,65,1,118
"74722",1074722,158,106,9,273
"74723",1074723,31,118,4,153
"74724",1074724,113,4,7,124
"74725",1074725,20,23,3,46
"74726",1074726,82,117,15,214
"74727",1074727,79,180,3,262
"74728",1074728,158,108,22,288
"74729",1074729,136,118,17,271
"74730",1074730,73,53,5,131
"74731",1074731,139,55,6,200
"74732",1074732,144,68,5,217
"74733",1074733,145,44,9,198
"74734",1074734,142,28,5,175
"74735",1074735,38,208,1,247
"74736",1074736,94,108,11,213
"74737",1074737,183,66,8,257
"74738",1074738,50,249,11,310
"74739",1074739,91,108,4,203
"74740",1074740,26,20,3,49
"74741",1074741,108,119,15,242
"74742",1074742,156,30,8,194
"74743",1074743,178,52,5,235
"74744",1074744,18,23,2,43
"74745",1074745,182,85,11,278
"74746",1074746,53,300,2,355
"74747",1074747,69,61,9,139
"74748",1074748,45,281,5,331
"74749",1074749,87,120,9,216
"74750",1074750,72,50,6,128
"74751",1074751,51,148,2,201
"74752",1074752,49,235,5,289
"74753",1074753,42,277,9,328
"74754",1074754,204,43,9,256
"74755",1074755,32,28,4,64
"74756",1074756,107,81,9,197
"74757",1074757,116,22,5,143
"74758",1074758,165,26,14,205
"74759",1074759,162,59,3,224
"74760",1074760,55,47,2,104
"74761",1074761,7,13,1,21
"74762",1074762,103,151,7,261
"74763",1074763,189,8,2,199
"74764",1074764,120,108,3,231
"74765",1074765,113,96,9,218
"74766",1074766,116,191,1,308
"74767",1074767,120,112,10,242
"74768",1074768,137,144,19,300
"74769",1074769,173,25,5,203
"74770",1074770,30,220,1,251
"74771",1074771,48,129,7,184
"74772",1074772,165,62,18,245
"74773",1074773,220,23,14,257
"74774",1074774,112,7,1,120
"74775",1074775,206,44,4,254
"74776",1074776,92,168,9,269
"74777",1074777,97,95,9,201
"74778",1074778,195,38,2,235
"74779",1074779,121,166,8,295
"74780",1074780,29,56,4,89
"74781",1074781,139,102,4,245
"74782",1074782,53,195,4,252
"74783",1074783,28,191,4,223
"74784",1074784,80,161,20,261
"74785",1074785,19,224,4,247
"74786",1074786,195,32,11,238
"74787",1074787,51,234,6,291
"74788",1074788,167,40,10,217
"74789",1074789,128,42,2,172
"74790",1074790,131,78,8,217
"74791",1074791,93,130,6,229
"74792",1074792,22,239,3,264
"74793",1074793,93,1,0,94
"74794",1074794,83,26,6,115
"74795",1074795,172,66,10,248
"74796",1074796,114,126,6,246
"74797",1074797,64,112,24,200
"74798",1074798,43,181,8,232
"74799",1074799,217,107,10,334
"74800",1074800,163,109,20,292
"74801",1074801,221,24,6,251
"74802",1074802,111,77,4,192
"74803",1074803,72,138,13,223
"74804",1074804,234,90,6,330
"74805",1074805,21,32,1,54
"74806",1074806,166,120,15,301
"74807",1074807,22,182,7,211
"74808",1074808,105,57,14,176
"74809",1074809,33,180,6,219
"74810",1074810,36,174,10,220
"74811",1074811,221,69,9,299
"74812",1074812,91,132,21,244
"74813",1074813,105,153,10,268
"74814",1074814,126,72,13,211
"74815",1074815,80,180,13,273
"74816",1074816,78,167,9,254
"74817",1074817,169,75,17,261
"74818",1074818,61,193,16,270
"74819",1074819,21,114,6,141
"74820",1074820,101,177,11,289
"74821",1074821,134,66,5,205
"74822",1074822,150,59,6,215
"74823",1074823,255,26,7,288
"74824",1074824,55,114,5,174
"74825",1074825,83,209,13,305
"74826",1074826,74,178,6,258
"74827",1074827,46,138,4,188
"74828",1074828,198,41,8,247
"74829",1074829,60,173,18,251
"74830",1074830,82,176,11,269
"74831",1074831,193,66,13,272
"74832",1074832,174,106,4,284
"74833",1074833,24,35,5,64
"74834",1074834,78,110,6,194
"74835",1074835,83,208,15,306
"74836",1074836,35,180,1,216
"74837",1074837,10,64,2,76
"74838",1074838,227,18,4,249
"74839",1074839,81,127,10,218
"74840",1074840,135,85,8,228
"74841",1074841,104,197,10,311
"74842",1074842,60,209,2,271
"74843",1074843,46,225,0,271
"74844",1074844,161,105,9,275
"74845",1074845,139,113,20,272
"74846",1074846,55,179,26,260
"74847",1074847,207,23,5,235
"74848",1074848,186,0,0,186
"74849",1074849,72,105,16,193
"74850",1074850,73,52,3,128
"74851",1074851,120,90,12,222
"74852",1074852,47,155,3,205
"74853",1074853,75,105,4,184
"74854",1074854,54,240,8,302
"74855",1074855,303,101,21,425
"74856",1074856,97,164,4,265
"74857",1074857,105,270,3,378
"74858",1074858,121,91,4,216
"74859",1074859,162,32,13,207
"74860",1074860,67,159,15,241
"74861",1074861,146,58,14,218
"74862",1074862,154,75,19,248
"74863",1074863,51,22,0,73
"74864",1074864,119,49,6,174
"74865",1074865,172,39,11,222
"74866",1074866,140,89,8,237
"74867",1074867,94,47,4,145
"74868",1074868,101,83,9,193
"74869",1074869,73,151,2,226
"74870",1074870,186,28,15,229
"74871",1074871,84,14,7,105
"74872",1074872,64,50,2,116
"74873",1074873,135,143,9,287
"74874",1074874,93,150,11,254
"74875",1074875,224,43,9,276
"74876",1074876,155,128,21,304
"74877",1074877,183,69,3,255
"74878",1074878,52,62,3,117
"74879",1074879,49,173,2,224
"74880",1074880,144,60,7,211
"74881",1074881,88,95,9,192
"74882",1074882,53,197,10,260
"74883",1074883,164,119,15,298
"74884",1074884,172,46,9,227
"74885",1074885,215,52,9,276
"74886",1074886,16,143,3,162
"74887",1074887,59,249,5,313
"74888",1074888,162,51,5,218
"74889",1074889,36,201,5,242
"74890",1074890,82,63,4,149
"74891",1074891,164,24,4,192
"74892",1074892,310,82,13,405
"74893",1074893,190,79,12,281
"74894",1074894,180,104,13,297
"74895",1074895,130,42,5,177
"74896",1074896,173,23,6,202
"74897",1074897,112,138,7,257
"74898",1074898,154,144,9,307
"74899",1074899,115,57,2,174
"74900",1074900,167,50,9,226
"74901",1074901,52,19,1,72
"74902",1074902,212,79,3,294
"74903",1074903,149,107,6,262
"74904",1074904,195,71,18,284
"74905",1074905,154,32,9,195
"74906",1074906,31,194,2,227
"74907",1074907,54,237,8,299
"74908",1074908,181,19,1,201
"74909",1074909,205,44,7,256
"74910",1074910,40,200,4,244
"74911",1074911,91,229,8,328
"74912",1074912,111,94,9,214
"74913",1074913,198,90,12,300
"74914",1074914,37,214,3,254
"74915",1074915,235,22,8,265
"74916",1074916,68,63,3,134
"74917",1074917,87,115,3,205
"74918",1074918,54,260,10,324
"74919",1074919,55,221,13,289
"74920",1074920,107,99,12,218
"74921",1074921,45,150,10,205
"74922",1074922,76,193,5,274
"74923",1074923,116,118,12,246
"74924",1074924,92,186,3,281
"74925",1074925,59,70,2,131
"74926",1074926,222,62,10,294
"74927",1074927,45,214,9,268
"74928",1074928,37,31,0,68
"74929",1074929,78,188,7,273
"74930",1074930,35,213,3,251
"74931",1074931,61,120,12,193
"74932",1074932,67,189,18,274
"74933",1074933,29,150,11,190
"74934",1074934,37,32,6,75
"74935",1074935,113,142,11,266
"74936",1074936,176,35,8,219
"74937",1074937,31,168,7,206
"74938",1074938,55,152,2,209
"74939",1074939,143,53,3,199
"74940",1074940,88,180,13,281
"74941",1074941,75,303,5,383
"74942",1074942,168,42,10,220
"74943",1074943,157,73,2,232
"74944",1074944,116,77,8,201
"74945",1074945,57,7,1,65
"74946",1074946,161,74,16,251
"74947",1074947,63,104,4,171
"74948",1074948,29,180,1,210
"74949",1074949,90,278,16,384
"74950",1074950,29,30,3,62
"74951",1074951,169,36,11,216
"74952",1074952,192,61,10,263
"74953",1074953,99,136,19,254
"74954",1074954,71,9,0,80
"74955",1074955,6,77,1,84
"74956",1074956,133,99,0,232
"74957",1074957,43,34,3,80
"74958",1074958,74,186,7,267
"74959",1074959,187,130,21,338
"74960",1074960,160,125,24,309
"74961",1074961,97,83,14,194
"74962",1074962,147,155,12,314
"74963",1074963,61,137,3,201
"74964",1074964,234,35,13,282
"74965",1074965,320,5,4,329
"74966",1074966,119,186,9,314
"74967",1074967,141,105,9,255
"74968",1074968,143,153,19,315
"74969",1074969,66,153,5,224
"74970",1074970,64,104,3,171
"74971",1074971,208,48,7,263
"74972",1074972,44,6,1,51
"74973",1074973,131,111,13,255
"74974",1074974,95,86,11,192
"74975",1074975,142,62,5,209
"74976",1074976,143,96,8,247
"74977",1074977,70,150,4,224
"74978",1074978,132,67,12,211
"74979",1074979,52,179,4,235
"74980",1074980,65,112,1,178
"74981",1074981,212,7,10,229
"74982",1074982,54,213,6,273
"74983",1074983,177,123,20,320
"74984",1074984,165,96,7,268
"74985",1074985,149,91,2,242
"74986",1074986,166,88,8,262
"74987",1074987,18,219,0,237
"74988",1074988,235,43,10,288
"74989",1074989,23,135,2,160
"74990",1074990,40,247,3,290
"74991",1074991,101,92,13,206
"74992",1074992,111,87,10,208
"74993",1074993,160,26,13,199
"74994",1074994,108,42,7,157
"74995",1074995,155,98,5,258
"74996",1074996,125,106,12,243
"74997",1074997,15,2,0,17
"74998",1074998,74,161,6,241
"74999",1074999,77,163,14,254
"75000",1075000,215,5,6,226
"75001",1075001,131,46,4,181
"75002",1075002,146,92,4,242
"75003",1075003,80,244,2,326
"75004",1075004,149,88,4,241
"75005",1075005,169,24,5,198
"75006",1075006,110,120,13,243
"75007",1075007,12,14,7,33
"75008",1075008,105,33,5,143
"75009",1075009,55,169,5,229
"75010",1075010,173,30,2,205
"75011",1075011,52,197,3,252
"75012",1075012,114,67,4,185
"75013",1075013,181,44,5,230
"75014",1075014,141,72,7,220
"75015",1075015,205,96,14,315
"75016",1075016,84,26,10,120
"75017",1075017,181,26,9,216
"75018",1075018,117,41,8,166
"75019",1075019,110,29,2,141
"75020",1075020,52,201,17,270
"75021",1075021,20,80,2,102
"75022",1075022,156,112,6,274
"75023",1075023,66,151,4,221
"75024",1075024,75,166,9,250
"75025",1075025,116,129,10,255
"75026",1075026,125,125,5,255
"75027",1075027,162,55,4,221
"75028",1075028,141,0,0,141
"75029",1075029,196,60,8,264
"75030",1075030,74,54,10,138
"75031",1075031,67,34,4,105
"75032",1075032,123,145,13,281
"75033",1075033,114,119,11,244
"75034",1075034,28,260,4,292
"75035",1075035,261,22,7,290
"75036",1075036,66,93,8,167
"75037",1075037,196,31,7,234
"75038",1075038,137,85,8,230
"75039",1075039,134,62,18,214
"75040",1075040,3,4,0,7
"75041",1075041,139,60,5,204
"75042",1075042,81,189,6,276
"75043",1075043,105,91,3,199
"75044",1075044,221,105,3,329
"75045",1075045,162,18,5,185
"75046",1075046,71,171,18,260
"75047",1075047,90,56,4,150
"75048",1075048,5,61,0,66
"75049",1075049,96,180,14,290
"75050",1075050,131,88,8,227
"75051",1075051,156,80,14,250
"75052",1075052,93,123,4,220
"75053",1075053,114,30,7,151
"75054",1075054,141,70,9,220
"75055",1075055,80,21,1,102
"75056",1075056,202,20,4,226
"75057",1075057,85,188,12,285
"75058",1075058,183,55,2,240
"75059",1075059,86,45,2,133
"75060",1075060,153,42,6,201
"75061",1075061,150,108,9,267
"75062",1075062,88,76,1,165
"75063",1075063,39,27,1,67
"75064",1075064,110,143,0,253
"75065",1075065,249,32,8,289
"75066",1075066,161,86,4,251
"75067",1075067,242,20,6,268
"75068",1075068,32,63,3,98
"75069",1075069,39,224,0,263
"75070",1075070,142,50,5,197
"75071",1075071,53,202,5,260
"75072",1075072,140,117,9,266
"75073",1075073,151,72,10,233
"75074",1075074,243,11,6,260
"75075",1075075,92,207,10,309
"75076",1075076,30,217,5,252
"75077",1075077,90,150,23,263
"75078",1075078,22,251,5,278
"75079",1075079,171,37,12,220
"75080",1075080,207,83,8,298
"75081",1075081,196,66,7,269
"75082",1075082,159,69,8,236
"75083",1075083,162,60,17,239
"75084",1075084,111,90,6,207
"75085",1075085,213,93,11,317
"75086",1075086,130,192,11,333
"75087",1075087,223,54,17,294
"75088",1075088,95,145,8,248
"75089",1075089,115,85,8,208
"75090",1075090,150,50,5,205
"75091",1075091,5,5,3,13
"75092",1075092,52,86,9,147
"75093",1075093,127,7,5,139
"75094",1075094,138,121,4,263
"75095",1075095,29,241,2,272
"75096",1075096,42,116,5,163
"75097",1075097,115,108,3,226
"75098",1075098,168,18,6,192
"75099",1075099,166,171,14,351
"75100",1075100,49,70,5,124
"75101",1075101,61,244,4,309
"75102",1075102,49,47,7,103
"75103",1075103,225,63,11,299
"75104",1075104,190,21,3,214
"75105",1075105,6,11,0,17
"75106",1075106,141,153,6,300
"75107",1075107,161,79,7,247
"75108",1075108,66,74,3,143
"75109",1075109,45,172,17,234
"75110",1075110,35,16,5,56
"75111",1075111,138,86,8,232
"75112",1075112,188,70,15,273
"75113",1075113,46,195,0,241
"75114",1075114,137,71,13,221
"75115",1075115,104,115,9,228
"75116",1075116,222,24,9,255
"75117",1075117,223,37,10,270
"75118",1075118,131,19,2,152
"75119",1075119,130,86,10,226
"75120",1075120,193,118,10,321
"75121",1075121,62,75,15,152
"75122",1075122,154,65,7,226
"75123",1075123,37,130,3,170
"75124",1075124,140,63,4,207
"75125",1075125,83,164,4,251
"75126",1075126,46,129,7,182
"75127",1075127,198,114,14,326
"75128",1075128,16,339,4,359
"75129",1075129,160,65,8,233
"75130",1075130,1,2,0,3
"75131",1075131,151,85,3,239
"75132",1075132,160,39,7,206
"75133",1075133,62,184,19,265
"75134",1075134,130,92,16,238
"75135",1075135,128,81,15,224
"75136",1075136,38,206,3,247
"75137",1075137,109,201,13,323
"75138",1075138,114,23,3,140
"75139",1075139,145,64,7,216
"75140",1075140,118,145,7,270
"75141",1075141,229,25,8,262
"75142",1075142,79,40,7,126
"75143",1075143,229,27,4,260
"75144",1075144,119,152,7,278
"75145",1075145,161,106,10,277
"75146",1075146,178,21,5,204
"75147",1075147,189,34,7,230
"75148",1075148,87,151,5,243
"75149",1075149,178,71,7,256
"75150",1075150,97,178,25,300
"75151",1075151,29,198,2,229
"75152",1075152,137,9,4,150
"75153",1075153,150,121,13,284
"75154",1075154,155,29,6,190
"75155",1075155,64,195,11,270
"75156",1075156,84,204,9,297
"75157",1075157,71,27,7,105
"75158",1075158,155,55,4,214
"75159",1075159,38,198,3,239
"75160",1075160,140,91,13,244
"75161",1075161,74,182,20,276
"75162",1075162,231,38,12,281
"75163",1075163,57,176,15,248
"75164",1075164,101,68,6,175
"75165",1075165,105,111,6,222
"75166",1075166,87,203,9,299
"75167",1075167,77,210,8,295
"75168",1075168,92,42,3,137
"75169",1075169,149,106,19,274
"75170",1075170,83,161,9,253
"75171",1075171,237,17,5,259
"75172",1075172,35,223,7,265
"75173",1075173,144,77,14,235
"75174",1075174,129,75,8,212
"75175",1075175,53,287,7,347
"75176",1075176,76,101,4,181
"75177",1075177,73,155,20,248
"75178",1075178,60,148,9,217
"75179",1075179,115,140,5,260
"75180",1075180,68,149,7,224
"75181",1075181,110,140,10,260
"75182",1075182,50,39,3,92
"75183",1075183,183,8,1,192
"75184",1075184,181,43,5,229
"75185",1075185,123,43,9,175
"75186",1075186,216,8,10,234
"75187",1075187,152,113,9,274
"75188",1075188,54,125,14,193
"75189",1075189,138,1,7,146
"75190",1075190,101,124,2,227
"75191",1075191,81,111,6,198
"75192",1075192,170,91,8,269
"75193",1075193,53,218,13,284
"75194",1075194,111,59,12,182
"75195",1075195,98,121,16,235
"75196",1075196,44,165,5,214
"75197",1075197,81,159,18,258
"75198",1075198,59,149,7,215
"75199",1075199,110,56,10,176
"75200",1075200,218,15,6,239
"75201",1075201,113,35,7,155
"75202",1075202,56,76,5,137
"75203",1075203,193,88,12,293
"75204",1075204,126,126,8,260
"75205",1075205,69,232,3,304
"75206",1075206,157,59,0,216
"75207",1075207,88,136,6,230
"75208",1075208,84,161,8,253
"75209",1075209,116,11,2,129
"75210",1075210,62,164,8,234
"75211",1075211,149,103,4,256
"75212",1075212,68,77,9,154
"75213",1075213,20,182,5,207
"75214",1075214,94,122,3,219
"75215",1075215,206,37,10,253
"75216",1075216,134,90,15,239
"75217",1075217,143,158,15,316
"75218",1075218,120,34,5,159
"75219",1075219,108,67,1,176
"75220",1075220,53,212,1,266
"75221",1075221,85,86,10,181
"75222",1075222,172,55,7,234
"75223",1075223,151,48,6,205
"75224",1075224,65,157,14,236
"75225",1075225,201,90,7,298
"75226",1075226,79,195,1,275
"75227",1075227,127,43,4,174
"75228",1075228,217,31,2,250
"75229",1075229,112,47,13,172
"75230",1075230,108,136,7,251
"75231",1075231,123,91,27,241
"75232",1075232,25,37,2,64
"75233",1075233,60,212,4,276
"75234",1075234,87,196,9,292
"75235",1075235,175,107,7,289
"75236",1075236,91,87,14,192
"75237",1075237,116,114,22,252
"75238",1075238,174,26,18,218
"75239",1075239,73,244,6,323
"75240",1075240,159,82,5,246
"75241",1075241,168,84,12,264
"75242",1075242,27,89,4,120
"75243",1075243,99,70,4,173
"75244",1075244,218,73,5,296
"75245",1075245,96,83,5,184
"75246",1075246,182,20,2,204
"75247",1075247,244,14,5,263
"75248",1075248,104,106,8,218
"75249",1075249,10,7,0,17
"75250",1075250,71,183,24,278
"75251",1075251,31,32,1,64
"75252",1075252,8,1,0,9
"75253",1075253,133,143,6,282
"75254",1075254,128,125,5,258
"75255",1075255,130,92,11,233
"75256",1075256,159,12,4,175
"75257",1075257,137,18,1,156
"75258",1075258,134,31,6,171
"75259",1075259,182,40,8,230
"75260",1075260,14,20,0,34
"75261",1075261,82,185,19,286
"75262",1075262,257,196,19,472
"75263",1075263,75,147,3,225
"75264",1075264,92,173,4,269
"75265",1075265,162,59,7,228
"75266",1075266,133,81,11,225
"75267",1075267,148,98,10,256
"75268",1075268,149,83,6,238
"75269",1075269,66,73,9,148
"75270",1075270,128,147,11,286
"75271",1075271,27,0,0,27
"75272",1075272,148,162,8,318
"75273",1075273,73,71,1,145
"75274",1075274,186,85,8,279
"75275",1075275,109,70,10,189
"75276",1075276,100,96,7,203
"75277",1075277,216,64,8,288
"75278",1075278,96,53,11,160
"75279",1075279,163,70,6,239
"75280",1075280,56,130,5,191
"75281",1075281,92,137,14,243
"75282",1075282,111,72,4,187
"75283",1075283,158,58,7,223
"75284",1075284,154,131,21,306
"75285",1075285,41,210,10,261
"75286",1075286,131,99,9,239
"75287",1075287,110,178,5,293
"75288",1075288,187,105,12,304
"75289",1075289,79,217,14,310
"75290",1075290,226,48,11,285
"75291",1075291,167,42,6,215
"75292",1075292,134,50,12,196
"75293",1075293,181,92,12,285
"75294",1075294,190,66,4,260
"75295",1075295,12,72,0,84
"75296",1075296,265,6,4,275
"75297",1075297,76,194,12,282
"75298",1075298,42,184,0,226
"75299",1075299,126,108,17,251
"75300",1075300,41,213,5,259
"75301",1075301,158,79,11,248
"75302",1075302,85,38,5,128
"75303",1075303,166,97,7,270
"75304",1075304,92,195,2,289
"75305",1075305,99,0,1,100
"75306",1075306,213,33,10,256
"75307",1075307,34,211,8,253
"75308",1075308,118,161,4,283
"75309",1075309,44,217,15,276
"75310",1075310,35,204,5,244
"75311",1075311,24,128,6,158
"75312",1075312,98,99,9,206
"75313",1075313,42,222,6,270
"75314",1075314,155,105,5,265
"75315",1075315,79,86,0,165
"75316",1075316,143,103,14,260
"75317",1075317,152,27,2,181
"75318",1075318,134,150,22,306
"75319",1075319,242,47,7,296
"75320",1075320,148,75,4,227
"75321",1075321,107,81,7,195
"75322",1075322,142,108,17,267
"75323",1075323,130,103,12,245
"75324",1075324,64,190,9,263
"75325",1075325,68,111,14,193
"75326",1075326,63,108,10,181
"75327",1075327,123,177,11,311
"75328",1075328,60,173,7,240
"75329",1075329,203,60,13,276
"75330",1075330,64,174,19,257
"75331",1075331,130,115,10,255
"75332",1075332,54,206,4,264
"75333",1075333,17,248,2,267
"75334",1075334,208,57,6,271
"75335",1075335,153,94,16,263
"75336",1075336,143,81,13,237
"75337",1075337,170,86,11,267
"75338",1075338,86,227,8,321
"75339",1075339,156,87,10,253
"75340",1075340,90,165,7,262
"75341",1075341,91,193,7,291
"75342",1075342,249,25,7,281
"75343",1075343,80,154,10,244
"75344",1075344,44,144,2,190
"75345",1075345,96,74,14,184
"75346",1075346,52,136,4,192
"75347",1075347,65,5,1,71
"75348",1075348,30,173,1,204
"75349",1075349,161,109,12,282
"75350",1075350,165,109,8,282
"75351",1075351,77,46,5,128
"75352",1075352,48,157,18,223
"75353",1075353,24,12,0,36
"75354",1075354,102,139,1,242
"75355",1075355,276,30,9,315
"75356",1075356,40,62,3,105
"75357",1075357,188,104,6,298
"75358",1075358,162,103,2,267
"75359",1075359,130,64,7,201
"75360",1075360,49,106,6,161
"75361",1075361,160,91,1,252
"75362",1075362,108,184,16,308
"75363",1075363,122,160,12,294
"75364",1075364,85,42,3,130
"75365",1075365,3,6,0,9
"75366",1075366,173,114,13,300
"75367",1075367,149,41,3,193
"75368",1075368,115,63,6,184
"75369",1075369,128,37,14,179
"75370",1075370,287,12,14,313
"75371",1075371,118,196,17,331
"75372",1075372,59,28,1,88
"75373",1075373,143,110,4,257
"75374",1075374,29,1,0,30
"75375",1075375,213,52,17,282
"75376",1075376,127,55,15,197
"75377",1075377,124,107,13,244
"75378",1075378,57,205,18,280
"75379",1075379,148,100,6,254
"75380",1075380,20,150,4,174
"75381",1075381,42,8,3,53
"75382",1075382,50,247,4,301
"75383",1075383,115,51,9,175
"75384",1075384,74,212,6,292
"75385",1075385,129,67,6,202
"75386",1075386,40,157,9,206
"75387",1075387,128,47,6,181
"75388",1075388,182,34,6,222
"75389",1075389,59,262,12,333
"75390",1075390,37,29,2,68
"75391",1075391,241,29,9,279
"75392",1075392,174,31,4,209
"75393",1075393,174,14,1,189
"75394",1075394,125,69,12,206
"75395",1075395,70,232,4,306
"75396",1075396,177,74,9,260
"75397",1075397,218,22,7,247
"75398",1075398,51,230,11,292
"75399",1075399,2,94,1,97
"75400",1075400,123,43,6,172
"75401",1075401,93,179,13,285
"75402",1075402,184,58,22,264
"75403",1075403,258,8,4,270
"75404",1075404,133,108,1,242
"75405",1075405,16,84,2,102
"75406",1075406,120,107,23,250
"75407",1075407,89,117,1,207
"75408",1075408,114,174,9,297
"75409",1075409,138,80,2,220
"75410",1075410,250,51,14,315
"75411",1075411,2,1,0,3
"75412",1075412,252,34,3,289
"75413",1075413,121,43,3,167
"75414",1075414,171,33,11,215
"75415",1075415,33,236,8,277
"75416",1075416,131,44,8,183
"75417",1075417,69,94,8,171
"75418",1075418,81,65,1,147
"75419",1075419,92,113,11,216
"75420",1075420,38,162,7,207
"75421",1075421,184,54,21,259
"75422",1075422,71,230,13,314
"75423",1075423,160,56,10,226
"75424",1075424,101,94,8,203
"75425",1075425,101,37,9,147
"75426",1075426,100,190,8,298
"75427",1075427,139,86,7,232
"75428",1075428,160,90,6,256
"75429",1075429,201,40,22,263
"75430",1075430,115,91,12,218
"75431",1075431,115,73,18,206
"75432",1075432,10,12,0,22
"75433",1075433,68,76,5,149
"75434",1075434,178,49,2,229
"75435",1075435,99,71,7,177
"75436",1075436,191,46,9,246
"75437",1075437,196,92,6,294
"75438",1075438,130,132,24,286
"75439",1075439,68,122,27,217
"75440",1075440,184,74,5,263
"75441",1075441,181,14,16,211
"75442",1075442,12,4,2,18
"75443",1075443,95,40,5,140
"75444",1075444,74,95,7,176
"75445",1075445,126,158,14,298
"75446",1075446,13,6,0,19
"75447",1075447,157,99,14,270
"75448",1075448,210,59,5,274
"75449",1075449,100,131,5,236
"75450",1075450,70,157,10,237
"75451",1075451,136,70,6,212
"75452",1075452,97,124,3,224
"75453",1075453,101,77,10,188
"75454",1075454,33,247,6,286
"75455",1075455,22,269,16,307
"75456",1075456,207,49,7,263
"75457",1075457,84,80,15,179
"75458",1075458,81,220,11,312
"75459",1075459,187,102,17,306
"75460",1075460,1,11,1,13
"75461",1075461,135,61,6,202
"75462",1075462,62,10,4,76
"75463",1075463,63,186,7,256
"75464",1075464,69,213,9,291
"75465",1075465,155,99,11,265
"75466",1075466,102,36,8,146
"75467",1075467,75,181,12,268
"75468",1075468,205,42,6,253
"75469",1075469,73,98,17,188
"75470",1075470,14,250,4,268
"75471",1075471,205,26,4,235
"75472",1075472,144,78,9,231
"75473",1075473,44,190,5,239
"75474",1075474,161,44,9,214
"75475",1075475,184,68,10,262
"75476",1075476,18,107,5,130
"75477",1075477,194,59,3,256
"75478",1075478,165,50,6,221
"75479",1075479,50,202,6,258
"75480",1075480,156,114,5,275
"75481",1075481,157,46,4,207
"75482",1075482,143,60,2,205
"75483",1075483,1,5,0,6
"75484",1075484,117,142,15,274
"75485",1075485,100,154,12,266
"75486",1075486,64,51,5,120
"75487",1075487,291,17,11,319
"75488",1075488,36,156,2,194
"75489",1075489,69,362,22,453
"75490",1075490,175,101,5,281
"75491",1075491,63,157,5,225
"75492",1075492,70,25,3,98
"75493",1075493,182,48,8,238
"75494",1075494,57,186,2,245
"75495",1075495,64,192,16,272
"75496",1075496,153,77,5,235
"75497",1075497,154,106,12,272
"75498",1075498,343,3,2,348
"75499",1075499,65,260,2,327
"75500",1075500,192,33,5,230
"75501",1075501,55,141,7,203
"75502",1075502,189,109,6,304
"75503",1075503,37,176,7,220
"75504",1075504,115,100,15,230
"75505",1075505,10,10,1,21
"75506",1075506,168,110,7,285
"75507",1075507,83,111,12,206
"75508",1075508,171,24,2,197
"75509",1075509,54,213,16,283
"75510",1075510,203,66,3,272
"75511",1075511,197,59,6,262
"75512",1075512,29,160,3,192
"75513",1075513,99,69,12,180
"75514",1075514,75,120,1,196
"75515",1075515,74,162,9,245
"75516",1075516,19,65,0,84
"75517",1075517,129,140,18,287
"75518",1075518,133,68,11,212
"75519",1075519,99,43,2,144
"75520",1075520,173,101,17,291
"75521",1075521,102,65,3,170
"75522",1075522,29,184,9,222
"75523",1075523,95,114,22,231
"75524",1075524,139,107,20,266
"75525",1075525,102,133,9,244
"75526",1075526,19,33,1,53
"75527",1075527,45,56,1,102
"75528",1075528,132,71,13,216
"75529",1075529,191,57,10,258
"75530",1075530,104,136,8,248
"75531",1075531,76,151,2,229
"75532",1075532,140,177,13,330
"75533",1075533,57,48,2,107
"75534",1075534,157,16,2,175
"75535",1075535,149,112,2,263
"75536",1075536,79,138,8,225
"75537",1075537,39,243,13,295
"75538",1075538,79,186,16,281
"75539",1075539,156,78,22,256
"75540",1075540,207,27,8,242
"75541",1075541,200,18,2,220
"75542",1075542,238,66,1,305
"75543",1075543,131,17,2,150
"75544",1075544,19,160,2,181
"75545",1075545,131,91,11,233
"75546",1075546,208,60,5,273
"75547",1075547,115,20,6,141
"75548",1075548,11,12,1,24
"75549",1075549,135,44,7,186
"75550",1075550,106,44,6,156
"75551",1075551,43,266,3,312
"75552",1075552,42,143,7,192
"75553",1075553,77,166,9,252
"75554",1075554,108,6,10,124
"75555",1075555,53,172,3,228
"75556",1075556,139,67,14,220
"75557",1075557,29,185,3,217
"75558",1075558,97,110,3,210
"75559",1075559,181,85,15,281
"75560",1075560,80,125,10,215
"75561",1075561,85,69,8,162
"75562",1075562,70,120,16,206
"75563",1075563,65,107,3,175
"75564",1075564,17,5,4,26
"75565",1075565,210,80,6,296
"75566",1075566,90,84,5,179
"75567",1075567,45,230,6,281
"75568",1075568,141,100,5,246
"75569",1075569,139,142,3,284
"75570",1075570,140,54,4,198
"75571",1075571,101,13,4,118
"75572",1075572,49,122,4,175
"75573",1075573,49,184,5,238
"75574",1075574,63,189,11,263
"75575",1075575,89,137,5,231
"75576",1075576,28,14,2,44
"75577",1075577,186,75,6,267
"75578",1075578,87,52,2,141
"75579",1075579,72,131,5,208
"75580",1075580,152,53,11,216
"75581",1075581,149,11,6,166
"75582",1075582,93,54,6,153
"75583",1075583,206,50,6,262
"75584",1075584,29,248,11,288
"75585",1075585,33,37,8,78
"75586",1075586,75,59,10,144
"75587",1075587,64,182,7,253
"75588",1075588,185,32,5,222
"75589",1075589,136,29,4,169
"75590",1075590,116,64,6,186
"75591",1075591,62,133,5,200
"75592",1075592,35,126,3,164
"75593",1075593,61,94,5,160
"75594",1075594,117,132,6,255
"75595",1075595,95,170,9,274
"75596",1075596,107,54,9,170
"75597",1075597,61,150,17,228
"75598",1075598,160,139,10,309
"75599",1075599,117,173,5,295
"75600",1075600,203,10,8,221
"75601",1075601,1,5,1,7
"75602",1075602,42,154,17,213
"75603",1075603,70,251,14,335
"75604",1075604,180,123,12,315
"75605",1075605,9,46,5,60
"75606",1075606,106,51,4,161
"75607",1075607,229,66,6,301
"75608",1075608,86,101,2,189
"75609",1075609,77,187,11,275
"75610",1075610,160,59,14,233
"75611",1075611,158,61,4,223
"75612",1075612,76,152,9,237
"75613",1075613,61,147,5,213
"75614",1075614,54,173,18,245
"75615",1075615,165,126,20,311
"75616",1075616,138,123,8,269
"75617",1075617,127,88,12,227
"75618",1075618,121,72,5,198
"75619",1075619,92,94,9,195
"75620",1075620,179,96,7,282
"75621",1075621,69,162,8,239
"75622",1075622,157,60,7,224
"75623",1075623,180,84,4,268
"75624",1075624,44,252,5,301
"75625",1075625,200,99,17,316
"75626",1075626,144,149,21,314
"75627",1075627,126,98,24,248
"75628",1075628,222,32,5,259
"75629",1075629,145,97,3,245
"75630",1075630,40,197,3,240
"75631",1075631,154,106,10,270
"75632",1075632,106,190,6,302
"75633",1075633,42,262,5,309
"75634",1075634,60,184,34,278
"75635",1075635,129,159,17,305
"75636",1075636,110,102,16,228
"75637",1075637,213,84,15,312
"75638",1075638,52,24,6,82
"75639",1075639,18,244,4,266
"75640",1075640,123,111,0,234
"75641",1075641,80,81,8,169
"75642",1075642,131,15,2,148
"75643",1075643,30,76,0,106
"75644",1075644,134,119,11,264
"75645",1075645,90,119,3,212
"75646",1075646,237,60,14,311
"75647",1075647,102,15,1,118
"75648",1075648,165,62,8,235
"75649",1075649,30,170,6,206
"75650",1075650,237,31,7,275
"75651",1075651,167,110,8,285
"75652",1075652,215,96,25,336
"75653",1075653,4,3,1,8
"75654",1075654,140,59,6,205
"75655",1075655,91,228,13,332
"75656",1075656,2,6,0,8
"75657",1075657,114,126,7,247
"75658",1075658,14,67,1,82
"75659",1075659,99,209,7,315
"75660",1075660,110,149,11,270
"75661",1075661,121,154,7,282
"75662",1075662,158,27,5,190
"75663",1075663,173,88,16,277
"75664",1075664,136,132,7,275
"75665",1075665,201,42,5,248
"75666",1075666,67,161,3,231
"75667",1075667,94,118,1,213
"75668",1075668,218,27,13,258
"75669",1075669,76,193,2,271
"75670",1075670,160,33,6,199
"75671",1075671,110,109,20,239
"75672",1075672,47,58,2,107
"75673",1075673,128,115,7,250
"75674",1075674,114,44,6,164
"75675",1075675,57,163,5,225
"75676",1075676,20,8,1,29
"75677",1075677,148,111,13,272
"75678",1075678,29,22,0,51
"75679",1075679,300,207,53,560
"75680",1075680,226,74,8,308
"75681",1075681,124,85,12,221
"75682",1075682,156,23,4,183
"75683",1075683,101,70,16,187
"75684",1075684,81,69,11,161
"75685",1075685,133,29,3,165
"75686",1075686,44,67,3,114
"75687",1075687,150,132,8,290
"75688",1075688,165,164,13,342
"75689",1075689,15,5,0,20
"75690",1075690,147,95,7,249
"75691",1075691,64,2,0,66
"75692",1075692,77,1,1,79
"75693",1075693,113,70,11,194
"75694",1075694,230,99,14,343
"75695",1075695,150,112,3,265
"75696",1075696,170,41,3,214
"75697",1075697,33,90,5,128
"75698",1075698,40,144,0,184
"75699",1075699,73,177,4,254
"75700",1075700,106,49,7,162
"75701",1075701,88,43,5,136
"75702",1075702,160,129,14,303
"75703",1075703,115,26,7,148
"75704",1075704,112,60,8,180
"75705",1075705,212,28,1,241
"75706",1075706,162,23,7,192
"75707",1075707,189,94,18,301
"75708",1075708,227,53,6,286
"75709",1075709,147,58,1,206
"75710",1075710,245,41,10,296
"75711",1075711,44,164,2,210
"75712",1075712,39,140,5,184
"75713",1075713,173,59,28,260
"75714",1075714,128,88,8,224
"75715",1075715,138,34,8,180
"75716",1075716,172,37,1,210
"75717",1075717,205,81,27,313
"75718",1075718,24,284,6,314
"75719",1075719,80,240,4,324
"75720",1075720,122,160,26,308
"75721",1075721,16,194,4,214
"75722",1075722,69,182,4,255
"75723",1075723,38,56,2,96
"75724",1075724,83,190,11,284
"75725",1075725,177,62,4,243
"75726",1075726,150,52,11,213
"75727",1075727,108,60,10,178
"75728",1075728,0,0,0,0
"75729",1075729,34,219,4,257
"75730",1075730,93,114,6,213
"75731",1075731,96,32,4,132
"75732",1075732,102,129,13,244
"75733",1075733,59,238,9,306
"75734",1075734,57,6,2,65
"75735",1075735,92,171,13,276
"75736",1075736,70,147,9,226
"75737",1075737,16,0,1,17
"75738",1075738,108,38,8,154
"75739",1075739,144,75,4,223
"75740",1075740,40,7,2,49
"75741",1075741,210,41,11,262
"75742",1075742,201,10,5,216
"75743",1075743,109,166,8,283
"75744",1075744,82,131,15,228
"75745",1075745,8,284,1,293
"75746",1075746,201,52,2,255
"75747",1075747,90,147,19,256
"75748",1075748,156,63,17,236
"75749",1075749,42,309,3,354
"75750",1075750,41,96,2,139
"75751",1075751,68,232,0,300
"75752",1075752,54,274,6,334
"75753",1075753,126,189,29,344
"75754",1075754,13,8,0,21
"75755",1075755,45,108,4,157
"75756",1075756,71,165,5,241
"75757",1075757,37,244,6,287
"75758",1075758,168,66,10,244
"75759",1075759,181,126,19,326
"75760",1075760,116,132,9,257
"75761",1075761,8,126,2,136
"75762",1075762,136,132,4,272
"75763",1075763,283,65,14,362
"75764",1075764,182,95,24,301
"75765",1075765,60,40,4,104
"75766",1075766,75,139,12,226
"75767",1075767,30,235,5,270
"75768",1075768,66,29,5,100
"75769",1075769,236,12,3,251
"75770",1075770,65,13,3,81
"75771",1075771,77,104,11,192
"75772",1075772,32,241,2,275
"75773",1075773,171,16,7,194
"75774",1075774,48,120,13,181
"75775",1075775,85,235,11,331
"75776",1075776,195,76,17,288
"75777",1075777,14,16,2,32
"75778",1075778,49,95,18,162
"75779",1075779,39,195,4,238
"75780",1075780,118,68,9,195
"75781",1075781,192,43,11,246
"75782",1075782,36,14,1,51
"75783",1075783,162,37,7,206
"75784",1075784,165,54,2,221
"75785",1075785,238,1,11,250
"75786",1075786,27,68,2,97
"75787",1075787,121,112,6,239
"75788",1075788,213,22,7,242
"75789",1075789,181,20,3,204
"75790",1075790,136,60,29,225
"75791",1075791,77,121,6,204
"75792",1075792,11,100,5,116
"75793",1075793,98,148,8,254
"75794",1075794,205,88,19,312
"75795",1075795,161,148,14,323
"75796",1075796,48,166,6,220
"75797",1075797,112,79,9,200
"75798",1075798,184,35,16,235
"75799",1075799,125,152,27,304
"75800",1075800,21,90,5,116
"75801",1075801,142,21,6,169
"75802",1075802,99,34,3,136
"75803",1075803,172,97,3,272
"75804",1075804,162,95,9,266
"75805",1075805,4,8,0,12
"75806",1075806,171,48,9,228
"75807",1075807,141,93,3,237
"75808",1075808,91,57,4,152
"75809",1075809,116,32,4,152
"75810",1075810,156,63,8,227
"75811",1075811,160,107,14,281
"75812",1075812,62,199,12,273
"75813",1075813,205,37,10,252
"75814",1075814,141,162,24,327
"75815",1075815,80,125,4,209
"75816",1075816,33,232,9,274
"75817",1075817,94,56,4,154
"75818",1075818,103,96,11,210
"75819",1075819,98,190,8,296
"75820",1075820,145,69,10,224
"75821",1075821,92,134,11,237
"75822",1075822,165,66,6,237
"75823",1075823,80,138,13,231
"75824",1075824,28,82,4,114
"75825",1075825,141,84,7,232
"75826",1075826,27,185,6,218
"75827",1075827,56,243,15,314
"75828",1075828,62,138,4,204
"75829",1075829,91,30,5,126
"75830",1075830,30,24,1,55
"75831",1075831,166,52,9,227
"75832",1075832,64,191,6,261
"75833",1075833,210,27,9,246
"75834",1075834,156,44,9,209
"75835",1075835,63,33,5,101
"75836",1075836,156,77,16,249
"75837",1075837,47,207,13,267
"75838",1075838,231,21,5,257
"75839",1075839,17,165,0,182
"75840",1075840,229,32,9,270
"75841",1075841,108,90,5,203
"75842",1075842,86,159,4,249
"75843",1075843,161,23,10,194
"75844",1075844,47,186,10,243
"75845",1075845,123,141,17,281
"75846",1075846,87,180,14,281
"75847",1075847,151,102,19,272
"75848",1075848,153,113,10,276
"75849",1075849,97,51,8,156
"75850",1075850,12,27,1,40
"75851",1075851,44,208,18,270
"75852",1075852,17,270,0,287
"75853",1075853,108,187,5,300
"75854",1075854,136,96,10,242
"75855",1075855,72,204,14,290
"75856",1075856,77,224,8,309
"75857",1075857,102,67,1,170
"75858",1075858,40,163,5,208
"75859",1075859,94,129,5,228
"75860",1075860,85,116,5,206
"75861",1075861,127,176,11,314
"75862",1075862,52,177,1,230
"75863",1075863,183,113,19,315
"75864",1075864,20,122,3,145
"75865",1075865,85,216,7,308
"75866",1075866,146,79,5,230
"75867",1075867,101,147,13,261
"75868",1075868,87,200,6,293
"75869",1075869,71,267,4,342
"75870",1075870,117,29,12,158
"75871",1075871,142,92,6,240
"75872",1075872,142,87,11,240
"75873",1075873,69,138,16,223
"75874",1075874,29,250,8,287
"75875",1075875,203,118,8,329
"75876",1075876,136,23,6,165
"75877",1075877,54,201,7,262
"75878",1075878,130,39,8,177
"75879",1075879,57,14,4,75
"75880",1075880,12,89,0,101
"75881",1075881,153,112,9,274
"75882",1075882,105,99,5,209
"75883",1075883,5,7,0,12
"75884",1075884,88,28,0,116
"75885",1075885,28,181,12,221
"75886",1075886,43,11,0,54
"75887",1075887,59,228,3,290
"75888",1075888,203,17,7,227
"75889",1075889,97,72,3,172
"75890",1075890,87,168,11,266
"75891",1075891,148,16,7,171
"75892",1075892,83,38,4,125
"75893",1075893,92,237,9,338
"75894",1075894,34,7,2,43
"75895",1075895,148,142,12,302
"75896",1075896,12,82,2,96
"75897",1075897,100,31,12,143
"75898",1075898,103,68,13,184
"75899",1075899,114,62,4,180
"75900",1075900,156,100,9,265
"75901",1075901,48,179,11,238
"75902",1075902,223,54,7,284
"75903",1075903,37,137,14,188
"75904",1075904,53,61,4,118
"75905",1075905,132,54,6,192
"75906",1075906,74,55,5,134
"75907",1075907,98,148,12,258
"75908",1075908,53,163,17,233
"75909",1075909,30,191,2,223
"75910",1075910,147,111,4,262
"75911",1075911,209,27,11,247
"75912",1075912,85,105,20,210
"75913",1075913,114,24,9,147
"75914",1075914,164,21,7,192
"75915",1075915,107,49,3,159
"75916",1075916,93,145,7,245
"75917",1075917,44,31,3,78
"75918",1075918,3,10,2,15
"75919",1075919,55,89,7,151
"75920",1075920,22,4,2,28
"75921",1075921,111,34,5,150
"75922",1075922,85,0,0,85
"75923",1075923,14,4,0,18
"75924",1075924,183,16,11,210
"75925",1075925,134,26,8,168
"75926",1075926,6,26,2,34
"75927",1075927,102,201,7,310
"75928",1075928,17,89,1,107
"75929",1075929,210,83,21,314
"75930",1075930,176,20,7,203
"75931",1075931,45,6,0,51
"75932",1075932,115,55,1,171
"75933",1075933,82,128,6,216
"75934",1075934,146,68,2,216
"75935",1075935,54,128,9,191
"75936",1075936,187,50,8,245
"75937",1075937,64,51,3,118
"75938",1075938,99,21,7,127
"75939",1075939,95,92,2,189
"75940",1075940,185,17,3,205
"75941",1075941,141,90,14,245
"75942",1075942,86,83,7,176
"75943",1075943,177,31,6,214
"75944",1075944,75,142,22,239
"75945",1075945,41,173,5,219
"75946",1075946,178,30,5,213
"75947",1075947,138,24,5,167
"75948",1075948,13,5,0,18
"75949",1075949,123,62,7,192
"75950",1075950,60,199,17,276
"75951",1075951,39,183,9,231
"75952",1075952,146,47,4,197
"75953",1075953,241,20,8,269
"75954",1075954,123,138,16,277
"75955",1075955,67,188,11,266
"75956",1075956,329,14,8,351
"75957",1075957,151,60,12,223
"75958",1075958,83,195,18,296
"75959",1075959,66,68,2,136
"75960",1075960,164,13,6,183
"75961",1075961,54,139,8,201
"75962",1075962,189,121,12,322
"75963",1075963,189,67,14,270
"75964",1075964,112,51,7,170
"75965",1075965,32,193,7,232
"75966",1075966,203,35,12,250
"75967",1075967,135,44,2,181
"75968",1075968,264,57,12,333
"75969",1075969,130,97,13,240
"75970",1075970,128,85,9,222
"75971",1075971,164,95,7,266
"75972",1075972,216,1,0,217
"75973",1075973,59,187,51,297
"75974",1075974,85,185,6,276
"75975",1075975,70,61,11,142
"75976",1075976,67,178,8,253
"75977",1075977,114,202,24,340
"75978",1075978,54,243,4,301
"75979",1075979,227,5,5,237
"75980",1075980,87,132,11,230
"75981",1075981,56,172,10,238
"75982",1075982,108,112,11,231
"75983",1075983,55,44,9,108
"75984",1075984,175,82,1,258
"75985",1075985,181,24,5,210
"75986",1075986,17,18,1,36
"75987",1075987,150,138,17,305
"75988",1075988,32,87,2,121
"75989",1075989,93,90,6,189
"75990",1075990,158,51,4,213
"75991",1075991,55,145,6,206
"75992",1075992,74,78,3,155
"75993",1075993,243,28,9,280
"75994",1075994,22,183,3,208
"75995",1075995,81,105,14,200
"75996",1075996,126,107,10,243
"75997",1075997,175,99,13,287
"75998",1075998,79,121,4,204
"75999",1075999,157,9,4,170
"76000",1076000,38,276,5,319
"76001",1076001,109,83,15,207
"76002",1076002,119,80,11,210
"76003",1076003,32,12,1,45
"76004",1076004,89,3,1,93
"76005",1076005,97,187,13,297
"76006",1076006,130,92,8,230
"76007",1076007,46,187,18,251
"76008",1076008,184,91,21,296
"76009",1076009,60,30,7,97
"76010",1076010,28,22,1,51
"76011",1076011,129,160,8,297
"76012",1076012,122,96,13,231
"76013",1076013,175,25,6,206
"76014",1076014,48,96,7,151
"76015",1076015,121,117,11,249
"76016",1076016,57,90,3,150
"76017",1076017,97,75,16,188
"76018",1076018,75,44,3,122
"76019",1076019,146,101,5,252
"76020",1076020,172,117,14,303
"76021",1076021,31,43,0,74
"76022",1076022,239,41,6,286
"76023",1076023,159,91,8,258
"76024",1076024,71,4,4,79
"76025",1076025,58,31,3,92
"76026",1076026,157,69,19,245
"76027",1076027,74,206,16,296
"76028",1076028,11,34,2,47
"76029",1076029,97,101,7,205
"76030",1076030,59,145,5,209
"76031",1076031,114,39,4,157
"76032",1076032,120,90,8,218
"76033",1076033,63,34,2,99
"76034",1076034,91,117,15,223
"76035",1076035,130,129,12,271
"76036",1076036,83,141,6,230
"76037",1076037,150,83,7,240
"76038",1076038,121,49,16,186
"76039",1076039,101,39,8,148
"76040",1076040,118,102,16,236
"76041",1076041,15,234,1,250
"76042",1076042,7,5,1,13
"76043",1076043,13,150,5,168
"76044",1076044,109,185,28,322
"76045",1076045,61,42,5,108
"76046",1076046,67,78,6,151
"76047",1076047,28,150,6,184
"76048",1076048,106,221,18,345
"76049",1076049,89,65,15,169
"76050",1076050,11,278,8,297
"76051",1076051,103,76,5,184
"76052",1076052,212,14,7,233
"76053",1076053,102,163,14,279
"76054",1076054,68,141,12,221
"76055",1076055,137,74,9,220
"76056",1076056,80,166,19,265
"76057",1076057,140,167,6,313
"76058",1076058,173,80,5,258
"76059",1076059,20,72,6,98
"76060",1076060,182,37,7,226
"76061",1076061,132,76,7,215
"76062",1076062,98,142,8,248
"76063",1076063,27,10,1,38
"76064",1076064,162,88,15,265
"76065",1076065,86,139,9,234
"76066",1076066,178,97,6,281
"76067",1076067,61,26,6,93
"76068",1076068,37,238,2,277
"76069",1076069,21,42,7,70
"76070",1076070,30,159,7,196
"76071",1076071,208,55,4,267
"76072",1076072,167,8,7,182
"76073",1076073,61,165,8,234
"76074",1076074,104,52,4,160
"76075",1076075,184,19,7,210
"76076",1076076,86,15,7,108
"76077",1076077,124,91,7,222
"76078",1076078,16,138,1,155
"76079",1076079,144,61,7,212
"76080",1076080,99,39,8,146
"76081",1076081,166,150,11,327
"76082",1076082,93,64,1,158
"76083",1076083,49,269,11,329
"76084",1076084,164,80,14,258
"76085",1076085,93,170,4,267
"76086",1076086,112,63,1,176
"76087",1076087,78,197,24,299
"76088",1076088,95,171,11,277
"76089",1076089,69,246,6,321
"76090",1076090,34,20,1,55
"76091",1076091,61,190,26,277
"76092",1076092,128,21,3,152
"76093",1076093,150,82,3,235
"76094",1076094,92,192,5,289
"76095",1076095,46,214,7,267
"76096",1076096,109,149,3,261
"76097",1076097,231,60,6,297
"76098",1076098,96,93,3,192
"76099",1076099,163,90,22,275
"76100",1076100,140,125,11,276
"76101",1076101,19,198,10,227
"76102",1076102,63,0,1,64
"76103",1076103,47,212,6,265
"76104",1076104,37,117,1,155
"76105",1076105,3,15,0,18
"76106",1076106,191,92,13,296
"76107",1076107,138,73,11,222
"76108",1076108,108,86,10,204
"76109",1076109,99,64,3,166
"76110",1076110,81,159,11,251
"76111",1076111,75,181,5,261
"76112",1076112,140,55,13,208
"76113",1076113,89,192,5,286
"76114",1076114,166,119,5,290
"76115",1076115,158,168,9,335
"76116",1076116,12,36,3,51
"76117",1076117,118,91,4,213
"76118",1076118,130,60,6,196
"76119",1076119,115,180,20,315
"76120",1076120,188,81,22,291
"76121",1076121,53,174,12,239
"76122",1076122,110,48,8,166
"76123",1076123,115,85,3,203
"76124",1076124,117,83,16,216
"76125",1076125,70,52,4,126
"76126",1076126,145,160,13,318
"76127",1076127,182,99,22,303
"76128",1076128,99,32,7,138
"76129",1076129,104,69,10,183
"76130",1076130,239,44,7,290
"76131",1076131,139,18,2,159
"76132",1076132,49,183,5,237
"76133",1076133,170,122,7,299
"76134",1076134,148,90,8,246
"76135",1076135,90,156,24,270
"76136",1076136,20,36,4,60
"76137",1076137,94,146,7,247
"76138",1076138,96,157,3,256
"76139",1076139,84,167,4,255
"76140",1076140,235,13,9,257
"76141",1076141,37,218,2,257
"76142",1076142,68,22,6,96
"76143",1076143,173,114,17,304
"76144",1076144,151,47,4,202
"76145",1076145,117,111,5,233
"76146",1076146,157,108,8,273
"76147",1076147,116,142,6,264
"76148",1076148,203,36,10,249
"76149",1076149,230,24,5,259
"76150",1076150,95,96,7,198
"76151",1076151,168,76,1,245
"76152",1076152,45,148,10,203
"76153",1076153,95,26,9,130
"76154",1076154,118,50,17,185
"76155",1076155,98,74,4,176
"76156",1076156,19,270,2,291
"76157",1076157,264,21,14,299
"76158",1076158,84,154,9,247
"76159",1076159,102,114,9,225
"76160",1076160,58,37,5,100
"76161",1076161,145,54,11,210
"76162",1076162,197,32,10,239
"76163",1076163,83,6,1,90
"76164",1076164,188,35,5,228
"76165",1076165,33,300,0,333
"76166",1076166,156,116,17,289
"76167",1076167,103,168,7,278
"76168",1076168,130,42,3,175
"76169",1076169,21,264,3,288
"76170",1076170,63,20,3,86
"76171",1076171,144,131,11,286
"76172",1076172,201,33,5,239
"76173",1076173,3,12,3,18
"76174",1076174,99,73,6,178
"76175",1076175,38,104,4,146
"76176",1076176,129,120,10,259
"76177",1076177,15,27,1,43
"76178",1076178,124,34,7,165
"76179",1076179,205,22,12,239
"76180",1076180,56,98,4,158
"76181",1076181,51,3,0,54
"76182",1076182,27,67,2,96
"76183",1076183,11,64,1,76
"76184",1076184,172,68,11,251
"76185",1076185,31,149,8,188
"76186",1076186,107,204,20,331
"76187",1076187,244,73,16,333
"76188",1076188,90,80,19,189
"76189",1076189,175,16,2,193
"76190",1076190,182,87,8,277
"76191",1076191,102,155,21,278
"76192",1076192,102,197,1,300
"76193",1076193,93,76,3,172
"76194",1076194,142,74,18,234
"76195",1076195,83,209,15,307
"76196",1076196,157,52,17,226
"76197",1076197,131,108,18,257
"76198",1076198,207,20,7,234
"76199",1076199,32,21,2,55
"76200",1076200,174,30,12,216
"76201",1076201,56,115,7,178
"76202",1076202,49,255,4,308
"76203",1076203,30,95,6,131
"76204",1076204,60,106,9,175
"76205",1076205,229,19,9,257
"76206",1076206,99,171,10,280
"76207",1076207,79,173,9,261
"76208",1076208,163,88,5,256
"76209",1076209,121,12,2,135
"76210",1076210,59,182,10,251
"76211",1076211,120,113,6,239
"76212",1076212,166,90,16,272
"76213",1076213,115,45,5,165
"76214",1076214,50,213,4,267
"76215",1076215,176,43,9,228
"76216",1076216,43,112,6,161
"76217",1076217,36,224,8,268
"76218",1076218,50,295,7,352
"76219",1076219,195,64,4,263
"76220",1076220,222,104,19,345
"76221",1076221,5,2,0,7
"76222",1076222,47,42,3,92
"76223",1076223,34,165,8,207
"76224",1076224,220,54,11,285
"76225",1076225,43,5,5,53
"76226",1076226,10,89,0,99
"76227",1076227,116,77,3,196
"76228",1076228,46,194,8,248
"76229",1076229,249,24,6,279
"76230",1076230,211,38,7,256
"76231",1076231,192,21,9,222
"76232",1076232,110,35,7,152
"76233",1076233,26,120,4,150
"76234",1076234,47,250,5,302
"76235",1076235,23,200,2,225
"76236",1076236,178,79,9,266
"76237",1076237,108,122,11,241
"76238",1076238,70,32,1,103
"76239",1076239,39,221,8,268
"76240",1076240,13,77,2,92
"76241",1076241,90,35,8,133
"76242",1076242,132,167,15,314
"76243",1076243,116,170,10,296
"76244",1076244,154,117,12,283
"76245",1076245,180,54,10,244
"76246",1076246,86,62,14,162
"76247",1076247,79,133,5,217
"76248",1076248,15,46,1,62
"76249",1076249,167,8,1,176
"76250",1076250,106,222,8,336
"76251",1076251,11,72,0,83
"76252",1076252,43,41,2,86
"76253",1076253,99,44,9,152
"76254",1076254,94,15,9,118
"76255",1076255,129,69,4,202
"76256",1076256,29,13,2,44
"76257",1076257,190,100,7,297
"76258",1076258,82,219,4,305
"76259",1076259,79,172,6,257
"76260",1076260,78,127,10,215
"76261",1076261,39,115,3,157
"76262",1076262,160,150,9,319
"76263",1076263,132,88,6,226
"76264",1076264,45,69,0,114
"76265",1076265,37,251,6,294
"76266",1076266,207,37,5,249
"76267",1076267,73,245,9,327
"76268",1076268,139,79,4,222
"76269",1076269,71,91,2,164
"76270",1076270,172,130,15,317
"76271",1076271,154,98,15,267
"76272",1076272,5,4,2,11
"76273",1076273,57,158,5,220
"76274",1076274,4,34,4,42
"76275",1076275,186,54,2,242
"76276",1076276,50,68,5,123
"76277",1076277,30,260,15,305
"76278",1076278,44,87,6,137
"76279",1076279,109,182,9,300
"76280",1076280,211,60,18,289
"76281",1076281,72,159,6,237
"76282",1076282,93,119,5,217
"76283",1076283,69,192,8,269
"76284",1076284,204,75,19,298
"76285",1076285,100,60,1,161
"76286",1076286,86,174,18,278
"76287",1076287,73,213,13,299
"76288",1076288,94,15,2,111
"76289",1076289,148,101,11,260
"76290",1076290,197,41,13,251
"76291",1076291,91,99,8,198
"76292",1076292,100,11,2,113
"76293",1076293,52,149,4,205
"76294",1076294,204,88,11,303
"76295",1076295,210,87,12,309
"76296",1076296,113,63,4,180
"76297",1076297,110,28,6,144
"76298",1076298,33,119,16,168
"76299",1076299,47,55,5,107
"76300",1076300,3,4,0,7
"76301",1076301,39,236,5,280
"76302",1076302,214,8,6,228
"76303",1076303,106,110,17,233
"76304",1076304,159,24,1,184
"76305",1076305,38,101,4,143
"76306",1076306,67,217,0,284
"76307",1076307,153,100,6,259
"76308",1076308,9,43,1,53
"76309",1076309,163,275,24,462
"76310",1076310,89,90,10,189
"76311",1076311,169,82,10,261
"76312",1076312,171,186,5,362
"76313",1076313,78,92,7,177
"76314",1076314,69,164,18,251
"76315",1076315,102,135,14,251
"76316",1076316,144,21,2,167
"76317",1076317,128,65,2,195
"76318",1076318,200,88,15,303
"76319",1076319,138,106,13,257
"76320",1076320,154,68,13,235
"76321",1076321,70,148,2,220
"76322",1076322,68,197,7,272
"76323",1076323,157,70,4,231
"76324",1076324,139,70,11,220
"76325",1076325,35,189,8,232
"76326",1076326,110,169,10,289
"76327",1076327,75,19,3,97
"76328",1076328,95,168,4,267
"76329",1076329,32,30,1,63
"76330",1076330,120,147,31,298
"76331",1076331,101,150,13,264
"76332",1076332,191,23,5,219
"76333",1076333,222,31,10,263
"76334",1076334,200,20,4,224
"76335",1076335,225,68,22,315
"76336",1076336,56,220,11,287
"76337",1076337,172,18,6,196
"76338",1076338,102,177,16,295
"76339",1076339,238,56,15,309
"76340",1076340,57,221,13,291
"76341",1076341,134,68,9,211
"76342",1076342,50,153,34,237
"76343",1076343,152,58,3,213
"76344",1076344,321,0,1,322
"76345",1076345,59,243,8,310
"76346",1076346,66,166,3,235
"76347",1076347,100,103,5,208
"76348",1076348,121,108,7,236
"76349",1076349,80,51,6,137
"76350",1076350,57,267,2,326
"76351",1076351,81,170,6,257
"76352",1076352,162,142,10,314
"76353",1076353,217,71,29,317
"76354",1076354,59,136,6,201
"76355",1076355,159,39,8,206
"76356",1076356,200,7,5,212
"76357",1076357,152,51,9,212
"76358",1076358,87,61,9,157
"76359",1076359,148,45,5,198
"76360",1076360,32,140,7,179
"76361",1076361,234,22,11,267
"76362",1076362,230,41,7,278
"76363",1076363,53,38,5,96
"76364",1076364,49,247,2,298
"76365",1076365,48,8,0,56
"76366",1076366,224,16,18,258
"76367",1076367,48,176,8,232
"76368",1076368,99,209,15,323
"76369",1076369,238,4,5,247
"76370",1076370,210,54,9,273
"76371",1076371,69,179,4,252
"76372",1076372,136,67,5,208
"76373",1076373,149,150,24,323
"76374",1076374,221,66,22,309
"76375",1076375,161,55,1,217
"76376",1076376,128,136,17,281
"76377",1076377,55,230,6,291
"76378",1076378,123,93,8,224
"76379",1076379,109,115,6,230
"76380",1076380,139,100,7,246
"76381",1076381,129,165,10,304
"76382",1076382,182,36,12,230
"76383",1076383,94,168,15,277
"76384",1076384,245,91,21,357
"76385",1076385,150,132,9,291
"76386",1076386,67,9,1,77
"76387",1076387,100,164,10,274
"76388",1076388,173,51,9,233
"76389",1076389,135,103,7,245
"76390",1076390,24,143,6,173
"76391",1076391,44,34,4,82
"76392",1076392,56,161,9,226
"76393",1076393,130,104,14,248
"76394",1076394,18,99,1,118
"76395",1076395,57,181,3,241
"76396",1076396,191,74,13,278
"76397",1076397,66,92,15,173
"76398",1076398,105,154,9,268
"76399",1076399,38,17,1,56
"76400",1076400,178,80,1,259
"76401",1076401,103,83,4,190
"76402",1076402,3,20,2,25
"76403",1076403,32,150,7,189
"76404",1076404,116,122,11,249
"76405",1076405,35,107,3,145
"76406",1076406,112,157,19,288
"76407",1076407,153,60,8,221
"76408",1076408,158,31,1,190
"76409",1076409,112,119,5,236
"76410",1076410,245,65,14,324
"76411",1076411,174,98,30,302
"76412",1076412,61,101,11,173
"76413",1076413,181,70,5,256
"76414",1076414,150,29,4,183
"76415",1076415,34,217,4,255
"76416",1076416,208,16,7,231
"76417",1076417,41,221,9,271
"76418",1076418,42,31,5,78
"76419",1076419,37,44,1,82
"76420",1076420,146,17,4,167
"76421",1076421,75,246,16,337
"76422",1076422,137,80,6,223
"76423",1076423,41,274,6,321
"76424",1076424,33,51,7,91
"76425",1076425,164,27,2,193
"76426",1076426,161,61,6,228
"76427",1076427,54,107,4,165
"76428",1076428,121,109,3,233
"76429",1076429,118,80,5,203
"76430",1076430,84,200,9,293
"76431",1076431,76,145,5,226
"76432",1076432,33,186,7,226
"76433",1076433,84,173,17,274
"76434",1076434,25,56,6,87
"76435",1076435,348,44,6,398
"76436",1076436,51,136,11,198
"76437",1076437,117,21,4,142
"76438",1076438,46,224,14,284
"76439",1076439,61,11,1,73
"76440",1076440,268,32,5,305
"76441",1076441,34,196,7,237
"76442",1076442,47,48,4,99
"76443",1076443,151,63,4,218
"76444",1076444,134,61,8,203
"76445",1076445,74,171,7,252
"76446",1076446,168,103,10,281
"76447",1076447,149,162,8,319
"76448",1076448,77,157,12,246
"76449",1076449,181,93,5,279
"76450",1076450,123,127,15,265
"76451",1076451,132,93,23,248
"76452",1076452,100,65,2,167
"76453",1076453,234,19,3,256
"76454",1076454,64,237,8,309
"76455",1076455,102,208,11,321
"76456",1076456,131,25,3,159
"76457",1076457,11,1,0,12
"76458",1076458,50,165,10,225
"76459",1076459,73,144,7,224
"76460",1076460,210,82,11,303
"76461",1076461,32,156,2,190
"76462",1076462,130,49,1,180
"76463",1076463,34,8,0,42
"76464",1076464,89,157,8,254
"76465",1076465,163,39,5,207
"76466",1076466,69,151,11,231
"76467",1076467,81,43,5,129
"76468",1076468,62,201,15,278
"76469",1076469,99,173,18,290
"76470",1076470,129,135,2,266
"76471",1076471,121,208,9,338
"76472",1076472,129,41,2,172
"76473",1076473,48,97,6,151
"76474",1076474,43,177,9,229
"76475",1076475,34,254,4,292
"76476",1076476,251,19,23,293
"76477",1076477,77,99,8,184
"76478",1076478,144,56,8,208
"76479",1076479,87,153,6,246
"76480",1076480,61,164,7,232
"76481",1076481,47,177,4,228
"76482",1076482,73,123,6,202
"76483",1076483,119,29,4,152
"76484",1076484,9,16,0,25
"76485",1076485,36,166,3,205
"76486",1076486,53,65,10,128
"76487",1076487,138,90,15,243
"76488",1076488,199,28,9,236
"76489",1076489,64,177,4,245
"76490",1076490,156,41,12,209
"76491",1076491,123,110,9,242
"76492",1076492,17,80,5,102
"76493",1076493,238,14,12,264
"76494",1076494,105,135,9,249
"76495",1076495,196,72,8,276
"76496",1076496,126,29,4,159
"76497",1076497,204,81,4,289
"76498",1076498,48,104,6,158
"76499",1076499,55,198,9,262
"76500",1076500,81,0,1,82
"76501",1076501,182,63,8,253
"76502",1076502,133,153,8,294
"76503",1076503,154,33,10,197
"76504",1076504,91,109,10,210
"76505",1076505,18,151,1,170
"76506",1076506,25,228,3,256
"76507",1076507,167,104,18,289
"76508",1076508,179,195,17,391
"76509",1076509,149,87,13,249
"76510",1076510,93,13,2,108
"76511",1076511,76,47,6,129
"76512",1076512,239,8,5,252
"76513",1076513,230,21,9,260
"76514",1076514,123,52,8,183
"76515",1076515,171,24,5,200
"76516",1076516,255,58,16,329
"76517",1076517,147,159,12,318
"76518",1076518,44,91,10,145
"76519",1076519,110,27,2,139
"76520",1076520,49,220,12,281
"76521",1076521,190,39,4,233
"76522",1076522,334,40,15,389
"76523",1076523,72,99,5,176
"76524",1076524,185,99,11,295
"76525",1076525,15,11,3,29
"76526",1076526,89,52,1,142
"76527",1076527,191,16,0,207
"76528",1076528,95,190,4,289
"76529",1076529,46,113,10,169
"76530",1076530,37,244,8,289
"76531",1076531,87,85,9,181
"76532",1076532,47,171,6,224
"76533",1076533,303,34,10,347
"76534",1076534,113,36,1,150
"76535",1076535,259,18,13,290
"76536",1076536,191,15,6,212
"76537",1076537,1,9,0,10
"76538",1076538,101,137,2,240
"76539",1076539,153,47,13,213
"76540",1076540,86,159,14,259
"76541",1076541,197,32,6,235
"76542",1076542,183,42,8,233
"76543",1076543,115,184,9,308
"76544",1076544,57,203,3,263
"76545",1076545,103,142,17,262
"76546",1076546,50,185,9,244
"76547",1076547,46,21,4,71
"76548",1076548,37,226,8,271
"76549",1076549,99,171,4,274
"76550",1076550,88,40,2,130
"76551",1076551,184,31,9,224
"76552",1076552,182,79,14,275
"76553",1076553,156,87,9,252
"76554",1076554,62,110,9,181
"76555",1076555,59,115,6,180
"76556",1076556,122,127,8,257
"76557",1076557,29,191,4,224
"76558",1076558,40,62,3,105
"76559",1076559,7,40,0,47
"76560",1076560,148,128,9,285
"76561",1076561,245,213,24,482
"76562",1076562,126,7,4,137
"76563",1076563,140,69,1,210
"76564",1076564,165,53,5,223
"76565",1076565,241,49,14,304
"76566",1076566,31,183,3,217
"76567",1076567,27,256,7,290
"76568",1076568,42,220,5,267
"76569",1076569,162,60,1,223
"76570",1076570,4,8,0,12
"76571",1076571,167,90,11,268
"76572",1076572,116,139,31,286
"76573",1076573,64,52,4,120
"76574",1076574,121,58,12,191
"76575",1076575,189,82,15,286
"76576",1076576,149,37,2,188
"76577",1076577,36,14,8,58
"76578",1076578,51,56,8,115
"76579",1076579,101,169,6,276
"76580",1076580,58,15,11,84
"76581",1076581,64,181,6,251
"76582",1076582,73,120,6,199
"76583",1076583,176,59,7,242
"76584",1076584,62,195,16,273
"76585",1076585,133,147,12,292
"76586",1076586,79,160,10,249
"76587",1076587,233,100,10,343
"76588",1076588,105,51,7,163
"76589",1076589,132,29,4,165
"76590",1076590,64,88,3,155
"76591",1076591,106,179,9,294
"76592",1076592,33,196,8,237
"76593",1076593,77,168,7,252
"76594",1076594,156,127,6,289
"76595",1076595,65,93,12,170
"76596",1076596,73,170,20,263
"76597",1076597,168,60,7,235
"76598",1076598,113,92,5,210
"76599",1076599,3,12,0,15
"76600",1076600,156,53,5,214
"76601",1076601,35,17,0,52
"76602",1076602,101,80,6,187
"76603",1076603,214,75,10,299
"76604",1076604,73,136,4,213
"76605",1076605,129,21,6,156
"76606",1076606,110,105,4,219
"76607",1076607,166,38,4,208
"76608",1076608,8,26,3,37
"76609",1076609,93,59,6,158
"76610",1076610,197,83,22,302
"76611",1076611,205,46,10,261
"76612",1076612,32,257,6,295
"76613",1076613,118,108,12,238
"76614",1076614,234,35,1,270
"76615",1076615,35,66,0,101
"76616",1076616,7,0,0,7
"76617",1076617,215,49,6,270
"76618",1076618,130,74,17,221
"76619",1076619,99,202,16,317
"76620",1076620,42,17,1,60
"76621",1076621,50,212,13,275
"76622",1076622,24,146,2,172
"76623",1076623,141,21,5,167
"76624",1076624,25,157,7,189
"76625",1076625,129,158,21,308
"76626",1076626,24,166,2,192
"76627",1076627,13,31,3,47
"76628",1076628,109,88,13,210
"76629",1076629,83,130,13,226
"76630",1076630,7,7,0,14
"76631",1076631,104,80,10,194
"76632",1076632,3,5,2,10
"76633",1076633,74,121,0,195
"76634",1076634,122,159,15,296
"76635",1076635,210,16,8,234
"76636",1076636,205,43,20,268
"76637",1076637,98,47,8,153
"76638",1076638,34,293,5,332
"76639",1076639,174,58,13,245
"76640",1076640,103,162,14,279
"76641",1076641,27,204,5,236
"76642",1076642,22,204,1,227
"76643",1076643,40,206,3,249
"76644",1076644,104,52,5,161
"76645",1076645,33,113,6,152
"76646",1076646,175,72,5,252
"76647",1076647,229,56,8,293
"76648",1076648,62,19,3,84
"76649",1076649,58,212,11,281
"76650",1076650,60,109,18,187
"76651",1076651,129,98,17,244
"76652",1076652,60,155,10,225
"76653",1076653,65,185,8,258
"76654",1076654,13,10,1,24
"76655",1076655,67,23,4,94
"76656",1076656,81,94,8,183
"76657",1076657,111,92,12,215
"76658",1076658,45,229,3,277
"76659",1076659,54,241,11,306
"76660",1076660,4,70,0,74
"76661",1076661,95,143,10,248
"76662",1076662,118,68,5,191
"76663",1076663,51,235,2,288
"76664",1076664,80,158,4,242
"76665",1076665,61,154,11,226
"76666",1076666,143,65,4,212
"76667",1076667,85,188,5,278
"76668",1076668,17,74,4,95
"76669",1076669,150,100,16,266
"76670",1076670,132,27,4,163
"76671",1076671,109,138,6,253
"76672",1076672,150,63,7,220
"76673",1076673,130,36,4,170
"76674",1076674,76,173,7,256
"76675",1076675,186,107,10,303
"76676",1076676,23,24,0,47
"76677",1076677,151,58,5,214
"76678",1076678,184,44,3,231
"76679",1076679,120,22,7,149
"76680",1076680,124,156,17,297
"76681",1076681,200,74,6,280
"76682",1076682,220,27,12,259
"76683",1076683,100,134,16,250
"76684",1076684,127,46,4,177
"76685",1076685,191,39,2,232
"76686",1076686,77,18,3,98
"76687",1076687,61,214,6,281
"76688",1076688,89,188,15,292
"76689",1076689,130,110,8,248
"76690",1076690,90,4,2,96
"76691",1076691,64,148,10,222
"76692",1076692,25,17,1,43
"76693",1076693,34,149,6,189
"76694",1076694,200,64,19,283
"76695",1076695,134,43,6,183
"76696",1076696,112,254,9,375
"76697",1076697,186,41,3,230
"76698",1076698,62,192,10,264
"76699",1076699,147,76,9,232
"76700",1076700,236,43,4,283
"76701",1076701,79,41,8,128
"76702",1076702,54,198,11,263
"76703",1076703,180,57,10,247
"76704",1076704,41,123,3,167
"76705",1076705,103,57,7,167
"76706",1076706,82,186,5,273
"76707",1076707,92,39,0,131
"76708",1076708,188,51,4,243
"76709",1076709,163,29,3,195
"76710",1076710,32,249,4,285
"76711",1076711,96,56,13,165
"76712",1076712,63,46,2,111
"76713",1076713,78,29,2,109
"76714",1076714,29,62,0,91
"76715",1076715,170,103,17,290
"76716",1076716,52,36,2,90
"76717",1076717,142,127,26,295
"76718",1076718,175,82,18,275
"76719",1076719,98,14,4,116
"76720",1076720,172,89,9,270
"76721",1076721,3,25,2,30
"76722",1076722,149,182,6,337
"76723",1076723,25,35,4,64
"76724",1076724,90,158,7,255
"76725",1076725,49,31,1,81
"76726",1076726,78,79,8,165
"76727",1076727,155,74,10,239
"76728",1076728,106,136,14,256
"76729",1076729,138,17,1,156
"76730",1076730,146,70,15,231
"76731",1076731,58,93,6,157
"76732",1076732,190,80,17,287
"76733",1076733,179,118,5,302
"76734",1076734,94,209,7,310
"76735",1076735,3,18,0,21
"76736",1076736,123,68,8,199
"76737",1076737,163,68,9,240
"76738",1076738,154,46,10,210
"76739",1076739,145,46,10,201
"76740",1076740,90,201,13,304
"76741",1076741,147,60,4,211
"76742",1076742,125,16,1,142
"76743",1076743,190,62,14,266
"76744",1076744,88,26,1,115
"76745",1076745,44,28,1,73
"76746",1076746,165,24,2,191
"76747",1076747,190,60,11,261
"76748",1076748,22,117,7,146
"76749",1076749,87,198,10,295
"76750",1076750,5,1,2,8
"76751",1076751,84,95,10,189
"76752",1076752,145,20,6,171
"76753",1076753,90,159,12,261
"76754",1076754,175,21,5,201
"76755",1076755,49,116,4,169
"76756",1076756,166,61,10,237
"76757",1076757,78,225,6,309
"76758",1076758,5,3,0,8
"76759",1076759,177,99,19,295
"76760",1076760,52,145,10,207
"76761",1076761,44,246,13,303
"76762",1076762,182,14,2,198
"76763",1076763,167,46,1,214
"76764",1076764,87,46,4,137
"76765",1076765,93,44,5,142
"76766",1076766,201,95,22,318
"76767",1076767,64,116,2,182
"76768",1076768,138,136,7,281
"76769",1076769,62,100,3,165
"76770",1076770,47,85,2,134
"76771",1076771,97,138,5,240
"76772",1076772,32,162,3,197
"76773",1076773,48,61,5,114
"76774",1076774,44,205,10,259
"76775",1076775,201,70,9,280
"76776",1076776,105,10,4,119
"76777",1076777,190,136,14,340
"76778",1076778,16,199,4,219
"76779",1076779,181,32,8,221
"76780",1076780,38,253,5,296
"76781",1076781,87,14,4,105
"76782",1076782,118,104,1,223
"76783",1076783,120,14,5,139
"76784",1076784,42,197,9,248
"76785",1076785,26,11,1,38
"76786",1076786,46,228,4,278
"76787",1076787,138,78,17,233
"76788",1076788,137,107,11,255
"76789",1076789,55,57,0,112
"76790",1076790,186,122,6,314
"76791",1076791,119,1,0,120
"76792",1076792,194,27,7,228
"76793",1076793,100,129,10,239
"76794",1076794,41,85,5,131
"76795",1076795,112,124,23,259
"76796",1076796,79,142,8,229
"76797",1076797,96,104,6,206
"76798",1076798,7,3,0,10
"76799",1076799,70,240,17,327
"76800",1076800,65,258,5,328
"76801",1076801,93,36,3,132
"76802",1076802,143,79,17,239
"76803",1076803,165,25,9,199
"76804",1076804,52,73,2,127
"76805",1076805,60,175,11,246
"76806",1076806,174,72,10,256
"76807",1076807,208,36,6,250
"76808",1076808,159,24,4,187
"76809",1076809,91,187,16,294
"76810",1076810,75,132,5,212
"76811",1076811,78,103,3,184
"76812",1076812,38,41,1,80
"76813",1076813,142,64,1,207
"76814",1076814,233,67,9,309
"76815",1076815,117,150,6,273
"76816",1076816,142,56,4,202
"76817",1076817,71,186,3,260
"76818",1076818,57,211,8,276
"76819",1076819,203,126,11,340
"76820",1076820,119,163,14,296
"76821",1076821,120,110,12,242
"76822",1076822,220,117,11,348
"76823",1076823,136,54,10,200
"76824",1076824,42,135,3,180
"76825",1076825,48,86,13,147
"76826",1076826,109,131,12,252
"76827",1076827,162,38,8,208
"76828",1076828,53,173,4,230
"76829",1076829,152,103,6,261
"76830",1076830,72,182,12,266
"76831",1076831,39,12,3,54
"76832",1076832,6,2,0,8
"76833",1076833,96,184,19,299
"76834",1076834,34,54,4,92
"76835",1076835,128,15,10,153
"76836",1076836,100,20,0,120
"76837",1076837,69,80,5,154
"76838",1076838,74,149,7,230
"76839",1076839,7,13,0,20
"76840",1076840,26,238,3,267
"76841",1076841,202,49,7,258
"76842",1076842,105,169,9,283
"76843",1076843,66,164,4,234
"76844",1076844,31,225,2,258
"76845",1076845,209,46,10,265
"76846",1076846,44,188,7,239
"76847",1076847,10,128,3,141
"76848",1076848,109,88,11,208
"76849",1076849,14,1,1,16
"76850",1076850,112,141,13,266
"76851",1076851,17,235,4,256
"76852",1076852,63,181,12,256
"76853",1076853,140,46,7,193
"76854",1076854,167,125,24,316
"76855",1076855,40,166,5,211
"76856",1076856,71,78,1,150
"76857",1076857,220,85,14,319
"76858",1076858,67,93,4,164
"76859",1076859,166,35,5,206
"76860",1076860,80,127,12,219
"76861",1076861,161,29,9,199
"76862",1076862,46,251,6,303
"76863",1076863,161,2,1,164
"76864",1076864,192,56,13,261
"76865",1076865,25,18,6,49
"76866",1076866,40,206,3,249
"76867",1076867,66,144,6,216
"76868",1076868,103,107,2,212
"76869",1076869,170,16,4,190
"76870",1076870,142,91,6,239
"76871",1076871,81,173,6,260
"76872",1076872,116,203,30,349
"76873",1076873,46,86,3,135
"76874",1076874,76,144,14,234
"76875",1076875,134,128,12,274
"76876",1076876,161,173,10,344
"76877",1076877,193,129,11,333
"76878",1076878,164,100,17,281
"76879",1076879,109,94,8,211
"76880",1076880,141,129,25,295
"76881",1076881,47,159,25,231
"76882",1076882,131,112,7,250
"76883",1076883,141,95,4,240
"76884",1076884,42,160,4,206
"76885",1076885,45,51,2,98
"76886",1076886,49,201,9,259
"76887",1076887,76,56,3,135
"76888",1076888,173,90,8,271
"76889",1076889,113,79,15,207
"76890",1076890,62,42,5,109
"76891",1076891,159,112,14,285
"76892",1076892,72,107,6,185
"76893",1076893,41,190,7,238
"76894",1076894,212,21,8,241
"76895",1076895,48,35,0,83
"76896",1076896,86,29,6,121
"76897",1076897,55,168,10,233
"76898",1076898,92,187,12,291
"76899",1076899,91,73,5,169
"76900",1076900,271,16,7,294
"76901",1076901,70,106,6,182
"76902",1076902,52,139,30,221
"76903",1076903,19,173,2,194
"76904",1076904,91,107,15,213
"76905",1076905,78,106,8,192
"76906",1076906,126,146,14,286
"76907",1076907,159,62,4,225
"76908",1076908,163,122,14,299
"76909",1076909,47,75,3,125
"76910",1076910,60,205,11,276
"76911",1076911,134,85,6,225
"76912",1076912,46,225,8,279
"76913",1076913,146,53,11,210
"76914",1076914,12,211,3,226
"76915",1076915,118,2,2,122
"76916",1076916,101,131,11,243
"76917",1076917,106,119,4,229
"76918",1076918,5,49,0,54
"76919",1076919,53,147,2,202
"76920",1076920,152,40,2,194
"76921",1076921,180,74,13,267
"76922",1076922,70,95,2,167
"76923",1076923,47,12,1,60
"76924",1076924,87,138,9,234
"76925",1076925,52,46,5,103
"76926",1076926,152,42,4,198
"76927",1076927,40,132,5,177
"76928",1076928,1,8,0,9
"76929",1076929,64,180,16,260
"76930",1076930,107,177,3,287
"76931",1076931,48,73,3,124
"76932",1076932,214,53,13,280
"76933",1076933,23,244,4,271
"76934",1076934,125,55,6,186
"76935",1076935,88,88,9,185
"76936",1076936,72,232,7,311
"76937",1076937,99,126,3,228
"76938",1076938,36,84,1,121
"76939",1076939,95,185,15,295
"76940",1076940,123,242,35,400
"76941",1076941,110,156,1,267
"76942",1076942,55,103,2,160
"76943",1076943,127,173,6,306
"76944",1076944,135,140,5,280
"76945",1076945,200,33,8,241
"76946",1076946,12,49,1,62
"76947",1076947,26,87,1,114
"76948",1076948,41,22,1,64
"76949",1076949,163,7,6,176
"76950",1076950,123,68,4,195
"76951",1076951,199,108,14,321
"76952",1076952,227,64,11,302
"76953",1076953,194,36,9,239
"76954",1076954,144,111,18,273
"76955",1076955,41,194,5,240
"76956",1076956,127,147,11,285
"76957",1076957,85,13,1,99
"76958",1076958,137,71,12,220
"76959",1076959,51,198,2,251
"76960",1076960,155,110,15,280
"76961",1076961,201,92,11,304
"76962",1076962,93,36,4,133
"76963",1076963,215,23,9,247
"76964",1076964,107,149,18,274
"76965",1076965,120,130,18,268
"76966",1076966,138,46,9,193
"76967",1076967,59,221,3,283
"76968",1076968,164,18,13,195
"76969",1076969,52,156,2,210
"76970",1076970,200,62,12,274
"76971",1076971,87,106,3,196
"76972",1076972,102,52,4,158
"76973",1076973,50,21,0,71
"76974",1076974,121,113,3,237
"76975",1076975,47,209,4,260
"76976",1076976,137,79,7,223
"76977",1076977,28,254,2,284
"76978",1076978,45,237,12,294
"76979",1076979,102,142,10,254
"76980",1076980,28,199,3,230
"76981",1076981,128,134,10,272
"76982",1076982,175,128,8,311
"76983",1076983,35,170,4,209
"76984",1076984,47,186,8,241
"76985",1076985,149,43,8,200
"76986",1076986,59,217,4,280
"76987",1076987,53,39,8,100
"76988",1076988,225,42,9,276
"76989",1076989,62,154,27,243
"76990",1076990,131,34,4,169
"76991",1076991,59,117,3,179
"76992",1076992,142,85,5,232
"76993",1076993,209,21,5,235
"76994",1076994,242,63,12,317
"76995",1076995,51,237,3,291
"76996",1076996,53,181,9,243
"76997",1076997,106,167,9,282
"76998",1076998,71,123,3,197
"76999",1076999,141,123,12,276
"77000",1077000,157,51,7,215
"77001",1077001,51,112,0,163
"77002",1077002,157,48,7,212
"77003",1077003,138,91,12,241
"77004",1077004,28,7,0,35
"77005",1077005,154,65,4,223
"77006",1077006,106,32,1,139
"77007",1077007,52,182,10,244
"77008",1077008,152,58,3,213
"77009",1077009,54,197,10,261
"77010",1077010,83,185,18,286
"77011",1077011,83,188,13,284
"77012",1077012,41,220,2,263
"77013",1077013,86,157,10,253
"77014",1077014,38,260,7,305
"77015",1077015,133,62,2,197
"77016",1077016,47,182,2,231
"77017",1077017,92,99,5,196
"77018",1077018,86,151,17,254
"77019",1077019,94,118,7,219
"77020",1077020,21,225,1,247
"77021",1077021,82,118,11,211
"77022",1077022,104,110,9,223
"77023",1077023,57,173,10,240
"77024",1077024,37,19,2,58
"77025",1077025,78,125,6,209
"77026",1077026,170,25,8,203
"77027",1077027,177,87,9,273
"77028",1077028,143,91,4,238
"77029",1077029,67,62,13,142
"77030",1077030,46,206,9,261
"77031",1077031,128,108,4,240
"77032",1077032,184,36,7,227
"77033",1077033,108,90,5,203
"77034",1077034,135,126,13,274
"77035",1077035,16,248,4,268
"77036",1077036,126,124,9,259
"77037",1077037,15,100,1,116
"77038",1077038,51,197,9,257
"77039",1077039,105,195,8,308
"77040",1077040,134,113,23,270
"77041",1077041,106,10,1,117
"77042",1077042,123,75,15,213
"77043",1077043,30,201,4,235
"77044",1077044,13,28,0,41
"77045",1077045,164,106,8,278
"77046",1077046,145,33,12,190
"77047",1077047,48,244,6,298
"77048",1077048,207,90,8,305
"77049",1077049,163,49,7,219
"77050",1077050,200,36,6,242
"77051",1077051,206,27,4,237
"77052",1077052,191,75,11,277
"77053",1077053,89,68,11,168
"77054",1077054,49,137,9,195
"77055",1077055,43,262,6,311
"77056",1077056,154,77,11,242
"77057",1077057,28,125,2,155
"77058",1077058,11,94,1,106
"77059",1077059,69,184,16,269
"77060",1077060,176,22,4,202
"77061",1077061,46,189,5,240
"77062",1077062,238,20,8,266
"77063",1077063,101,38,6,145
"77064",1077064,61,225,5,291
"77065",1077065,150,10,6,166
"77066",1077066,69,85,7,161
"77067",1077067,86,151,12,249
"77068",1077068,41,83,0,124
"77069",1077069,111,170,30,311
"77070",1077070,65,98,2,165
"77071",1077071,102,117,8,227
"77072",1077072,111,135,11,257
"77073",1077073,98,143,7,248
"77074",1077074,76,181,11,268
"77075",1077075,131,77,10,218
"77076",1077076,23,238,2,263
"77077",1077077,167,28,6,201
"77078",1077078,145,54,13,212
"77079",1077079,24,149,6,179
"77080",1077080,132,131,2,265
"77081",1077081,43,167,7,217
"77082",1077082,16,305,2,323
"77083",1077083,65,246,9,320
"77084",1077084,41,225,13,279
"77085",1077085,189,20,9,218
"77086",1077086,64,188,1,253
"77087",1077087,155,32,4,191
"77088",1077088,19,6,0,25
"77089",1077089,85,59,9,153
"77090",1077090,144,154,14,312
"77091",1077091,99,111,9,219
"77092",1077092,229,20,12,261
"77093",1077093,166,22,5,193
"77094",1077094,226,56,15,297
"77095",1077095,123,94,8,225
"77096",1077096,55,257,8,320
"77097",1077097,105,68,10,183
"77098",1077098,114,44,7,165
"77099",1077099,98,159,10,267
"77100",1077100,158,138,7,303
"77101",1077101,150,73,4,227
"77102",1077102,103,202,7,312
"77103",1077103,27,203,5,235
"77104",1077104,12,30,5,47
"77105",1077105,110,159,9,278
"77106",1077106,58,221,6,285
"77107",1077107,83,117,4,204
"77108",1077108,114,93,11,218
"77109",1077109,10,11,2,23
"77110",1077110,141,100,9,250
"77111",1077111,89,24,1,114
"77112",1077112,8,304,7,319
"77113",1077113,94,111,11,216
"77114",1077114,69,59,5,133
"77115",1077115,74,172,16,262
"77116",1077116,96,93,2,191
"77117",1077117,92,157,13,262
"77118",1077118,151,62,5,218
"77119",1077119,90,133,14,237
"77120",1077120,41,129,15,185
"77121",1077121,129,23,12,164
"77122",1077122,248,39,6,293
"77123",1077123,161,77,7,245
"77124",1077124,139,41,6,186
"77125",1077125,207,21,3,231
"77126",1077126,152,76,23,251
"77127",1077127,132,160,14,306
"77128",1077128,178,67,18,263
"77129",1077129,16,140,2,158
"77130",1077130,34,218,7,259
"77131",1077131,109,69,8,186
"77132",1077132,161,68,4,233
"77133",1077133,106,33,8,147
"77134",1077134,166,103,12,281
"77135",1077135,93,178,17,288
"77136",1077136,67,286,5,358
"77137",1077137,111,148,10,269
"77138",1077138,131,92,11,234
"77139",1077139,140,12,5,157
"77140",1077140,189,69,13,271
"77141",1077141,111,87,7,205
"77142",1077142,112,140,5,257
"77143",1077143,138,142,6,286
"77144",1077144,14,31,0,45
"77145",1077145,154,20,1,175
"77146",1077146,146,39,6,191
"77147",1077147,132,42,7,181
"77148",1077148,46,59,3,108
"77149",1077149,108,147,1,256
"77150",1077150,122,125,11,258
"77151",1077151,129,103,5,237
"77152",1077152,76,166,3,245
"77153",1077153,28,84,6,118
"77154",1077154,142,105,7,254
"77155",1077155,133,74,13,220
"77156",1077156,54,146,8,208
"77157",1077157,120,183,9,312
"77158",1077158,108,130,6,244
"77159",1077159,125,109,9,243
"77160",1077160,45,178,2,225
"77161",1077161,2,9,0,11
"77162",1077162,179,57,11,247
"77163",1077163,62,96,4,162
"77164",1077164,54,24,4,82
"77165",1077165,125,86,5,216
"77166",1077166,115,31,9,155
"77167",1077167,1,22,0,23
"77168",1077168,318,77,14,409
"77169",1077169,64,236,8,308
"77170",1077170,59,205,9,273
"77171",1077171,158,131,7,296
"77172",1077172,105,62,5,172
"77173",1077173,121,214,23,358
"77174",1077174,114,35,12,161
"77175",1077175,132,88,21,241
"77176",1077176,67,180,1,248
"77177",1077177,113,122,10,245
"77178",1077178,143,132,9,284
"77179",1077179,79,107,14,200
"77180",1077180,61,49,3,113
"77181",1077181,62,184,12,258
"77182",1077182,121,147,11,279
"77183",1077183,24,236,3,263
"77184",1077184,14,35,2,51
"77185",1077185,39,174,1,214
"77186",1077186,76,84,3,163
"77187",1077187,12,151,2,165
"77188",1077188,219,74,8,301
"77189",1077189,45,166,9,220
"77190",1077190,21,1,1,23
"77191",1077191,172,88,8,268
"77192",1077192,74,192,8,274
"77193",1077193,92,126,5,223
"77194",1077194,77,96,17,190
"77195",1077195,239,77,9,325
"77196",1077196,88,158,4,250
"77197",1077197,24,66,3,93
"77198",1077198,98,40,17,155
"77199",1077199,61,154,8,223
"77200",1077200,95,102,2,199
"77201",1077201,167,130,15,312
"77202",1077202,45,155,6,206
"77203",1077203,97,114,3,214
"77204",1077204,38,218,2,258
"77205",1077205,85,124,6,215
"77206",1077206,209,90,6,305
"77207",1077207,182,45,10,237
"77208",1077208,122,127,3,252
"77209",1077209,31,268,6,305
"77210",1077210,13,51,3,67
"77211",1077211,102,121,27,250
"77212",1077212,48,101,11,160
"77213",1077213,194,67,19,280
"77214",1077214,70,198,3,271
"77215",1077215,112,74,0,186
"77216",1077216,65,194,17,276
"77217",1077217,94,54,5,153
"77218",1077218,3,2,2,7
"77219",1077219,20,84,2,106
"77220",1077220,29,48,4,81
"77221",1077221,179,134,28,341
"77222",1077222,161,61,13,235
"77223",1077223,119,62,2,183
"77224",1077224,139,51,6,196
"77225",1077225,145,40,9,194
"77226",1077226,49,139,6,194
"77227",1077227,248,53,6,307
"77228",1077228,46,202,4,252
"77229",1077229,26,246,3,275
"77230",1077230,216,43,25,284
"77231",1077231,9,9,1,19
"77232",1077232,48,215,11,274
"77233",1077233,103,119,2,224
"77234",1077234,77,205,20,302
"77235",1077235,77,155,5,237
"77236",1077236,137,287,28,452
"77237",1077237,218,28,8,254
"77238",1077238,138,157,19,314
"77239",1077239,193,111,1,305
"77240",1077240,179,75,15,269
"77241",1077241,43,125,6,174
"77242",1077242,35,206,2,243
"77243",1077243,38,12,1,51
"77244",1077244,69,124,9,202
"77245",1077245,32,186,5,223
"77246",1077246,156,81,14,251
"77247",1077247,179,98,13,290
"77248",1077248,27,252,11,290
"77249",1077249,124,189,7,320
"77250",1077250,48,135,4,187
"77251",1077251,127,42,7,176
"77252",1077252,56,235,20,311
"77253",1077253,179,140,13,332
"77254",1077254,235,96,15,346
"77255",1077255,231,18,10,259
"77256",1077256,275,14,2,291
"77257",1077257,137,103,17,257
"77258",1077258,156,30,6,192
"77259",1077259,35,190,5,230
"77260",1077260,54,167,10,231
"77261",1077261,34,187,4,225
"77262",1077262,142,19,2,163
"77263",1077263,60,137,13,210
"77264",1077264,106,151,16,273
"77265",1077265,82,17,3,102
"77266",1077266,48,34,3,85
"77267",1077267,66,75,5,146
"77268",1077268,158,115,17,290
"77269",1077269,68,139,10,217
"77270",1077270,164,77,7,248
"77271",1077271,198,89,13,300
"77272",1077272,81,143,11,235
"77273",1077273,0,9,1,10
"77274",1077274,33,43,0,76
"77275",1077275,77,186,6,269
"77276",1077276,39,19,4,62
"77277",1077277,71,104,15,190
"77278",1077278,161,61,3,225
"77279",1077279,144,62,17,223
"77280",1077280,209,73,12,294
"77281",1077281,157,54,8,219
"77282",1077282,20,332,2,354
"77283",1077283,179,83,11,273
"77284",1077284,278,6,10,294
"77285",1077285,84,151,4,239
"77286",1077286,212,44,6,262
"77287",1077287,14,186,3,203
"77288",1077288,153,38,12,203
"77289",1077289,144,144,20,308
"77290",1077290,147,56,3,206
"77291",1077291,247,73,8,328
"77292",1077292,134,123,10,267
"77293",1077293,97,187,4,288
"77294",1077294,98,106,10,214
"77295",1077295,221,92,9,322
"77296",1077296,20,5,1,26
"77297",1077297,22,297,6,325
"77298",1077298,124,112,3,239
"77299",1077299,63,232,6,301
"77300",1077300,209,78,8,295
"77301",1077301,52,116,6,174
"77302",1077302,169,99,8,276
"77303",1077303,56,95,1,152
"77304",1077304,51,188,2,241
"77305",1077305,87,108,7,202
"77306",1077306,80,219,2,301
"77307",1077307,183,22,3,208
"77308",1077308,89,66,16,171
"77309",1077309,56,119,10,185
"77310",1077310,91,123,2,216
"77311",1077311,84,152,2,238
"77312",1077312,77,156,3,236
"77313",1077313,17,164,6,187
"77314",1077314,139,170,12,321
"77315",1077315,17,4,0,21
"77316",1077316,14,8,0,22
"77317",1077317,153,108,7,268
"77318",1077318,6,2,0,8
"77319",1077319,165,75,21,261
"77320",1077320,83,12,4,99
"77321",1077321,33,249,12,294
"77322",1077322,41,211,1,253
"77323",1077323,145,77,10,232
"77324",1077324,200,92,7,299
"77325",1077325,32,182,0,214
"77326",1077326,193,73,12,278
"77327",1077327,128,56,8,192
"77328",1077328,165,82,13,260
"77329",1077329,83,52,10,145
"77330",1077330,31,199,3,233
"77331",1077331,48,147,4,199
"77332",1077332,161,88,0,249
"77333",1077333,124,22,5,151
"77334",1077334,39,105,7,151
"77335",1077335,5,3,0,8
"77336",1077336,150,89,14,253
"77337",1077337,124,15,3,142
"77338",1077338,135,131,8,274
"77339",1077339,235,36,14,285
"77340",1077340,41,10,1,52
"77341",1077341,50,236,19,305
"77342",1077342,107,123,17,247
"77343",1077343,44,235,5,284
"77344",1077344,5,3,0,8
"77345",1077345,19,32,2,53
"77346",1077346,76,163,10,249
"77347",1077347,35,217,10,262
"77348",1077348,6,44,1,51
"77349",1077349,57,130,10,197
"77350",1077350,124,44,11,179
"77351",1077351,95,257,8,360
"77352",1077352,55,205,4,264
"77353",1077353,107,184,12,303
"77354",1077354,49,7,2,58
"77355",1077355,130,100,7,237
"77356",1077356,47,273,5,325
"77357",1077357,246,41,9,296
"77358",1077358,189,68,16,273
"77359",1077359,100,24,4,128
"77360",1077360,55,101,6,162
"77361",1077361,47,181,18,246
"77362",1077362,159,78,8,245
"77363",1077363,42,186,13,241
"77364",1077364,158,64,4,226
"77365",1077365,103,151,3,257
"77366",1077366,27,251,7,285
"77367",1077367,144,56,9,209
"77368",1077368,155,133,18,306
"77369",1077369,45,260,2,307
"77370",1077370,68,173,5,246
"77371",1077371,142,29,1,172
"77372",1077372,145,119,6,270
"77373",1077373,201,63,8,272
"77374",1077374,158,35,13,206
"77375",1077375,93,151,6,250
"77376",1077376,61,46,5,112
"77377",1077377,39,193,1,233
"77378",1077378,211,42,2,255
"77379",1077379,147,55,6,208
"77380",1077380,144,156,19,319
"77381",1077381,28,129,3,160
"77382",1077382,47,191,8,246
"77383",1077383,72,107,8,187
"77384",1077384,120,69,8,197
"77385",1077385,96,182,4,282
"77386",1077386,94,186,11,291
"77387",1077387,38,112,0,150
"77388",1077388,66,242,25,333
"77389",1077389,92,168,15,275
"77390",1077390,35,163,5,203
"77391",1077391,166,33,9,208
"77392",1077392,193,69,27,289
"77393",1077393,59,202,13,274
"77394",1077394,126,110,2,238
"77395",1077395,159,97,13,269
"77396",1077396,100,146,25,271
"77397",1077397,136,41,6,183
"77398",1077398,188,83,12,283
"77399",1077399,166,46,6,218
"77400",1077400,55,190,11,256
"77401",1077401,171,24,9,204
"77402",1077402,127,66,7,200
"77403",1077403,26,249,0,275
"77404",1077404,62,238,4,304
"77405",1077405,75,83,11,169
"77406",1077406,31,24,0,55
"77407",1077407,50,81,9,140
"77408",1077408,68,181,26,275
"77409",1077409,198,99,16,313
"77410",1077410,237,39,9,285
"77411",1077411,79,79,8,166
"77412",1077412,55,95,7,157
"77413",1077413,41,85,4,130
"77414",1077414,224,37,11,272
"77415",1077415,144,25,1,170
"77416",1077416,62,141,5,208
"77417",1077417,139,106,8,253
"77418",1077418,158,160,21,339
"77419",1077419,119,21,5,145
"77420",1077420,24,32,1,57
"77421",1077421,151,110,8,269
"77422",1077422,53,260,8,321
"77423",1077423,49,267,2,318
"77424",1077424,92,92,11,195
"77425",1077425,101,122,5,228
"77426",1077426,132,112,3,247
"77427",1077427,115,151,12,278
"77428",1077428,105,153,28,286
"77429",1077429,164,22,8,194
"77430",1077430,137,83,10,230
"77431",1077431,126,167,8,301
"77432",1077432,184,101,4,289
"77433",1077433,266,7,10,283
"77434",1077434,20,200,3,223
"77435",1077435,10,228,2,240
"77436",1077436,180,34,13,227
"77437",1077437,74,55,6,135
"77438",1077438,47,185,2,234
"77439",1077439,99,56,3,158
"77440",1077440,89,101,11,201
"77441",1077441,224,33,7,264
"77442",1077442,182,50,11,243
"77443",1077443,214,35,5,254
"77444",1077444,214,54,14,282
"77445",1077445,198,28,2,228
"77446",1077446,113,132,19,264
"77447",1077447,75,115,6,196
"77448",1077448,134,111,4,249
"77449",1077449,18,228,0,246
"77450",1077450,73,105,9,187
"77451",1077451,31,33,3,67
"77452",1077452,180,19,7,206
"77453",1077453,36,287,8,331
"77454",1077454,132,178,18,328
"77455",1077455,52,212,7,271
"77456",1077456,72,28,5,105
"77457",1077457,136,99,10,245
"77458",1077458,43,185,8,236
"77459",1077459,108,103,5,216
"77460",1077460,53,88,6,147
"77461",1077461,25,22,4,51
"77462",1077462,94,222,11,327
"77463",1077463,75,186,6,267
"77464",1077464,53,184,6,243
"77465",1077465,120,48,5,173
"77466",1077466,135,87,4,226
"77467",1077467,76,159,11,246
"77468",1077468,78,48,1,127
"77469",1077469,32,149,2,183
"77470",1077470,31,88,5,124
"77471",1077471,186,17,3,206
"77472",1077472,40,206,4,250
"77473",1077473,48,172,7,227
"77474",1077474,33,139,8,180
"77475",1077475,95,189,9,293
"77476",1077476,97,153,7,257
"77477",1077477,119,85,10,214
"77478",1077478,42,107,1,150
"77479",1077479,129,83,12,224
"77480",1077480,69,158,10,237
"77481",1077481,164,113,12,289
"77482",1077482,157,54,5,216
"77483",1077483,89,198,7,294
"77484",1077484,108,184,12,304
"77485",1077485,203,88,4,295
"77486",1077486,212,36,11,259
"77487",1077487,52,34,6,92
"77488",1077488,24,0,0,24
"77489",1077489,148,61,5,214
"77490",1077490,45,205,7,257
"77491",1077491,35,219,4,258
"77492",1077492,198,33,7,238
"77493",1077493,183,44,0,227
"77494",1077494,81,120,6,207
"77495",1077495,205,15,4,224
"77496",1077496,95,72,2,169
"77497",1077497,12,47,1,60
"77498",1077498,94,211,14,319
"77499",1077499,45,5,1,51
"77500",1077500,13,251,2,266
"77501",1077501,101,43,8,152
"77502",1077502,117,87,13,217
"77503",1077503,23,197,0,220
"77504",1077504,63,27,5,95
"77505",1077505,143,166,15,324
"77506",1077506,173,13,6,192
"77507",1077507,77,120,4,201
"77508",1077508,150,96,8,254
"77509",1077509,107,31,3,141
"77510",1077510,3,13,0,16
"77511",1077511,0,7,1,8
"77512",1077512,154,102,12,268
"77513",1077513,146,129,6,281
"77514",1077514,61,203,1,265
"77515",1077515,164,44,12,220
"77516",1077516,116,189,9,314
"77517",1077517,232,31,9,272
"77518",1077518,113,91,2,206
"77519",1077519,136,36,10,182
"77520",1077520,145,89,9,243
"77521",1077521,50,108,9,167
"77522",1077522,18,213,2,233
"77523",1077523,63,88,3,154
"77524",1077524,83,186,12,281
"77525",1077525,128,22,6,156
"77526",1077526,62,229,2,293
"77527",1077527,142,59,10,211
"77528",1077528,180,72,17,269
"77529",1077529,203,40,6,249
"77530",1077530,90,93,8,191
"77531",1077531,105,176,6,287
"77532",1077532,153,79,8,240
"77533",1077533,212,61,13,286
"77534",1077534,111,84,7,202
"77535",1077535,51,24,5,80
"77536",1077536,82,160,17,259
"77537",1077537,124,18,0,142
"77538",1077538,230,15,7,252
"77539",1077539,42,225,8,275
"77540",1077540,18,16,4,38
"77541",1077541,94,122,7,223
"77542",1077542,17,54,2,73
"77543",1077543,62,189,12,263
"77544",1077544,89,204,14,307
"77545",1077545,138,114,20,272
"77546",1077546,4,19,2,25
"77547",1077547,222,22,4,248
"77548",1077548,101,130,7,238
"77549",1077549,136,1,0,137
"77550",1077550,79,54,6,139
"77551",1077551,201,35,10,246
"77552",1077552,159,29,3,191
"77553",1077553,152,91,13,256
"77554",1077554,159,42,13,214
"77555",1077555,177,114,15,306
"77556",1077556,10,41,4,55
"77557",1077557,142,67,7,216
"77558",1077558,124,85,5,214
"77559",1077559,35,191,5,231
"77560",1077560,49,155,25,229
"77561",1077561,178,19,5,202
"77562",1077562,133,128,6,267
"77563",1077563,193,113,17,323
"77564",1077564,85,162,13,260
"77565",1077565,151,87,10,248
"77566",1077566,196,28,6,230
"77567",1077567,97,86,3,186
"77568",1077568,154,30,8,192
"77569",1077569,77,41,9,127
"77570",1077570,151,72,4,227
"77571",1077571,111,123,10,244
"77572",1077572,164,44,16,224
"77573",1077573,42,207,9,258
"77574",1077574,116,102,8,226
"77575",1077575,75,121,11,207
"77576",1077576,125,71,8,204
"77577",1077577,18,212,2,232
"77578",1077578,42,94,12,148
"77579",1077579,151,115,15,281
"77580",1077580,219,24,13,256
"77581",1077581,162,102,5,269
"77582",1077582,127,53,9,189
"77583",1077583,164,26,6,196
"77584",1077584,131,49,9,189
"77585",1077585,162,47,4,213
"77586",1077586,132,134,34,300
"77587",1077587,160,70,13,243
"77588",1077588,120,51,9,180
"77589",1077589,147,92,7,246
"77590",1077590,184,66,4,254
"77591",1077591,52,6,1,59
"77592",1077592,215,65,20,300
"77593",1077593,56,128,3,187
"77594",1077594,152,21,7,180
"77595",1077595,1,4,0,5
"77596",1077596,32,198,3,233
"77597",1077597,16,204,4,224
"77598",1077598,97,136,28,261
"77599",1077599,145,150,10,305
"77600",1077600,45,129,13,187
"77601",1077601,183,37,7,227
"77602",1077602,112,104,8,224
"77603",1077603,120,120,11,251
"77604",1077604,75,137,3,215
"77605",1077605,87,75,4,166
"77606",1077606,62,192,11,265
"77607",1077607,24,239,2,265
"77608",1077608,190,90,10,290
"77609",1077609,188,140,18,346
"77610",1077610,163,76,9,248
"77611",1077611,69,236,2,307
"77612",1077612,156,109,7,272
"77613",1077613,71,11,2,84
"77614",1077614,28,26,5,59
"77615",1077615,3,42,2,47
"77616",1077616,33,214,15,262
"77617",1077617,7,236,0,243
"77618",1077618,233,20,2,255
"77619",1077619,48,66,5,119
"77620",1077620,106,217,16,339
"77621",1077621,216,46,3,265
"77622",1077622,18,14,2,34
"77623",1077623,163,76,14,253
"77624",1077624,145,28,1,174
"77625",1077625,179,227,9,415
"77626",1077626,117,184,12,313
"77627",1077627,191,66,3,260
"77628",1077628,114,49,7,170
"77629",1077629,145,49,10,204
"77630",1077630,2,11,0,13
"77631",1077631,106,158,7,271
"77632",1077632,121,52,10,183
"77633",1077633,174,60,10,244
"77634",1077634,95,145,3,243
"77635",1077635,251,3,2,256
"77636",1077636,151,146,32,329
"77637",1077637,54,252,4,310
"77638",1077638,31,215,6,252
"77639",1077639,126,184,7,317
"77640",1077640,72,234,4,310
"77641",1077641,208,134,17,359
"77642",1077642,211,45,12,268
"77643",1077643,117,134,10,261
"77644",1077644,152,28,2,182
"77645",1077645,110,127,7,244
"77646",1077646,163,75,8,246
"77647",1077647,17,97,0,114
"77648",1077648,132,132,8,272
"77649",1077649,81,32,1,114
"77650",1077650,173,74,14,261
"77651",1077651,180,59,9,248
"77652",1077652,101,207,11,319
"77653",1077653,40,194,6,240
"77654",1077654,31,222,3,256
"77655",1077655,85,8,3,96
"77656",1077656,151,83,14,248
"77657",1077657,75,165,21,261
"77658",1077658,40,54,8,102
"77659",1077659,229,14,4,247
"77660",1077660,156,52,7,215
"77661",1077661,101,126,5,232
"77662",1077662,102,161,14,277
"77663",1077663,113,49,5,167
"77664",1077664,22,209,3,234
"77665",1077665,108,57,5,170
"77666",1077666,87,115,6,208
"77667",1077667,88,178,11,277
"77668",1077668,11,27,0,38
"77669",1077669,240,20,9,269
"77670",1077670,76,123,13,212
"77671",1077671,155,55,9,219
"77672",1077672,156,144,10,310
"77673",1077673,143,101,13,257
"77674",1077674,81,191,5,277
"77675",1077675,169,61,20,250
"77676",1077676,23,109,3,135
"77677",1077677,88,122,14,224
"77678",1077678,132,125,7,264
"77679",1077679,176,106,5,287
"77680",1077680,65,204,4,273
"77681",1077681,68,200,2,270
"77682",1077682,65,157,28,250
"77683",1077683,40,239,10,289
"77684",1077684,137,6,4,147
"77685",1077685,132,109,12,253
"77686",1077686,137,58,9,204
"77687",1077687,117,67,14,198
"77688",1077688,201,93,8,302
"77689",1077689,102,182,7,291
"77690",1077690,120,86,13,219
"77691",1077691,167,69,23,259
"77692",1077692,205,14,8,227
"77693",1077693,190,85,8,283
"77694",1077694,138,64,3,205
"77695",1077695,43,138,7,188
"77696",1077696,39,70,2,111
"77697",1077697,6,5,1,12
"77698",1077698,18,169,2,189
"77699",1077699,39,29,0,68
"77700",1077700,76,36,3,115
"77701",1077701,127,36,4,167
"77702",1077702,73,218,10,301
"77703",1077703,103,130,19,252
"77704",1077704,98,60,3,161
"77705",1077705,61,135,6,202
"77706",1077706,151,20,9,180
"77707",1077707,180,83,12,275
"77708",1077708,65,263,3,331
"77709",1077709,122,17,5,144
"77710",1077710,156,91,6,253
"77711",1077711,173,151,19,343
"77712",1077712,307,19,14,340
"77713",1077713,20,226,9,255
"77714",1077714,120,86,2,208
"77715",1077715,5,14,0,19
"77716",1077716,69,142,15,226
"77717",1077717,172,63,23,258
"77718",1077718,1,2,0,3
"77719",1077719,136,105,12,253
"77720",1077720,74,214,6,294
"77721",1077721,198,67,4,269
"77722",1077722,74,104,9,187
"77723",1077723,235,31,7,273
"77724",1077724,48,291,0,339
"77725",1077725,154,30,8,192
"77726",1077726,5,12,1,18
"77727",1077727,162,26,13,201
"77728",1077728,105,139,5,249
"77729",1077729,228,32,6,266
"77730",1077730,83,187,6,276
"77731",1077731,88,108,7,203
"77732",1077732,203,43,10,256
"77733",1077733,148,98,5,251
"77734",1077734,63,167,14,244
"77735",1077735,20,176,4,200
"77736",1077736,134,69,2,205
"77737",1077737,112,136,7,255
"77738",1077738,105,179,9,293
"77739",1077739,50,213,4,267
"77740",1077740,134,125,22,281
"77741",1077741,111,142,6,259
"77742",1077742,168,63,8,239
"77743",1077743,51,159,13,223
"77744",1077744,299,97,22,418
"77745",1077745,153,51,13,217
"77746",1077746,77,117,9,203
"77747",1077747,86,182,5,273
"77748",1077748,65,173,5,243
"77749",1077749,39,188,3,230
"77750",1077750,38,14,2,54
"77751",1077751,64,24,10,98
"77752",1077752,76,67,1,144
"77753",1077753,143,125,9,277
"77754",1077754,143,31,3,177
"77755",1077755,75,49,0,124
"77756",1077756,163,121,13,297
"77757",1077757,112,45,9,166
"77758",1077758,44,247,7,298
"77759",1077759,113,152,2,267
"77760",1077760,33,208,12,253
"77761",1077761,151,82,2,235
"77762",1077762,38,232,5,275
"77763",1077763,139,131,16,286
"77764",1077764,103,132,5,240
"77765",1077765,137,135,6,278
"77766",1077766,357,164,17,538
"77767",1077767,74,199,9,282
"77768",1077768,234,55,17,306
"77769",1077769,83,133,7,223
"77770",1077770,137,65,1,203
"77771",1077771,150,54,9,213
"77772",1077772,20,103,2,125
"77773",1077773,139,92,16,247
"77774",1077774,136,36,1,173
"77775",1077775,152,85,23,260
"77776",1077776,59,172,6,237
"77777",1077777,42,180,2,224
"77778",1077778,207,70,3,280
"77779",1077779,117,50,4,171
"77780",1077780,17,93,4,114
"77781",1077781,98,132,8,238
"77782",1077782,167,17,6,190
"77783",1077783,141,20,2,163
"77784",1077784,49,208,3,260
"77785",1077785,37,189,3,229
"77786",1077786,90,162,0,252
"77787",1077787,71,156,6,233
"77788",1077788,183,41,8,232
"77789",1077789,163,25,2,190
"77790",1077790,218,21,9,248
"77791",1077791,198,53,9,260
"77792",1077792,210,33,9,252
"77793",1077793,108,154,9,271
"77794",1077794,71,26,3,100
"77795",1077795,102,220,24,346
"77796",1077796,36,180,4,220
"77797",1077797,142,61,12,215
"77798",1077798,156,66,18,240
"77799",1077799,40,253,8,301
"77800",1077800,160,58,6,224
"77801",1077801,31,38,2,71
"77802",1077802,10,0,0,10
"77803",1077803,39,214,3,256
"77804",1077804,176,41,11,228
"77805",1077805,177,77,7,261
"77806",1077806,16,156,0,172
"77807",1077807,47,15,3,65
"77808",1077808,106,144,5,255
"77809",1077809,66,176,11,253
"77810",1077810,96,137,7,240
"77811",1077811,110,30,2,142
"77812",1077812,87,114,3,204
"77813",1077813,129,120,5,254
"77814",1077814,138,174,17,329
"77815",1077815,148,73,10,231
"77816",1077816,116,60,9,185
"77817",1077817,95,131,12,238
"77818",1077818,148,125,11,284
"77819",1077819,40,195,4,239
"77820",1077820,219,45,12,276
"77821",1077821,153,110,9,272
"77822",1077822,186,36,2,224
"77823",1077823,66,125,10,201
"77824",1077824,242,48,25,315
"77825",1077825,182,72,8,262
"77826",1077826,143,93,5,241
"77827",1077827,44,21,6,71
"77828",1077828,193,83,29,305
"77829",1077829,197,144,11,352
"77830",1077830,187,113,19,319
"77831",1077831,59,180,11,250
"77832",1077832,88,138,6,232
"77833",1077833,31,148,8,187
"77834",1077834,39,280,11,330
"77835",1077835,93,129,9,231
"77836",1077836,76,11,2,89
"77837",1077837,64,90,2,156
"77838",1077838,170,59,1,230
"77839",1077839,70,195,28,293
"77840",1077840,34,256,6,296
"77841",1077841,41,159,4,204
"77842",1077842,133,125,5,263
"77843",1077843,156,60,8,224
"77844",1077844,65,271,13,349
"77845",1077845,68,18,2,88
"77846",1077846,65,139,5,209
"77847",1077847,26,21,2,49
"77848",1077848,108,89,6,203
"77849",1077849,224,34,6,264
"77850",1077850,164,154,21,339
"77851",1077851,137,98,3,238
"77852",1077852,110,165,14,289
"77853",1077853,0,4,0,4
"77854",1077854,96,95,12,203
"77855",1077855,146,55,2,203
"77856",1077856,60,15,1,76
"77857",1077857,130,113,11,254
"77858",1077858,205,34,8,247
"77859",1077859,120,21,6,147
"77860",1077860,152,37,8,197
"77861",1077861,222,88,3,313
"77862",1077862,186,52,3,241
"77863",1077863,129,127,10,266
"77864",1077864,117,68,7,192
"77865",1077865,101,17,9,127
"77866",1077866,104,111,12,227
"77867",1077867,52,180,17,249
"77868",1077868,107,153,11,271
"77869",1077869,141,167,20,328
"77870",1077870,36,16,1,53
"77871",1077871,122,52,8,182
"77872",1077872,73,120,7,200
"77873",1077873,182,132,7,321
"77874",1077874,152,46,8,206
"77875",1077875,74,19,0,93
"77876",1077876,57,241,9,307
"77877",1077877,93,63,13,169
"77878",1077878,139,49,8,196
"77879",1077879,39,357,4,400
"77880",1077880,120,221,11,352
"77881",1077881,37,258,5,300
"77882",1077882,134,141,12,287
"77883",1077883,124,122,3,249
"77884",1077884,110,74,11,195
"77885",1077885,17,227,0,244
"77886",1077886,94,121,11,226
"77887",1077887,152,23,2,177
"77888",1077888,17,7,4,28
"77889",1077889,53,15,3,71
"77890",1077890,111,174,13,298
"77891",1077891,183,37,4,224
"77892",1077892,162,68,10,240
"77893",1077893,101,60,17,178
"77894",1077894,46,110,9,165
"77895",1077895,132,174,7,313
"77896",1077896,59,107,3,169
"77897",1077897,199,59,12,270
"77898",1077898,162,32,7,201
"77899",1077899,18,54,0,72
"77900",1077900,143,55,2,200
"77901",1077901,160,37,5,202
"77902",1077902,42,103,7,152
"77903",1077903,75,253,13,341
"77904",1077904,58,276,11,345
"77905",1077905,203,63,8,274
"77906",1077906,160,57,11,228
"77907",1077907,128,85,9,222
"77908",1077908,34,28,2,64
"77909",1077909,195,26,7,228
"77910",1077910,133,107,6,246
"77911",1077911,176,50,25,251
"77912",1077912,95,146,7,248
"77913",1077913,204,50,8,262
"77914",1077914,162,12,5,179
"77915",1077915,123,178,11,312
"77916",1077916,260,32,8,300
"77917",1077917,211,41,5,257
"77918",1077918,133,34,5,172
"77919",1077919,140,136,14,290
"77920",1077920,168,90,8,266
"77921",1077921,153,96,16,265
"77922",1077922,81,224,8,313
"77923",1077923,127,118,5,250
"77924",1077924,93,193,6,292
"77925",1077925,131,54,3,188
"77926",1077926,12,5,0,17
"77927",1077927,34,126,5,165
"77928",1077928,57,90,4,151
"77929",1077929,125,117,17,259
"77930",1077930,50,245,9,304
"77931",1077931,64,47,8,119
"77932",1077932,125,36,5,166
"77933",1077933,18,54,3,75
"77934",1077934,201,54,5,260
"77935",1077935,70,25,5,100
"77936",1077936,91,207,8,306
"77937",1077937,37,148,2,187
"77938",1077938,36,40,0,76
"77939",1077939,220,15,3,238
"77940",1077940,68,198,7,273
"77941",1077941,107,13,4,124
"77942",1077942,151,41,12,204
"77943",1077943,158,40,5,203
"77944",1077944,101,196,13,310
"77945",1077945,26,40,0,66
"77946",1077946,32,14,3,49
"77947",1077947,61,220,11,292
"77948",1077948,163,63,8,234
"77949",1077949,216,26,8,250
"77950",1077950,184,52,6,242
"77951",1077951,158,154,7,319
"77952",1077952,26,116,4,146
"77953",1077953,152,100,9,261
"77954",1077954,150,55,11,216
"77955",1077955,135,113,10,258
"77956",1077956,232,3,0,235
"77957",1077957,8,2,0,10
"77958",1077958,26,249,5,280
"77959",1077959,45,290,7,342
"77960",1077960,178,17,2,197
"77961",1077961,141,60,4,205
"77962",1077962,17,255,7,279
"77963",1077963,223,121,11,355
"77964",1077964,142,57,7,206
"77965",1077965,136,139,8,283
"77966",1077966,71,200,10,281
"77967",1077967,161,22,7,190
"77968",1077968,90,97,13,200
"77969",1077969,138,86,5,229
"77970",1077970,37,108,5,150
"77971",1077971,18,78,0,96
"77972",1077972,86,47,5,138
"77973",1077973,50,276,8,334
"77974",1077974,110,140,10,260
"77975",1077975,172,108,2,282
"77976",1077976,64,219,4,287
"77977",1077977,142,17,3,162
"77978",1077978,35,177,3,215
"77979",1077979,100,174,18,292
"77980",1077980,52,158,14,224
"77981",1077981,26,277,2,305
"77982",1077982,182,61,4,247
"77983",1077983,107,17,2,126
"77984",1077984,197,54,11,262
"77985",1077985,49,80,1,130
"77986",1077986,46,262,8,316
"77987",1077987,107,36,5,148
"77988",1077988,140,132,4,276
"77989",1077989,124,107,16,247
"77990",1077990,252,53,6,311
"77991",1077991,39,179,7,225
"77992",1077992,34,17,3,54
"77993",1077993,98,204,4,306
"77994",1077994,50,6,3,59
"77995",1077995,138,123,18,279
"77996",1077996,72,168,11,251
"77997",1077997,62,126,7,195
"77998",1077998,125,97,15,237
"77999",1077999,216,53,9,278
"78000",1078000,199,87,16,302
"78001",1078001,99,145,7,251
"78002",1078002,64,254,12,330
"78003",1078003,176,96,25,297
"78004",1078004,13,80,3,96
"78005",1078005,17,86,4,107
"78006",1078006,52,165,5,222
"78007",1078007,145,157,18,320
"78008",1078008,37,246,9,292
"78009",1078009,202,76,19,297
"78010",1078010,66,106,11,183
"78011",1078011,61,167,7,235
"78012",1078012,85,152,11,248
"78013",1078013,179,89,29,297
"78014",1078014,54,75,7,136
"78015",1078015,157,117,16,290
"78016",1078016,211,64,20,295
"78017",1078017,23,114,7,144
"78018",1078018,223,36,4,263
"78019",1078019,49,153,13,215
"78020",1078020,40,95,1,136
"78021",1078021,201,45,4,250
"78022",1078022,158,75,13,246
"78023",1078023,159,94,19,272
"78024",1078024,160,137,18,315
"78025",1078025,146,143,13,302
"78026",1078026,171,16,4,191
"78027",1078027,68,115,8,191
"78028",1078028,80,218,5,303
"78029",1078029,137,107,5,249
"78030",1078030,213,80,9,302
"78031",1078031,128,220,7,355
"78032",1078032,94,72,4,170
"78033",1078033,120,56,4,180
"78034",1078034,144,151,16,311
"78035",1078035,207,88,9,304
"78036",1078036,98,182,11,291
"78037",1078037,185,31,15,231
"78038",1078038,150,13,2,165
"78039",1078039,158,76,20,254
"78040",1078040,195,40,16,251
"78041",1078041,145,13,6,164
"78042",1078042,134,79,9,222
"78043",1078043,261,21,3,285
"78044",1078044,127,21,3,151
"78045",1078045,66,119,10,195
"78046",1078046,14,162,1,177
"78047",1078047,157,3,1,161
"78048",1078048,91,217,4,312
"78049",1078049,66,184,16,266
"78050",1078050,27,183,5,215
"78051",1078051,148,23,3,174
"78052",1078052,135,23,7,165
"78053",1078053,71,156,16,243
"78054",1078054,114,62,4,180
"78055",1078055,132,85,12,229
"78056",1078056,131,83,3,217
"78057",1078057,40,275,3,318
"78058",1078058,36,193,3,232
"78059",1078059,169,54,8,231
"78060",1078060,51,59,7,117
"78061",1078061,46,60,4,110
"78062",1078062,187,87,9,283
"78063",1078063,83,163,6,252
"78064",1078064,186,110,12,308
"78065",1078065,59,220,1,280
"78066",1078066,155,155,14,324
"78067",1078067,134,80,13,227
"78068",1078068,151,22,8,181
"78069",1078069,149,57,12,218
"78070",1078070,170,33,5,208
"78071",1078071,101,174,12,287
"78072",1078072,6,35,2,43
"78073",1078073,46,220,3,269
"78074",1078074,95,93,4,192
"78075",1078075,25,136,1,162
"78076",1078076,61,233,8,302
"78077",1078077,164,111,24,299
"78078",1078078,164,36,7,207
"78079",1078079,143,41,10,194
"78080",1078080,39,189,12,240
"78081",1078081,31,194,10,235
"78082",1078082,160,46,15,221
"78083",1078083,60,197,13,270
"78084",1078084,199,37,7,243
"78085",1078085,231,10,7,248
"78086",1078086,79,67,17,163
"78087",1078087,107,136,7,250
"78088",1078088,111,201,20,332
"78089",1078089,54,253,2,309
"78090",1078090,116,47,5,168
"78091",1078091,114,125,19,258
"78092",1078092,51,205,7,263
"78093",1078093,155,108,12,275
"78094",1078094,99,148,13,260
"78095",1078095,21,278,0,299
"78096",1078096,207,17,7,231
"78097",1078097,104,115,11,230
"78098",1078098,184,79,18,281
"78099",1078099,83,178,8,269
"78100",1078100,55,167,4,226
"78101",1078101,115,63,24,202
"78102",1078102,146,56,9,211
"78103",1078103,150,114,9,273
"78104",1078104,216,44,5,265
"78105",1078105,159,97,10,266
"78106",1078106,104,137,8,249
"78107",1078107,187,109,2,298
"78108",1078108,141,50,8,199
"78109",1078109,153,69,7,229
"78110",1078110,107,34,7,148
"78111",1078111,147,127,11,285
"78112",1078112,124,130,6,260
"78113",1078113,63,261,4,328
"78114",1078114,45,241,11,297
"78115",1078115,61,141,19,221
"78116",1078116,116,147,9,272
"78117",1078117,137,26,2,165
"78118",1078118,132,45,14,191
"78119",1078119,60,281,4,345
"78120",1078120,132,98,6,236
"78121",1078121,171,51,2,224
"78122",1078122,162,21,4,187
"78123",1078123,150,186,12,348
"78124",1078124,144,111,12,267
"78125",1078125,36,0,0,36
"78126",1078126,144,79,8,231
"78127",1078127,52,78,2,132
"78128",1078128,156,49,10,215
"78129",1078129,129,72,10,211
"78130",1078130,14,48,1,63
"78131",1078131,31,5,3,39
"78132",1078132,44,217,3,264
"78133",1078133,25,243,5,273
"78134",1078134,25,298,9,332
"78135",1078135,36,177,2,215
"78136",1078136,62,209,2,273
"78137",1078137,24,257,10,291
"78138",1078138,183,101,15,299
"78139",1078139,185,77,12,274
"78140",1078140,110,102,6,218
"78141",1078141,109,92,4,205
"78142",1078142,9,135,2,146
"78143",1078143,149,75,7,231
"78144",1078144,112,24,3,139
"78145",1078145,5,5,0,10
"78146",1078146,245,47,5,297
"78147",1078147,62,252,5,319
"78148",1078148,94,111,5,210
"78149",1078149,172,15,9,196
"78150",1078150,22,53,1,76
"78151",1078151,119,130,18,267
"78152",1078152,129,99,7,235
"78153",1078153,152,74,10,236
"78154",1078154,203,41,7,251
"78155",1078155,42,194,1,237
"78156",1078156,32,178,1,211
"78157",1078157,114,79,3,196
"78158",1078158,74,10,2,86
"78159",1078159,220,55,5,280
"78160",1078160,1,0,0,1
"78161",1078161,131,83,4,218
"78162",1078162,95,89,3,187
"78163",1078163,214,46,10,270
"78164",1078164,95,5,2,102
"78165",1078165,99,56,1,156
"78166",1078166,31,78,3,112
"78167",1078167,201,73,21,295
"78168",1078168,213,59,24,296
"78169",1078169,117,95,7,219
"78170",1078170,89,180,6,275
"78171",1078171,178,10,9,197
"78172",1078172,106,50,13,169
"78173",1078173,311,130,22,463
"78174",1078174,157,93,14,264
"78175",1078175,127,125,14,266
"78176",1078176,130,87,25,242
"78177",1078177,10,25,0,35
"78178",1078178,52,164,16,232
"78179",1078179,66,137,7,210
"78180",1078180,223,60,8,291
"78181",1078181,143,63,7,213
"78182",1078182,130,113,4,247
"78183",1078183,132,108,2,242
"78184",1078184,155,64,8,227
"78185",1078185,88,196,18,302
"78186",1078186,150,101,3,254
"78187",1078187,148,101,16,265
"78188",1078188,38,198,5,241
"78189",1078189,48,224,16,288
"78190",1078190,148,34,9,191
"78191",1078191,114,50,9,173
"78192",1078192,52,150,10,212
"78193",1078193,137,60,8,205
"78194",1078194,149,103,18,270
"78195",1078195,96,179,17,292
"78196",1078196,219,40,11,270
"78197",1078197,38,263,2,303
"78198",1078198,85,213,6,304
"78199",1078199,89,154,4,247
"78200",1078200,96,36,2,134
"78201",1078201,63,172,16,251
"78202",1078202,32,150,9,191
"78203",1078203,10,17,0,27
"78204",1078204,113,132,6,251
"78205",1078205,85,162,9,256
"78206",1078206,121,17,1,139
"78207",1078207,65,220,17,302
"78208",1078208,14,44,4,62
"78209",1078209,36,254,3,293
"78210",1078210,174,105,13,292
"78211",1078211,164,74,5,243
"78212",1078212,101,126,11,238
"78213",1078213,153,127,20,300
"78214",1078214,66,264,8,338
"78215",1078215,63,248,7,318
"78216",1078216,171,24,4,199
"78217",1078217,140,143,20,303
"78218",1078218,201,42,12,255
"78219",1078219,213,17,4,234
"78220",1078220,50,161,4,215
"78221",1078221,36,47,3,86
"78222",1078222,145,149,21,315
"78223",1078223,97,67,0,164
"78224",1078224,3,9,1,13
"78225",1078225,85,182,7,274
"78226",1078226,136,86,6,228
"78227",1078227,154,42,2,198
"78228",1078228,71,32,4,107
"78229",1078229,187,57,13,257
"78230",1078230,122,55,9,186
"78231",1078231,55,59,5,119
"78232",1078232,64,135,4,203
"78233",1078233,109,78,7,194
"78234",1078234,29,243,6,278
"78235",1078235,235,30,9,274
"78236",1078236,169,177,9,355
"78237",1078237,154,79,7,240
"78238",1078238,176,39,5,220
"78239",1078239,50,243,3,296
"78240",1078240,127,144,0,271
"78241",1078241,13,292,0,305
"78242",1078242,73,163,11,247
"78243",1078243,235,83,12,330
"78244",1078244,63,173,3,239
"78245",1078245,73,84,18,175
"78246",1078246,31,240,3,274
"78247",1078247,124,159,8,291
"78248",1078248,147,93,10,250
"78249",1078249,211,40,6,257
"78250",1078250,165,102,16,283
"78251",1078251,220,37,5,262
"78252",1078252,71,140,2,213
"78253",1078253,196,115,15,326
"78254",1078254,112,166,11,289
"78255",1078255,49,172,2,223
"78256",1078256,172,52,5,229
"78257",1078257,147,107,15,269
"78258",1078258,220,26,6,252
"78259",1078259,67,162,11,240
"78260",1078260,131,65,9,205
"78261",1078261,119,174,6,299
"78262",1078262,45,137,7,189
"78263",1078263,170,46,7,223
"78264",1078264,117,78,6,201
"78265",1078265,33,27,2,62
"78266",1078266,20,26,0,46
"78267",1078267,98,32,8,138
"78268",1078268,113,64,3,180
"78269",1078269,125,64,13,202
"78270",1078270,9,26,2,37
"78271",1078271,92,44,6,142
"78272",1078272,38,204,12,254
"78273",1078273,113,30,9,152
"78274",1078274,25,110,0,135
"78275",1078275,14,59,1,74
"78276",1078276,83,25,5,113
"78277",1078277,19,51,3,73
"78278",1078278,27,164,6,197
"78279",1078279,119,27,5,151
"78280",1078280,137,124,11,272
"78281",1078281,71,172,6,249
"78282",1078282,102,126,9,237
"78283",1078283,66,124,6,196
"78284",1078284,57,198,15,270
"78285",1078285,64,162,13,239
"78286",1078286,42,231,6,279
"78287",1078287,86,42,2,130
"78288",1078288,50,163,9,222
"78289",1078289,10,215,4,229
"78290",1078290,124,55,9,188
"78291",1078291,71,175,10,256
"78292",1078292,73,11,1,85
"78293",1078293,28,18,1,47
"78294",1078294,46,219,5,270
"78295",1078295,162,53,5,220
"78296",1078296,101,56,8,165
"78297",1078297,47,44,2,93
"78298",1078298,28,8,0,36
"78299",1078299,178,16,7,201
"78300",1078300,148,8,4,160
"78301",1078301,35,100,3,138
"78302",1078302,43,237,5,285
"78303",1078303,17,24,1,42
"78304",1078304,96,141,10,247
"78305",1078305,118,192,20,330
"78306",1078306,86,166,8,260
"78307",1078307,153,37,5,195
"78308",1078308,154,19,4,177
"78309",1078309,30,124,2,156
"78310",1078310,57,52,4,113
"78311",1078311,144,39,6,189
"78312",1078312,13,290,6,309
"78313",1078313,104,72,13,189
"78314",1078314,116,119,10,245
"78315",1078315,175,57,7,239
"78316",1078316,202,39,1,242
"78317",1078317,137,58,2,197
"78318",1078318,152,23,3,178
"78319",1078319,213,33,10,256
"78320",1078320,107,19,2,128
"78321",1078321,113,115,10,238
"78322",1078322,43,142,20,205
"78323",1078323,3,16,0,19
"78324",1078324,133,108,10,251
"78325",1078325,136,58,9,203
"78326",1078326,92,136,7,235
"78327",1078327,44,42,1,87
"78328",1078328,172,32,8,212
"78329",1078329,19,141,2,162
"78330",1078330,122,57,5,184
"78331",1078331,101,37,2,140
"78332",1078332,156,152,9,317
"78333",1078333,198,100,9,307
"78334",1078334,55,211,14,280
"78335",1078335,74,161,10,245
"78336",1078336,76,224,5,305
"78337",1078337,237,62,16,315
"78338",1078338,260,83,22,365
"78339",1078339,89,73,19,181
"78340",1078340,32,96,2,130
"78341",1078341,13,207,2,222
"78342",1078342,216,40,21,277
"78343",1078343,2,26,3,31
"78344",1078344,42,32,2,76
"78345",1078345,94,188,10,292
"78346",1078346,154,119,5,278
"78347",1078347,74,236,3,313
"78348",1078348,207,59,6,272
"78349",1078349,150,67,9,226
"78350",1078350,100,33,5,138
"78351",1078351,74,189,5,268
"78352",1078352,103,96,8,207
"78353",1078353,206,19,8,233
"78354",1078354,197,61,11,269
"78355",1078355,48,257,4,309
"78356",1078356,231,48,10,289
"78357",1078357,113,143,10,266
"78358",1078358,106,216,18,340
"78359",1078359,25,124,2,151
"78360",1078360,49,163,2,214
"78361",1078361,22,76,1,99
"78362",1078362,180,91,14,285
"78363",1078363,194,103,9,306
"78364",1078364,89,82,5,176
"78365",1078365,11,10,2,23
"78366",1078366,65,127,8,200
"78367",1078367,196,16,5,217
"78368",1078368,224,43,4,271
"78369",1078369,105,106,33,244
"78370",1078370,41,155,7,203
"78371",1078371,192,99,6,297
"78372",1078372,55,66,11,132
"78373",1078373,63,34,2,99
"78374",1078374,178,48,16,242
"78375",1078375,35,276,0,311
"78376",1078376,63,31,0,94
"78377",1078377,242,52,8,302
"78378",1078378,163,112,15,290
"78379",1078379,102,116,4,222
"78380",1078380,144,31,5,180
"78381",1078381,126,74,16,216
"78382",1078382,169,17,7,193
"78383",1078383,167,26,3,196
"78384",1078384,120,182,5,307
"78385",1078385,46,160,7,213
"78386",1078386,207,36,2,245
"78387",1078387,66,189,3,258
"78388",1078388,60,73,9,142
"78389",1078389,167,103,9,279
"78390",1078390,184,94,8,286
"78391",1078391,166,41,6,213
"78392",1078392,160,21,9,190
"78393",1078393,82,115,4,201
"78394",1078394,38,36,4,78
"78395",1078395,205,46,2,253
"78396",1078396,23,182,3,208
"78397",1078397,196,29,6,231
"78398",1078398,117,62,3,182
"78399",1078399,88,177,25,290
"78400",1078400,238,80,13,331
"78401",1078401,162,82,2,246
"78402",1078402,49,162,12,223
"78403",1078403,156,26,5,187
"78404",1078404,102,29,4,135
"78405",1078405,154,20,4,178
"78406",1078406,118,107,8,233
"78407",1078407,97,185,16,298
"78408",1078408,174,40,14,228
"78409",1078409,116,171,22,309
"78410",1078410,232,93,20,345
"78411",1078411,59,70,10,139
"78412",1078412,119,123,3,245
"78413",1078413,150,100,6,256
"78414",1078414,81,244,16,341
"78415",1078415,6,44,2,52
"78416",1078416,47,66,5,118
"78417",1078417,95,38,4,137
"78418",1078418,7,9,0,16
"78419",1078419,11,20,0,31
"78420",1078420,83,162,6,251
"78421",1078421,155,74,11,240
"78422",1078422,166,9,1,176
"78423",1078423,15,100,2,117
"78424",1078424,162,34,7,203
"78425",1078425,138,20,7,165
"78426",1078426,163,80,3,246
"78427",1078427,154,56,4,214
"78428",1078428,91,123,6,220
"78429",1078429,55,149,3,207
"78430",1078430,133,45,18,196
"78431",1078431,141,59,7,207
"78432",1078432,108,130,13,251
"78433",1078433,2,66,1,69
"78434",1078434,110,23,6,139
"78435",1078435,144,51,7,202
"78436",1078436,44,123,8,175
"78437",1078437,52,196,12,260
"78438",1078438,130,57,14,201
"78439",1078439,163,61,4,228
"78440",1078440,34,192,9,235
"78441",1078441,114,114,2,230
"78442",1078442,126,47,5,178
"78443",1078443,72,217,16,305
"78444",1078444,155,78,8,241
"78445",1078445,117,108,21,246
"78446",1078446,180,15,4,199
"78447",1078447,211,72,13,296
"78448",1078448,3,4,1,8
"78449",1078449,26,205,10,241
"78450",1078450,121,48,7,176
"78451",1078451,106,2,2,110
"78452",1078452,116,185,8,309
"78453",1078453,49,84,7,140
"78454",1078454,39,182,3,224
"78455",1078455,199,24,7,230
"78456",1078456,155,13,7,175
"78457",1078457,92,52,2,146
"78458",1078458,158,49,13,220
"78459",1078459,4,26,1,31
"78460",1078460,146,124,10,280
"78461",1078461,57,55,2,114
"78462",1078462,32,174,5,211
"78463",1078463,91,197,10,298
"78464",1078464,109,122,12,243
"78465",1078465,205,39,13,257
"78466",1078466,31,2,1,34
"78467",1078467,23,22,3,48
"78468",1078468,129,38,2,169
"78469",1078469,96,162,10,268
"78470",1078470,81,75,7,163
"78471",1078471,64,144,21,229
"78472",1078472,190,98,27,315
"78473",1078473,1,6,2,9
"78474",1078474,61,9,3,73
"78475",1078475,14,19,1,34
"78476",1078476,114,164,9,287
"78477",1078477,1,3,2,6
"78478",1078478,142,103,11,256
"78479",1078479,84,196,4,284
"78480",1078480,222,35,10,267
"78481",1078481,121,108,11,240
"78482",1078482,155,84,8,247
"78483",1078483,138,79,5,222
"78484",1078484,45,258,16,319
"78485",1078485,103,190,6,299
"78486",1078486,51,18,2,71
"78487",1078487,144,92,21,257
"78488",1078488,145,141,14,300
"78489",1078489,68,213,3,284
"78490",1078490,22,140,2,164
"78491",1078491,47,190,12,249
"78492",1078492,221,42,10,273
"78493",1078493,102,141,11,254
"78494",1078494,179,63,15,257
"78495",1078495,91,124,10,225
"78496",1078496,52,204,6,262
"78497",1078497,165,39,10,214
"78498",1078498,20,241,11,272
"78499",1078499,67,204,7,278
"78500",1078500,156,69,4,229
"78501",1078501,202,24,9,235
"78502",1078502,150,138,8,296
"78503",1078503,33,163,6,202
"78504",1078504,211,61,19,291
"78505",1078505,101,155,18,274
"78506",1078506,121,37,8,166
"78507",1078507,76,185,6,267
"78508",1078508,57,18,2,77
"78509",1078509,61,204,3,268
"78510",1078510,83,83,4,170
"78511",1078511,52,3,2,57
"78512",1078512,84,56,6,146
"78513",1078513,39,214,12,265
"78514",1078514,167,71,2,240
"78515",1078515,176,69,8,253
"78516",1078516,110,112,5,227
"78517",1078517,148,25,3,176
"78518",1078518,50,180,6,236
"78519",1078519,171,132,4,307
"78520",1078520,118,102,5,225
"78521",1078521,93,152,16,261
"78522",1078522,168,14,0,182
"78523",1078523,200,37,7,244
"78524",1078524,63,90,5,158
"78525",1078525,63,35,0,98
"78526",1078526,84,2,1,87
"78527",1078527,196,88,7,291
"78528",1078528,52,209,5,266
"78529",1078529,95,119,6,220
"78530",1078530,83,128,12,223
"78531",1078531,90,129,10,229
"78532",1078532,252,46,6,304
"78533",1078533,6,5,1,12
"78534",1078534,165,126,7,298
"78535",1078535,90,95,22,207
"78536",1078536,93,107,9,209
"78537",1078537,89,34,15,138
"78538",1078538,232,18,12,262
"78539",1078539,55,171,5,231
"78540",1078540,89,6,4,99
"78541",1078541,159,75,13,247
"78542",1078542,40,63,1,104
"78543",1078543,134,52,3,189
"78544",1078544,170,121,17,308
"78545",1078545,54,184,2,240
"78546",1078546,210,13,18,241
"78547",1078547,141,39,12,192
"78548",1078548,160,93,15,268
"78549",1078549,61,10,1,72
"78550",1078550,23,102,5,130
"78551",1078551,197,35,4,236
"78552",1078552,149,56,8,213
"78553",1078553,154,64,11,229
"78554",1078554,157,44,5,206
"78555",1078555,116,148,11,275
"78556",1078556,179,121,7,307
"78557",1078557,70,170,11,251
"78558",1078558,22,214,5,241
"78559",1078559,115,189,17,321
"78560",1078560,3,15,0,18
"78561",1078561,50,17,0,67
"78562",1078562,164,124,13,301
"78563",1078563,239,31,7,277
"78564",1078564,119,10,0,129
"78565",1078565,178,72,15,265
"78566",1078566,46,202,6,254
"78567",1078567,6,12,1,19
"78568",1078568,59,210,11,280
"78569",1078569,157,42,2,201
"78570",1078570,58,244,4,306
"78571",1078571,174,48,8,230
"78572",1078572,184,94,6,284
"78573",1078573,60,182,15,257
"78574",1078574,10,5,0,15
"78575",1078575,125,117,3,245
"78576",1078576,93,104,10,207
"78577",1078577,31,56,0,87
"78578",1078578,53,151,7,211
"78579",1078579,170,77,3,250
"78580",1078580,64,56,6,126
"78581",1078581,116,38,3,157
"78582",1078582,99,20,6,125
"78583",1078583,48,89,8,145
"78584",1078584,19,13,3,35
"78585",1078585,123,153,5,281
"78586",1078586,97,56,2,155
"78587",1078587,47,128,8,183
"78588",1078588,202,26,12,240
"78589",1078589,126,188,17,331
"78590",1078590,162,40,49,251
"78591",1078591,14,245,5,264
"78592",1078592,80,53,2,135
"78593",1078593,161,83,2,246
"78594",1078594,38,53,3,94
"78595",1078595,71,226,14,311
"78596",1078596,29,261,6,296
"78597",1078597,55,16,3,74
"78598",1078598,63,222,9,294
"78599",1078599,40,200,2,242
"78600",1078600,77,117,2,196
"78601",1078601,169,7,6,182
"78602",1078602,165,35,0,200
"78603",1078603,10,5,0,15
"78604",1078604,134,114,3,251
"78605",1078605,53,8,7,68
"78606",1078606,107,85,6,198
"78607",1078607,169,80,6,255
"78608",1078608,54,245,7,306
"78609",1078609,16,195,1,212
"78610",1078610,102,17,3,122
"78611",1078611,63,66,2,131
"78612",1078612,97,155,5,257
"78613",1078613,25,169,5,199
"78614",1078614,204,48,12,264
"78615",1078615,85,18,8,111
"78616",1078616,181,59,8,248
"78617",1078617,88,185,9,282
"78618",1078618,110,192,9,311
"78619",1078619,189,45,5,239
"78620",1078620,120,34,9,163
"78621",1078621,222,30,7,259
"78622",1078622,118,128,8,254
"78623",1078623,96,99,6,201
"78624",1078624,52,255,7,314
"78625",1078625,164,138,17,319
"78626",1078626,158,112,22,292
"78627",1078627,129,87,11,227
"78628",1078628,144,166,11,321
"78629",1078629,156,94,12,262
"78630",1078630,171,75,12,258
"78631",1078631,107,157,5,269
"78632",1078632,31,214,10,255
"78633",1078633,92,206,8,306
"78634",1078634,79,181,11,271
"78635",1078635,201,36,5,242
"78636",1078636,19,254,2,275
"78637",1078637,33,285,6,324
"78638",1078638,4,31,1,36
"78639",1078639,143,116,9,268
"78640",1078640,135,14,3,152
"78641",1078641,55,32,9,96
"78642",1078642,46,215,8,269
"78643",1078643,212,52,18,282
"78644",1078644,49,145,15,209
"78645",1078645,162,92,7,261
"78646",1078646,211,39,9,259
"78647",1078647,192,90,17,299
"78648",1078648,244,3,4,251
"78649",1078649,186,80,3,269
"78650",1078650,87,127,7,221
"78651",1078651,21,37,2,60
"78652",1078652,43,8,0,51
"78653",1078653,46,148,5,199
"78654",1078654,168,81,13,262
"78655",1078655,208,89,4,301
"78656",1078656,45,216,10,271
"78657",1078657,158,69,3,230
"78658",1078658,72,108,15,195
"78659",1078659,107,46,3,156
"78660",1078660,169,110,24,303
"78661",1078661,116,145,15,276
"78662",1078662,17,99,5,121
"78663",1078663,58,77,9,144
"78664",1078664,65,49,5,119
"78665",1078665,12,217,1,230
"78666",1078666,26,43,5,74
"78667",1078667,13,128,6,147
"78668",1078668,72,47,10,129
"78669",1078669,138,107,9,254
"78670",1078670,62,229,14,305
"78671",1078671,146,76,4,226
"78672",1078672,211,17,8,236
"78673",1078673,4,17,0,21
"78674",1078674,49,219,3,271
"78675",1078675,50,195,4,249
"78676",1078676,58,156,6,220
"78677",1078677,17,37,2,56
"78678",1078678,190,27,7,224
"78679",1078679,132,103,22,257
"78680",1078680,88,22,5,115
"78681",1078681,137,138,15,290
"78682",1078682,201,36,2,239
"78683",1078683,72,114,2,188
"78684",1078684,120,91,16,227
"78685",1078685,262,7,29,298
"78686",1078686,41,11,2,54
"78687",1078687,215,18,11,244
"78688",1078688,116,125,6,247
"78689",1078689,64,260,9,333
"78690",1078690,117,147,10,274
"78691",1078691,112,88,7,207
"78692",1078692,49,74,5,128
"78693",1078693,87,40,8,135
"78694",1078694,92,169,3,264
"78695",1078695,109,170,4,283
"78696",1078696,142,102,21,265
"78697",1078697,165,48,5,218
"78698",1078698,55,199,8,262
"78699",1078699,62,151,2,215
"78700",1078700,65,129,0,194
"78701",1078701,21,313,2,336
"78702",1078702,170,65,9,244
"78703",1078703,137,98,6,241
"78704",1078704,176,27,2,205
"78705",1078705,58,148,5,211
"78706",1078706,133,48,6,187
"78707",1078707,4,122,1,127
"78708",1078708,121,50,12,183
"78709",1078709,18,153,6,177
"78710",1078710,39,3,1,43
"78711",1078711,19,56,3,78
"78712",1078712,96,130,8,234
"78713",1078713,98,211,14,323
"78714",1078714,165,75,2,242
"78715",1078715,218,22,8,248
"78716",1078716,219,28,7,254
"78717",1078717,183,76,6,265
"78718",1078718,137,23,2,162
"78719",1078719,69,187,4,260
"78720",1078720,60,96,2,158
"78721",1078721,78,138,7,223
"78722",1078722,156,66,22,244
"78723",1078723,159,100,4,263
"78724",1078724,153,138,19,310
"78725",1078725,4,6,1,11
"78726",1078726,9,5,0,14
"78727",1078727,78,169,3,250
"78728",1078728,1,6,0,7
"78729",1078729,195,40,9,244
"78730",1078730,118,90,13,221
"78731",1078731,262,1,4,267
"78732",1078732,190,21,4,215
"78733",1078733,236,27,10,273
"78734",1078734,122,31,0,153
"78735",1078735,76,87,7,170
"78736",1078736,147,33,0,180
"78737",1078737,147,68,3,218
"78738",1078738,169,69,3,241
"78739",1078739,25,54,1,80
"78740",1078740,157,115,9,281
"78741",1078741,9,9,2,20
"78742",1078742,103,24,7,134
"78743",1078743,190,79,5,274
"78744",1078744,101,53,13,167
"78745",1078745,196,78,15,289
"78746",1078746,36,38,0,74
"78747",1078747,96,77,5,178
"78748",1078748,133,152,10,295
"78749",1078749,176,121,10,307
"78750",1078750,84,127,8,219
"78751",1078751,57,266,2,325
"78752",1078752,11,41,1,53
"78753",1078753,136,201,11,348
"78754",1078754,170,66,9,245
"78755",1078755,73,95,4,172
"78756",1078756,57,157,22,236
"78757",1078757,13,236,5,254
"78758",1078758,172,69,6,247
"78759",1078759,152,39,2,193
"78760",1078760,149,88,1,238
"78761",1078761,137,167,6,310
"78762",1078762,148,36,8,192
"78763",1078763,18,12,1,31
"78764",1078764,33,212,10,255
"78765",1078765,84,208,9,301
"78766",1078766,58,226,16,300
"78767",1078767,20,196,11,227
"78768",1078768,189,9,4,202
"78769",1078769,48,264,5,317
"78770",1078770,112,92,11,215
"78771",1078771,155,78,18,251
"78772",1078772,120,62,2,184
"78773",1078773,158,59,9,226
"78774",1078774,39,177,4,220
"78775",1078775,34,233,13,280
"78776",1078776,209,126,12,347
"78777",1078777,223,74,7,304
"78778",1078778,141,167,21,329
"78779",1078779,79,210,7,296
"78780",1078780,146,75,2,223
"78781",1078781,212,23,9,244
"78782",1078782,176,92,10,278
"78783",1078783,10,3,4,17
"78784",1078784,18,153,3,174
"78785",1078785,117,173,16,306
"78786",1078786,100,12,3,115
"78787",1078787,214,80,24,318
"78788",1078788,233,25,5,263
"78789",1078789,116,75,1,192
"78790",1078790,66,269,2,337
"78791",1078791,145,72,10,227
"78792",1078792,111,52,10,173
"78793",1078793,123,66,7,196
"78794",1078794,106,121,14,241
"78795",1078795,71,168,8,247
"78796",1078796,36,111,5,152
"78797",1078797,136,162,9,307
"78798",1078798,39,146,5,190
"78799",1078799,114,122,4,240
"78800",1078800,142,33,4,179
"78801",1078801,190,147,11,348
"78802",1078802,1,68,0,69
"78803",1078803,132,77,1,210
"78804",1078804,31,261,6,298
"78805",1078805,28,234,5,267
"78806",1078806,48,247,5,300
"78807",1078807,94,188,15,297
"78808",1078808,227,44,2,273
"78809",1078809,75,21,2,98
"78810",1078810,115,15,0,130
"78811",1078811,152,90,4,246
"78812",1078812,35,4,4,43
"78813",1078813,125,120,8,253
"78814",1078814,125,87,14,226
"78815",1078815,83,84,5,172
"78816",1078816,35,238,4,277
"78817",1078817,144,21,2,167
"78818",1078818,91,96,11,198
"78819",1078819,223,31,5,259
"78820",1078820,162,94,12,268
"78821",1078821,55,177,2,234
"78822",1078822,23,16,2,41
"78823",1078823,104,13,3,120
"78824",1078824,103,190,19,312
"78825",1078825,255,17,15,287
"78826",1078826,98,52,7,157
"78827",1078827,172,13,6,191
"78828",1078828,153,62,4,219
"78829",1078829,146,122,4,272
"78830",1078830,54,6,2,62
"78831",1078831,161,75,6,242
"78832",1078832,171,34,8,213
"78833",1078833,89,94,8,191
"78834",1078834,41,2,0,43
"78835",1078835,179,64,4,247
"78836",1078836,99,163,6,268
"78837",1078837,41,265,7,313
"78838",1078838,70,130,6,206
"78839",1078839,71,155,10,236
"78840",1078840,138,27,6,171
"78841",1078841,30,14,2,46
"78842",1078842,59,151,6,216
"78843",1078843,93,205,8,306
"78844",1078844,169,178,8,355
"78845",1078845,13,197,1,211
"78846",1078846,147,62,17,226
"78847",1078847,60,92,7,159
"78848",1078848,174,44,17,235
"78849",1078849,141,128,3,272
"78850",1078850,139,70,5,214
"78851",1078851,133,109,5,247
"78852",1078852,190,50,11,251
"78853",1078853,71,193,3,267
"78854",1078854,79,172,8,259
"78855",1078855,81,5,3,89
"78856",1078856,71,171,5,247
"78857",1078857,44,21,9,74
"78858",1078858,72,175,2,249
"78859",1078859,195,29,7,231
"78860",1078860,40,16,5,61
"78861",1078861,168,96,4,268
"78862",1078862,52,131,19,202
"78863",1078863,133,51,11,195
"78864",1078864,109,41,7,157
"78865",1078865,111,219,5,335
"78866",1078866,160,92,16,268
"78867",1078867,52,236,8,296
"78868",1078868,50,171,2,223
"78869",1078869,129,26,9,164
"78870",1078870,61,182,13,256
"78871",1078871,136,208,7,351
"78872",1078872,62,15,2,79
"78873",1078873,107,119,8,234
"78874",1078874,162,117,14,293
"78875",1078875,61,226,5,292
"78876",1078876,132,122,10,264
"78877",1078877,102,183,13,298
"78878",1078878,81,173,13,267
"78879",1078879,115,159,11,285
"78880",1078880,84,109,4,197
"78881",1078881,144,40,7,191
"78882",1078882,63,153,13,229
"78883",1078883,220,22,6,248
"78884",1078884,62,116,7,185
"78885",1078885,125,148,6,279
"78886",1078886,65,74,4,143
"78887",1078887,27,78,6,111
"78888",1078888,146,24,8,178
"78889",1078889,8,0,1,9
"78890",1078890,24,16,0,40
"78891",1078891,153,93,9,255
"78892",1078892,171,42,14,227
"78893",1078893,149,32,7,188
"78894",1078894,93,148,7,248
"78895",1078895,152,74,10,236
"78896",1078896,105,52,7,164
"78897",1078897,38,159,1,198
"78898",1078898,127,85,5,217
"78899",1078899,179,60,11,250
"78900",1078900,93,175,14,282
"78901",1078901,79,181,4,264
"78902",1078902,155,29,4,188
"78903",1078903,130,31,6,167
"78904",1078904,134,119,12,265
"78905",1078905,90,189,11,290
"78906",1078906,60,110,4,174
"78907",1078907,36,65,0,101
"78908",1078908,176,44,12,232
"78909",1078909,131,50,8,189
"78910",1078910,86,178,5,269
"78911",1078911,125,44,8,177
"78912",1078912,90,223,10,323
"78913",1078913,143,35,5,183
"78914",1078914,30,55,2,87
"78915",1078915,248,14,3,265
"78916",1078916,52,63,2,117
"78917",1078917,97,42,3,142
"78918",1078918,137,115,8,260
"78919",1078919,33,167,8,208
"78920",1078920,183,98,8,289
"78921",1078921,151,126,13,290
"78922",1078922,48,253,0,301
"78923",1078923,120,134,5,259
"78924",1078924,108,120,6,234
"78925",1078925,143,104,5,252
"78926",1078926,92,209,5,306
"78927",1078927,140,111,21,272
"78928",1078928,102,52,5,159
"78929",1078929,75,45,2,122
"78930",1078930,54,255,17,326
"78931",1078931,29,0,0,29
"78932",1078932,127,75,8,210
"78933",1078933,66,167,4,237
"78934",1078934,97,198,21,316
"78935",1078935,135,109,2,246
"78936",1078936,58,237,6,301
"78937",1078937,152,83,11,246
"78938",1078938,122,100,4,226
"78939",1078939,74,28,7,109
"78940",1078940,81,146,7,234
"78941",1078941,142,112,7,261
"78942",1078942,109,147,5,261
"78943",1078943,67,170,12,249
"78944",1078944,86,209,6,301
"78945",1078945,185,76,6,267
"78946",1078946,81,116,12,209
"78947",1078947,80,98,6,184
"78948",1078948,103,107,6,216
"78949",1078949,189,65,9,263
"78950",1078950,107,146,15,268
"78951",1078951,132,150,14,296
"78952",1078952,59,198,7,264
"78953",1078953,50,163,13,226
"78954",1078954,200,31,3,234
"78955",1078955,81,176,11,268
"78956",1078956,56,155,5,216
"78957",1078957,174,13,4,191
"78958",1078958,140,104,6,250
"78959",1078959,92,87,8,187
"78960",1078960,214,56,9,279
"78961",1078961,40,46,1,87
"78962",1078962,64,149,7,220
"78963",1078963,231,62,16,309
"78964",1078964,67,18,4,89
"78965",1078965,104,141,9,254
"78966",1078966,104,164,28,296
"78967",1078967,60,135,13,208
"78968",1078968,67,63,7,137
"78969",1078969,238,14,4,256
"78970",1078970,139,93,5,237
"78971",1078971,314,7,4,325
"78972",1078972,108,120,6,234
"78973",1078973,197,116,11,324
"78974",1078974,138,98,13,249
"78975",1078975,32,77,2,111
"78976",1078976,7,1,1,9
"78977",1078977,75,65,8,148
"78978",1078978,138,113,7,258
"78979",1078979,72,174,12,258
"78980",1078980,80,148,11,239
"78981",1078981,23,49,1,73
"78982",1078982,142,64,5,211
"78983",1078983,119,21,2,142
"78984",1078984,26,215,1,242
"78985",1078985,34,204,5,243
"78986",1078986,22,9,2,33
"78987",1078987,44,243,8,295
"78988",1078988,138,153,13,304
"78989",1078989,64,208,8,280
"78990",1078990,218,19,5,242
"78991",1078991,127,144,23,294
"78992",1078992,145,52,13,210
"78993",1078993,41,63,6,110
"78994",1078994,90,148,6,244
"78995",1078995,72,185,5,262
"78996",1078996,138,51,13,202
"78997",1078997,172,42,4,218
"78998",1078998,133,159,10,302
"78999",1078999,65,77,8,150
"79000",1079000,41,209,7,257
"79001",1079001,31,27,1,59
"79002",1079002,186,68,9,263
"79003",1079003,162,43,4,209
"79004",1079004,114,58,8,180
"79005",1079005,98,100,22,220
"79006",1079006,117,148,18,283
"79007",1079007,90,82,7,179
"79008",1079008,143,116,10,269
"79009",1079009,126,45,11,182
"79010",1079010,136,124,6,266
"79011",1079011,0,9,1,10
"79012",1079012,172,39,8,219
"79013",1079013,217,85,11,313
"79014",1079014,174,62,8,244
"79015",1079015,8,4,0,12
"79016",1079016,147,94,6,247
"79017",1079017,178,23,7,208
"79018",1079018,71,90,5,166
"79019",1079019,168,25,5,198
"79020",1079020,194,62,7,263
"79021",1079021,111,157,12,280
"79022",1079022,104,44,11,159
"79023",1079023,92,98,11,201
"79024",1079024,0,22,0,22
"79025",1079025,133,160,9,302
"79026",1079026,105,283,15,403
"79027",1079027,66,176,15,257
"79028",1079028,74,186,5,265
"79029",1079029,85,157,6,248
"79030",1079030,98,10,2,110
"79031",1079031,87,138,5,230
"79032",1079032,113,62,4,179
"79033",1079033,78,130,13,221
"79034",1079034,156,11,4,171
"79035",1079035,262,14,17,293
"79036",1079036,37,245,3,285
"79037",1079037,130,52,3,185
"79038",1079038,43,194,12,249
"79039",1079039,65,181,11,257
"79040",1079040,94,88,2,184
"79041",1079041,138,64,12,214
"79042",1079042,52,229,2,283
"79043",1079043,131,169,14,314
"79044",1079044,61,94,0,155
"79045",1079045,219,60,5,284
"79046",1079046,83,93,7,183
"79047",1079047,19,84,2,105
"79048",1079048,67,147,7,221
"79049",1079049,133,113,11,257
"79050",1079050,222,58,14,294
"79051",1079051,68,23,3,94
"79052",1079052,63,115,5,183
"79053",1079053,127,186,3,316
"79054",1079054,57,158,4,219
"79055",1079055,84,57,9,150
"79056",1079056,40,191,18,249
"79057",1079057,41,139,21,201
"79058",1079058,123,79,5,207
"79059",1079059,84,159,18,261
"79060",1079060,64,46,5,115
"79061",1079061,203,183,12,398
"79062",1079062,106,21,3,130
"79063",1079063,99,79,6,184
"79064",1079064,121,71,5,197
"79065",1079065,125,43,6,174
"79066",1079066,101,102,10,213
"79067",1079067,223,21,4,248
"79068",1079068,146,51,11,208
"79069",1079069,261,22,7,290
"79070",1079070,89,38,1,128
"79071",1079071,152,31,10,193
"79072",1079072,75,133,5,213
"79073",1079073,62,66,9,137
"79074",1079074,200,44,4,248
"79075",1079075,62,114,4,180
"79076",1079076,104,72,6,182
"79077",1079077,34,199,4,237
"79078",1079078,160,52,4,216
"79079",1079079,90,87,19,196
"79080",1079080,69,76,2,147
"79081",1079081,103,132,10,245
"79082",1079082,56,125,3,184
"79083",1079083,155,60,11,226
"79084",1079084,114,51,10,175
"79085",1079085,60,172,11,243
"79086",1079086,128,25,5,158
"79087",1079087,138,98,8,244
"79088",1079088,183,55,4,242
"79089",1079089,152,80,6,238
"79090",1079090,191,69,2,262
"79091",1079091,167,124,4,295
"79092",1079092,76,106,8,190
"79093",1079093,71,170,16,257
"79094",1079094,102,97,11,210
"79095",1079095,169,32,4,205
"79096",1079096,70,47,5,122
"79097",1079097,48,216,7,271
"79098",1079098,38,171,11,220
"79099",1079099,62,158,10,230
"79100",1079100,105,79,10,194
"79101",1079101,110,162,17,289
"79102",1079102,67,90,0,157
"79103",1079103,36,136,5,177
"79104",1079104,159,94,12,265
"79105",1079105,160,118,17,295
"79106",1079106,197,40,4,241
"79107",1079107,49,3,2,54
"79108",1079108,51,135,1,187
"79109",1079109,50,246,3,299
"79110",1079110,37,139,6,182
"79111",1079111,211,36,6,253
"79112",1079112,158,49,10,217
"79113",1079113,41,27,1,69
"79114",1079114,32,172,24,228
"79115",1079115,184,65,10,259
"79116",1079116,181,65,7,253
"79117",1079117,136,28,3,167
"79118",1079118,94,140,11,245
"79119",1079119,87,120,5,212
"79120",1079120,96,76,5,177
"79121",1079121,234,16,10,260
"79122",1079122,90,118,14,222
"79123",1079123,225,17,3,245
"79124",1079124,162,72,8,242
"79125",1079125,234,49,16,299
"79126",1079126,190,165,5,360
"79127",1079127,195,50,4,249
"79128",1079128,83,170,11,264
"79129",1079129,95,183,7,285
"79130",1079130,128,181,4,313
"79131",1079131,106,123,11,240
"79132",1079132,92,166,4,262
"79133",1079133,40,153,3,196
"79134",1079134,53,110,6,169
"79135",1079135,123,102,10,235
"79136",1079136,43,12,1,56
"79137",1079137,85,90,2,177
"79138",1079138,141,17,5,163
"79139",1079139,111,102,10,223
"79140",1079140,160,119,13,292
"79141",1079141,8,6,2,16
"79142",1079142,122,114,12,248
"79143",1079143,89,55,4,148
"79144",1079144,129,64,7,200
"79145",1079145,109,8,4,121
"79146",1079146,246,35,10,291
"79147",1079147,182,41,5,228
"79148",1079148,155,66,20,241
"79149",1079149,49,210,10,269
"79150",1079150,148,56,7,211
"79151",1079151,77,158,3,238
"79152",1079152,36,230,3,269
"79153",1079153,113,152,13,278
"79154",1079154,21,151,4,176
"79155",1079155,37,184,2,223
"79156",1079156,245,182,5,432
"79157",1079157,125,39,11,175
"79158",1079158,167,93,6,266
"79159",1079159,153,136,14,303
"79160",1079160,91,116,9,216
"79161",1079161,181,44,8,233
"79162",1079162,152,73,10,235
"79163",1079163,1,0,0,1
"79164",1079164,74,125,18,217
"79165",1079165,131,101,7,239
"79166",1079166,41,19,2,62
"79167",1079167,27,175,7,209
"79168",1079168,97,157,13,267
"79169",1079169,145,101,12,258
"79170",1079170,264,13,11,288
"79171",1079171,47,199,4,250
"79172",1079172,53,140,2,195
"79173",1079173,44,250,4,298
"79174",1079174,12,39,0,51
"79175",1079175,112,113,4,229
"79176",1079176,113,112,14,239
"79177",1079177,131,89,10,230
"79178",1079178,113,97,8,218
"79179",1079179,125,111,11,247
"79180",1079180,245,12,4,261
"79181",1079181,140,120,15,275
"79182",1079182,230,33,5,268
"79183",1079183,177,85,13,275
"79184",1079184,106,99,6,211
"79185",1079185,111,155,19,285
"79186",1079186,185,75,5,265
"79187",1079187,170,88,21,279
"79188",1079188,128,77,14,219
"79189",1079189,26,11,0,37
"79190",1079190,65,163,2,230
"79191",1079191,161,114,9,284
"79192",1079192,132,133,4,269
"79193",1079193,132,65,11,208
"79194",1079194,111,205,13,329
"79195",1079195,173,101,21,295
"79196",1079196,56,177,6,239
"79197",1079197,130,63,4,197
"79198",1079198,206,22,5,233
"79199",1079199,204,102,14,320
"79200",1079200,140,50,10,200
"79201",1079201,224,57,6,287
"79202",1079202,204,77,5,286
"79203",1079203,56,135,7,198
"79204",1079204,25,288,9,322
"79205",1079205,115,79,1,195
"79206",1079206,154,95,9,258
"79207",1079207,34,185,5,224
"79208",1079208,209,29,6,244
"79209",1079209,36,58,5,99
"79210",1079210,42,67,5,114
"79211",1079211,135,21,4,160
"79212",1079212,70,206,11,287
"79213",1079213,51,243,6,300
"79214",1079214,27,324,8,359
"79215",1079215,84,134,12,230
"79216",1079216,167,58,7,232
"79217",1079217,182,47,5,234
"79218",1079218,77,143,20,240
"79219",1079219,80,209,12,301
"79220",1079220,94,138,4,236
"79221",1079221,154,120,8,282
"79222",1079222,147,169,18,334
"79223",1079223,57,293,7,357
"79224",1079224,36,126,6,168
"79225",1079225,100,111,15,226
"79226",1079226,188,65,6,259
"79227",1079227,208,34,3,245
"79228",1079228,117,15,4,136
"79229",1079229,175,54,7,236
"79230",1079230,79,66,4,149
"79231",1079231,112,95,6,213
"79232",1079232,94,70,8,172
"79233",1079233,58,51,8,117
"79234",1079234,69,145,9,223
"79235",1079235,92,50,7,149
"79236",1079236,97,62,5,164
"79237",1079237,85,190,5,280
"79238",1079238,139,33,11,183
"79239",1079239,126,21,5,152
"79240",1079240,89,65,2,156
"79241",1079241,250,15,10,275
"79242",1079242,72,166,11,249
"79243",1079243,20,104,3,127
"79244",1079244,14,10,1,25
"79245",1079245,134,36,8,178
"79246",1079246,226,108,14,348
"79247",1079247,142,97,8,247
"79248",1079248,136,16,3,155
"79249",1079249,42,232,15,289
"79250",1079250,9,36,1,46
"79251",1079251,20,11,2,33
"79252",1079252,144,63,3,210
"79253",1079253,34,29,3,66
"79254",1079254,105,253,8,366
"79255",1079255,104,167,31,302
"79256",1079256,121,149,15,285
"79257",1079257,59,65,4,128
"79258",1079258,15,162,4,181
"79259",1079259,32,228,6,266
"79260",1079260,37,242,12,291
"79261",1079261,109,51,5,165
"79262",1079262,27,149,3,179
"79263",1079263,28,21,0,49
"79264",1079264,41,21,1,63
"79265",1079265,173,81,15,269
"79266",1079266,174,22,7,203
"79267",1079267,28,25,1,54
"79268",1079268,77,155,11,243
"79269",1079269,146,51,4,201
"79270",1079270,1,104,2,107
"79271",1079271,55,200,9,264
"79272",1079272,176,27,4,207
"79273",1079273,167,38,9,214
"79274",1079274,92,12,4,108
"79275",1079275,52,184,16,252
"79276",1079276,16,32,1,49
"79277",1079277,182,40,12,234
"79278",1079278,60,61,2,123
"79279",1079279,95,123,26,244
"79280",1079280,121,134,4,259
"79281",1079281,81,205,9,295
"79282",1079282,10,77,1,88
"79283",1079283,212,62,9,283
"79284",1079284,22,21,1,44
"79285",1079285,112,65,9,186
"79286",1079286,63,29,2,94
"79287",1079287,173,67,10,250
"79288",1079288,128,103,12,243
"79289",1079289,18,73,4,95
"79290",1079290,105,78,15,198
"79291",1079291,154,13,8,175
"79292",1079292,111,132,3,246
"79293",1079293,94,146,7,247
"79294",1079294,152,83,1,236
"79295",1079295,47,153,2,202
"79296",1079296,180,83,16,279
"79297",1079297,149,65,8,222
"79298",1079298,140,69,5,214
"79299",1079299,56,142,16,214
"79300",1079300,76,114,4,194
"79301",1079301,73,75,1,149
"79302",1079302,141,140,11,292
"79303",1079303,53,232,5,290
"79304",1079304,36,0,0,36
"79305",1079305,25,86,1,112
"79306",1079306,106,33,7,146
"79307",1079307,178,42,5,225
"79308",1079308,52,117,1,170
"79309",1079309,68,47,1,116
"79310",1079310,95,137,10,242
"79311",1079311,188,134,12,334
"79312",1079312,10,7,1,18
"79313",1079313,89,180,3,272
"79314",1079314,39,91,4,134
"79315",1079315,177,121,12,310
"79316",1079316,172,99,14,285
"79317",1079317,167,20,4,191
"79318",1079318,152,75,13,240
"79319",1079319,79,203,6,288
"79320",1079320,153,153,8,314
"79321",1079321,59,152,1,212
"79322",1079322,133,62,10,205
"79323",1079323,120,76,13,209
"79324",1079324,55,251,10,316
"79325",1079325,105,98,15,218
"79326",1079326,259,48,17,324
"79327",1079327,91,204,2,297
"79328",1079328,118,119,26,263
"79329",1079329,138,122,6,266
"79330",1079330,17,176,8,201
"79331",1079331,28,100,9,137
"79332",1079332,96,130,17,243
"79333",1079333,87,153,5,245
"79334",1079334,145,17,6,168
"79335",1079335,40,225,4,269
"79336",1079336,14,232,5,251
"79337",1079337,111,63,21,195
"79338",1079338,34,128,15,177
"79339",1079339,71,69,7,147
"79340",1079340,141,7,3,151
"79341",1079341,94,32,4,130
"79342",1079342,132,67,5,204
"79343",1079343,159,131,10,300
"79344",1079344,58,117,9,184
"79345",1079345,134,123,4,261
"79346",1079346,104,53,4,161
"79347",1079347,37,216,4,257
"79348",1079348,45,298,12,355
"79349",1079349,49,18,0,67
"79350",1079350,144,138,21,303
"79351",1079351,127,52,3,182
"79352",1079352,107,166,11,284
"79353",1079353,156,51,9,216
"79354",1079354,117,71,4,192
"79355",1079355,219,103,14,336
"79356",1079356,29,259,10,298
"79357",1079357,137,17,1,155
"79358",1079358,131,97,12,240
"79359",1079359,141,96,4,241
"79360",1079360,240,61,17,318
"79361",1079361,23,160,8,191
"79362",1079362,124,77,18,219
"79363",1079363,146,66,8,220
"79364",1079364,70,34,4,108
"79365",1079365,157,159,16,332
"79366",1079366,218,45,13,276
"79367",1079367,256,81,14,351
"79368",1079368,94,150,3,247
"79369",1079369,219,14,2,235
"79370",1079370,40,147,4,191
"79371",1079371,205,26,6,237
"79372",1079372,143,67,13,223
"79373",1079373,137,108,8,253
"79374",1079374,120,94,7,221
"79375",1079375,245,56,19,320
"79376",1079376,203,51,6,260
"79377",1079377,130,90,12,232
"79378",1079378,167,51,2,220
"79379",1079379,59,258,15,332
"79380",1079380,58,181,10,249
"79381",1079381,171,94,12,277
"79382",1079382,25,58,2,85
"79383",1079383,142,61,1,204
"79384",1079384,114,148,11,273
"79385",1079385,158,117,9,284
"79386",1079386,40,242,14,296
"79387",1079387,39,223,2,264
"79388",1079388,20,34,3,57
"79389",1079389,28,100,0,128
"79390",1079390,63,251,8,322
"79391",1079391,129,24,4,157
"79392",1079392,57,230,13,300
"79393",1079393,81,202,9,292
"79394",1079394,50,158,5,213
"79395",1079395,43,176,5,224
"79396",1079396,185,112,15,312
"79397",1079397,52,157,8,217
"79398",1079398,114,203,13,330
"79399",1079399,131,17,4,152
"79400",1079400,24,174,11,209
"79401",1079401,27,239,5,271
"79402",1079402,158,0,1,159
"79403",1079403,80,24,3,107
"79404",1079404,54,73,4,131
"79405",1079405,86,167,11,264
"79406",1079406,117,148,12,277
"79407",1079407,143,56,10,209
"79408",1079408,41,212,3,256
"79409",1079409,191,41,6,238
"79410",1079410,152,41,5,198
"79411",1079411,146,105,1,252
"79412",1079412,96,173,22,291
"79413",1079413,188,29,10,227
"79414",1079414,105,173,22,300
"79415",1079415,52,0,2,54
"79416",1079416,166,107,13,286
"79417",1079417,8,1,0,9
"79418",1079418,78,153,5,236
"79419",1079419,67,149,8,224
"79420",1079420,197,48,13,258
"79421",1079421,166,98,12,276
"79422",1079422,167,26,9,202
"79423",1079423,63,109,11,183
"79424",1079424,160,55,5,220
"79425",1079425,25,202,0,227
"79426",1079426,112,28,5,145
"79427",1079427,147,147,8,302
"79428",1079428,104,155,11,270
"79429",1079429,67,87,3,157
"79430",1079430,117,40,1,158
"79431",1079431,154,64,2,220
"79432",1079432,141,78,6,225
"79433",1079433,105,85,9,199
"79434",1079434,154,91,2,247
"79435",1079435,128,137,11,276
"79436",1079436,155,81,17,253
"79437",1079437,144,166,7,317
"79438",1079438,118,112,9,239
"79439",1079439,146,88,8,242
"79440",1079440,175,39,7,221
"79441",1079441,29,55,0,84
"79442",1079442,8,2,0,10
"79443",1079443,55,170,4,229
"79444",1079444,74,203,8,285
"79445",1079445,163,130,5,298
"79446",1079446,140,41,8,189
"79447",1079447,137,87,4,228
"79448",1079448,97,126,3,226
"79449",1079449,217,83,9,309
"79450",1079450,107,42,4,153
"79451",1079451,116,131,4,251
"79452",1079452,208,52,6,266
"79453",1079453,34,266,8,308
"79454",1079454,190,142,9,341
"79455",1079455,23,218,7,248
"79456",1079456,90,148,2,240
"79457",1079457,138,19,4,161
"79458",1079458,77,139,6,222
"79459",1079459,189,14,10,213
"79460",1079460,106,60,5,171
"79461",1079461,120,23,5,148
"79462",1079462,180,27,12,219
"79463",1079463,161,103,19,283
"79464",1079464,38,17,1,56
"79465",1079465,94,73,5,172
"79466",1079466,39,44,0,83
"79467",1079467,13,31,1,45
"79468",1079468,194,71,7,272
"79469",1079469,10,29,2,41
"79470",1079470,149,54,4,207
"79471",1079471,144,8,5,157
"79472",1079472,64,190,7,261
"79473",1079473,61,171,14,246
"79474",1079474,56,170,8,234
"79475",1079475,33,252,1,286
"79476",1079476,159,98,18,275
"79477",1079477,75,55,10,140
"79478",1079478,149,65,3,217
"79479",1079479,91,154,11,256
"79480",1079480,151,57,3,211
"79481",1079481,113,35,1,149
"79482",1079482,65,247,10,322
"79483",1079483,137,90,10,237
"79484",1079484,234,31,9,274
"79485",1079485,29,22,5,56
"79486",1079486,20,190,1,211
"79487",1079487,122,88,14,224
"79488",1079488,150,61,4,215
"79489",1079489,7,4,0,11
"79490",1079490,19,103,6,128
"79491",1079491,15,120,10,145
"79492",1079492,253,43,7,303
"79493",1079493,5,5,3,13
"79494",1079494,61,213,14,288
"79495",1079495,46,42,2,90
"79496",1079496,90,225,9,324
"79497",1079497,59,156,3,218
"79498",1079498,131,182,26,339
"79499",1079499,191,44,14,249
"79500",1079500,210,38,5,253
"79501",1079501,53,226,8,287
"79502",1079502,51,135,15,201
"79503",1079503,6,185,6,197
"79504",1079504,79,121,22,222
"79505",1079505,132,5,6,143
"79506",1079506,126,98,7,231
"79507",1079507,125,32,3,160
"79508",1079508,200,97,14,311
"79509",1079509,2,63,0,65
"79510",1079510,23,242,8,273
"79511",1079511,36,175,6,217
"79512",1079512,93,88,9,190
"79513",1079513,127,123,12,262
"79514",1079514,40,247,1,288
"79515",1079515,170,127,16,313
"79516",1079516,177,46,8,231
"79517",1079517,46,131,8,185
"79518",1079518,84,170,19,273
"79519",1079519,124,78,13,215
"79520",1079520,165,49,6,220
"79521",1079521,265,18,5,288
"79522",1079522,171,42,7,220
"79523",1079523,100,13,17,130
"79524",1079524,75,138,2,215
"79525",1079525,185,69,11,265
"79526",1079526,228,43,7,278
"79527",1079527,126,106,3,235
"79528",1079528,129,23,8,160
"79529",1079529,174,29,6,209
"79530",1079530,160,139,14,313
"79531",1079531,8,33,1,42
"79532",1079532,138,93,6,237
"79533",1079533,59,112,3,174
"79534",1079534,113,182,21,316
"79535",1079535,220,15,6,241
"79536",1079536,61,154,13,228
"79537",1079537,27,77,2,106
"79538",1079538,39,179,4,222
"79539",1079539,186,163,8,357
"79540",1079540,138,92,15,245
"79541",1079541,97,43,8,148
"79542",1079542,131,109,6,246
"79543",1079543,85,204,11,300
"79544",1079544,110,35,5,150
"79545",1079545,97,59,7,163
"79546",1079546,49,93,6,148
"79547",1079547,0,2,0,2
"79548",1079548,132,103,13,248
"79549",1079549,164,104,16,284
"79550",1079550,97,201,22,320
"79551",1079551,14,3,2,19
"79552",1079552,126,52,3,181
"79553",1079553,174,85,15,274
"79554",1079554,102,115,9,226
"79555",1079555,147,49,3,199
"79556",1079556,34,162,12,208
"79557",1079557,107,81,13,201
"79558",1079558,207,86,11,304
"79559",1079559,108,112,6,226
"79560",1079560,53,235,13,301
"79561",1079561,173,28,6,207
"79562",1079562,90,82,20,192
"79563",1079563,67,103,11,181
"79564",1079564,164,125,6,295
"79565",1079565,115,79,12,206
"79566",1079566,150,75,4,229
"79567",1079567,388,57,10,455
"79568",1079568,64,210,3,277
"79569",1079569,162,69,12,243
"79570",1079570,190,45,5,240
"79571",1079571,184,28,9,221
"79572",1079572,101,62,6,169
"79573",1079573,69,46,4,119
"79574",1079574,391,65,24,480
"79575",1079575,16,251,2,269
"79576",1079576,128,78,11,217
"79577",1079577,119,184,4,307
"79578",1079578,68,199,6,273
"79579",1079579,59,122,5,186
"79580",1079580,62,126,11,199
"79581",1079581,99,99,9,207
"79582",1079582,77,206,7,290
"79583",1079583,231,79,19,329
"79584",1079584,168,117,12,297
"79585",1079585,24,93,13,130
"79586",1079586,126,80,12,218
"79587",1079587,80,192,13,285
"79588",1079588,133,134,7,274
"79589",1079589,87,168,8,263
"79590",1079590,92,69,4,165
"79591",1079591,134,37,5,176
"79592",1079592,153,105,12,270
"79593",1079593,30,112,8,150
"79594",1079594,171,132,12,315
"79595",1079595,107,140,6,253
"79596",1079596,96,103,6,205
"79597",1079597,155,105,5,265
"79598",1079598,114,77,5,196
"79599",1079599,156,128,9,293
"79600",1079600,56,223,18,297
"79601",1079601,172,21,6,199
"79602",1079602,214,53,13,280
"79603",1079603,52,25,4,81
"79604",1079604,26,35,8,69
"79605",1079605,241,59,13,313
"79606",1079606,39,163,14,216
"79607",1079607,48,176,11,235
"79608",1079608,121,79,1,201
"79609",1079609,119,61,8,188
"79610",1079610,207,3,3,213
"79611",1079611,51,89,6,146
"79612",1079612,140,76,23,239
"79613",1079613,242,22,7,271
"79614",1079614,197,45,6,248
"79615",1079615,133,112,12,257
"79616",1079616,146,35,21,202
"79617",1079617,83,175,16,274
"79618",1079618,131,49,8,188
"79619",1079619,0,20,0,20
"79620",1079620,105,64,3,172
"79621",1079621,13,6,1,20
"79622",1079622,254,76,15,345
"79623",1079623,11,93,3,107
"79624",1079624,124,33,5,162
"79625",1079625,199,97,17,313
"79626",1079626,175,32,4,211
"79627",1079627,58,151,7,216
"79628",1079628,74,147,3,224
"79629",1079629,42,236,1,279
"79630",1079630,17,161,1,179
"79631",1079631,53,179,3,235
"79632",1079632,43,102,4,149
"79633",1079633,65,142,9,216
"79634",1079634,100,238,5,343
"79635",1079635,211,125,9,345
"79636",1079636,43,104,6,153
"79637",1079637,91,138,1,230
"79638",1079638,103,110,9,222
"79639",1079639,57,132,10,199
"79640",1079640,235,36,13,284
"79641",1079641,117,169,16,302
"79642",1079642,61,271,2,334
"79643",1079643,62,55,5,122
"79644",1079644,22,309,6,337
"79645",1079645,152,8,5,165
"79646",1079646,155,86,9,250
"79647",1079647,174,104,11,289
"79648",1079648,148,138,7,293
"79649",1079649,227,46,8,281
"79650",1079650,7,5,1,13
"79651",1079651,255,36,12,303
"79652",1079652,85,113,4,202
"79653",1079653,156,104,25,285
"79654",1079654,51,42,3,96
"79655",1079655,156,104,10,270
"79656",1079656,210,33,6,249
"79657",1079657,100,163,9,272
"79658",1079658,70,4,2,76
"79659",1079659,236,20,6,262
"79660",1079660,149,67,6,222
"79661",1079661,148,70,13,231
"79662",1079662,92,178,10,280
"79663",1079663,174,23,10,207
"79664",1079664,132,178,19,329
"79665",1079665,218,102,18,338
"79666",1079666,90,32,5,127
"79667",1079667,106,71,25,202
"79668",1079668,219,22,8,249
"79669",1079669,211,48,7,266
"79670",1079670,221,31,6,258
"79671",1079671,53,154,7,214
"79672",1079672,115,22,1,138
"79673",1079673,102,149,5,256
"79674",1079674,96,7,0,103
"79675",1079675,47,39,2,88
"79676",1079676,188,84,18,290
"79677",1079677,169,10,1,180
"79678",1079678,42,105,3,150
"79679",1079679,47,232,7,286
"79680",1079680,116,40,1,157
"79681",1079681,103,45,6,154
"79682",1079682,117,196,8,321
"79683",1079683,35,212,3,250
"79684",1079684,80,17,1,98
"79685",1079685,192,38,4,234
"79686",1079686,113,199,15,327
"79687",1079687,85,172,14,271
"79688",1079688,169,88,10,267
"79689",1079689,43,254,6,303
"79690",1079690,214,12,11,237
"79691",1079691,41,92,7,140
"79692",1079692,42,1,0,43
"79693",1079693,164,81,2,247
"79694",1079694,192,64,16,272
"79695",1079695,89,225,8,322
"79696",1079696,160,134,11,305
"79697",1079697,69,209,8,286
"79698",1079698,175,42,10,227
"79699",1079699,90,104,2,196
"79700",1079700,126,126,2,254
"79701",1079701,84,159,6,249
"79702",1079702,128,134,6,268
"79703",1079703,93,196,13,302
"79704",1079704,32,172,1,205
"79705",1079705,189,29,5,223
"79706",1079706,22,138,1,161
"79707",1079707,66,111,15,192
"79708",1079708,40,149,12,201
"79709",1079709,21,166,8,195
"79710",1079710,137,89,5,231
"79711",1079711,81,144,13,238
"79712",1079712,161,60,14,235
"79713",1079713,62,180,7,249
"79714",1079714,109,38,9,156
"79715",1079715,38,212,5,255
"79716",1079716,44,215,7,266
"79717",1079717,109,133,4,246
"79718",1079718,140,87,8,235
"79719",1079719,79,24,8,111
"79720",1079720,343,80,19,442
"79721",1079721,152,71,10,233
"79722",1079722,67,163,3,233
"79723",1079723,54,178,12,244
"79724",1079724,124,149,10,283
"79725",1079725,61,46,8,115
"79726",1079726,144,75,4,223
"79727",1079727,89,134,6,229
"79728",1079728,130,28,1,159
"79729",1079729,245,44,11,300
"79730",1079730,73,213,2,288
"79731",1079731,112,19,4,135
"79732",1079732,21,9,0,30
"79733",1079733,131,58,14,203
"79734",1079734,61,194,5,260
"79735",1079735,89,109,5,203
"79736",1079736,121,152,20,293
"79737",1079737,42,95,2,139
"79738",1079738,153,164,22,339
"79739",1079739,45,154,17,216
"79740",1079740,74,32,5,111
"79741",1079741,190,48,4,242
"79742",1079742,167,13,6,186
"79743",1079743,131,34,5,170
"79744",1079744,173,34,3,210
"79745",1079745,64,216,4,284
"79746",1079746,94,75,19,188
"79747",1079747,149,29,6,184
"79748",1079748,32,101,3,136
"79749",1079749,71,221,10,302
"79750",1079750,263,1,1,265
"79751",1079751,65,13,5,83
"79752",1079752,105,198,7,310
"79753",1079753,140,138,13,291
"79754",1079754,55,140,16,211
"79755",1079755,178,107,5,290
"79756",1079756,125,129,9,263
"79757",1079757,55,143,4,202
"79758",1079758,157,80,11,248
"79759",1079759,129,61,12,202
"79760",1079760,87,187,5,279
"79761",1079761,65,190,7,262
"79762",1079762,207,91,6,304
"79763",1079763,195,23,7,225
"79764",1079764,7,3,1,11
"79765",1079765,52,105,1,158
"79766",1079766,232,45,8,285
"79767",1079767,82,66,3,151
"79768",1079768,18,184,2,204
"79769",1079769,39,154,9,202
"79770",1079770,108,167,7,282
"79771",1079771,60,175,1,236
"79772",1079772,87,13,6,106
"79773",1079773,144,172,7,323
"79774",1079774,112,137,17,266
"79775",1079775,131,76,5,212
"79776",1079776,2,4,0,6
"79777",1079777,238,67,13,318
"79778",1079778,128,146,4,278
"79779",1079779,73,246,5,324
"79780",1079780,167,37,9,213
"79781",1079781,43,150,4,197
"79782",1079782,48,9,4,61
"79783",1079783,197,30,5,232
"79784",1079784,79,178,7,264
"79785",1079785,23,169,3,195
"79786",1079786,63,86,1,150
"79787",1079787,28,61,4,93
"79788",1079788,114,100,4,218
"79789",1079789,134,40,23,197
"79790",1079790,138,85,2,225
"79791",1079791,214,29,8,251
"79792",1079792,93,199,3,295
"79793",1079793,93,103,4,200
"79794",1079794,155,185,10,350
"79795",1079795,126,87,7,220
"79796",1079796,134,151,4,289
"79797",1079797,90,223,10,323
"79798",1079798,64,66,5,135
"79799",1079799,28,134,9,171
"79800",1079800,28,156,4,188
"79801",1079801,37,43,0,80
"79802",1079802,26,10,1,37
"79803",1079803,114,90,2,206
"79804",1079804,120,116,9,245
"79805",1079805,21,36,2,59
"79806",1079806,69,214,5,288
"79807",1079807,153,30,6,189
"79808",1079808,19,110,4,133
"79809",1079809,25,38,4,67
"79810",1079810,127,144,8,279
"79811",1079811,143,40,3,186
"79812",1079812,178,29,7,214
"79813",1079813,37,141,6,184
"79814",1079814,89,37,2,128
"79815",1079815,60,233,14,307
"79816",1079816,165,25,11,201
"79817",1079817,111,86,9,206
"79818",1079818,75,135,12,222
"79819",1079819,56,217,5,278
"79820",1079820,265,37,16,318
"79821",1079821,165,20,4,189
"79822",1079822,176,63,17,256
"79823",1079823,64,155,4,223
"79824",1079824,188,49,6,243
"79825",1079825,99,159,11,269
"79826",1079826,208,56,9,273
"79827",1079827,117,162,4,283
"79828",1079828,62,103,5,170
"79829",1079829,9,8,0,17
"79830",1079830,171,81,8,260
"79831",1079831,55,75,4,134
"79832",1079832,81,50,8,139
"79833",1079833,111,52,4,167
"79834",1079834,199,74,19,292
"79835",1079835,74,137,13,224
"79836",1079836,18,69,1,88
"79837",1079837,182,74,4,260
"79838",1079838,81,66,12,159
"79839",1079839,198,87,12,297
"79840",1079840,215,27,3,245
"79841",1079841,96,173,8,277
"79842",1079842,54,98,8,160
"79843",1079843,86,27,4,117
"79844",1079844,122,147,8,277
"79845",1079845,49,101,6,156
"79846",1079846,206,72,2,280
"79847",1079847,204,91,8,303
"79848",1079848,226,17,11,254
"79849",1079849,114,182,8,304
"79850",1079850,117,90,1,208
"79851",1079851,127,176,15,318
"79852",1079852,32,187,2,221
"79853",1079853,175,111,4,290
"79854",1079854,109,49,6,164
"79855",1079855,141,126,5,272
"79856",1079856,67,99,4,170
"79857",1079857,191,60,5,256
"79858",1079858,74,147,12,233
"79859",1079859,129,87,11,227
"79860",1079860,137,59,12,208
"79861",1079861,153,93,7,253
"79862",1079862,117,208,13,338
"79863",1079863,5,59,5,69
"79864",1079864,144,113,8,265
"79865",1079865,158,89,11,258
"79866",1079866,109,271,6,386
"79867",1079867,76,172,8,256
"79868",1079868,52,272,5,329
"79869",1079869,53,207,2,262
"79870",1079870,69,177,2,248
"79871",1079871,47,46,3,96
"79872",1079872,189,75,5,269
"79873",1079873,41,62,11,114
"79874",1079874,103,228,3,334
"79875",1079875,33,121,5,159
"79876",1079876,132,33,3,168
"79877",1079877,52,24,6,82
"79878",1079878,86,93,15,194
"79879",1079879,157,82,3,242
"79880",1079880,108,149,10,267
"79881",1079881,115,120,9,244
"79882",1079882,57,30,5,92
"79883",1079883,112,176,7,295
"79884",1079884,159,65,8,232
"79885",1079885,113,7,0,120
"79886",1079886,87,104,14,205
"79887",1079887,92,121,10,223
"79888",1079888,205,6,4,215
"79889",1079889,262,116,7,385
"79890",1079890,138,61,11,210
"79891",1079891,120,86,6,212
"79892",1079892,43,135,1,179
"79893",1079893,58,183,4,245
"79894",1079894,63,111,6,180
"79895",1079895,115,150,21,286
"79896",1079896,103,188,12,303
"79897",1079897,77,99,1,177
"79898",1079898,143,104,3,250
"79899",1079899,68,147,5,220
"79900",1079900,207,105,9,321
"79901",1079901,168,63,8,239
"79902",1079902,45,227,4,276
"79903",1079903,211,56,6,273
"79904",1079904,243,28,11,282
"79905",1079905,114,127,11,252
"79906",1079906,10,29,2,41
"79907",1079907,105,77,4,186
"79908",1079908,180,47,4,231
"79909",1079909,89,96,10,195
"79910",1079910,34,255,1,290
"79911",1079911,55,137,5,197
"79912",1079912,53,148,11,212
"79913",1079913,164,16,6,186
"79914",1079914,77,199,8,284
"79915",1079915,153,59,6,218
"79916",1079916,65,60,6,131
"79917",1079917,65,190,6,261
"79918",1079918,171,62,4,237
"79919",1079919,1,0,0,1
"79920",1079920,42,224,4,270
"79921",1079921,10,25,3,38
"79922",1079922,13,48,0,61
"79923",1079923,83,157,7,247
"79924",1079924,51,167,14,232
"79925",1079925,165,111,14,290
"79926",1079926,135,52,12,199
"79927",1079927,224,6,7,237
"79928",1079928,140,96,8,244
"79929",1079929,89,46,6,141
"79930",1079930,59,212,7,278
"79931",1079931,138,155,20,313
"79932",1079932,226,98,13,337
"79933",1079933,99,76,10,185
"79934",1079934,92,158,10,260
"79935",1079935,122,140,28,290
"79936",1079936,37,209,3,249
"79937",1079937,159,41,5,205
"79938",1079938,94,75,18,187
"79939",1079939,124,108,5,237
"79940",1079940,47,180,5,232
"79941",1079941,173,118,1,292
"79942",1079942,56,216,2,274
"79943",1079943,56,123,4,183
"79944",1079944,121,97,5,223
"79945",1079945,129,55,7,191
"79946",1079946,24,260,4,288
"79947",1079947,22,19,3,44
"79948",1079948,5,51,1,57
"79949",1079949,183,29,3,215
"79950",1079950,119,64,6,189
"79951",1079951,172,48,6,226
"79952",1079952,165,83,12,260
"79953",1079953,55,175,13,243
"79954",1079954,31,216,9,256
"79955",1079955,233,92,13,338
"79956",1079956,83,194,12,289
"79957",1079957,160,56,16,232
"79958",1079958,115,24,9,148
"79959",1079959,166,19,8,193
"79960",1079960,36,68,6,110
"79961",1079961,147,10,7,164
"79962",1079962,178,104,13,295
"79963",1079963,37,28,2,67
"79964",1079964,115,64,20,199
"79965",1079965,119,48,3,170
"79966",1079966,187,115,9,311
"79967",1079967,102,68,10,180
"79968",1079968,146,28,8,182
"79969",1079969,93,222,5,320
"79970",1079970,103,122,10,235
"79971",1079971,167,27,8,202
"79972",1079972,103,202,15,320
"79973",1079973,59,227,5,291
"79974",1079974,124,32,7,163
"79975",1079975,88,122,7,217
"79976",1079976,219,76,5,300
"79977",1079977,87,182,1,270
"79978",1079978,144,56,17,217
"79979",1079979,21,75,4,100
"79980",1079980,34,212,7,253
"79981",1079981,28,17,1,46
"79982",1079982,122,180,23,325
"79983",1079983,98,5,4,107
"79984",1079984,146,109,9,264
"79985",1079985,238,15,5,258
"79986",1079986,203,53,9,265
"79987",1079987,43,209,4,256
"79988",1079988,43,12,2,57
"79989",1079989,143,115,15,273
"79990",1079990,22,75,2,99
"79991",1079991,8,3,1,12
"79992",1079992,216,11,4,231
"79993",1079993,91,207,4,302
"79994",1079994,123,87,2,212
"79995",1079995,49,18,1,68
"79996",1079996,229,54,5,288
"79997",1079997,39,107,12,158
"79998",1079998,129,144,15,288
"79999",1079999,111,149,14,274
"80000",1080000,141,90,5,236
"80001",1080001,160,56,7,223
"80002",1080002,94,0,0,94
"80003",1080003,165,59,5,229
"80004",1080004,167,38,1,206
"80005",1080005,115,126,19,260
"80006",1080006,81,8,2,91
"80007",1080007,208,49,7,264
"80008",1080008,106,139,5,250
"80009",1080009,168,84,16,268
"80010",1080010,56,261,4,321
"80011",1080011,137,113,12,262
"80012",1080012,202,15,7,224
"80013",1080013,93,67,3,163
"80014",1080014,67,189,13,269
"80015",1080015,102,39,2,143
"80016",1080016,92,170,6,268
"80017",1080017,94,45,11,150
"80018",1080018,211,25,3,239
"80019",1080019,56,170,2,228
"80020",1080020,63,157,6,226
"80021",1080021,204,44,13,261
"80022",1080022,140,62,6,208
"80023",1080023,100,81,3,184
"80024",1080024,28,69,3,100
"80025",1080025,91,122,8,221
"80026",1080026,127,152,7,286
"80027",1080027,133,119,5,257
"80028",1080028,52,236,3,291
"80029",1080029,72,28,9,109
"80030",1080030,54,157,4,215
"80031",1080031,59,13,7,79
"80032",1080032,153,162,12,327
"80033",1080033,15,11,0,26
"80034",1080034,49,126,7,182
"80035",1080035,99,135,6,240
"80036",1080036,13,52,0,65
"80037",1080037,150,67,4,221
"80038",1080038,114,10,2,126
"80039",1080039,128,83,4,215
"80040",1080040,59,189,8,256
"80041",1080041,192,55,13,260
"80042",1080042,184,82,5,271
"80043",1080043,114,51,3,168
"80044",1080044,238,18,6,262
"80045",1080045,27,85,4,116
"80046",1080046,50,222,8,280
"80047",1080047,153,77,14,244
"80048",1080048,88,62,13,163
"80049",1080049,162,81,8,251
"80050",1080050,49,180,5,234
"80051",1080051,166,65,10,241
"80052",1080052,159,30,5,194
"80053",1080053,156,78,6,240
"80054",1080054,166,32,5,203
"80055",1080055,159,79,8,246
"80056",1080056,82,196,14,292
"80057",1080057,179,91,1,271
"80058",1080058,130,110,11,251
"80059",1080059,88,81,0,169
"80060",1080060,85,123,11,219
"80061",1080061,100,143,8,251
"80062",1080062,156,143,6,305
"80063",1080063,118,114,4,236
"80064",1080064,30,194,6,230
"80065",1080065,59,20,2,81
"80066",1080066,144,51,8,203
"80067",1080067,180,78,9,267
"80068",1080068,141,144,7,292
"80069",1080069,31,51,4,86
"80070",1080070,31,224,4,259
"80071",1080071,200,109,16,325
"80072",1080072,142,102,12,256
"80073",1080073,124,29,3,156
"80074",1080074,18,226,13,257
"80075",1080075,111,89,16,216
"80076",1080076,93,148,14,255
"80077",1080077,60,41,5,106
"80078",1080078,149,56,5,210
"80079",1080079,133,49,4,186
"80080",1080080,80,236,9,325
"80081",1080081,148,59,6,213
"80082",1080082,195,55,16,266
"80083",1080083,16,66,0,82
"80084",1080084,90,93,17,200
"80085",1080085,236,23,5,264
"80086",1080086,155,158,27,340
"80087",1080087,10,207,0,217
"80088",1080088,180,53,12,245
"80089",1080089,168,75,9,252
"80090",1080090,2,5,0,7
"80091",1080091,11,28,0,39
"80092",1080092,145,76,9,230
"80093",1080093,69,235,12,316
"80094",1080094,76,250,18,344
"80095",1080095,106,88,7,201
"80096",1080096,153,120,8,281
"80097",1080097,212,131,12,355
"80098",1080098,94,179,3,276
"80099",1080099,107,147,7,261
"80100",1080100,93,49,4,146
"80101",1080101,114,75,14,203
"80102",1080102,14,121,0,135
"80103",1080103,77,217,7,301
"80104",1080104,82,132,4,218
"80105",1080105,174,64,4,242
"80106",1080106,119,31,11,161
"80107",1080107,32,66,2,100
"80108",1080108,164,121,9,294
"80109",1080109,96,184,13,293
"80110",1080110,54,111,5,170
"80111",1080111,132,141,23,296
"80112",1080112,178,23,2,203
"80113",1080113,195,40,12,247
"80114",1080114,21,120,2,143
"80115",1080115,74,4,8,86
"80116",1080116,159,120,15,294
"80117",1080117,27,46,4,77
"80118",1080118,132,132,10,274
"80119",1080119,80,126,7,213
"80120",1080120,126,170,12,308
"80121",1080121,126,154,17,297
"80122",1080122,139,48,6,193
"80123",1080123,89,137,1,227
"80124",1080124,46,63,4,113
"80125",1080125,190,26,5,221
"80126",1080126,37,29,8,74
"80127",1080127,132,58,4,194
"80128",1080128,244,59,9,312
"80129",1080129,110,71,11,192
"80130",1080130,118,72,4,194
"80131",1080131,127,41,6,174
"80132",1080132,142,49,5,196
"80133",1080133,111,101,4,216
"80134",1080134,163,18,6,187
"80135",1080135,192,86,27,305
"80136",1080136,19,4,0,23
"80137",1080137,62,241,14,317
"80138",1080138,75,184,5,264
"80139",1080139,86,159,12,257
"80140",1080140,168,44,18,230
"80141",1080141,43,162,13,218
"80142",1080142,155,89,5,249
"80143",1080143,192,48,5,245
"80144",1080144,152,131,11,294
"80145",1080145,114,131,11,256
"80146",1080146,217,32,6,255
"80147",1080147,166,25,6,197
"80148",1080148,2,16,0,18
"80149",1080149,157,87,3,247
"80150",1080150,59,259,13,331
"80151",1080151,42,201,1,244
"80152",1080152,121,190,8,319
"80153",1080153,118,87,3,208
"80154",1080154,35,119,3,157
"80155",1080155,39,232,4,275
"80156",1080156,42,195,3,240
"80157",1080157,64,159,17,240
"80158",1080158,145,85,8,238
"80159",1080159,137,67,10,214
"80160",1080160,104,227,10,341
"80161",1080161,111,16,4,131
"80162",1080162,174,10,5,189
"80163",1080163,95,163,16,274
"80164",1080164,90,170,10,270
"80165",1080165,137,113,11,261
"80166",1080166,217,38,5,260
"80167",1080167,1,1,0,2
"80168",1080168,167,139,8,314
"80169",1080169,44,37,5,86
"80170",1080170,114,37,5,156
"80171",1080171,173,66,5,244
"80172",1080172,75,151,8,234
"80173",1080173,87,136,4,227
"80174",1080174,103,178,7,288
"80175",1080175,150,110,4,264
"80176",1080176,7,16,1,24
"80177",1080177,176,12,6,194
"80178",1080178,215,63,8,286
"80179",1080179,147,160,16,323
"80180",1080180,85,177,7,269
"80181",1080181,153,131,11,295
"80182",1080182,174,135,12,321
"80183",1080183,42,138,5,185
"80184",1080184,95,40,4,139
"80185",1080185,141,94,7,242
"80186",1080186,113,141,15,269
"80187",1080187,107,46,8,161
"80188",1080188,228,34,14,276
"80189",1080189,74,21,4,99
"80190",1080190,68,110,9,187
"80191",1080191,23,155,3,181
"80192",1080192,115,186,10,311
"80193",1080193,160,48,15,223
"80194",1080194,120,78,4,202
"80195",1080195,74,167,5,246
"80196",1080196,133,57,10,200
"80197",1080197,149,99,13,261
"80198",1080198,135,126,12,273
"80199",1080199,186,37,12,235
"80200",1080200,55,232,2,289
"80201",1080201,86,150,9,245
"80202",1080202,23,147,2,172
"80203",1080203,120,70,6,196
"80204",1080204,201,42,6,249
"80205",1080205,15,22,1,38
"80206",1080206,87,103,2,192
"80207",1080207,91,146,1,238
"80208",1080208,141,54,8,203
"80209",1080209,203,86,6,295
"80210",1080210,103,144,9,256
"80211",1080211,116,17,6,139
"80212",1080212,36,296,6,338
"80213",1080213,141,92,10,243
"80214",1080214,176,112,13,301
"80215",1080215,8,13,4,25
"80216",1080216,149,75,6,230
"80217",1080217,173,73,13,259
"80218",1080218,153,100,3,256
"80219",1080219,173,33,5,211
"80220",1080220,246,21,8,275
"80221",1080221,136,60,12,208
"80222",1080222,97,153,4,254
"80223",1080223,136,126,10,272
"80224",1080224,55,30,9,94
"80225",1080225,73,139,24,236
"80226",1080226,169,37,14,220
"80227",1080227,110,84,9,203
"80228",1080228,75,161,11,247
"80229",1080229,130,82,11,223
"80230",1080230,125,25,7,157
"80231",1080231,128,85,8,221
"80232",1080232,67,114,10,191
"80233",1080233,60,14,1,75
"80234",1080234,237,195,12,444
"80235",1080235,78,17,8,103
"80236",1080236,144,32,12,188
"80237",1080237,76,5,3,84
"80238",1080238,71,69,4,144
"80239",1080239,94,146,31,271
"80240",1080240,245,14,12,271
"80241",1080241,20,4,2,26
"80242",1080242,100,186,17,303
"80243",1080243,64,1,0,65
"80244",1080244,62,156,21,239
"80245",1080245,26,119,6,151
"80246",1080246,99,187,5,291
"80247",1080247,196,111,22,329
"80248",1080248,113,160,7,280
"80249",1080249,173,48,9,230
"80250",1080250,72,195,7,274
"80251",1080251,200,91,9,300
"80252",1080252,114,49,4,167
"80253",1080253,155,168,17,340
"80254",1080254,96,43,1,140
"80255",1080255,194,32,2,228
"80256",1080256,70,137,3,210
"80257",1080257,162,24,4,190
"80258",1080258,32,214,2,248
"80259",1080259,289,3,4,296
"80260",1080260,144,86,9,239
"80261",1080261,95,31,3,129
"80262",1080262,79,49,4,132
"80263",1080263,81,128,10,219
"80264",1080264,38,227,5,270
"80265",1080265,15,60,5,80
"80266",1080266,34,48,5,87
"80267",1080267,141,87,3,231
"80268",1080268,129,136,17,282
"80269",1080269,159,120,20,299
"80270",1080270,160,47,6,213
"80271",1080271,132,111,3,246
"80272",1080272,137,97,12,246
"80273",1080273,247,36,8,291
"80274",1080274,135,146,6,287
"80275",1080275,205,67,9,281
"80276",1080276,177,25,5,207
"80277",1080277,189,75,0,264
"80278",1080278,95,102,10,207
"80279",1080279,55,77,7,139
"80280",1080280,27,32,0,59
"80281",1080281,70,181,11,262
"80282",1080282,11,149,12,172
"80283",1080283,36,7,0,43
"80284",1080284,30,5,3,38
"80285",1080285,64,140,7,211
"80286",1080286,148,133,6,287
"80287",1080287,127,168,5,300
"80288",1080288,158,97,4,259
"80289",1080289,125,87,14,226
"80290",1080290,9,75,1,85
"80291",1080291,201,34,0,235
"80292",1080292,71,157,10,238
"80293",1080293,253,83,10,346
"80294",1080294,205,30,3,238
"80295",1080295,203,41,10,254
"80296",1080296,200,12,6,218
"80297",1080297,181,86,28,295
"80298",1080298,150,41,8,199
"80299",1080299,180,86,13,279
"80300",1080300,171,57,6,234
"80301",1080301,106,107,16,229
"80302",1080302,104,13,0,117
"80303",1080303,90,34,7,131
"80304",1080304,133,119,21,273
"80305",1080305,53,169,7,229
"80306",1080306,31,95,5,131
"80307",1080307,129,150,6,285
"80308",1080308,16,182,2,200
"80309",1080309,106,107,10,223
"80310",1080310,71,111,5,187
"80311",1080311,53,201,6,260
"80312",1080312,150,118,6,274
"80313",1080313,127,98,6,231
"80314",1080314,176,62,11,249
"80315",1080315,83,146,6,235
"80316",1080316,112,45,6,163
"80317",1080317,206,58,9,273
"80318",1080318,46,241,8,295
"80319",1080319,236,76,15,327
"80320",1080320,85,180,17,282
"80321",1080321,212,24,10,246
"80322",1080322,15,96,2,113
"80323",1080323,119,99,4,222
"80324",1080324,275,1,2,278
"80325",1080325,144,112,4,260
"80326",1080326,161,41,2,204
"80327",1080327,52,80,4,136
"80328",1080328,111,161,13,285
"80329",1080329,194,61,18,273
"80330",1080330,146,56,5,207
"80331",1080331,134,16,7,157
"80332",1080332,52,229,3,284
"80333",1080333,138,82,7,227
"80334",1080334,12,276,1,289
"80335",1080335,124,68,10,202
"80336",1080336,71,172,9,252
"80337",1080337,40,18,2,60
"80338",1080338,89,89,5,183
"80339",1080339,85,88,8,181
"80340",1080340,17,73,3,93
"80341",1080341,156,42,5,203
"80342",1080342,104,134,9,247
"80343",1080343,103,114,18,235
"80344",1080344,17,3,1,21
"80345",1080345,108,153,18,279
"80346",1080346,100,104,16,220
"80347",1080347,114,86,14,214
"80348",1080348,256,31,4,291
"80349",1080349,112,141,5,258
"80350",1080350,129,54,5,188
"80351",1080351,37,38,2,77
"80352",1080352,196,57,6,259
"80353",1080353,67,81,8,156
"80354",1080354,35,228,2,265
"80355",1080355,11,9,0,20
"80356",1080356,127,62,13,202
"80357",1080357,149,59,6,214
"80358",1080358,167,47,7,221
"80359",1080359,11,251,2,264
"80360",1080360,82,59,9,150
"80361",1080361,129,99,14,242
"80362",1080362,42,133,12,187
"80363",1080363,46,156,6,208
"80364",1080364,136,4,4,144
"80365",1080365,36,35,4,75
"80366",1080366,68,180,15,263
"80367",1080367,170,18,7,195
"80368",1080368,48,154,2,204
"80369",1080369,66,170,11,247
"80370",1080370,104,147,5,256
"80371",1080371,184,71,15,270
"80372",1080372,85,43,6,134
"80373",1080373,177,61,6,244
"80374",1080374,180,20,5,205
"80375",1080375,79,14,4,97
"80376",1080376,128,70,3,201
"80377",1080377,135,150,5,290
"80378",1080378,62,233,6,301
"80379",1080379,48,132,6,186
"80380",1080380,36,17,2,55
"80381",1080381,67,105,7,179
"80382",1080382,28,222,8,258
"80383",1080383,24,242,7,273
"80384",1080384,201,106,7,314
"80385",1080385,159,69,13,241
"80386",1080386,129,154,6,289
"80387",1080387,61,201,7,269
"80388",1080388,41,33,1,75
"80389",1080389,112,196,5,313
"80390",1080390,125,72,11,208
"80391",1080391,214,71,21,306
"80392",1080392,120,43,8,171
"80393",1080393,71,84,3,158
"80394",1080394,178,14,4,196
"80395",1080395,29,174,9,212
"80396",1080396,146,25,3,174
"80397",1080397,40,203,2,245
"80398",1080398,130,49,13,192
"80399",1080399,137,68,10,215
"80400",1080400,110,98,16,224
"80401",1080401,63,49,5,117
"80402",1080402,145,17,5,167
"80403",1080403,69,234,3,306
"80404",1080404,121,73,3,197
"80405",1080405,151,63,12,226
"80406",1080406,121,100,5,226
"80407",1080407,126,147,9,282
"80408",1080408,165,25,5,195
"80409",1080409,90,70,6,166
"80410",1080410,35,31,3,69
"80411",1080411,176,43,5,224
"80412",1080412,36,235,4,275
"80413",1080413,41,11,2,54
"80414",1080414,62,196,9,267
"80415",1080415,54,194,4,252
"80416",1080416,176,140,15,331
"80417",1080417,36,203,3,242
"80418",1080418,133,146,18,297
"80419",1080419,142,42,6,190
"80420",1080420,90,98,6,194
"80421",1080421,139,56,8,203
"80422",1080422,233,1,0,234
"80423",1080423,149,16,2,167
"80424",1080424,67,131,9,207
"80425",1080425,131,84,8,223
"80426",1080426,221,55,15,291
"80427",1080427,127,113,6,246
"80428",1080428,141,108,27,276
"80429",1080429,106,14,5,125
"80430",1080430,133,90,9,232
"80431",1080431,181,34,7,222
"80432",1080432,94,160,15,269
"80433",1080433,13,102,3,118
"80434",1080434,184,69,12,265
"80435",1080435,82,100,5,187
"80436",1080436,135,52,2,189
"80437",1080437,41,35,3,79
"80438",1080438,108,35,3,146
"80439",1080439,59,122,7,188
"80440",1080440,6,33,1,40
"80441",1080441,31,34,4,69
"80442",1080442,20,5,0,25
"80443",1080443,146,9,2,157
"80444",1080444,117,35,5,157
"80445",1080445,12,8,2,22
"80446",1080446,223,41,9,273
"80447",1080447,155,2,3,160
"80448",1080448,13,96,1,110
"80449",1080449,66,169,10,245
"80450",1080450,181,45,6,232
"80451",1080451,43,30,1,74
"80452",1080452,54,130,6,190
"80453",1080453,94,14,3,111
"80454",1080454,132,41,6,179
"80455",1080455,85,88,3,176
"80456",1080456,103,68,7,178
"80457",1080457,85,160,4,249
"80458",1080458,124,64,8,196
"80459",1080459,110,208,12,330
"80460",1080460,201,65,13,279
"80461",1080461,49,59,4,112
"80462",1080462,214,14,9,237
"80463",1080463,172,55,8,235
"80464",1080464,17,2,0,19
"80465",1080465,118,146,20,284
"80466",1080466,184,167,2,353
"80467",1080467,122,146,14,282
"80468",1080468,49,157,1,207
"80469",1080469,94,207,10,311
"80470",1080470,57,220,12,289
"80471",1080471,135,94,7,236
"80472",1080472,189,34,7,230
"80473",1080473,108,97,11,216
"80474",1080474,48,18,5,71
"80475",1080475,206,76,17,299
"80476",1080476,43,202,2,247
"80477",1080477,61,230,7,298
"80478",1080478,51,235,5,291
"80479",1080479,80,159,7,246
"80480",1080480,103,15,6,124
"80481",1080481,93,153,11,257
"80482",1080482,134,136,17,287
"80483",1080483,10,177,4,191
"80484",1080484,189,31,9,229
"80485",1080485,50,22,0,72
"80486",1080486,168,144,17,329
"80487",1080487,48,63,5,116
"80488",1080488,43,248,5,296
"80489",1080489,248,28,10,286
"80490",1080490,28,242,6,276
"80491",1080491,37,145,13,195
"80492",1080492,64,154,6,224
"80493",1080493,56,177,2,235
"80494",1080494,159,54,3,216
"80495",1080495,140,94,20,254
"80496",1080496,195,30,7,232
"80497",1080497,172,136,10,318
"80498",1080498,77,59,0,136
"80499",1080499,9,220,1,230
"80500",1080500,42,213,2,257
"80501",1080501,82,22,2,106
"80502",1080502,181,87,7,275
"80503",1080503,49,71,3,123
"80504",1080504,10,128,1,139
"80505",1080505,59,105,3,167
"80506",1080506,138,66,9,213
"80507",1080507,151,47,15,213
"80508",1080508,80,63,8,151
"80509",1080509,88,119,10,217
"80510",1080510,141,79,3,223
"80511",1080511,47,166,3,216
"80512",1080512,173,19,4,196
"80513",1080513,177,23,4,204
"80514",1080514,8,247,5,260
"80515",1080515,87,199,18,304
"80516",1080516,105,195,7,307
"80517",1080517,93,184,5,282
"80518",1080518,184,42,11,237
"80519",1080519,25,15,1,41
"80520",1080520,29,139,9,177
"80521",1080521,153,97,8,258
"80522",1080522,73,134,1,208
"80523",1080523,62,150,9,221
"80524",1080524,145,94,6,245
"80525",1080525,24,193,3,220
"80526",1080526,98,191,17,306
"80527",1080527,67,179,12,258
"80528",1080528,23,152,2,177
"80529",1080529,139,33,4,176
"80530",1080530,147,41,6,194
"80531",1080531,272,48,6,326
"80532",1080532,110,156,4,270
"80533",1080533,23,27,6,56
"80534",1080534,127,63,11,201
"80535",1080535,117,161,12,290
"80536",1080536,139,104,13,256
"80537",1080537,64,190,6,260
"80538",1080538,186,27,9,222
"80539",1080539,169,38,15,222
"80540",1080540,51,257,7,315
"80541",1080541,158,66,5,229
"80542",1080542,95,140,6,241
"80543",1080543,204,71,17,292
"80544",1080544,16,116,2,134
"80545",1080545,156,65,19,240
"80546",1080546,169,59,12,240
"80547",1080547,211,18,5,234
"80548",1080548,89,37,28,154
"80549",1080549,121,166,4,291
"80550",1080550,39,155,4,198
"80551",1080551,73,28,1,102
"80552",1080552,173,166,7,346
"80553",1080553,213,42,4,259
"80554",1080554,97,84,7,188
"80555",1080555,135,94,7,236
"80556",1080556,58,10,1,69
"80557",1080557,77,99,17,193
"80558",1080558,166,96,6,268
"80559",1080559,196,78,10,284
"80560",1080560,6,27,1,34
"80561",1080561,146,126,11,283
"80562",1080562,84,89,4,177
"80563",1080563,100,179,8,287
"80564",1080564,45,217,14,276
"80565",1080565,79,103,11,193
"80566",1080566,46,181,2,229
"80567",1080567,130,156,7,293
"80568",1080568,37,30,4,71
"80569",1080569,110,187,14,311
"80570",1080570,175,22,2,199
"80571",1080571,233,14,7,254
"80572",1080572,65,123,12,200
"80573",1080573,77,182,6,265
"80574",1080574,101,103,12,216
"80575",1080575,228,57,12,297
"80576",1080576,94,97,3,194
"80577",1080577,155,21,6,182
"80578",1080578,118,32,9,159
"80579",1080579,99,250,7,356
"80580",1080580,84,110,8,202
"80581",1080581,179,100,6,285
"80582",1080582,110,153,1,264
"80583",1080583,205,45,9,259
"80584",1080584,102,166,11,279
"80585",1080585,233,106,9,348
"80586",1080586,200,85,16,301
"80587",1080587,75,155,12,242
"80588",1080588,90,29,3,122
"80589",1080589,153,57,5,215
"80590",1080590,158,98,14,270
"80591",1080591,205,33,8,246
"80592",1080592,125,101,10,236
"80593",1080593,166,30,6,202
"80594",1080594,124,42,2,168
"80595",1080595,129,118,5,252
"80596",1080596,50,196,6,252
"80597",1080597,123,85,4,212
"80598",1080598,130,139,5,274
"80599",1080599,19,4,0,23
"80600",1080600,97,117,23,237
"80601",1080601,28,29,0,57
"80602",1080602,157,17,7,181
"80603",1080603,37,212,4,253
"80604",1080604,18,214,7,239
"80605",1080605,175,112,8,295
"80606",1080606,59,139,4,202
"80607",1080607,33,209,7,249
"80608",1080608,41,187,8,236
"80609",1080609,171,124,8,303
"80610",1080610,53,159,13,225
"80611",1080611,74,157,20,251
"80612",1080612,88,104,16,208
"80613",1080613,60,22,2,84
"80614",1080614,73,181,3,257
"80615",1080615,63,185,5,253
"80616",1080616,85,117,16,218
"80617",1080617,158,23,9,190
"80618",1080618,120,141,6,267
"80619",1080619,98,73,8,179
"80620",1080620,152,58,6,216
"80621",1080621,138,168,13,319
"80622",1080622,157,36,4,197
"80623",1080623,113,111,4,228
"80624",1080624,192,82,11,285
"80625",1080625,127,74,2,203
"80626",1080626,116,149,5,270
"80627",1080627,150,146,7,303
"80628",1080628,41,33,5,79
"80629",1080629,102,87,8,197
"80630",1080630,269,14,5,288
"80631",1080631,79,1,0,80
"80632",1080632,125,81,13,219
"80633",1080633,127,114,11,252
"80634",1080634,178,16,11,205
"80635",1080635,41,175,4,220
"80636",1080636,33,240,7,280
"80637",1080637,208,11,7,226
"80638",1080638,165,147,14,326
"80639",1080639,32,191,6,229
"80640",1080640,187,39,4,230
"80641",1080641,111,48,8,167
"80642",1080642,4,3,0,7
"80643",1080643,244,30,12,286
"80644",1080644,90,236,3,329
"80645",1080645,178,77,10,265
"80646",1080646,54,120,4,178
"80647",1080647,171,89,14,274
"80648",1080648,173,91,10,274
"80649",1080649,128,102,3,233
"80650",1080650,17,2,3,22
"80651",1080651,146,105,9,260
"80652",1080652,194,64,8,266
"80653",1080653,137,24,1,162
"80654",1080654,131,148,13,292
"80655",1080655,112,1,0,113
"80656",1080656,212,25,10,247
"80657",1080657,95,227,11,333
"80658",1080658,116,206,13,335
"80659",1080659,18,6,1,25
"80660",1080660,189,52,15,256
"80661",1080661,168,23,7,198
"80662",1080662,71,179,11,261
"80663",1080663,176,80,6,262
"80664",1080664,71,20,2,93
"80665",1080665,124,78,14,216
"80666",1080666,108,50,3,161
"80667",1080667,115,73,9,197
"80668",1080668,57,68,4,129
"80669",1080669,261,29,5,295
"80670",1080670,67,152,19,238
"80671",1080671,107,146,8,261
"80672",1080672,144,43,11,198
"80673",1080673,128,45,5,178
"80674",1080674,76,188,19,283
"80675",1080675,126,63,6,195
"80676",1080676,59,178,9,246
"80677",1080677,261,22,20,303
"80678",1080678,56,142,5,203
"80679",1080679,59,275,7,341
"80680",1080680,123,151,15,289
"80681",1080681,146,89,8,243
"80682",1080682,80,167,22,269
"80683",1080683,19,12,1,32
"80684",1080684,49,117,3,169
"80685",1080685,32,255,7,294
"80686",1080686,169,78,40,287
"80687",1080687,67,171,9,247
"80688",1080688,157,53,5,215
"80689",1080689,91,101,6,198
"80690",1080690,180,31,3,214
"80691",1080691,101,173,8,282
"80692",1080692,48,55,7,110
"80693",1080693,195,14,7,216
"80694",1080694,43,184,1,228
"80695",1080695,207,66,6,279
"80696",1080696,67,29,6,102
"80697",1080697,55,252,6,313
"80698",1080698,158,70,11,239
"80699",1080699,90,147,2,239
"80700",1080700,159,40,2,201
"80701",1080701,157,46,10,213
"80702",1080702,76,87,4,167
"80703",1080703,11,10,0,21
"80704",1080704,228,36,8,272
"80705",1080705,169,7,2,178
"80706",1080706,66,152,8,226
"80707",1080707,142,19,1,162
"80708",1080708,115,40,8,163
"80709",1080709,227,103,11,341
"80710",1080710,37,134,5,176
"80711",1080711,150,130,15,295
"80712",1080712,102,21,4,127
"80713",1080713,97,0,0,97
"80714",1080714,73,102,2,177
"80715",1080715,171,18,10,199
"80716",1080716,19,238,6,263
"80717",1080717,1,7,0,8
"80718",1080718,183,115,14,312
"80719",1080719,30,258,4,292
"80720",1080720,97,119,7,223
"80721",1080721,112,89,13,214
"80722",1080722,59,75,6,140
"80723",1080723,45,266,3,314
"80724",1080724,100,36,5,141
"80725",1080725,63,211,6,280
"80726",1080726,49,163,10,222
"80727",1080727,95,138,6,239
"80728",1080728,44,216,11,271
"80729",1080729,42,211,20,273
"80730",1080730,165,59,9,233
"80731",1080731,131,25,6,162
"80732",1080732,203,20,17,240
"80733",1080733,163,84,10,257
"80734",1080734,158,129,28,315
"80735",1080735,97,168,21,286
"80736",1080736,106,118,6,230
"80737",1080737,95,127,25,247
"80738",1080738,60,140,9,209
"80739",1080739,38,46,1,85
"80740",1080740,33,41,8,82
"80741",1080741,112,158,9,279
"80742",1080742,184,130,5,319
"80743",1080743,196,76,6,278
"80744",1080744,123,141,21,285
"80745",1080745,171,21,3,195
"80746",1080746,151,70,13,234
"80747",1080747,153,87,17,257
"80748",1080748,211,41,8,260
"80749",1080749,173,13,9,195
"80750",1080750,31,138,2,171
"80751",1080751,80,225,1,306
"80752",1080752,133,134,12,279
"80753",1080753,65,146,4,215
"80754",1080754,181,20,6,207
"80755",1080755,124,90,4,218
"80756",1080756,163,93,8,264
"80757",1080757,57,65,2,124
"80758",1080758,107,85,3,195
"80759",1080759,153,47,5,205
"80760",1080760,36,208,3,247
"80761",1080761,170,95,3,268
"80762",1080762,87,236,12,335
"80763",1080763,111,82,8,201
"80764",1080764,177,106,14,297
"80765",1080765,245,32,7,284
"80766",1080766,245,50,15,310
"80767",1080767,256,26,15,297
"80768",1080768,45,191,2,238
"80769",1080769,79,18,3,100
"80770",1080770,41,14,0,55
"80771",1080771,102,106,8,216
"80772",1080772,214,81,6,301
"80773",1080773,70,129,9,208
"80774",1080774,210,47,9,266
"80775",1080775,220,76,14,310
"80776",1080776,206,107,15,328
"80777",1080777,95,60,6,161
"80778",1080778,200,31,9,240
"80779",1080779,121,75,7,203
"80780",1080780,147,128,10,285
"80781",1080781,197,55,8,260
"80782",1080782,92,149,8,249
"80783",1080783,199,69,11,279
"80784",1080784,23,217,0,240
"80785",1080785,53,140,0,193
"80786",1080786,12,2,1,15
"80787",1080787,116,58,14,188
"80788",1080788,73,239,13,325
"80789",1080789,50,244,3,297
"80790",1080790,59,209,9,277
"80791",1080791,154,68,8,230
"80792",1080792,81,107,18,206
"80793",1080793,89,97,10,196
"80794",1080794,69,22,5,96
"80795",1080795,97,56,3,156
"80796",1080796,65,206,7,278
"80797",1080797,108,183,11,302
"80798",1080798,228,32,5,265
"80799",1080799,33,28,3,64
"80800",1080800,36,23,6,65
"80801",1080801,89,98,2,189
"80802",1080802,131,125,9,265
"80803",1080803,100,198,17,315
"80804",1080804,89,68,4,161
"80805",1080805,32,231,1,264
"80806",1080806,145,30,3,178
"80807",1080807,182,173,7,362
"80808",1080808,154,130,15,299
"80809",1080809,49,210,5,264
"80810",1080810,87,165,12,264
"80811",1080811,157,121,7,285
"80812",1080812,135,145,10,290
"80813",1080813,100,137,7,244
"80814",1080814,64,202,11,277
"80815",1080815,137,37,18,192
"80816",1080816,175,21,4,200
"80817",1080817,149,73,7,229
"80818",1080818,213,20,5,238
"80819",1080819,34,213,4,251
"80820",1080820,115,118,5,238
"80821",1080821,101,98,13,212
"80822",1080822,172,50,7,229
"80823",1080823,153,107,20,280
"80824",1080824,121,143,20,284
"80825",1080825,224,28,6,258
"80826",1080826,53,170,5,228
"80827",1080827,147,43,6,196
"80828",1080828,65,106,2,173
"80829",1080829,55,292,17,364
"80830",1080830,142,120,30,292
"80831",1080831,144,10,4,158
"80832",1080832,67,114,10,191
"80833",1080833,178,121,3,302
"80834",1080834,141,167,13,321
"80835",1080835,108,110,14,232
"80836",1080836,130,161,24,315
"80837",1080837,77,141,11,229
"80838",1080838,99,79,8,186
"80839",1080839,197,47,4,248
"80840",1080840,71,259,7,337
"80841",1080841,32,226,8,266
"80842",1080842,90,223,20,333
"80843",1080843,154,128,9,291
"80844",1080844,10,7,0,17
"80845",1080845,86,166,6,258
"80846",1080846,153,80,16,249
"80847",1080847,208,24,3,235
"80848",1080848,133,103,6,242
"80849",1080849,87,122,10,219
"80850",1080850,88,46,6,140
"80851",1080851,200,43,8,251
"80852",1080852,73,150,7,230
"80853",1080853,191,70,4,265
"80854",1080854,74,196,15,285
"80855",1080855,33,33,4,70
"80856",1080856,183,53,7,243
"80857",1080857,28,178,7,213
"80858",1080858,0,123,1,124
"80859",1080859,41,39,4,84
"80860",1080860,141,55,5,201
"80861",1080861,146,48,17,211
"80862",1080862,39,196,4,239
"80863",1080863,84,169,4,257
"80864",1080864,64,124,0,188
"80865",1080865,88,79,2,169
"80866",1080866,30,149,7,186
"80867",1080867,133,137,8,278
"80868",1080868,50,10,3,63
"80869",1080869,82,187,17,286
"80870",1080870,38,136,1,175
"80871",1080871,26,98,14,138
"80872",1080872,227,15,11,253
"80873",1080873,177,16,8,201
"80874",1080874,37,213,3,253
"80875",1080875,83,213,10,306
"80876",1080876,44,222,11,277
"80877",1080877,73,184,8,265
"80878",1080878,99,76,13,188
"80879",1080879,166,92,8,266
"80880",1080880,124,27,6,157
"80881",1080881,116,155,1,272
"80882",1080882,97,101,12,210
"80883",1080883,195,18,6,219
"80884",1080884,88,73,3,164
"80885",1080885,171,92,12,275
"80886",1080886,178,34,5,217
"80887",1080887,157,19,8,184
"80888",1080888,123,78,6,207
"80889",1080889,6,0,0,6
"80890",1080890,96,176,7,279
"80891",1080891,39,152,11,202
"80892",1080892,185,32,2,219
"80893",1080893,104,118,24,246
"80894",1080894,129,93,8,230
"80895",1080895,157,124,12,293
"80896",1080896,166,67,3,236
"80897",1080897,177,93,8,278
"80898",1080898,43,229,12,284
"80899",1080899,131,136,19,286
"80900",1080900,56,198,7,261
"80901",1080901,136,33,7,176
"80902",1080902,205,47,3,255
"80903",1080903,59,121,20,200
"80904",1080904,153,92,8,253
"80905",1080905,65,39,0,104
"80906",1080906,38,254,18,310
"80907",1080907,116,83,4,203
"80908",1080908,22,150,2,174
"80909",1080909,135,76,4,215
"80910",1080910,127,78,7,212
"80911",1080911,51,164,2,217
"80912",1080912,72,19,1,92
"80913",1080913,72,113,8,193
"80914",1080914,49,8,1,58
"80915",1080915,64,231,3,298
"80916",1080916,382,45,19,446
"80917",1080917,24,304,2,330
"80918",1080918,155,89,9,253
"80919",1080919,120,141,13,274
"80920",1080920,107,146,13,266
"80921",1080921,6,34,0,40
"80922",1080922,123,113,18,254
"80923",1080923,111,95,6,212
"80924",1080924,213,35,11,259
"80925",1080925,136,109,14,259
"80926",1080926,93,175,14,282
"80927",1080927,142,49,13,204
"80928",1080928,192,3,5,200
"80929",1080929,106,9,5,120
"80930",1080930,223,78,8,309
"80931",1080931,21,36,2,59
"80932",1080932,157,83,7,247
"80933",1080933,220,74,4,298
"80934",1080934,63,163,15,241
"80935",1080935,196,98,13,307
"80936",1080936,131,148,11,290
"80937",1080937,5,93,0,98
"80938",1080938,46,153,4,203
"80939",1080939,58,16,7,81
"80940",1080940,48,177,2,227
"80941",1080941,21,37,2,60
"80942",1080942,119,83,22,224
"80943",1080943,70,75,2,147
"80944",1080944,143,74,11,228
"80945",1080945,123,125,17,265
"80946",1080946,119,47,11,177
"80947",1080947,173,69,8,250
"80948",1080948,174,106,10,290
"80949",1080949,89,186,6,281
"80950",1080950,90,152,8,250
"80951",1080951,16,2,2,20
"80952",1080952,32,57,12,101
"80953",1080953,137,122,13,272
"80954",1080954,153,55,2,210
"80955",1080955,216,26,9,251
"80956",1080956,181,117,10,308
"80957",1080957,124,7,2,133
"80958",1080958,86,150,9,245
"80959",1080959,57,239,11,307
"80960",1080960,195,16,10,221
"80961",1080961,22,196,5,223
"80962",1080962,59,151,17,227
"80963",1080963,138,86,8,232
"80964",1080964,189,31,6,226
"80965",1080965,136,23,5,164
"80966",1080966,218,96,15,329
"80967",1080967,114,101,8,223
"80968",1080968,88,175,9,272
"80969",1080969,50,254,8,312
"80970",1080970,98,40,9,147
"80971",1080971,2,9,1,12
"80972",1080972,180,59,11,250
"80973",1080973,32,74,0,106
"80974",1080974,36,221,4,261
"80975",1080975,15,161,4,180
"80976",1080976,133,128,12,273
"80977",1080977,106,233,3,342
"80978",1080978,22,235,3,260
"80979",1080979,157,75,9,241
"80980",1080980,161,38,3,202
"80981",1080981,121,137,4,262
"80982",1080982,147,71,4,222
"80983",1080983,37,14,5,56
"80984",1080984,91,248,6,345
"80985",1080985,6,0,1,7
"80986",1080986,117,141,13,271
"80987",1080987,34,96,4,134
"80988",1080988,105,66,10,181
"80989",1080989,25,45,8,78
"80990",1080990,47,30,4,81
"80991",1080991,42,177,4,223
"80992",1080992,186,55,2,243
"80993",1080993,73,107,9,189
"80994",1080994,188,48,15,251
"80995",1080995,202,105,17,324
"80996",1080996,282,75,16,373
"80997",1080997,178,84,11,273
"80998",1080998,159,75,17,251
"80999",1080999,87,26,4,117
"81000",1081000,134,139,7,280
"81001",1081001,41,265,12,318
"81002",1081002,202,65,7,274
"81003",1081003,161,81,8,250
"81004",1081004,224,48,12,284
"81005",1081005,85,155,8,248
"81006",1081006,144,148,17,309
"81007",1081007,40,207,3,250
"81008",1081008,128,82,19,229
"81009",1081009,222,60,10,292
"81010",1081010,18,111,1,130
"81011",1081011,142,105,5,252
"81012",1081012,218,130,10,358
"81013",1081013,194,49,5,248
"81014",1081014,206,87,7,300
"81015",1081015,112,44,2,158
"81016",1081016,88,228,11,327
"81017",1081017,212,92,11,315
"81018",1081018,101,118,3,222
"81019",1081019,92,54,4,150
"81020",1081020,33,138,4,175
"81021",1081021,129,111,2,242
"81022",1081022,123,116,15,254
"81023",1081023,177,86,8,271
"81024",1081024,44,202,4,250
"81025",1081025,76,47,9,132
"81026",1081026,143,80,18,241
"81027",1081027,104,87,10,201
"81028",1081028,88,175,18,281
"81029",1081029,147,78,7,232
"81030",1081030,105,148,14,267
"81031",1081031,141,72,14,227
"81032",1081032,64,123,8,195
"81033",1081033,162,56,16,234
"81034",1081034,67,225,6,298
"81035",1081035,38,103,3,144
"81036",1081036,107,105,19,231
"81037",1081037,115,42,5,162
"81038",1081038,57,118,3,178
"81039",1081039,61,86,13,160
"81040",1081040,175,97,6,278
"81041",1081041,90,221,17,328
"81042",1081042,13,9,1,23
"81043",1081043,103,11,4,118
"81044",1081044,174,91,19,284
"81045",1081045,139,23,3,165
"81046",1081046,143,28,2,173
"81047",1081047,54,187,11,252
"81048",1081048,9,0,0,9
"81049",1081049,167,88,18,273
"81050",1081050,218,36,14,268
"81051",1081051,33,258,6,297
"81052",1081052,22,266,0,288
"81053",1081053,44,263,2,309
"81054",1081054,89,207,13,309
"81055",1081055,96,69,7,172
"81056",1081056,28,118,7,153
"81057",1081057,136,134,9,279
"81058",1081058,89,124,9,222
"81059",1081059,9,51,5,65
"81060",1081060,46,153,8,207
"81061",1081061,180,25,2,207
"81062",1081062,211,54,12,277
"81063",1081063,180,65,12,257
"81064",1081064,104,90,8,202
"81065",1081065,110,32,6,148
"81066",1081066,86,171,15,272
"81067",1081067,31,35,6,72
"81068",1081068,202,99,29,330
"81069",1081069,79,115,10,204
"81070",1081070,30,222,5,257
"81071",1081071,109,149,8,266
"81072",1081072,135,43,3,181
"81073",1081073,24,235,3,262
"81074",1081074,56,16,3,75
"81075",1081075,128,20,7,155
"81076",1081076,6,2,3,11
"81077",1081077,48,126,8,182
"81078",1081078,43,4,2,49
"81079",1081079,216,38,2,256
"81080",1081080,236,54,9,299
"81081",1081081,131,153,17,301
"81082",1081082,128,53,7,188
"81083",1081083,5,14,0,19
"81084",1081084,114,102,10,226
"81085",1081085,84,156,18,258
"81086",1081086,67,205,8,280
"81087",1081087,81,184,16,281
"81088",1081088,32,9,3,44
"81089",1081089,98,98,4,200
"81090",1081090,114,60,13,187
"81091",1081091,76,145,3,224
"81092",1081092,93,105,9,207
"81093",1081093,95,117,3,215
"81094",1081094,37,280,1,318
"81095",1081095,124,94,3,221
"81096",1081096,146,16,1,163
"81097",1081097,51,40,4,95
"81098",1081098,99,53,3,155
"81099",1081099,4,8,1,13
"81100",1081100,69,136,1,206
"81101",1081101,127,91,13,231
"81102",1081102,89,128,12,229
"81103",1081103,83,141,7,231
"81104",1081104,119,150,10,279
"81105",1081105,95,208,21,324
"81106",1081106,240,28,9,277
"81107",1081107,97,21,2,120
"81108",1081108,34,247,4,285
"81109",1081109,148,140,15,303
"81110",1081110,41,165,4,210
"81111",1081111,133,243,12,388
"81112",1081112,182,39,4,225
"81113",1081113,38,143,16,197
"81114",1081114,98,120,12,230
"81115",1081115,50,275,3,328
"81116",1081116,24,3,0,27
"81117",1081117,242,30,12,284
"81118",1081118,39,198,2,239
"81119",1081119,150,114,17,281
"81120",1081120,264,30,4,298
"81121",1081121,232,46,10,288
"81122",1081122,194,72,10,276
"81123",1081123,167,94,15,276
"81124",1081124,179,69,17,265
"81125",1081125,84,32,4,120
"81126",1081126,58,164,3,225
"81127",1081127,87,93,5,185
"81128",1081128,59,240,11,310
"81129",1081129,225,31,7,263
"81130",1081130,164,120,7,291
"81131",1081131,202,117,14,333
"81132",1081132,169,43,5,217
"81133",1081133,68,15,1,84
"81134",1081134,94,74,4,172
"81135",1081135,203,42,2,247
"81136",1081136,103,194,25,322
"81137",1081137,27,210,5,242
"81138",1081138,154,91,10,255
"81139",1081139,91,52,2,145
"81140",1081140,38,238,3,279
"81141",1081141,142,92,8,242
"81142",1081142,174,105,9,288
"81143",1081143,62,213,9,284
"81144",1081144,163,100,4,267
"81145",1081145,58,252,3,313
"81146",1081146,39,294,3,336
"81147",1081147,194,97,10,301
"81148",1081148,9,275,4,288
"81149",1081149,84,95,7,186
"81150",1081150,114,202,9,325
"81151",1081151,174,106,7,287
"81152",1081152,166,76,15,257
"81153",1081153,25,251,17,293
"81154",1081154,65,214,10,289
"81155",1081155,101,44,5,150
"81156",1081156,17,397,1,415
"81157",1081157,173,25,5,203
"81158",1081158,95,156,15,266
"81159",1081159,53,116,9,178
"81160",1081160,225,60,5,290
"81161",1081161,127,73,8,208
"81162",1081162,70,245,9,324
"81163",1081163,139,93,4,236
"81164",1081164,142,119,3,264
"81165",1081165,116,147,6,269
"81166",1081166,75,169,6,250
"81167",1081167,31,29,1,61
"81168",1081168,122,11,5,138
"81169",1081169,119,119,11,249
"81170",1081170,91,146,4,241
"81171",1081171,69,213,3,285
"81172",1081172,135,15,5,155
"81173",1081173,151,16,2,169
"81174",1081174,67,115,11,193
"81175",1081175,35,200,8,243
"81176",1081176,68,162,7,237
"81177",1081177,96,46,10,152
"81178",1081178,110,23,2,135
"81179",1081179,181,32,22,235
"81180",1081180,137,127,22,286
"81181",1081181,217,17,6,240
"81182",1081182,82,140,4,226
"81183",1081183,36,234,5,275
"81184",1081184,103,200,8,311
"81185",1081185,89,119,10,218
"81186",1081186,176,102,17,295
"81187",1081187,49,94,2,145
"81188",1081188,160,75,19,254
"81189",1081189,225,25,8,258
"81190",1081190,47,16,2,65
"81191",1081191,54,57,11,122
"81192",1081192,147,85,9,241
"81193",1081193,165,108,7,280
"81194",1081194,224,57,7,288
"81195",1081195,47,215,1,263
"81196",1081196,115,112,9,236
"81197",1081197,125,72,12,209
"81198",1081198,19,260,9,288
"81199",1081199,102,138,17,257
"81200",1081200,125,27,3,155
"81201",1081201,40,137,8,185
"81202",1081202,165,71,6,242
"81203",1081203,170,96,17,283
"81204",1081204,55,121,8,184
"81205",1081205,117,43,3,163
"81206",1081206,56,148,14,218
"81207",1081207,119,147,28,294
"81208",1081208,85,51,19,155
"81209",1081209,75,199,3,277
"81210",1081210,187,19,6,212
"81211",1081211,16,140,3,159
"81212",1081212,42,249,6,297
"81213",1081213,116,113,3,232
"81214",1081214,185,19,4,208
"81215",1081215,235,39,3,277
"81216",1081216,140,60,6,206
"81217",1081217,12,210,3,225
"81218",1081218,173,107,18,298
"81219",1081219,121,50,8,179
"81220",1081220,155,57,8,220
"81221",1081221,174,116,9,299
"81222",1081222,124,106,6,236
"81223",1081223,120,99,4,223
"81224",1081224,51,140,3,194
"81225",1081225,10,110,4,124
"81226",1081226,161,109,15,285
"81227",1081227,172,90,7,269
"81228",1081228,173,132,10,315
"81229",1081229,127,20,6,153
"81230",1081230,170,63,9,242
"81231",1081231,189,47,5,241
"81232",1081232,168,48,8,224
"81233",1081233,86,193,13,292
"81234",1081234,183,23,5,211
"81235",1081235,58,39,3,100
"81236",1081236,51,157,8,216
"81237",1081237,157,48,7,212
"81238",1081238,124,149,9,282
"81239",1081239,183,79,15,277
"81240",1081240,69,103,10,182
"81241",1081241,103,98,16,217
"81242",1081242,94,204,4,302
"81243",1081243,128,8,4,140
"81244",1081244,37,212,11,260
"81245",1081245,70,134,9,213
"81246",1081246,12,48,1,61
"81247",1081247,229,73,0,302
"81248",1081248,26,158,12,196
"81249",1081249,59,81,6,146
"81250",1081250,123,108,7,238
"81251",1081251,136,136,16,288
"81252",1081252,144,72,10,226
"81253",1081253,189,17,6,212
"81254",1081254,134,140,12,286
"81255",1081255,33,9,1,43
"81256",1081256,50,87,5,142
"81257",1081257,187,43,10,240
"81258",1081258,276,23,13,312
"81259",1081259,274,49,13,336
"81260",1081260,40,238,8,286
"81261",1081261,18,178,1,197
"81262",1081262,93,112,19,224
"81263",1081263,73,81,4,158
"81264",1081264,10,239,2,251
"81265",1081265,103,70,8,181
"81266",1081266,101,3,2,106
"81267",1081267,174,86,19,279
"81268",1081268,162,106,7,275
"81269",1081269,63,106,2,171
"81270",1081270,66,78,11,155
"81271",1081271,78,109,8,195
"81272",1081272,157,53,4,214
"81273",1081273,151,60,2,213
"81274",1081274,87,53,5,145
"81275",1081275,168,71,8,247
"81276",1081276,107,61,13,181
"81277",1081277,62,15,4,81
"81278",1081278,191,109,23,323
"81279",1081279,173,27,8,208
"81280",1081280,105,169,13,287
"81281",1081281,51,45,1,97
"81282",1081282,38,226,1,265
"81283",1081283,178,85,5,268
"81284",1081284,8,16,0,24
"81285",1081285,106,113,9,228
"81286",1081286,132,59,11,202
"81287",1081287,62,15,3,80
"81288",1081288,164,37,4,205
"81289",1081289,98,80,11,189
"81290",1081290,195,16,9,220
"81291",1081291,43,183,17,243
"81292",1081292,71,78,10,159
"81293",1081293,85,211,11,307
"81294",1081294,28,150,1,179
"81295",1081295,70,172,11,253
"81296",1081296,41,229,10,280
"81297",1081297,137,66,2,205
"81298",1081298,71,98,10,179
"81299",1081299,20,187,2,209
"81300",1081300,185,118,10,313
"81301",1081301,205,80,11,296
"81302",1081302,87,170,10,267
"81303",1081303,158,6,2,166
"81304",1081304,79,105,15,199
"81305",1081305,93,50,4,147
"81306",1081306,143,123,11,277
"81307",1081307,115,61,13,189
"81308",1081308,68,98,13,179
"81309",1081309,100,98,6,204
"81310",1081310,117,166,14,297
"81311",1081311,152,25,8,185
"81312",1081312,208,83,27,318
"81313",1081313,110,53,4,167
"81314",1081314,50,121,7,178
"81315",1081315,82,161,6,249
"81316",1081316,70,268,2,340
"81317",1081317,43,264,4,311
"81318",1081318,35,257,6,298
"81319",1081319,100,115,18,233
"81320",1081320,110,139,2,251
"81321",1081321,72,222,2,296
"81322",1081322,70,164,7,241
"81323",1081323,93,82,9,184
"81324",1081324,20,33,1,54
"81325",1081325,90,24,10,124
"81326",1081326,138,6,1,145
"81327",1081327,25,213,0,238
"81328",1081328,64,123,8,195
"81329",1081329,23,178,5,206
"81330",1081330,155,53,13,221
"81331",1081331,112,61,8,181
"81332",1081332,115,38,5,158
"81333",1081333,136,68,14,218
"81334",1081334,161,133,16,310
"81335",1081335,62,161,7,230
"81336",1081336,55,174,10,239
"81337",1081337,27,272,10,309
"81338",1081338,150,42,13,205
"81339",1081339,114,81,5,200
"81340",1081340,81,122,7,210
"81341",1081341,179,17,5,201
"81342",1081342,149,118,12,279
"81343",1081343,224,90,22,336
"81344",1081344,201,129,17,347
"81345",1081345,199,6,9,214
"81346",1081346,13,40,1,54
"81347",1081347,73,43,4,120
"81348",1081348,66,215,8,289
"81349",1081349,22,69,4,95
"81350",1081350,39,240,10,289
"81351",1081351,8,75,2,85
"81352",1081352,116,114,18,248
"81353",1081353,81,200,8,289
"81354",1081354,79,126,13,218
"81355",1081355,125,54,8,187
"81356",1081356,39,113,7,159
"81357",1081357,91,146,13,250
"81358",1081358,75,101,4,180
"81359",1081359,87,82,8,177
"81360",1081360,43,107,6,156
"81361",1081361,146,15,9,170
"81362",1081362,31,87,0,118
"81363",1081363,89,161,20,270
"81364",1081364,61,170,6,237
"81365",1081365,137,74,6,217
"81366",1081366,256,50,7,313
"81367",1081367,248,30,4,282
"81368",1081368,114,0,0,114
"81369",1081369,142,80,7,229
"81370",1081370,104,101,4,209
"81371",1081371,84,150,5,239
"81372",1081372,144,103,0,247
"81373",1081373,60,222,23,305
"81374",1081374,107,73,6,186
"81375",1081375,76,157,4,237
"81376",1081376,27,150,3,180
"81377",1081377,123,55,6,184
"81378",1081378,134,94,19,247
"81379",1081379,113,128,7,248
"81380",1081380,124,95,3,222
"81381",1081381,172,113,12,297
"81382",1081382,47,158,3,208
"81383",1081383,90,115,16,221
"81384",1081384,112,101,7,220
"81385",1081385,55,98,7,160
"81386",1081386,30,249,8,287
"81387",1081387,172,98,9,279
"81388",1081388,147,40,7,194
"81389",1081389,134,16,3,153
"81390",1081390,125,70,3,198
"81391",1081391,58,105,3,166
"81392",1081392,125,43,9,177
"81393",1081393,49,88,3,140
"81394",1081394,197,25,3,225
"81395",1081395,13,113,2,128
"81396",1081396,35,76,3,114
"81397",1081397,172,102,21,295
"81398",1081398,125,106,5,236
"81399",1081399,22,178,3,203
"81400",1081400,151,144,11,306
"81401",1081401,101,67,2,170
"81402",1081402,175,31,10,216
"81403",1081403,89,169,8,266
"81404",1081404,227,46,3,276
"81405",1081405,158,123,7,288
"81406",1081406,118,10,6,134
"81407",1081407,74,144,14,232
"81408",1081408,120,160,16,296
"81409",1081409,76,244,6,326
"81410",1081410,132,160,13,305
"81411",1081411,44,78,1,123
"81412",1081412,65,171,32,268
"81413",1081413,97,35,6,138
"81414",1081414,21,201,3,225
"81415",1081415,209,57,11,277
"81416",1081416,142,21,3,166
"81417",1081417,103,84,1,188
"81418",1081418,26,9,2,37
"81419",1081419,58,231,5,294
"81420",1081420,149,30,7,186
"81421",1081421,78,69,4,151
"81422",1081422,60,175,9,244
"81423",1081423,132,15,4,151
"81424",1081424,152,33,15,200
"81425",1081425,22,8,6,36
"81426",1081426,24,142,3,169
"81427",1081427,84,214,5,303
"81428",1081428,93,140,4,237
"81429",1081429,231,45,7,283
"81430",1081430,157,65,7,229
"81431",1081431,74,5,9,88
"81432",1081432,135,71,15,221
"81433",1081433,96,141,13,250
"81434",1081434,20,3,1,24
"81435",1081435,202,56,8,266
"81436",1081436,82,110,9,201
"81437",1081437,58,288,3,349
"81438",1081438,99,138,10,247
"81439",1081439,157,83,7,247
"81440",1081440,87,62,2,151
"81441",1081441,226,70,5,301
"81442",1081442,152,70,9,231
"81443",1081443,63,164,11,238
"81444",1081444,157,2,1,160
"81445",1081445,12,48,1,61
"81446",1081446,23,9,0,32
"81447",1081447,130,139,5,274
"81448",1081448,188,33,4,225
"81449",1081449,93,109,2,204
"81450",1081450,43,47,4,94
"81451",1081451,172,133,13,318
"81452",1081452,21,10,3,34
"81453",1081453,165,88,12,265
"81454",1081454,206,38,4,248
"81455",1081455,105,32,5,142
"81456",1081456,112,80,9,201
"81457",1081457,63,157,20,240
"81458",1081458,258,50,7,315
"81459",1081459,180,58,6,244
"81460",1081460,155,17,8,180
"81461",1081461,3,1,0,4
"81462",1081462,95,185,15,295
"81463",1081463,4,49,2,55
"81464",1081464,124,149,7,280
"81465",1081465,40,257,9,306
"81466",1081466,92,191,20,303
"81467",1081467,134,135,30,299
"81468",1081468,72,273,3,348
"81469",1081469,107,129,12,248
"81470",1081470,245,49,9,303
"81471",1081471,70,135,7,212
"81472",1081472,157,29,7,193
"81473",1081473,152,101,17,270
"81474",1081474,133,58,8,199
"81475",1081475,156,159,24,339
"81476",1081476,173,23,4,200
"81477",1081477,13,5,1,19
"81478",1081478,184,104,10,298
"81479",1081479,173,96,11,280
"81480",1081480,137,90,7,234
"81481",1081481,195,23,4,222
"81482",1081482,128,41,6,175
"81483",1081483,132,111,10,253
"81484",1081484,145,67,13,225
"81485",1081485,73,151,27,251
"81486",1081486,96,142,5,243
"81487",1081487,162,66,13,241
"81488",1081488,170,18,5,193
"81489",1081489,99,65,5,169
"81490",1081490,19,261,2,282
"81491",1081491,179,85,12,276
"81492",1081492,121,70,6,197
"81493",1081493,84,192,8,284
"81494",1081494,92,144,12,248
"81495",1081495,213,29,11,253
"81496",1081496,42,56,2,100
"81497",1081497,35,79,2,116
"81498",1081498,197,55,12,264
"81499",1081499,191,81,11,283
"81500",1081500,23,135,6,164
"81501",1081501,151,74,5,230
"81502",1081502,115,78,16,209
"81503",1081503,288,55,14,357
"81504",1081504,187,96,5,288
"81505",1081505,41,149,2,192
"81506",1081506,105,140,6,251
"81507",1081507,125,1,0,126
"81508",1081508,90,186,8,284
"81509",1081509,105,180,14,299
"81510",1081510,6,10,1,17
"81511",1081511,66,202,7,275
"81512",1081512,206,54,5,265
"81513",1081513,155,56,11,222
"81514",1081514,73,232,11,316
"81515",1081515,32,212,3,247
"81516",1081516,138,165,24,327
"81517",1081517,78,192,6,276
"81518",1081518,80,164,14,258
"81519",1081519,170,11,6,187
"81520",1081520,48,246,6,300
"81521",1081521,95,183,9,287
"81522",1081522,219,64,8,291
"81523",1081523,53,169,16,238
"81524",1081524,97,176,13,286
"81525",1081525,196,130,4,330
"81526",1081526,83,73,19,175
"81527",1081527,164,68,19,251
"81528",1081528,47,74,8,129
"81529",1081529,115,69,11,195
"81530",1081530,85,65,10,160
"81531",1081531,109,3,2,114
"81532",1081532,72,73,2,147
"81533",1081533,85,156,7,248
"81534",1081534,150,95,14,259
"81535",1081535,62,246,10,318
"81536",1081536,150,79,6,235
"81537",1081537,180,35,10,225
"81538",1081538,100,189,12,301
"81539",1081539,158,37,11,206
"81540",1081540,162,58,5,225
"81541",1081541,50,39,5,94
"81542",1081542,46,147,10,203
"81543",1081543,76,87,7,170
"81544",1081544,130,101,11,242
"81545",1081545,122,65,9,196
"81546",1081546,170,18,6,194
"81547",1081547,87,221,1,309
"81548",1081548,134,101,7,242
"81549",1081549,117,155,13,285
"81550",1081550,143,81,22,246
"81551",1081551,158,16,3,177
"81552",1081552,103,140,4,247
"81553",1081553,226,42,9,277
"81554",1081554,33,12,1,46
"81555",1081555,42,199,12,253
"81556",1081556,67,153,9,229
"81557",1081557,143,17,4,164
"81558",1081558,21,188,1,210
"81559",1081559,109,89,12,210
"81560",1081560,105,159,8,272
"81561",1081561,144,70,11,225
"81562",1081562,79,170,6,255
"81563",1081563,75,152,20,247
"81564",1081564,58,128,12,198
"81565",1081565,36,207,1,244
"81566",1081566,64,160,0,224
"81567",1081567,121,54,7,182
"81568",1081568,38,61,3,102
"81569",1081569,136,96,16,248
"81570",1081570,134,141,10,285
"81571",1081571,79,0,1,80
"81572",1081572,179,70,5,254
"81573",1081573,205,32,9,246
"81574",1081574,51,218,12,281
"81575",1081575,40,178,0,218
"81576",1081576,30,176,2,208
"81577",1081577,128,70,6,204
"81578",1081578,107,134,11,252
"81579",1081579,96,88,4,188
"81580",1081580,49,287,3,339
"81581",1081581,13,7,2,22
"81582",1081582,52,270,3,325
"81583",1081583,176,33,8,217
"81584",1081584,85,41,11,137
"81585",1081585,180,80,5,265
"81586",1081586,11,3,0,14
"81587",1081587,174,101,18,293
"81588",1081588,209,66,4,279
"81589",1081589,95,117,12,224
"81590",1081590,265,28,2,295
"81591",1081591,60,159,2,221
"81592",1081592,188,33,3,224
"81593",1081593,207,15,8,230
"81594",1081594,117,84,12,213
"81595",1081595,99,190,13,302
"81596",1081596,69,165,10,244
"81597",1081597,125,52,13,190
"81598",1081598,168,34,6,208
"81599",1081599,178,28,3,209
"81600",1081600,23,252,6,281
"81601",1081601,197,47,6,250
"81602",1081602,17,201,2,220
"81603",1081603,151,134,5,290
"81604",1081604,101,103,3,207
"81605",1081605,7,79,2,88
"81606",1081606,97,58,5,160
"81607",1081607,239,43,13,295
"81608",1081608,75,184,8,267
"81609",1081609,126,22,3,151
"81610",1081610,78,192,12,282
"81611",1081611,156,24,9,189
"81612",1081612,99,105,11,215
"81613",1081613,120,120,8,248
"81614",1081614,149,132,4,285
"81615",1081615,173,149,26,348
"81616",1081616,2,31,1,34
"81617",1081617,43,10,4,57
"81618",1081618,60,52,4,116
"81619",1081619,42,197,6,245
"81620",1081620,73,11,3,87
"81621",1081621,112,140,6,258
"81622",1081622,41,217,1,259
"81623",1081623,125,53,9,187
"81624",1081624,20,202,5,227
"81625",1081625,104,140,15,259
"81626",1081626,11,25,0,36
"81627",1081627,45,244,4,293
"81628",1081628,64,133,12,209
"81629",1081629,94,64,6,164
"81630",1081630,194,30,8,232
"81631",1081631,39,0,0,39
"81632",1081632,37,145,1,183
"81633",1081633,133,57,8,198
"81634",1081634,258,44,9,311
"81635",1081635,62,211,24,297
"81636",1081636,137,123,33,293
"81637",1081637,31,139,1,171
"81638",1081638,203,53,13,269
"81639",1081639,120,38,3,161
"81640",1081640,12,39,0,51
"81641",1081641,131,100,20,251
"81642",1081642,161,112,9,282
"81643",1081643,201,80,8,289
"81644",1081644,109,112,29,250
"81645",1081645,83,155,24,262
"81646",1081646,124,107,8,239
"81647",1081647,61,26,4,91
"81648",1081648,161,144,7,312
"81649",1081649,26,207,13,246
"81650",1081650,66,30,1,97
"81651",1081651,70,174,11,255
"81652",1081652,78,82,15,175
"81653",1081653,89,191,8,288
"81654",1081654,180,125,11,316
"81655",1081655,16,13,4,33
"81656",1081656,19,193,3,215
"81657",1081657,37,320,4,361
"81658",1081658,232,29,11,272
"81659",1081659,140,35,7,182
"81660",1081660,6,14,1,21
"81661",1081661,146,39,8,193
"81662",1081662,132,113,11,256
"81663",1081663,87,151,10,248
"81664",1081664,4,103,2,109
"81665",1081665,106,124,12,242
"81666",1081666,54,20,2,76
"81667",1081667,148,52,7,207
"81668",1081668,71,184,3,258
"81669",1081669,128,59,6,193
"81670",1081670,46,35,2,83
"81671",1081671,107,20,1,128
"81672",1081672,63,140,12,215
"81673",1081673,187,80,14,281
"81674",1081674,47,256,12,315
"81675",1081675,74,205,19,298
"81676",1081676,106,111,19,236
"81677",1081677,27,69,1,97
"81678",1081678,32,30,1,63
"81679",1081679,92,43,7,142
"81680",1081680,153,49,7,209
"81681",1081681,160,32,9,201
"81682",1081682,156,62,13,231
"81683",1081683,165,30,0,195
"81684",1081684,104,21,4,129
"81685",1081685,86,94,8,188
"81686",1081686,60,84,4,148
"81687",1081687,109,173,7,289
"81688",1081688,48,210,4,262
"81689",1081689,66,207,19,292
"81690",1081690,179,40,6,225
"81691",1081691,75,3,2,80
"81692",1081692,127,81,11,219
"81693",1081693,134,66,9,209
"81694",1081694,164,27,4,195
"81695",1081695,121,28,4,153
"81696",1081696,126,96,13,235
"81697",1081697,22,169,6,197
"81698",1081698,208,78,5,291
"81699",1081699,91,160,15,266
"81700",1081700,104,85,9,198
"81701",1081701,35,233,5,273
"81702",1081702,67,212,9,288
"81703",1081703,78,152,8,238
"81704",1081704,165,55,9,229
"81705",1081705,61,202,16,279
"81706",1081706,11,3,0,14
"81707",1081707,81,112,15,208
"81708",1081708,156,108,2,266
"81709",1081709,101,159,15,275
"81710",1081710,53,260,6,319
"81711",1081711,179,89,13,281
"81712",1081712,113,66,2,181
"81713",1081713,14,21,2,37
"81714",1081714,66,150,17,233
"81715",1081715,101,169,8,278
"81716",1081716,53,22,0,75
"81717",1081717,34,167,2,203
"81718",1081718,155,90,9,254
"81719",1081719,145,47,3,195
"81720",1081720,22,281,3,306
"81721",1081721,210,17,8,235
"81722",1081722,106,27,5,138
"81723",1081723,111,130,25,266
"81724",1081724,104,102,26,232
"81725",1081725,64,10,0,74
"81726",1081726,45,239,7,291
"81727",1081727,38,192,8,238
"81728",1081728,187,21,8,216
"81729",1081729,71,183,6,260
"81730",1081730,83,173,6,262
"81731",1081731,123,171,19,313
"81732",1081732,66,192,18,276
"81733",1081733,76,99,8,183
"81734",1081734,97,166,15,278
"81735",1081735,89,199,7,295
"81736",1081736,145,56,1,202
"81737",1081737,96,143,6,245
"81738",1081738,94,167,18,279
"81739",1081739,193,18,3,214
"81740",1081740,32,232,4,268
"81741",1081741,71,99,5,175
"81742",1081742,181,40,28,249
"81743",1081743,138,79,12,229
"81744",1081744,135,109,15,259
"81745",1081745,172,26,5,203
"81746",1081746,95,133,8,236
"81747",1081747,180,13,6,199
"81748",1081748,66,179,17,262
"81749",1081749,59,22,2,83
"81750",1081750,1,3,0,4
"81751",1081751,188,50,10,248
"81752",1081752,132,196,12,340
"81753",1081753,160,120,13,293
"81754",1081754,180,87,14,281
"81755",1081755,2,7,0,9
"81756",1081756,84,34,9,127
"81757",1081757,180,101,10,291
"81758",1081758,26,251,6,283
"81759",1081759,165,51,12,228
"81760",1081760,168,63,13,244
"81761",1081761,116,120,16,252
"81762",1081762,31,203,4,238
"81763",1081763,52,101,6,159
"81764",1081764,147,102,8,257
"81765",1081765,82,69,2,153
"81766",1081766,200,42,5,247
"81767",1081767,73,117,6,196
"81768",1081768,139,93,9,241
"81769",1081769,209,18,8,235
"81770",1081770,89,33,2,124
"81771",1081771,117,157,8,282
"81772",1081772,90,26,5,121
"81773",1081773,33,83,9,125
"81774",1081774,181,106,23,310
"81775",1081775,37,232,4,273
"81776",1081776,34,157,4,195
"81777",1081777,44,270,7,321
"81778",1081778,127,114,12,253
"81779",1081779,121,35,3,159
"81780",1081780,80,342,9,431
"81781",1081781,49,230,4,283
"81782",1081782,175,115,10,300
"81783",1081783,132,79,13,224
"81784",1081784,121,128,2,251
"81785",1081785,135,57,2,194
"81786",1081786,73,79,15,167
"81787",1081787,111,189,1,301
"81788",1081788,198,51,3,252
"81789",1081789,29,114,1,144
"81790",1081790,102,59,12,173
"81791",1081791,65,17,5,87
"81792",1081792,91,154,2,247
"81793",1081793,79,200,8,287
"81794",1081794,89,18,2,109
"81795",1081795,270,12,2,284
"81796",1081796,154,102,12,268
"81797",1081797,136,94,11,241
"81798",1081798,109,143,2,254
"81799",1081799,126,102,14,242
"81800",1081800,68,155,19,242
"81801",1081801,129,52,1,182
"81802",1081802,179,27,5,211
"81803",1081803,28,236,3,267
"81804",1081804,80,127,10,217
"81805",1081805,195,106,8,309
"81806",1081806,149,70,1,220
"81807",1081807,185,51,10,246
"81808",1081808,74,63,10,147
"81809",1081809,35,174,4,213
"81810",1081810,132,90,9,231
"81811",1081811,129,73,9,211
"81812",1081812,99,44,4,147
"81813",1081813,135,82,6,223
"81814",1081814,223,45,6,274
"81815",1081815,110,17,5,132
"81816",1081816,63,112,8,183
"81817",1081817,137,37,4,178
"81818",1081818,255,10,6,271
"81819",1081819,96,58,7,161
"81820",1081820,118,49,7,174
"81821",1081821,44,205,3,252
"81822",1081822,164,101,30,295
"81823",1081823,145,3,3,151
"81824",1081824,13,5,1,19
"81825",1081825,81,109,1,191
"81826",1081826,191,72,14,277
"81827",1081827,8,20,0,28
"81828",1081828,79,232,12,323
"81829",1081829,51,211,9,271
"81830",1081830,46,210,9,265
"81831",1081831,82,28,4,114
"81832",1081832,215,35,8,258
"81833",1081833,123,105,11,239
"81834",1081834,102,118,13,233
"81835",1081835,141,26,4,171
"81836",1081836,171,118,5,294
"81837",1081837,101,76,5,182
"81838",1081838,136,149,5,290
"81839",1081839,201,60,22,283
"81840",1081840,22,19,1,42
"81841",1081841,139,71,6,216
"81842",1081842,137,74,5,216
"81843",1081843,45,177,4,226
"81844",1081844,34,247,12,293
"81845",1081845,150,41,9,200
"81846",1081846,12,1,1,14
"81847",1081847,136,198,7,341
"81848",1081848,131,33,7,171
"81849",1081849,36,241,3,280
"81850",1081850,20,41,2,63
"81851",1081851,111,99,14,224
"81852",1081852,136,88,3,227
"81853",1081853,201,73,2,276
"81854",1081854,110,105,7,222
"81855",1081855,137,126,10,273
"81856",1081856,167,139,5,311
"81857",1081857,150,36,2,188
"81858",1081858,68,136,0,204
"81859",1081859,169,35,9,213
"81860",1081860,159,81,15,255
"81861",1081861,33,203,13,249
"81862",1081862,110,66,11,187
"81863",1081863,135,123,15,273
"81864",1081864,28,218,6,252
"81865",1081865,189,72,12,273
"81866",1081866,87,23,3,113
"81867",1081867,190,106,17,313
"81868",1081868,52,223,5,280
"81869",1081869,64,141,13,218
"81870",1081870,139,51,9,199
"81871",1081871,112,11,13,136
"81872",1081872,86,140,11,237
"81873",1081873,154,4,5,163
"81874",1081874,109,54,6,169
"81875",1081875,36,132,8,176
"81876",1081876,59,150,9,218
"81877",1081877,221,27,7,255
"81878",1081878,71,134,5,210
"81879",1081879,148,49,4,201
"81880",1081880,145,11,4,160
"81881",1081881,197,20,5,222
"81882",1081882,210,42,10,262
"81883",1081883,109,160,19,288
"81884",1081884,190,75,9,274
"81885",1081885,19,233,1,253
"81886",1081886,80,49,4,133
"81887",1081887,223,37,8,268
"81888",1081888,153,116,6,275
"81889",1081889,96,134,8,238
"81890",1081890,62,161,7,230
"81891",1081891,169,164,5,338
"81892",1081892,60,2,1,63
"81893",1081893,177,112,10,299
"81894",1081894,28,85,1,114
"81895",1081895,73,129,4,206
"81896",1081896,44,193,4,241
"81897",1081897,42,208,3,253
"81898",1081898,106,167,16,289
"81899",1081899,110,128,13,251
"81900",1081900,83,243,19,345
"81901",1081901,165,82,9,256
"81902",1081902,209,30,11,250
"81903",1081903,43,260,8,311
"81904",1081904,59,190,12,261
"81905",1081905,69,91,3,163
"81906",1081906,101,70,5,176
"81907",1081907,1,23,0,24
"81908",1081908,147,9,5,161
"81909",1081909,82,109,8,199
"81910",1081910,8,226,2,236
"81911",1081911,173,48,17,238
"81912",1081912,167,113,13,293
"81913",1081913,103,184,14,301
"81914",1081914,121,77,1,199
"81915",1081915,138,101,7,246
"81916",1081916,191,66,7,264
"81917",1081917,123,167,8,298
"81918",1081918,185,106,11,302
"81919",1081919,68,197,12,277
"81920",1081920,58,238,2,298
"81921",1081921,129,141,6,276
"81922",1081922,229,25,22,276
"81923",1081923,125,114,9,248
"81924",1081924,30,146,3,179
"81925",1081925,112,152,4,268
"81926",1081926,87,143,6,236
"81927",1081927,83,33,2,118
"81928",1081928,107,146,12,265
"81929",1081929,6,89,5,100
"81930",1081930,112,179,10,301
"81931",1081931,77,104,14,195
"81932",1081932,115,71,3,189
"81933",1081933,126,104,10,240
"81934",1081934,32,16,7,55
"81935",1081935,152,19,7,178
"81936",1081936,18,246,8,272
"81937",1081937,209,23,4,236
"81938",1081938,72,228,3,303
"81939",1081939,239,43,14,296
"81940",1081940,102,50,1,153
"81941",1081941,237,15,8,260
"81942",1081942,31,195,6,232
"81943",1081943,214,84,3,301
"81944",1081944,240,10,12,262
"81945",1081945,56,130,7,193
"81946",1081946,109,149,8,266
"81947",1081947,157,241,5,403
"81948",1081948,4,13,0,17
"81949",1081949,36,229,4,269
"81950",1081950,62,156,3,221
"81951",1081951,263,41,8,312
"81952",1081952,100,155,17,272
"81953",1081953,38,246,4,288
"81954",1081954,179,101,15,295
"81955",1081955,133,42,6,181
"81956",1081956,60,124,17,201
"81957",1081957,177,48,6,231
"81958",1081958,108,114,1,223
"81959",1081959,166,74,16,256
"81960",1081960,86,227,14,327
"81961",1081961,147,119,8,274
"81962",1081962,88,26,7,121
"81963",1081963,5,7,0,12
"81964",1081964,158,30,7,195
"81965",1081965,131,150,27,308
"81966",1081966,48,124,13,185
"81967",1081967,174,36,8,218
"81968",1081968,61,111,5,177
"81969",1081969,43,103,4,150
"81970",1081970,53,100,2,155
"81971",1081971,57,72,4,133
"81972",1081972,158,3,0,161
"81973",1081973,139,58,10,207
"81974",1081974,100,159,15,274
"81975",1081975,249,13,38,300
"81976",1081976,112,152,18,282
"81977",1081977,164,34,29,227
"81978",1081978,140,140,12,292
"81979",1081979,147,106,3,256
"81980",1081980,155,76,2,233
"81981",1081981,43,52,2,97
"81982",1081982,182,113,7,302
"81983",1081983,2,1,0,3
"81984",1081984,167,77,21,265
"81985",1081985,109,176,9,294
"81986",1081986,104,131,6,241
"81987",1081987,60,83,7,150
"81988",1081988,109,160,5,274
"81989",1081989,286,54,11,351
"81990",1081990,93,10,1,104
"81991",1081991,134,29,5,168
"81992",1081992,18,65,4,87
"81993",1081993,82,189,16,287
"81994",1081994,94,175,6,275
"81995",1081995,95,82,10,187
"81996",1081996,157,19,4,180
"81997",1081997,48,160,6,214
"81998",1081998,140,140,6,286
"81999",1081999,66,170,10,246
"82000",1082000,57,62,11,130
"82001",1082001,200,0,0,200
"82002",1082002,40,147,8,195
"82003",1082003,58,258,6,322
"82004",1082004,163,134,10,307
"82005",1082005,82,169,6,257
"82006",1082006,45,207,2,254
"82007",1082007,100,41,4,145
"82008",1082008,38,226,16,280
"82009",1082009,73,72,5,150
"82010",1082010,1,16,1,18
"82011",1082011,169,62,3,234
"82012",1082012,80,87,5,172
"82013",1082013,127,56,7,190
"82014",1082014,185,45,7,237
"82015",1082015,99,45,14,158
"82016",1082016,152,42,12,206
"82017",1082017,59,43,6,108
"82018",1082018,67,176,5,248
"82019",1082019,140,31,5,176
"82020",1082020,80,135,13,228
"82021",1082021,32,38,4,74
"82022",1082022,127,114,5,246
"82023",1082023,269,1,2,272
"82024",1082024,144,130,6,280
"82025",1082025,138,12,8,158
"82026",1082026,88,183,13,284
"82027",1082027,138,127,9,274
"82028",1082028,135,118,16,269
"82029",1082029,44,181,8,233
"82030",1082030,218,37,10,265
"82031",1082031,200,36,6,242
"82032",1082032,119,30,10,159
"82033",1082033,28,37,5,70
"82034",1082034,113,135,11,259
"82035",1082035,133,108,10,251
"82036",1082036,99,133,10,242
"82037",1082037,42,195,1,238
"82038",1082038,194,65,9,268
"82039",1082039,34,273,4,311
"82040",1082040,145,58,2,205
"82041",1082041,161,57,8,226
"82042",1082042,104,20,0,124
"82043",1082043,87,179,14,280
"82044",1082044,89,182,10,281
"82045",1082045,60,124,10,194
"82046",1082046,82,168,10,260
"82047",1082047,228,25,9,262
"82048",1082048,79,46,8,133
"82049",1082049,71,114,2,187
"82050",1082050,99,92,10,201
"82051",1082051,164,55,3,222
"82052",1082052,11,47,0,58
"82053",1082053,132,52,4,188
"82054",1082054,131,153,24,308
"82055",1082055,137,154,25,316
"82056",1082056,169,115,14,298
"82057",1082057,133,38,1,172
"82058",1082058,56,69,4,129
"82059",1082059,23,231,8,262
"82060",1082060,215,99,18,332
"82061",1082061,150,66,4,220
"82062",1082062,123,38,5,166
"82063",1082063,204,61,5,270
"82064",1082064,50,178,4,232
"82065",1082065,55,8,5,68
"82066",1082066,161,70,1,232
"82067",1082067,186,56,2,244
"82068",1082068,89,62,7,158
"82069",1082069,83,54,1,138
"82070",1082070,41,206,4,251
"82071",1082071,37,222,4,263
"82072",1082072,4,78,0,82
"82073",1082073,90,186,8,284
"82074",1082074,112,160,9,281
"82075",1082075,187,58,7,252
"82076",1082076,121,91,10,222
"82077",1082077,181,90,20,291
"82078",1082078,27,138,3,168
"82079",1082079,149,142,66,357
"82080",1082080,84,193,5,282
"82081",1082081,132,99,4,235
"82082",1082082,77,203,15,295
"82083",1082083,76,72,2,150
"82084",1082084,80,165,3,248
"82085",1082085,108,147,24,279
"82086",1082086,23,95,3,121
"82087",1082087,62,187,16,265
"82088",1082088,174,24,9,207
"82089",1082089,182,72,15,269
"82090",1082090,209,67,19,295
"82091",1082091,78,26,3,107
"82092",1082092,66,141,2,209
"82093",1082093,114,96,3,213
"82094",1082094,34,218,3,255
"82095",1082095,52,219,8,279
"82096",1082096,130,159,22,311
"82097",1082097,108,31,3,142
"82098",1082098,10,6,1,17
"82099",1082099,132,365,7,504
"82100",1082100,126,96,8,230
"82101",1082101,28,241,3,272
"82102",1082102,88,122,6,216
"82103",1082103,119,160,5,284
"82104",1082104,95,41,10,146
"82105",1082105,97,187,6,290
"82106",1082106,121,12,8,141
"82107",1082107,82,108,12,202
"82108",1082108,149,73,11,233
"82109",1082109,47,50,0,97
"82110",1082110,48,127,14,189
"82111",1082111,32,231,2,265
"82112",1082112,165,66,12,243
"82113",1082113,146,123,6,275
"82114",1082114,146,78,5,229
"82115",1082115,41,248,2,291
"82116",1082116,189,10,14,213
"82117",1082117,32,13,3,48
"82118",1082118,100,98,9,207
"82119",1082119,76,71,9,156
"82120",1082120,78,199,12,289
"82121",1082121,6,192,0,198
"82122",1082122,81,141,10,232
"82123",1082123,295,12,0,307
"82124",1082124,125,58,6,189
"82125",1082125,193,32,9,234
"82126",1082126,102,105,27,234
"82127",1082127,80,62,5,147
"82128",1082128,162,58,7,227
"82129",1082129,97,166,18,281
"82130",1082130,136,106,4,246
"82131",1082131,42,241,3,286
"82132",1082132,8,3,0,11
"82133",1082133,98,51,5,154
"82134",1082134,192,22,5,219
"82135",1082135,102,32,3,137
"82136",1082136,9,32,1,42
"82137",1082137,67,116,1,184
"82138",1082138,35,6,0,41
"82139",1082139,195,44,5,244
"82140",1082140,104,94,6,204
"82141",1082141,112,55,11,178
"82142",1082142,122,93,6,221
"82143",1082143,56,201,6,263
"82144",1082144,108,108,4,220
"82145",1082145,36,134,7,177
"82146",1082146,66,187,13,266
"82147",1082147,103,39,11,153
"82148",1082148,109,173,10,292
"82149",1082149,63,139,9,211
"82150",1082150,81,110,9,200
"82151",1082151,45,85,3,133
"82152",1082152,93,157,4,254
"82153",1082153,13,11,1,25
"82154",1082154,59,170,7,236
"82155",1082155,133,48,8,189
"82156",1082156,102,219,13,334
"82157",1082157,143,116,16,275
"82158",1082158,189,76,9,274
"82159",1082159,51,256,1,308
"82160",1082160,96,97,13,206
"82161",1082161,63,167,5,235
"82162",1082162,185,80,3,268
"82163",1082163,144,126,9,279
"82164",1082164,82,137,4,223
"82165",1082165,97,33,6,136
"82166",1082166,236,11,3,250
"82167",1082167,105,153,8,266
"82168",1082168,170,78,8,256
"82169",1082169,51,167,17,235
"82170",1082170,72,24,2,98
"82171",1082171,41,140,1,182
"82172",1082172,101,105,1,207
"82173",1082173,157,98,14,269
"82174",1082174,74,257,2,333
"82175",1082175,135,27,8,170
"82176",1082176,136,13,1,150
"82177",1082177,78,217,5,300
"82178",1082178,35,116,5,156
"82179",1082179,184,60,16,260
"82180",1082180,75,176,8,259
"82181",1082181,58,160,4,222
"82182",1082182,210,66,9,285
"82183",1082183,37,228,3,268
"82184",1082184,140,76,7,223
"82185",1082185,178,27,14,219
"82186",1082186,47,204,5,256
"82187",1082187,40,215,3,258
"82188",1082188,179,47,11,237
"82189",1082189,197,125,19,341
"82190",1082190,220,65,9,294
"82191",1082191,1,1,0,2
"82192",1082192,245,70,6,321
"82193",1082193,7,9,2,18
"82194",1082194,94,182,13,289
"82195",1082195,65,213,9,287
"82196",1082196,55,101,4,160
"82197",1082197,135,137,8,280
"82198",1082198,109,149,16,274
"82199",1082199,61,14,3,78
"82200",1082200,151,138,9,298
"82201",1082201,132,1,1,134
"82202",1082202,250,66,10,326
"82203",1082203,73,197,4,274
"82204",1082204,62,122,35,219
"82205",1082205,117,161,17,295
"82206",1082206,29,243,4,276
"82207",1082207,230,32,5,267
"82208",1082208,52,182,5,239
"82209",1082209,102,129,14,245
"82210",1082210,13,189,0,202
"82211",1082211,190,39,3,232
"82212",1082212,61,62,3,126
"82213",1082213,58,135,14,207
"82214",1082214,116,163,21,300
"82215",1082215,114,120,14,248
"82216",1082216,98,122,5,225
"82217",1082217,217,16,4,237
"82218",1082218,75,107,4,186
"82219",1082219,25,86,1,112
"82220",1082220,140,62,10,212
"82221",1082221,192,52,5,249
"82222",1082222,169,52,15,236
"82223",1082223,86,80,10,176
"82224",1082224,141,150,22,313
"82225",1082225,142,37,5,184
"82226",1082226,110,166,29,305
"82227",1082227,132,57,11,200
"82228",1082228,55,25,1,81
"82229",1082229,210,64,12,286
"82230",1082230,29,11,3,43
"82231",1082231,172,59,2,233
"82232",1082232,78,221,12,311
"82233",1082233,113,37,5,155
"82234",1082234,128,28,6,162
"82235",1082235,14,147,4,165
"82236",1082236,69,193,5,267
"82237",1082237,95,75,2,172
"82238",1082238,117,164,6,287
"82239",1082239,38,282,5,325
"82240",1082240,199,5,1,205
"82241",1082241,84,51,6,141
"82242",1082242,38,215,2,255
"82243",1082243,45,252,5,302
"82244",1082244,115,61,9,185
"82245",1082245,107,118,12,237
"82246",1082246,54,56,7,117
"82247",1082247,150,38,5,193
"82248",1082248,219,49,18,286
"82249",1082249,117,28,5,150
"82250",1082250,183,124,13,320
"82251",1082251,72,65,4,141
"82252",1082252,169,127,11,307
"82253",1082253,134,52,4,190
"82254",1082254,132,75,3,210
"82255",1082255,189,34,10,233
"82256",1082256,112,77,8,197
"82257",1082257,6,12,0,18
"82258",1082258,121,48,2,171
"82259",1082259,165,99,5,269
"82260",1082260,77,133,0,210
"82261",1082261,40,80,2,122
"82262",1082262,93,42,11,146
"82263",1082263,86,207,6,299
"82264",1082264,122,44,0,166
"82265",1082265,207,39,12,258
"82266",1082266,47,241,4,292
"82267",1082267,66,179,11,256
"82268",1082268,142,93,14,249
"82269",1082269,163,54,18,235
"82270",1082270,151,78,8,237
"82271",1082271,30,24,3,57
"82272",1082272,31,285,5,321
"82273",1082273,82,96,6,184
"82274",1082274,43,62,4,109
"82275",1082275,194,42,6,242
"82276",1082276,108,45,8,161
"82277",1082277,195,43,7,245
"82278",1082278,191,38,12,241
"82279",1082279,60,167,9,236
"82280",1082280,111,192,2,305
"82281",1082281,151,68,3,222
"82282",1082282,79,150,14,243
"82283",1082283,67,58,4,129
"82284",1082284,97,162,7,266
"82285",1082285,192,4,5,201
"82286",1082286,55,84,6,145
"82287",1082287,71,127,4,202
"82288",1082288,138,131,13,282
"82289",1082289,36,259,9,304
"82290",1082290,197,76,9,282
"82291",1082291,231,34,9,274
"82292",1082292,37,150,1,188
"82293",1082293,23,221,6,250
"82294",1082294,40,217,4,261
"82295",1082295,14,218,3,235
"82296",1082296,233,48,8,289
"82297",1082297,5,43,1,49
"82298",1082298,127,109,13,249
"82299",1082299,265,57,13,335
"82300",1082300,166,11,0,177
"82301",1082301,48,218,3,269
"82302",1082302,193,25,7,225
"82303",1082303,79,200,3,282
"82304",1082304,219,22,5,246
"82305",1082305,173,25,3,201
"82306",1082306,116,88,7,211
"82307",1082307,3,5,2,10
"82308",1082308,60,1,2,63
"82309",1082309,157,28,2,187
"82310",1082310,62,195,16,273
"82311",1082311,200,88,7,295
"82312",1082312,176,96,9,281
"82313",1082313,137,83,12,232
"82314",1082314,82,86,2,170
"82315",1082315,110,72,2,184
"82316",1082316,106,128,5,239
"82317",1082317,89,144,9,242
"82318",1082318,124,173,23,320
"82319",1082319,174,50,6,230
"82320",1082320,223,16,14,253
"82321",1082321,156,39,18,213
"82322",1082322,155,114,6,275
"82323",1082323,240,27,10,277
"82324",1082324,160,56,0,216
"82325",1082325,208,81,18,307
"82326",1082326,110,223,12,345
"82327",1082327,166,65,4,235
"82328",1082328,36,212,3,251
"82329",1082329,188,55,0,243
"82330",1082330,102,83,8,193
"82331",1082331,25,174,2,201
"82332",1082332,33,249,4,286
"82333",1082333,111,51,4,166
"82334",1082334,135,102,6,243
"82335",1082335,67,201,3,271
"82336",1082336,93,185,8,286
"82337",1082337,86,43,4,133
"82338",1082338,90,174,9,273
"82339",1082339,163,121,3,287
"82340",1082340,45,202,7,254
"82341",1082341,44,252,8,304
"82342",1082342,82,97,3,182
"82343",1082343,167,104,13,284
"82344",1082344,92,172,5,269
"82345",1082345,36,149,6,191
"82346",1082346,106,149,5,260
"82347",1082347,57,168,9,234
"82348",1082348,230,71,11,312
"82349",1082349,142,48,2,192
"82350",1082350,129,93,0,222
"82351",1082351,75,108,7,190
"82352",1082352,119,91,15,225
"82353",1082353,111,105,1,217
"82354",1082354,87,101,5,193
"82355",1082355,167,74,7,248
"82356",1082356,106,69,8,183
"82357",1082357,153,137,22,312
"82358",1082358,81,106,7,194
"82359",1082359,113,84,7,204
"82360",1082360,46,248,7,301
"82361",1082361,59,0,0,59
"82362",1082362,87,156,2,245
"82363",1082363,57,73,2,132
"82364",1082364,37,4,4,45
"82365",1082365,145,75,13,233
"82366",1082366,81,177,7,265
"82367",1082367,67,99,1,167
"82368",1082368,146,79,3,228
"82369",1082369,200,75,14,289
"82370",1082370,8,65,1,74
"82371",1082371,181,88,18,287
"82372",1082372,84,131,7,222
"82373",1082373,120,76,8,204
"82374",1082374,79,116,5,200
"82375",1082375,24,75,8,107
"82376",1082376,161,127,12,300
"82377",1082377,106,106,8,220
"82378",1082378,101,66,3,170
"82379",1082379,135,146,16,297
"82380",1082380,18,209,3,230
"82381",1082381,161,45,10,216
"82382",1082382,2,165,2,169
"82383",1082383,194,23,2,219
"82384",1082384,34,249,6,289
"82385",1082385,122,48,12,182
"82386",1082386,34,243,9,286
"82387",1082387,99,189,5,293
"82388",1082388,58,128,5,191
"82389",1082389,143,30,2,175
"82390",1082390,170,90,19,279
"82391",1082391,172,44,7,223
"82392",1082392,170,84,13,267
"82393",1082393,153,43,14,210
"82394",1082394,52,205,3,260
"82395",1082395,192,52,10,254
"82396",1082396,207,67,4,278
"82397",1082397,61,180,20,261
"82398",1082398,108,114,12,234
"82399",1082399,55,1,0,56
"82400",1082400,109,3,0,112
"82401",1082401,47,193,4,244
"82402",1082402,34,138,4,176
"82403",1082403,153,95,7,255
"82404",1082404,268,49,7,324
"82405",1082405,195,32,12,239
"82406",1082406,124,113,5,242
"82407",1082407,203,40,10,253
"82408",1082408,156,49,8,213
"82409",1082409,139,169,19,327
"82410",1082410,55,53,2,110
"82411",1082411,3,20,0,23
"82412",1082412,180,70,9,259
"82413",1082413,247,76,17,340
"82414",1082414,145,37,12,194
"82415",1082415,140,51,10,201
"82416",1082416,128,98,7,233
"82417",1082417,142,10,7,159
"82418",1082418,150,136,7,293
"82419",1082419,93,207,27,327
"82420",1082420,25,210,3,238
"82421",1082421,116,192,12,320
"82422",1082422,119,88,7,214
"82423",1082423,134,44,9,187
"82424",1082424,92,157,12,261
"82425",1082425,90,88,9,187
"82426",1082426,103,86,9,198
"82427",1082427,87,31,2,120
"82428",1082428,23,162,9,194
"82429",1082429,107,155,10,272
"82430",1082430,41,256,6,303
"82431",1082431,64,31,2,97
"82432",1082432,103,83,11,197
"82433",1082433,211,34,11,256
"82434",1082434,195,11,3,209
"82435",1082435,79,142,17,238
"82436",1082436,166,17,5,188
"82437",1082437,141,85,8,234
"82438",1082438,99,30,1,130
"82439",1082439,156,61,6,223
"82440",1082440,102,14,3,119
"82441",1082441,137,80,6,223
"82442",1082442,205,8,4,217
"82443",1082443,111,119,6,236
"82444",1082444,221,39,11,271
"82445",1082445,78,32,5,115
"82446",1082446,196,76,10,282
"82447",1082447,71,79,7,157
"82448",1082448,70,173,15,258
"82449",1082449,74,85,5,164
"82450",1082450,115,119,13,247
"82451",1082451,130,13,5,148
"82452",1082452,237,17,9,263
"82453",1082453,191,14,4,209
"82454",1082454,64,208,3,275
"82455",1082455,44,239,5,288
"82456",1082456,104,43,8,155
"82457",1082457,59,84,2,145
"82458",1082458,62,27,1,90
"82459",1082459,31,272,6,309
"82460",1082460,28,126,0,154
"82461",1082461,112,106,9,227
"82462",1082462,37,258,6,301
"82463",1082463,157,82,4,243
"82464",1082464,70,174,6,250
"82465",1082465,115,68,4,187
"82466",1082466,103,106,11,220
"82467",1082467,28,193,3,224
"82468",1082468,102,141,5,248
"82469",1082469,44,137,11,192
"82470",1082470,208,53,12,273
"82471",1082471,145,118,6,269
"82472",1082472,203,39,9,251
"82473",1082473,118,62,8,188
"82474",1082474,136,39,1,176
"82475",1082475,155,78,8,241
"82476",1082476,119,59,4,182
"82477",1082477,153,8,2,163
"82478",1082478,101,73,7,181
"82479",1082479,12,60,3,75
"82480",1082480,155,99,7,261
"82481",1082481,52,175,4,231
"82482",1082482,212,12,4,228
"82483",1082483,17,90,1,108
"82484",1082484,124,184,11,319
"82485",1082485,173,60,13,246
"82486",1082486,135,102,9,246
"82487",1082487,156,68,9,233
"82488",1082488,158,51,4,213
"82489",1082489,64,245,0,309
"82490",1082490,87,189,12,288
"82491",1082491,88,144,9,241
"82492",1082492,29,76,0,105
"82493",1082493,103,121,1,225
"82494",1082494,186,10,4,200
"82495",1082495,190,78,13,281
"82496",1082496,62,87,3,152
"82497",1082497,149,80,0,229
"82498",1082498,95,141,24,260
"82499",1082499,63,212,4,279
"82500",1082500,89,196,20,305
"82501",1082501,166,42,6,214
"82502",1082502,75,206,16,297
"82503",1082503,4,9,0,13
"82504",1082504,2,18,1,21
"82505",1082505,143,51,4,198
"82506",1082506,127,82,10,219
"82507",1082507,209,29,9,247
"82508",1082508,78,169,5,252
"82509",1082509,46,165,8,219
"82510",1082510,169,23,8,200
"82511",1082511,168,41,3,212
"82512",1082512,142,125,2,269
"82513",1082513,285,12,14,311
"82514",1082514,214,69,8,291
"82515",1082515,167,42,1,210
"82516",1082516,76,194,4,274
"82517",1082517,180,75,18,273
"82518",1082518,73,144,17,234
"82519",1082519,139,91,15,245
"82520",1082520,20,131,3,154
"82521",1082521,98,104,11,213
"82522",1082522,80,258,2,340
"82523",1082523,169,41,10,220
"82524",1082524,129,11,2,142
"82525",1082525,39,257,5,301
"82526",1082526,105,18,4,127
"82527",1082527,143,120,3,266
"82528",1082528,130,23,2,155
"82529",1082529,234,43,3,280
"82530",1082530,48,122,3,173
"82531",1082531,169,33,2,204
"82532",1082532,119,31,9,159
"82533",1082533,135,100,10,245
"82534",1082534,140,78,12,230
"82535",1082535,84,63,3,150
"82536",1082536,47,254,7,308
"82537",1082537,165,90,19,274
"82538",1082538,174,50,7,231
"82539",1082539,207,54,12,273
"82540",1082540,192,74,9,275
"82541",1082541,20,1,1,22
"82542",1082542,184,198,19,401
"82543",1082543,49,108,5,162
"82544",1082544,174,55,8,237
"82545",1082545,68,32,4,104
"82546",1082546,86,107,1,194
"82547",1082547,74,132,11,217
"82548",1082548,125,80,10,215
"82549",1082549,215,113,6,334
"82550",1082550,86,194,6,286
"82551",1082551,91,157,18,266
"82552",1082552,226,67,18,311
"82553",1082553,109,151,16,276
"82554",1082554,56,86,5,147
"82555",1082555,117,196,3,316
"82556",1082556,175,109,7,291
"82557",1082557,137,121,8,266
"82558",1082558,93,56,5,154
"82559",1082559,114,159,10,283
"82560",1082560,10,65,1,76
"82561",1082561,173,131,15,319
"82562",1082562,72,105,9,186
"82563",1082563,42,114,3,159
"82564",1082564,67,121,6,194
"82565",1082565,74,195,31,300
"82566",1082566,78,171,9,258
"82567",1082567,194,55,4,253
"82568",1082568,107,110,7,224
"82569",1082569,112,152,15,279
"82570",1082570,40,184,7,231
"82571",1082571,132,59,4,195
"82572",1082572,159,59,1,219
"82573",1082573,183,31,6,220
"82574",1082574,85,33,2,120
"82575",1082575,112,68,5,185
"82576",1082576,93,119,21,233
"82577",1082577,48,86,0,134
"82578",1082578,33,245,4,282
"82579",1082579,224,50,14,288
"82580",1082580,84,33,2,119
"82581",1082581,179,26,5,210
"82582",1082582,51,79,3,133
"82583",1082583,126,60,10,196
"82584",1082584,157,51,5,213
"82585",1082585,73,199,8,280
"82586",1082586,121,142,17,280
"82587",1082587,79,184,7,270
"82588",1082588,126,21,0,147
"82589",1082589,162,112,9,283
"82590",1082590,13,124,5,142
"82591",1082591,150,6,4,160
"82592",1082592,99,183,10,292
"82593",1082593,107,63,4,174
"82594",1082594,104,55,6,165
"82595",1082595,92,183,5,280
"82596",1082596,187,43,9,239
"82597",1082597,57,193,4,254
"82598",1082598,269,36,10,315
"82599",1082599,59,246,20,325
"82600",1082600,150,62,6,218
"82601",1082601,121,7,24,152
"82602",1082602,68,133,16,217
"82603",1082603,152,120,17,289
"82604",1082604,14,252,7,273
"82605",1082605,186,26,6,218
"82606",1082606,61,26,6,93
"82607",1082607,65,204,11,280
"82608",1082608,196,25,7,228
"82609",1082609,148,105,7,260
"82610",1082610,121,44,12,177
"82611",1082611,113,70,6,189
"82612",1082612,113,119,10,242
"82613",1082613,92,153,18,263
"82614",1082614,153,39,7,199
"82615",1082615,31,64,9,104
"82616",1082616,95,242,9,346
"82617",1082617,178,61,11,250
"82618",1082618,190,13,5,208
"82619",1082619,77,159,11,247
"82620",1082620,37,7,1,45
"82621",1082621,141,34,7,182
"82622",1082622,237,220,13,470
"82623",1082623,29,135,2,166
"82624",1082624,26,294,2,322
"82625",1082625,216,19,2,237
"82626",1082626,200,22,8,230
"82627",1082627,156,36,7,199
"82628",1082628,65,36,4,105
"82629",1082629,115,127,17,259
"82630",1082630,132,116,1,249
"82631",1082631,77,192,5,274
"82632",1082632,93,73,11,177
"82633",1082633,80,27,4,111
"82634",1082634,93,150,11,254
"82635",1082635,320,85,20,425
"82636",1082636,9,8,0,17
"82637",1082637,91,189,6,286
"82638",1082638,115,65,6,186
"82639",1082639,108,9,2,119
"82640",1082640,125,96,7,228
"82641",1082641,74,50,4,128
"82642",1082642,107,155,9,271
"82643",1082643,35,168,7,210
"82644",1082644,53,27,0,80
"82645",1082645,158,124,10,292
"82646",1082646,138,90,9,237
"82647",1082647,118,190,12,320
"82648",1082648,38,16,2,56
"82649",1082649,16,10,0,26
"82650",1082650,94,60,1,155
"82651",1082651,32,167,9,208
"82652",1082652,147,61,12,220
"82653",1082653,67,111,5,183
"82654",1082654,252,58,10,320
"82655",1082655,143,153,15,311
"82656",1082656,189,35,4,228
"82657",1082657,38,277,2,317
"82658",1082658,97,157,14,268
"82659",1082659,94,129,8,231
"82660",1082660,169,61,6,236
"82661",1082661,56,257,6,319
"82662",1082662,45,74,7,126
"82663",1082663,139,136,10,285
"82664",1082664,107,170,3,280
"82665",1082665,105,122,6,233
"82666",1082666,212,77,23,312
"82667",1082667,103,160,21,284
"82668",1082668,138,65,3,206
"82669",1082669,112,87,5,204
"82670",1082670,86,205,10,301
"82671",1082671,131,88,3,222
"82672",1082672,44,115,0,159
"82673",1082673,47,228,3,278
"82674",1082674,44,14,2,60
"82675",1082675,70,147,18,235
"82676",1082676,176,95,9,280
"82677",1082677,136,54,10,200
"82678",1082678,110,274,9,393
"82679",1082679,68,190,7,265
"82680",1082680,302,106,19,427
"82681",1082681,91,53,3,147
"82682",1082682,37,220,6,263
"82683",1082683,69,14,2,85
"82684",1082684,21,9,1,31
"82685",1082685,107,107,12,226
"82686",1082686,60,55,5,120
"82687",1082687,38,27,2,67
"82688",1082688,113,53,3,169
"82689",1082689,62,148,10,220
"82690",1082690,115,173,15,303
"82691",1082691,57,133,11,201
"82692",1082692,144,50,2,196
"82693",1082693,216,78,13,307
"82694",1082694,101,187,8,296
"82695",1082695,35,52,2,89
"82696",1082696,38,105,5,148
"82697",1082697,130,125,9,264
"82698",1082698,47,261,1,309
"82699",1082699,47,216,5,268
"82700",1082700,147,64,2,213
"82701",1082701,150,29,5,184
"82702",1082702,56,219,6,281
"82703",1082703,90,134,6,230
"82704",1082704,128,127,22,277
"82705",1082705,105,60,11,176
"82706",1082706,163,42,5,210
"82707",1082707,218,82,14,314
"82708",1082708,155,44,9,208
"82709",1082709,162,112,24,298
"82710",1082710,13,113,8,134
"82711",1082711,150,114,15,279
"82712",1082712,159,20,5,184
"82713",1082713,91,130,8,229
"82714",1082714,78,123,13,214
"82715",1082715,110,176,7,293
"82716",1082716,55,140,11,206
"82717",1082717,54,220,7,281
"82718",1082718,139,77,7,223
"82719",1082719,8,8,0,16
"82720",1082720,34,62,1,97
"82721",1082721,164,17,2,183
"82722",1082722,158,56,13,227
"82723",1082723,37,263,3,303
"82724",1082724,134,30,7,171
"82725",1082725,168,88,12,268
"82726",1082726,30,188,2,220
"82727",1082727,134,16,5,155
"82728",1082728,30,44,2,76
"82729",1082729,58,196,10,264
"82730",1082730,116,163,12,291
"82731",1082731,78,153,14,245
"82732",1082732,159,26,4,189
"82733",1082733,37,224,1,262
"82734",1082734,186,27,3,216
"82735",1082735,92,40,6,138
"82736",1082736,53,220,6,279
"82737",1082737,149,117,16,282
"82738",1082738,129,165,8,302
"82739",1082739,157,85,24,266
"82740",1082740,187,92,17,296
"82741",1082741,125,174,4,303
"82742",1082742,57,111,9,177
"82743",1082743,85,85,1,171
"82744",1082744,211,63,8,282
"82745",1082745,126,53,10,189
"82746",1082746,85,80,1,166
"82747",1082747,107,83,18,208
"82748",1082748,62,154,7,223
"82749",1082749,179,132,5,316
"82750",1082750,14,7,0,21
"82751",1082751,154,59,9,222
"82752",1082752,63,153,17,233
"82753",1082753,119,66,10,195
"82754",1082754,157,78,5,240
"82755",1082755,138,143,7,288
"82756",1082756,81,71,5,157
"82757",1082757,49,225,3,277
"82758",1082758,119,121,18,258
"82759",1082759,160,80,2,242
"82760",1082760,210,38,5,253
"82761",1082761,17,137,8,162
"82762",1082762,92,214,32,338
"82763",1082763,35,267,1,303
"82764",1082764,27,244,9,280
"82765",1082765,150,95,3,248
"82766",1082766,66,37,5,108
"82767",1082767,115,203,12,330
"82768",1082768,105,161,5,271
"82769",1082769,133,136,10,279
"82770",1082770,138,7,4,149
"82771",1082771,124,85,5,214
"82772",1082772,106,57,8,171
"82773",1082773,46,193,8,247
"82774",1082774,122,54,3,179
"82775",1082775,52,38,4,94
"82776",1082776,44,47,3,94
"82777",1082777,55,56,8,119
"82778",1082778,77,179,23,279
"82779",1082779,164,59,12,235
"82780",1082780,122,150,24,296
"82781",1082781,170,62,4,236
"82782",1082782,52,198,7,257
"82783",1082783,161,105,5,271
"82784",1082784,209,23,10,242
"82785",1082785,120,109,14,243
"82786",1082786,134,93,4,231
"82787",1082787,113,78,5,196
"82788",1082788,156,60,5,221
"82789",1082789,150,138,15,303
"82790",1082790,179,55,8,242
"82791",1082791,86,63,2,151
"82792",1082792,134,140,14,288
"82793",1082793,129,185,17,331
"82794",1082794,176,102,16,294
"82795",1082795,166,49,15,230
"82796",1082796,35,257,4,296
"82797",1082797,65,157,6,228
"82798",1082798,148,136,3,287
"82799",1082799,151,78,9,238
"82800",1082800,13,213,3,229
"82801",1082801,93,92,7,192
"82802",1082802,17,258,3,278
"82803",1082803,96,40,5,141
"82804",1082804,124,53,6,183
"82805",1082805,131,105,2,238
"82806",1082806,89,47,6,142
"82807",1082807,155,35,8,198
"82808",1082808,124,69,8,201
"82809",1082809,210,50,7,267
"82810",1082810,82,144,5,231
"82811",1082811,125,91,15,231
"82812",1082812,133,150,13,296
"82813",1082813,99,195,24,318
"82814",1082814,179,81,10,270
"82815",1082815,168,116,21,305
"82816",1082816,173,83,5,261
"82817",1082817,93,157,9,259
"82818",1082818,6,41,1,48
"82819",1082819,36,1,2,39
"82820",1082820,161,115,12,288
"82821",1082821,74,160,8,242
"82822",1082822,82,86,6,174
"82823",1082823,92,34,2,128
"82824",1082824,16,15,1,32
"82825",1082825,119,211,7,337
"82826",1082826,38,215,1,254
"82827",1082827,173,29,4,206
"82828",1082828,116,53,7,176
"82829",1082829,108,148,15,271
"82830",1082830,258,35,5,298
"82831",1082831,148,49,5,202
"82832",1082832,99,33,4,136
"82833",1082833,87,140,3,230
"82834",1082834,59,163,17,239
"82835",1082835,101,77,3,181
"82836",1082836,205,90,6,301
"82837",1082837,254,11,14,279
"82838",1082838,194,33,10,237
"82839",1082839,69,102,11,182
"82840",1082840,97,48,2,147
"82841",1082841,58,51,3,112
"82842",1082842,132,77,16,225
"82843",1082843,74,203,8,285
"82844",1082844,148,183,8,339
"82845",1082845,116,177,3,296
"82846",1082846,80,161,8,249
"82847",1082847,132,75,3,210
"82848",1082848,157,101,7,265
"82849",1082849,100,49,1,150
"82850",1082850,174,88,14,276
"82851",1082851,171,112,13,296
"82852",1082852,139,36,3,178
"82853",1082853,13,31,0,44
"82854",1082854,126,53,5,184
"82855",1082855,51,103,16,170
"82856",1082856,90,220,11,321
"82857",1082857,99,154,7,260
"82858",1082858,61,33,7,101
"82859",1082859,96,136,17,249
"82860",1082860,123,120,15,258
"82861",1082861,59,269,5,333
"82862",1082862,90,122,14,226
"82863",1082863,100,128,9,237
"82864",1082864,119,124,4,247
"82865",1082865,133,98,2,233
"82866",1082866,160,15,4,179
"82867",1082867,129,149,8,286
"82868",1082868,4,63,1,68
"82869",1082869,86,160,7,253
"82870",1082870,65,192,4,261
"82871",1082871,178,35,6,219
"82872",1082872,61,34,4,99
"82873",1082873,84,178,7,269
"82874",1082874,88,64,12,164
"82875",1082875,127,122,14,263
"82876",1082876,125,108,12,245
"82877",1082877,41,146,3,190
"82878",1082878,179,69,10,258
"82879",1082879,163,48,7,218
"82880",1082880,133,54,3,190
"82881",1082881,106,88,2,196
"82882",1082882,56,102,3,161
"82883",1082883,287,37,7,331
"82884",1082884,3,114,1,118
"82885",1082885,75,6,1,82
"82886",1082886,106,89,2,197
"82887",1082887,143,35,5,183
"82888",1082888,95,127,10,232
"82889",1082889,53,93,13,159
"82890",1082890,104,27,4,135
"82891",1082891,16,8,0,24
"82892",1082892,28,101,6,135
"82893",1082893,106,59,8,173
"82894",1082894,169,57,13,239
"82895",1082895,49,139,3,191
"82896",1082896,47,30,2,79
"82897",1082897,149,55,4,208
"82898",1082898,18,7,2,27
"82899",1082899,82,118,9,209
"82900",1082900,14,3,2,19
"82901",1082901,139,92,4,235
"82902",1082902,122,49,6,177
"82903",1082903,66,138,27,231
"82904",1082904,78,190,11,279
"82905",1082905,201,34,22,257
"82906",1082906,76,233,10,319
"82907",1082907,23,116,3,142
"82908",1082908,106,135,7,248
"82909",1082909,58,146,10,214
"82910",1082910,60,78,3,141
"82911",1082911,127,29,4,160
"82912",1082912,70,217,6,293
"82913",1082913,278,14,10,302
"82914",1082914,48,102,4,154
"82915",1082915,116,114,2,232
"82916",1082916,19,206,2,227
"82917",1082917,60,115,12,187
"82918",1082918,229,48,6,283
"82919",1082919,107,190,8,305
"82920",1082920,127,176,18,321
"82921",1082921,76,183,17,276
"82922",1082922,23,4,4,31
"82923",1082923,12,246,8,266
"82924",1082924,98,152,6,256
"82925",1082925,153,70,3,226
"82926",1082926,101,89,8,198
"82927",1082927,52,232,8,292
"82928",1082928,15,175,3,193
"82929",1082929,53,125,24,202
"82930",1082930,99,50,2,151
"82931",1082931,103,145,8,256
"82932",1082932,1,7,0,8
"82933",1082933,187,16,8,211
"82934",1082934,68,240,4,312
"82935",1082935,50,214,1,265
"82936",1082936,197,62,12,271
"82937",1082937,9,25,3,37
"82938",1082938,148,12,8,168
"82939",1082939,43,27,2,72
"82940",1082940,95,191,12,298
"82941",1082941,140,79,4,223
"82942",1082942,153,42,12,207
"82943",1082943,194,72,3,269
"82944",1082944,121,89,2,212
"82945",1082945,143,111,15,269
"82946",1082946,32,11,0,43
"82947",1082947,176,109,11,296
"82948",1082948,200,36,8,244
"82949",1082949,38,177,3,218
"82950",1082950,141,125,13,279
"82951",1082951,38,243,5,286
"82952",1082952,93,172,11,276
"82953",1082953,95,174,10,279
"82954",1082954,8,1,0,9
"82955",1082955,33,218,8,259
"82956",1082956,109,165,15,289
"82957",1082957,91,119,12,222
"82958",1082958,184,37,11,232
"82959",1082959,95,95,10,200
"82960",1082960,60,167,9,236
"82961",1082961,225,38,10,273
"82962",1082962,84,172,7,263
"82963",1082963,145,8,7,160
"82964",1082964,134,79,12,225
"82965",1082965,32,20,1,53
"82966",1082966,108,90,4,202
"82967",1082967,76,15,5,96
"82968",1082968,159,117,1,277
"82969",1082969,135,73,7,215
"82970",1082970,127,176,12,315
"82971",1082971,139,158,11,308
"82972",1082972,129,144,13,286
"82973",1082973,127,82,8,217
"82974",1082974,50,218,9,277
"82975",1082975,50,140,8,198
"82976",1082976,61,270,12,343
"82977",1082977,150,57,4,211
"82978",1082978,119,72,1,192
"82979",1082979,118,158,21,297
"82980",1082980,240,21,12,273
"82981",1082981,160,32,9,201
"82982",1082982,40,78,6,124
"82983",1082983,105,40,0,145
"82984",1082984,101,139,5,245
"82985",1082985,62,59,4,125
"82986",1082986,74,200,7,281
"82987",1082987,49,281,2,332
"82988",1082988,80,203,5,288
"82989",1082989,225,133,16,374
"82990",1082990,164,23,8,195
"82991",1082991,161,127,16,304
"82992",1082992,36,199,4,239
"82993",1082993,145,156,12,313
"82994",1082994,138,124,4,266
"82995",1082995,147,70,4,221
"82996",1082996,79,122,8,209
"82997",1082997,94,130,15,239
"82998",1082998,70,270,19,359
"82999",1082999,69,38,0,107
"83000",1083000,34,6,1,41
"83001",1083001,86,43,9,138
"83002",1083002,111,9,3,123
"83003",1083003,97,230,17,344
"83004",1083004,115,73,13,201
"83005",1083005,58,177,15,250
"83006",1083006,211,85,19,315
"83007",1083007,164,38,10,212
"83008",1083008,82,204,12,298
"83009",1083009,67,39,4,110
"83010",1083010,53,84,12,149
"83011",1083011,124,60,6,190
"83012",1083012,50,264,0,314
"83013",1083013,50,91,5,146
"83014",1083014,6,49,1,56
"83015",1083015,107,68,12,187
"83016",1083016,59,74,6,139
"83017",1083017,98,174,6,278
"83018",1083018,96,59,11,166
"83019",1083019,58,50,2,110
"83020",1083020,79,133,3,215
"83021",1083021,102,57,11,170
"83022",1083022,63,105,10,178
"83023",1083023,122,37,10,169
"83024",1083024,120,140,5,265
"83025",1083025,208,17,7,232
"83026",1083026,112,102,3,217
"83027",1083027,67,239,1,307
"83028",1083028,77,178,8,263
"83029",1083029,159,112,18,289
"83030",1083030,99,120,8,227
"83031",1083031,44,172,3,219
"83032",1083032,185,60,7,252
"83033",1083033,33,22,2,57
"83034",1083034,168,145,8,321
"83035",1083035,263,37,16,316
"83036",1083036,115,33,8,156
"83037",1083037,93,131,13,237
"83038",1083038,170,55,1,226
"83039",1083039,90,5,0,95
"83040",1083040,118,124,18,260
"83041",1083041,123,57,6,186
"83042",1083042,155,72,6,233
"83043",1083043,10,2,0,12
"83044",1083044,116,134,6,256
"83045",1083045,7,28,1,36
"83046",1083046,52,188,3,243
"83047",1083047,162,58,5,225
"83048",1083048,215,18,4,237
"83049",1083049,54,223,5,282
"83050",1083050,97,37,9,143
"83051",1083051,146,89,17,252
"83052",1083052,75,74,5,154
"83053",1083053,188,67,10,265
"83054",1083054,6,14,1,21
"83055",1083055,133,145,11,289
"83056",1083056,127,41,15,183
"83057",1083057,96,46,4,146
"83058",1083058,220,32,10,262
"83059",1083059,104,18,1,123
"83060",1083060,102,124,4,230
"83061",1083061,97,23,4,124
"83062",1083062,31,17,0,48
"83063",1083063,46,31,5,82
"83064",1083064,110,167,7,284
"83065",1083065,44,117,1,162
"83066",1083066,111,83,7,201
"83067",1083067,148,63,6,217
"83068",1083068,129,70,7,206
"83069",1083069,264,11,6,281
"83070",1083070,101,129,18,248
"83071",1083071,181,143,16,340
"83072",1083072,109,89,3,201
"83073",1083073,111,143,6,260
"83074",1083074,111,121,10,242
"83075",1083075,167,59,19,245
"83076",1083076,154,71,13,238
"83077",1083077,78,176,13,267
"83078",1083078,86,161,18,265
"83079",1083079,194,24,4,222
"83080",1083080,122,118,11,251
"83081",1083081,115,214,7,336
"83082",1083082,101,105,11,217
"83083",1083083,39,12,1,52
"83084",1083084,122,208,18,348
"83085",1083085,117,118,5,240
"83086",1083086,90,82,2,174
"83087",1083087,33,232,5,270
"83088",1083088,131,96,16,243
"83089",1083089,96,151,11,258
"83090",1083090,80,231,8,319
"83091",1083091,223,28,14,265
"83092",1083092,21,137,0,158
"83093",1083093,204,96,7,307
"83094",1083094,22,16,1,39
"83095",1083095,15,56,1,72
"83096",1083096,159,114,11,284
"83097",1083097,84,199,7,290
"83098",1083098,179,12,1,192
"83099",1083099,160,114,22,296
"83100",1083100,144,13,6,163
"83101",1083101,9,183,6,198
"83102",1083102,96,36,4,136
"83103",1083103,140,117,5,262
"83104",1083104,67,137,19,223
"83105",1083105,183,63,14,260
"83106",1083106,8,40,1,49
"83107",1083107,34,1,3,38
"83108",1083108,68,119,7,194
"83109",1083109,45,231,3,279
"83110",1083110,59,45,7,111
"83111",1083111,24,13,3,40
"83112",1083112,18,142,1,161
"83113",1083113,91,70,4,165
"83114",1083114,51,25,7,83
"83115",1083115,130,84,3,217
"83116",1083116,118,26,2,146
"83117",1083117,107,106,7,220
"83118",1083118,78,186,17,281
"83119",1083119,116,149,6,271
"83120",1083120,107,132,8,247
"83121",1083121,103,176,13,292
"83122",1083122,157,79,4,240
"83123",1083123,52,85,3,140
"83124",1083124,57,166,2,225
"83125",1083125,100,60,3,163
"83126",1083126,71,100,4,175
"83127",1083127,106,139,12,257
"83128",1083128,59,109,3,171
"83129",1083129,157,103,12,272
"83130",1083130,27,143,2,172
"83131",1083131,160,121,8,289
"83132",1083132,93,24,12,129
"83133",1083133,87,91,10,188
"83134",1083134,148,114,13,275
"83135",1083135,117,91,7,215
"83136",1083136,120,38,7,165
"83137",1083137,34,144,7,185
"83138",1083138,115,38,7,160
"83139",1083139,162,67,12,241
"83140",1083140,137,149,9,295
"83141",1083141,3,17,1,21
"83142",1083142,35,82,2,119
"83143",1083143,227,51,10,288
"83144",1083144,114,176,10,300
"83145",1083145,50,22,6,78
"83146",1083146,114,142,6,262
"83147",1083147,21,6,2,29
"83148",1083148,207,36,8,251
"83149",1083149,30,222,5,257
"83150",1083150,64,13,2,79
"83151",1083151,49,172,2,223
"83152",1083152,46,187,3,236
"83153",1083153,220,86,19,325
"83154",1083154,117,28,1,146
"83155",1083155,66,134,14,214
"83156",1083156,264,6,5,275
"83157",1083157,81,242,6,329
"83158",1083158,102,95,10,207
"83159",1083159,47,127,21,195
"83160",1083160,69,170,2,241
"83161",1083161,84,187,1,272
"83162",1083162,77,64,6,147
"83163",1083163,166,31,3,200
"83164",1083164,117,119,5,241
"83165",1083165,80,84,12,176
"83166",1083166,101,46,7,154
"83167",1083167,83,151,2,236
"83168",1083168,16,82,10,108
"83169",1083169,111,169,14,294
"83170",1083170,193,75,7,275
"83171",1083171,95,210,8,313
"83172",1083172,54,234,9,297
"83173",1083173,43,211,8,262
"83174",1083174,207,18,4,229
"83175",1083175,53,10,1,64
"83176",1083176,154,19,7,180
"83177",1083177,262,53,12,327
"83178",1083178,130,80,8,218
"83179",1083179,71,83,16,170
"83180",1083180,179,34,10,223
"83181",1083181,62,225,4,291
"83182",1083182,88,27,1,116
"83183",1083183,169,117,10,296
"83184",1083184,146,103,4,253
"83185",1083185,136,13,4,153
"83186",1083186,158,70,12,240
"83187",1083187,61,181,11,253
"83188",1083188,3,0,0,3
"83189",1083189,167,74,2,243
"83190",1083190,40,186,8,234
"83191",1083191,83,45,2,130
"83192",1083192,130,170,11,311
"83193",1083193,45,130,9,184
"83194",1083194,405,60,22,487
"83195",1083195,155,102,12,269
"83196",1083196,62,131,9,202
"83197",1083197,171,125,10,306
"83198",1083198,36,57,6,99
"83199",1083199,95,67,14,176
"83200",1083200,56,33,3,92
"83201",1083201,79,116,4,199
"83202",1083202,86,208,9,303
"83203",1083203,144,97,18,259
"83204",1083204,74,213,6,293
"83205",1083205,70,180,14,264
"83206",1083206,56,211,7,274
"83207",1083207,14,133,5,152
"83208",1083208,76,15,3,94
"83209",1083209,98,185,11,294
"83210",1083210,107,100,9,216
"83211",1083211,226,85,17,328
"83212",1083212,109,52,2,163
"83213",1083213,182,109,13,304
"83214",1083214,164,62,9,235
"83215",1083215,156,55,13,224
"83216",1083216,45,140,9,194
"83217",1083217,43,57,3,103
"83218",1083218,41,178,10,229
"83219",1083219,65,220,9,294
"83220",1083220,144,63,6,213
"83221",1083221,27,19,0,46
"83222",1083222,73,160,14,247
"83223",1083223,86,155,1,242
"83224",1083224,140,57,4,201
"83225",1083225,108,113,5,226
"83226",1083226,50,168,8,226
"83227",1083227,173,48,4,225
"83228",1083228,62,52,4,118
"83229",1083229,65,259,8,332
"83230",1083230,135,33,5,173
"83231",1083231,67,180,8,255
"83232",1083232,106,210,5,321
"83233",1083233,108,188,15,311
"83234",1083234,238,69,9,316
"83235",1083235,76,210,18,304
"83236",1083236,32,83,7,122
"83237",1083237,224,27,7,258
"83238",1083238,111,29,9,149
"83239",1083239,154,108,6,268
"83240",1083240,131,53,6,190
"83241",1083241,67,102,3,172
"83242",1083242,187,60,10,257
"83243",1083243,35,153,7,195
"83244",1083244,108,194,6,308
"83245",1083245,136,80,3,219
"83246",1083246,153,87,4,244
"83247",1083247,110,103,5,218
"83248",1083248,150,157,10,317
"83249",1083249,38,169,4,211
"83250",1083250,115,64,2,181
"83251",1083251,50,217,2,269
"83252",1083252,91,29,8,128
"83253",1083253,161,123,10,294
"83254",1083254,105,22,7,134
"83255",1083255,198,23,6,227
"83256",1083256,187,86,16,289
"83257",1083257,142,33,11,186
"83258",1083258,98,156,4,258
"83259",1083259,159,106,15,280
"83260",1083260,110,197,11,318
"83261",1083261,113,50,4,167
"83262",1083262,64,101,7,172
"83263",1083263,17,142,0,159
"83264",1083264,41,206,8,255
"83265",1083265,37,320,5,362
"83266",1083266,171,43,6,220
"83267",1083267,169,68,10,247
"83268",1083268,49,16,2,67
"83269",1083269,73,76,1,150
"83270",1083270,249,45,10,304
"83271",1083271,88,169,3,260
"83272",1083272,152,36,10,198
"83273",1083273,58,168,15,241
"83274",1083274,183,11,3,197
"83275",1083275,83,151,4,238
"83276",1083276,146,51,9,206
"83277",1083277,159,8,10,177
"83278",1083278,100,109,18,227
"83279",1083279,120,65,10,195
"83280",1083280,86,162,7,255
"83281",1083281,157,136,27,320
"83282",1083282,110,110,8,228
"83283",1083283,127,34,7,168
"83284",1083284,47,81,4,132
"83285",1083285,81,253,9,343
"83286",1083286,203,66,19,288
"83287",1083287,47,80,4,131
"83288",1083288,83,66,4,153
"83289",1083289,168,38,5,211
"83290",1083290,40,31,2,73
"83291",1083291,83,181,21,285
"83292",1083292,98,168,0,266
"83293",1083293,225,89,15,329
"83294",1083294,44,160,2,206
"83295",1083295,116,46,2,164
"83296",1083296,139,62,7,208
"83297",1083297,171,23,8,202
"83298",1083298,85,123,10,218
"83299",1083299,174,40,9,223
"83300",1083300,101,37,4,142
"83301",1083301,125,28,4,157
"83302",1083302,20,133,1,154
"83303",1083303,128,31,5,164
"83304",1083304,75,66,13,154
"83305",1083305,57,209,8,274
"83306",1083306,138,36,15,189
"83307",1083307,146,48,7,201
"83308",1083308,116,124,25,265
"83309",1083309,122,121,8,251
"83310",1083310,200,176,29,405
"83311",1083311,13,5,1,19
"83312",1083312,91,14,2,107
"83313",1083313,19,52,4,75
"83314",1083314,217,24,6,247
"83315",1083315,61,17,3,81
"83316",1083316,94,227,15,336
"83317",1083317,145,29,10,184
"83318",1083318,184,55,6,245
"83319",1083319,52,104,2,158
"83320",1083320,95,133,9,237
"83321",1083321,207,58,6,271
"83322",1083322,61,10,3,74
"83323",1083323,107,101,0,208
"83324",1083324,35,232,3,270
"83325",1083325,147,34,7,188
"83326",1083326,144,111,9,264
"83327",1083327,151,69,21,241
"83328",1083328,173,60,9,242
"83329",1083329,184,54,7,245
"83330",1083330,66,218,6,290
"83331",1083331,162,72,10,244
"83332",1083332,49,255,12,316
"83333",1083333,117,87,5,209
"83334",1083334,217,56,11,284
"83335",1083335,0,7,0,7
"83336",1083336,81,193,12,286
"83337",1083337,37,136,1,174
"83338",1083338,28,129,1,158
"83339",1083339,98,178,11,287
"83340",1083340,134,36,0,170
"83341",1083341,20,91,1,112
"83342",1083342,109,153,9,271
"83343",1083343,173,82,10,265
"83344",1083344,138,137,6,281
"83345",1083345,85,211,16,312
"83346",1083346,224,21,3,248
"83347",1083347,179,52,11,242
"83348",1083348,165,33,13,211
"83349",1083349,38,190,17,245
"83350",1083350,90,126,24,240
"83351",1083351,54,81,2,137
"83352",1083352,95,141,1,237
"83353",1083353,104,157,20,281
"83354",1083354,148,56,17,221
"83355",1083355,112,67,3,182
"83356",1083356,157,71,17,245
"83357",1083357,140,39,1,180
"83358",1083358,55,136,9,200
"83359",1083359,68,103,9,180
"83360",1083360,197,118,21,336
"83361",1083361,108,56,8,172
"83362",1083362,148,79,4,231
"83363",1083363,107,129,16,252
"83364",1083364,212,16,6,234
"83365",1083365,219,59,9,287
"83366",1083366,222,41,3,266
"83367",1083367,95,51,14,160
"83368",1083368,13,16,1,30
"83369",1083369,217,28,9,254
"83370",1083370,43,226,2,271
"83371",1083371,132,10,11,153
"83372",1083372,169,110,19,298
"83373",1083373,103,49,9,161
"83374",1083374,39,230,6,275
"83375",1083375,92,191,20,303
"83376",1083376,21,138,3,162
"83377",1083377,142,112,4,258
"83378",1083378,162,13,7,182
"83379",1083379,124,68,3,195
"83380",1083380,72,201,7,280
"83381",1083381,137,88,10,235
"83382",1083382,214,13,5,232
"83383",1083383,70,168,4,242
"83384",1083384,108,18,5,131
"83385",1083385,140,85,10,235
"83386",1083386,62,178,16,256
"83387",1083387,147,33,1,181
"83388",1083388,167,17,7,191
"83389",1083389,83,206,20,309
"83390",1083390,73,64,16,153
"83391",1083391,91,148,6,245
"83392",1083392,72,143,1,216
"83393",1083393,123,78,12,213
"83394",1083394,27,42,1,70
"83395",1083395,61,157,6,224
"83396",1083396,100,244,1,345
"83397",1083397,162,48,7,217
"83398",1083398,145,139,13,297
"83399",1083399,17,332,1,350
"83400",1083400,96,89,6,191
"83401",1083401,192,124,19,335
"83402",1083402,11,51,3,65
"83403",1083403,66,240,5,311
"83404",1083404,87,171,5,263
"83405",1083405,17,229,1,247
"83406",1083406,6,11,0,17
"83407",1083407,56,12,4,72
"83408",1083408,22,176,3,201
"83409",1083409,185,121,12,318
"83410",1083410,198,44,5,247
"83411",1083411,96,160,8,264
"83412",1083412,77,203,7,287
"83413",1083413,186,21,7,214
"83414",1083414,105,56,8,169
"83415",1083415,88,143,3,234
"83416",1083416,42,207,2,251
"83417",1083417,53,76,7,136
"83418",1083418,28,260,0,288
"83419",1083419,50,173,5,228
"83420",1083420,65,130,7,202
"83421",1083421,139,144,11,294
"83422",1083422,120,183,4,307
"83423",1083423,133,57,9,199
"83424",1083424,154,53,12,219
"83425",1083425,81,129,7,217
"83426",1083426,72,42,1,115
"83427",1083427,70,115,10,195
"83428",1083428,78,220,26,324
"83429",1083429,100,36,3,139
"83430",1083430,206,62,8,276
"83431",1083431,125,76,5,206
"83432",1083432,87,187,3,277
"83433",1083433,212,25,6,243
"83434",1083434,131,29,4,164
"83435",1083435,46,186,13,245
"83436",1083436,80,32,9,121
"83437",1083437,17,35,1,53
"83438",1083438,142,41,5,188
"83439",1083439,72,31,4,107
"83440",1083440,181,64,14,259
"83441",1083441,5,69,6,80
"83442",1083442,175,10,3,188
"83443",1083443,128,120,13,261
"83444",1083444,173,56,12,241
"83445",1083445,125,23,8,156
"83446",1083446,145,120,16,281
"83447",1083447,32,199,3,234
"83448",1083448,85,193,7,285
"83449",1083449,36,213,12,261
"83450",1083450,97,119,13,229
"83451",1083451,102,121,10,233
"83452",1083452,123,59,10,192
"83453",1083453,116,79,11,206
"83454",1083454,115,186,12,313
"83455",1083455,87,156,2,245
"83456",1083456,124,37,8,169
"83457",1083457,59,111,16,186
"83458",1083458,105,153,9,267
"83459",1083459,215,48,6,269
"83460",1083460,65,229,19,313
"83461",1083461,149,45,10,204
"83462",1083462,47,207,7,261
"83463",1083463,87,141,6,234
"83464",1083464,8,160,3,171
"83465",1083465,142,18,4,164
"83466",1083466,68,179,4,251
"83467",1083467,69,211,20,300
"83468",1083468,111,82,11,204
"83469",1083469,188,9,4,201
"83470",1083470,179,73,12,264
"83471",1083471,63,198,14,275
"83472",1083472,49,105,5,159
"83473",1083473,243,50,3,296
"83474",1083474,173,88,6,267
"83475",1083475,117,41,5,163
"83476",1083476,218,26,7,251
"83477",1083477,0,0,0,0
"83478",1083478,14,43,1,58
"83479",1083479,146,112,3,261
"83480",1083480,196,11,4,211
"83481",1083481,206,50,8,264
"83482",1083482,73,256,2,331
"83483",1083483,80,153,7,240
"83484",1083484,35,39,7,81
"83485",1083485,232,21,3,256
"83486",1083486,46,195,19,260
"83487",1083487,68,69,4,141
"83488",1083488,115,69,2,186
"83489",1083489,54,258,1,313
"83490",1083490,161,38,2,201
"83491",1083491,95,250,9,354
"83492",1083492,160,124,11,295
"83493",1083493,84,15,9,108
"83494",1083494,40,144,7,191
"83495",1083495,80,70,8,158
"83496",1083496,54,1,3,58
"83497",1083497,13,83,4,100
"83498",1083498,103,163,6,272
"83499",1083499,123,90,11,224
"83500",1083500,124,62,21,207
"83501",1083501,156,159,8,323
"83502",1083502,99,204,18,321
"83503",1083503,52,189,3,244
"83504",1083504,99,102,7,208
"83505",1083505,77,170,4,251
"83506",1083506,42,255,0,297
"83507",1083507,162,21,6,189
"83508",1083508,210,78,19,307
"83509",1083509,108,87,11,206
"83510",1083510,154,114,13,281
"83511",1083511,30,160,5,195
"83512",1083512,90,49,3,142
"83513",1083513,49,166,7,222
"83514",1083514,13,198,1,212
"83515",1083515,109,152,15,276
"83516",1083516,75,45,3,123
"83517",1083517,28,278,9,315
"83518",1083518,142,56,7,205
"83519",1083519,216,31,21,268
"83520",1083520,127,94,3,224
"83521",1083521,23,244,1,268
"83522",1083522,105,130,15,250
"83523",1083523,134,42,7,183
"83524",1083524,187,0,1,188
"83525",1083525,251,53,7,311
"83526",1083526,122,153,4,279
"83527",1083527,48,150,7,205
"83528",1083528,31,212,3,246
"83529",1083529,22,85,3,110
"83530",1083530,198,122,5,325
"83531",1083531,129,114,16,259
"83532",1083532,76,132,8,216
"83533",1083533,208,10,5,223
"83534",1083534,219,20,14,253
"83535",1083535,45,79,0,124
"83536",1083536,157,56,3,216
"83537",1083537,148,43,2,193
"83538",1083538,13,54,2,69
"83539",1083539,47,76,3,126
"83540",1083540,225,16,15,256
"83541",1083541,110,126,15,251
"83542",1083542,29,156,2,187
"83543",1083543,98,221,8,327
"83544",1083544,47,200,8,255
"83545",1083545,60,76,2,138
"83546",1083546,209,63,18,290
"83547",1083547,55,208,9,272
"83548",1083548,65,49,4,118
"83549",1083549,160,101,4,265
"83550",1083550,194,76,5,275
"83551",1083551,26,192,1,219
"83552",1083552,86,132,6,224
"83553",1083553,74,152,10,236
"83554",1083554,159,122,3,284
"83555",1083555,120,9,2,131
"83556",1083556,34,74,2,110
"83557",1083557,163,88,11,262
"83558",1083558,132,47,5,184
"83559",1083559,108,88,14,210
"83560",1083560,121,159,12,292
"83561",1083561,152,110,5,267
"83562",1083562,51,57,4,112
"83563",1083563,121,53,4,178
"83564",1083564,65,268,12,345
"83565",1083565,78,63,4,145
"83566",1083566,205,72,10,287
"83567",1083567,66,162,14,242
"83568",1083568,46,169,8,223
"83569",1083569,171,33,5,209
"83570",1083570,237,25,11,273
"83571",1083571,120,96,3,219
"83572",1083572,99,41,6,146
"83573",1083573,163,21,6,190
"83574",1083574,95,153,16,264
"83575",1083575,42,70,3,115
"83576",1083576,167,54,12,233
"83577",1083577,137,67,8,212
"83578",1083578,30,52,12,94
"83579",1083579,146,92,16,254
"83580",1083580,11,61,0,72
"83581",1083581,92,135,6,233
"83582",1083582,103,161,8,272
"83583",1083583,156,55,7,218
"83584",1083584,19,252,0,271
"83585",1083585,166,48,10,224
"83586",1083586,144,106,15,265
"83587",1083587,73,120,9,202
"83588",1083588,154,49,6,209
"83589",1083589,82,36,4,122
"83590",1083590,157,42,2,201
"83591",1083591,24,241,6,271
"83592",1083592,55,147,9,211
"83593",1083593,56,167,11,234
"83594",1083594,239,8,7,254
"83595",1083595,191,66,5,262
"83596",1083596,92,178,11,281
"83597",1083597,41,181,4,226
"83598",1083598,70,214,10,294
"83599",1083599,168,90,5,263
"83600",1083600,55,231,10,296
"83601",1083601,72,139,10,221
"83602",1083602,29,18,5,52
"83603",1083603,95,42,13,150
"83604",1083604,66,162,11,239
"83605",1083605,108,11,6,125
"83606",1083606,51,202,3,256
"83607",1083607,164,25,7,196
"83608",1083608,94,201,14,309
"83609",1083609,42,196,5,243
"83610",1083610,9,172,3,184
"83611",1083611,40,21,2,63
"83612",1083612,70,258,8,336
"83613",1083613,157,58,7,222
"83614",1083614,53,10,2,65
"83615",1083615,102,155,14,271
"83616",1083616,120,37,5,162
"83617",1083617,123,92,16,231
"83618",1083618,169,60,6,235
"83619",1083619,70,103,10,183
"83620",1083620,132,100,6,238
"83621",1083621,146,40,5,191
"83622",1083622,238,56,4,298
"83623",1083623,86,186,13,285
"83624",1083624,55,233,1,289
"83625",1083625,163,66,4,233
"83626",1083626,22,283,6,311
"83627",1083627,28,214,5,247
"83628",1083628,111,175,5,291
"83629",1083629,55,182,6,243
"83630",1083630,131,85,13,229
"83631",1083631,79,158,8,245
"83632",1083632,49,142,5,196
"83633",1083633,114,126,13,253
"83634",1083634,121,60,0,181
"83635",1083635,107,32,4,143
"83636",1083636,204,16,10,230
"83637",1083637,39,195,14,248
"83638",1083638,229,42,6,277
"83639",1083639,61,144,11,216
"83640",1083640,76,114,4,194
"83641",1083641,127,91,13,231
"83642",1083642,92,41,3,136
"83643",1083643,130,122,13,265
"83644",1083644,30,29,2,61
"83645",1083645,204,21,12,237
"83646",1083646,136,132,5,273
"83647",1083647,78,101,18,197
"83648",1083648,77,133,9,219
"83649",1083649,106,159,13,278
"83650",1083650,94,83,10,187
"83651",1083651,93,143,2,238
"83652",1083652,29,240,2,271
"83653",1083653,38,200,8,246
"83654",1083654,190,22,4,216
"83655",1083655,121,94,10,225
"83656",1083656,170,109,21,300
"83657",1083657,103,28,1,132
"83658",1083658,150,125,15,290
"83659",1083659,48,12,0,60
"83660",1083660,143,153,9,305
"83661",1083661,130,81,9,220
"83662",1083662,92,30,3,125
"83663",1083663,65,25,10,100
"83664",1083664,102,146,8,256
"83665",1083665,236,29,8,273
"83666",1083666,105,166,9,280
"83667",1083667,39,181,7,227
"83668",1083668,87,51,9,147
"83669",1083669,44,141,2,187
"83670",1083670,72,96,3,171
"83671",1083671,40,212,5,257
"83672",1083672,167,70,18,255
"83673",1083673,44,9,3,56
"83674",1083674,137,48,9,194
"83675",1083675,5,2,2,9
"83676",1083676,133,66,5,204
"83677",1083677,152,0,0,152
"83678",1083678,108,34,6,148
"83679",1083679,34,191,8,233
"83680",1083680,105,100,12,217
"83681",1083681,141,101,9,251
"83682",1083682,101,27,4,132
"83683",1083683,101,36,10,147
"83684",1083684,49,155,9,213
"83685",1083685,87,172,3,262
"83686",1083686,141,102,7,250
"83687",1083687,56,233,3,292
"83688",1083688,31,221,8,260
"83689",1083689,154,114,21,289
"83690",1083690,198,21,5,224
"83691",1083691,94,204,8,306
"83692",1083692,44,98,4,146
"83693",1083693,150,102,13,265
"83694",1083694,52,161,17,230
"83695",1083695,135,0,1,136
"83696",1083696,19,86,6,111
"83697",1083697,62,259,1,322
"83698",1083698,88,158,13,259
"83699",1083699,140,38,2,180
"83700",1083700,49,203,4,256
"83701",1083701,137,74,6,217
"83702",1083702,39,115,8,162
"83703",1083703,145,32,5,182
"83704",1083704,152,24,0,176
"83705",1083705,115,17,1,133
"83706",1083706,66,195,10,271
"83707",1083707,17,143,5,165
"83708",1083708,81,104,3,188
"83709",1083709,114,38,2,154
"83710",1083710,116,164,24,304
"83711",1083711,24,52,1,77
"83712",1083712,234,67,23,324
"83713",1083713,53,147,5,205
"83714",1083714,208,50,5,263
"83715",1083715,53,10,1,64
"83716",1083716,135,66,14,215
"83717",1083717,136,72,11,219
"83718",1083718,148,48,6,202
"83719",1083719,122,143,9,274
"83720",1083720,173,137,14,324
"83721",1083721,131,45,3,179
"83722",1083722,204,26,11,241
"83723",1083723,247,19,3,269
"83724",1083724,91,46,9,146
"83725",1083725,129,34,11,174
"83726",1083726,77,73,11,161
"83727",1083727,128,55,8,191
"83728",1083728,139,54,12,205
"83729",1083729,119,93,5,217
"83730",1083730,172,24,4,200
"83731",1083731,40,19,1,60
"83732",1083732,127,33,7,167
"83733",1083733,20,121,3,144
"83734",1083734,53,110,6,169
"83735",1083735,27,107,7,141
"83736",1083736,127,92,4,223
"83737",1083737,221,37,5,263
"83738",1083738,138,126,13,277
"83739",1083739,180,124,10,314
"83740",1083740,247,7,6,260
"83741",1083741,57,167,11,235
"83742",1083742,133,28,6,167
"83743",1083743,14,137,1,152
"83744",1083744,153,61,17,231
"83745",1083745,111,93,12,216
"83746",1083746,206,43,10,259
"83747",1083747,186,20,9,215
"83748",1083748,87,181,7,275
"83749",1083749,214,93,2,309
"83750",1083750,152,142,17,311
"83751",1083751,44,229,14,287
"83752",1083752,106,105,1,212
"83753",1083753,88,215,18,321
"83754",1083754,11,96,1,108
"83755",1083755,225,65,12,302
"83756",1083756,49,230,2,281
"83757",1083757,108,93,16,217
"83758",1083758,47,166,8,221
"83759",1083759,121,80,5,206
"83760",1083760,165,61,2,228
"83761",1083761,57,46,1,104
"83762",1083762,159,137,6,302
"83763",1083763,46,217,13,276
"83764",1083764,43,157,4,204
"83765",1083765,126,109,17,252
"83766",1083766,80,164,14,258
"83767",1083767,51,83,6,140
"83768",1083768,22,141,5,168
"83769",1083769,94,174,5,273
"83770",1083770,60,212,10,282
"83771",1083771,81,145,6,232
"83772",1083772,194,67,12,273
"83773",1083773,87,122,15,224
"83774",1083774,29,293,5,327
"83775",1083775,132,45,12,189
"83776",1083776,118,35,12,165
"83777",1083777,23,150,2,175
"83778",1083778,34,267,1,302
"83779",1083779,109,144,10,263
"83780",1083780,134,97,2,233
"83781",1083781,19,50,2,71
"83782",1083782,40,115,2,157
"83783",1083783,121,161,12,294
"83784",1083784,42,164,3,209
"83785",1083785,97,184,3,284
"83786",1083786,80,160,1,241
"83787",1083787,185,28,10,223
"83788",1083788,13,4,1,18
"83789",1083789,93,70,12,175
"83790",1083790,32,16,2,50
"83791",1083791,134,17,5,156
"83792",1083792,153,116,10,279
"83793",1083793,84,80,3,167
"83794",1083794,80,202,13,295
"83795",1083795,110,160,3,273
"83796",1083796,125,51,1,177
"83797",1083797,57,235,8,300
"83798",1083798,35,245,6,286
"83799",1083799,98,144,9,251
"83800",1083800,113,30,18,161
"83801",1083801,130,48,4,182
"83802",1083802,94,205,6,305
"83803",1083803,60,153,12,225
"83804",1083804,222,52,17,291
"83805",1083805,121,69,5,195
"83806",1083806,51,54,9,114
"83807",1083807,19,34,1,54
"83808",1083808,191,57,5,253
"83809",1083809,53,170,11,234
"83810",1083810,46,187,14,247
"83811",1083811,164,120,18,302
"83812",1083812,83,149,21,253
"83813",1083813,72,159,3,234
"83814",1083814,50,196,8,254
"83815",1083815,132,29,4,165
"83816",1083816,30,223,2,255
"83817",1083817,103,68,13,184
"83818",1083818,100,140,3,243
"83819",1083819,54,0,0,54
"83820",1083820,73,125,4,202
"83821",1083821,102,48,2,152
"83822",1083822,53,158,23,234
"83823",1083823,75,216,9,300
"83824",1083824,98,152,6,256
"83825",1083825,80,48,3,131
"83826",1083826,186,40,11,237
"83827",1083827,105,195,9,309
"83828",1083828,118,57,7,182
"83829",1083829,32,255,11,298
"83830",1083830,129,117,5,251
"83831",1083831,88,106,3,197
"83832",1083832,54,98,18,170
"83833",1083833,29,231,3,263
"83834",1083834,57,122,7,186
"83835",1083835,24,76,2,102
"83836",1083836,170,70,15,255
"83837",1083837,94,166,14,274
"83838",1083838,156,59,8,223
"83839",1083839,156,56,6,218
"83840",1083840,14,3,0,17
"83841",1083841,7,7,2,16
"83842",1083842,144,93,8,245
"83843",1083843,260,10,3,273
"83844",1083844,74,75,9,158
"83845",1083845,114,27,4,145
"83846",1083846,187,243,8,438
"83847",1083847,82,205,3,290
"83848",1083848,112,40,11,163
"83849",1083849,34,175,3,212
"83850",1083850,88,51,4,143
"83851",1083851,90,138,12,240
"83852",1083852,156,73,10,239
"83853",1083853,104,114,1,219
"83854",1083854,126,145,13,284
"83855",1083855,266,64,11,341
"83856",1083856,121,91,22,234
"83857",1083857,53,211,14,278
"83858",1083858,139,83,3,225
"83859",1083859,201,88,8,297
"83860",1083860,219,11,9,239
"83861",1083861,111,59,7,177
"83862",1083862,67,37,1,105
"83863",1083863,174,32,5,211
"83864",1083864,178,73,2,253
"83865",1083865,45,40,0,85
"83866",1083866,190,70,5,265
"83867",1083867,152,45,5,202
"83868",1083868,137,119,6,262
"83869",1083869,134,127,24,285
"83870",1083870,28,137,5,170
"83871",1083871,111,133,14,258
"83872",1083872,148,3,3,154
"83873",1083873,182,55,6,243
"83874",1083874,125,115,11,251
"83875",1083875,95,82,6,183
"83876",1083876,93,66,5,164
"83877",1083877,45,219,7,271
"83878",1083878,168,49,8,225
"83879",1083879,82,104,14,200
"83880",1083880,147,91,13,251
"83881",1083881,66,182,4,252
"83882",1083882,71,114,5,190
"83883",1083883,4,33,2,39
"83884",1083884,149,80,9,238
"83885",1083885,111,169,17,297
"83886",1083886,73,204,10,287
"83887",1083887,84,238,2,324
"83888",1083888,44,204,14,262
"83889",1083889,0,0,0,0
"83890",1083890,256,17,11,284
"83891",1083891,1,3,0,4
"83892",1083892,146,74,20,240
"83893",1083893,16,68,6,90
"83894",1083894,71,154,7,232
"83895",1083895,208,14,12,234
"83896",1083896,25,130,8,163
"83897",1083897,77,207,8,292
"83898",1083898,59,174,12,245
"83899",1083899,37,187,3,227
"83900",1083900,119,147,15,281
"83901",1083901,94,58,6,158
"83902",1083902,114,142,18,274
"83903",1083903,151,79,21,251
"83904",1083904,34,231,5,270
"83905",1083905,98,100,3,201
"83906",1083906,173,51,14,238
"83907",1083907,90,114,2,206
"83908",1083908,42,144,12,198
"83909",1083909,224,154,9,387
"83910",1083910,70,66,5,141
"83911",1083911,59,47,2,108
"83912",1083912,135,105,8,248
"83913",1083913,54,206,9,269
"83914",1083914,13,65,1,79
"83915",1083915,132,127,9,268
"83916",1083916,139,35,4,178
"83917",1083917,16,94,3,113
"83918",1083918,129,87,20,236
"83919",1083919,22,21,0,43
"83920",1083920,176,35,5,216
"83921",1083921,172,25,4,201
"83922",1083922,165,58,4,227
"83923",1083923,198,76,20,294
"83924",1083924,91,122,14,227
"83925",1083925,146,33,6,185
"83926",1083926,161,111,8,280
"83927",1083927,72,42,3,117
"83928",1083928,149,59,10,218
"83929",1083929,129,76,19,224
"83930",1083930,40,26,1,67
"83931",1083931,51,20,2,73
"83932",1083932,40,268,13,321
"83933",1083933,116,53,8,177
"83934",1083934,162,56,9,227
"83935",1083935,158,72,15,245
"83936",1083936,145,72,8,225
"83937",1083937,145,111,21,277
"83938",1083938,195,27,2,224
"83939",1083939,105,154,5,264
"83940",1083940,214,33,5,252
"83941",1083941,42,186,11,239
"83942",1083942,179,74,9,262
"83943",1083943,130,105,14,249
"83944",1083944,62,71,5,138
"83945",1083945,217,55,24,296
"83946",1083946,133,135,14,282
"83947",1083947,69,175,5,249
"83948",1083948,142,69,9,220
"83949",1083949,169,59,5,233
"83950",1083950,191,3,0,194
"83951",1083951,118,131,10,259
"83952",1083952,158,123,18,299
"83953",1083953,113,95,14,222
"83954",1083954,195,33,7,235
"83955",1083955,83,62,16,161
"83956",1083956,113,19,5,137
"83957",1083957,107,127,8,242
"83958",1083958,33,296,14,343
"83959",1083959,139,131,20,290
"83960",1083960,64,138,14,216
"83961",1083961,198,35,5,238
"83962",1083962,63,248,12,323
"83963",1083963,113,44,8,165
"83964",1083964,158,53,5,216
"83965",1083965,15,30,1,46
"83966",1083966,180,49,11,240
"83967",1083967,204,27,8,239
"83968",1083968,69,183,13,265
"83969",1083969,171,105,24,300
"83970",1083970,49,71,3,123
"83971",1083971,25,17,2,44
"83972",1083972,127,90,15,232
"83973",1083973,135,101,2,238
"83974",1083974,133,86,0,219
"83975",1083975,166,54,3,223
"83976",1083976,20,34,2,56
"83977",1083977,83,57,5,145
"83978",1083978,82,50,5,137
"83979",1083979,132,116,2,250
"83980",1083980,83,108,9,200
"83981",1083981,219,85,15,319
"83982",1083982,191,112,7,310
"83983",1083983,168,63,6,237
"83984",1083984,40,10,2,52
"83985",1083985,135,110,4,249
"83986",1083986,9,51,3,63
"83987",1083987,60,143,8,211
"83988",1083988,34,167,3,204
"83989",1083989,104,107,6,217
"83990",1083990,116,89,17,222
"83991",1083991,133,160,9,302
"83992",1083992,11,8,0,19
"83993",1083993,102,128,16,246
"83994",1083994,146,52,16,214
"83995",1083995,148,129,22,299
"83996",1083996,155,46,15,216
"83997",1083997,143,73,7,223
"83998",1083998,110,34,4,148
"83999",1083999,68,130,22,220
"84000",1084000,159,113,13,285
"84001",1084001,120,160,11,291
"84002",1084002,130,98,3,231
"84003",1084003,133,56,2,191
"84004",1084004,133,128,7,268
"84005",1084005,95,61,8,164
"84006",1084006,38,239,3,280
"84007",1084007,69,256,3,328
"84008",1084008,168,58,3,229
"84009",1084009,7,14,1,22
"84010",1084010,88,185,7,280
"84011",1084011,165,44,11,220
"84012",1084012,95,167,21,283
"84013",1084013,45,80,6,131
"84014",1084014,102,105,14,221
"84015",1084015,153,51,6,210
"84016",1084016,37,8,1,46
"84017",1084017,153,105,12,270
"84018",1084018,178,72,6,256
"84019",1084019,90,74,9,173
"84020",1084020,140,98,10,248
"84021",1084021,96,49,9,154
"84022",1084022,158,120,7,285
"84023",1084023,146,92,8,246
"84024",1084024,131,68,13,212
"84025",1084025,49,43,4,96
"84026",1084026,61,161,6,228
"84027",1084027,189,30,3,222
"84028",1084028,75,132,9,216
"84029",1084029,99,93,5,197
"84030",1084030,81,257,7,345
"84031",1084031,78,5,7,90
"84032",1084032,67,207,21,295
"84033",1084033,220,12,3,235
"84034",1084034,190,86,14,290
"84035",1084035,208,23,9,240
"84036",1084036,51,30,3,84
"84037",1084037,205,80,13,298
"84038",1084038,69,167,7,243
"84039",1084039,23,203,3,229
"84040",1084040,221,12,5,238
"84041",1084041,126,115,4,245
"84042",1084042,117,67,6,190
"84043",1084043,73,165,26,264
"84044",1084044,131,35,7,173
"84045",1084045,75,55,1,131
"84046",1084046,35,49,3,87
"84047",1084047,180,52,8,240
"84048",1084048,27,181,9,217
"84049",1084049,107,103,8,218
"84050",1084050,49,31,7,87
"84051",1084051,78,175,3,256
"84052",1084052,166,84,8,258
"84053",1084053,154,23,4,181
"84054",1084054,29,5,0,34
"84055",1084055,40,39,11,90
"84056",1084056,160,56,2,218
"84057",1084057,67,197,5,269
"84058",1084058,204,27,12,243
"84059",1084059,50,40,2,92
"84060",1084060,71,231,22,324
"84061",1084061,147,96,10,253
"84062",1084062,21,235,5,261
"84063",1084063,70,64,7,141
"84064",1084064,167,109,19,295
"84065",1084065,26,87,0,113
"84066",1084066,83,229,8,320
"84067",1084067,175,36,9,220
"84068",1084068,76,21,3,100
"84069",1084069,131,23,9,163
"84070",1084070,43,92,13,148
"84071",1084071,177,73,15,265
"84072",1084072,112,28,5,145
"84073",1084073,62,179,9,250
"84074",1084074,158,150,18,326
"84075",1084075,162,33,5,200
"84076",1084076,252,125,5,382
"84077",1084077,153,89,13,255
"84078",1084078,241,22,12,275
"84079",1084079,208,126,17,351
"84080",1084080,168,73,12,253
"84081",1084081,93,74,7,174
"84082",1084082,142,84,22,248
"84083",1084083,97,44,9,150
"84084",1084084,158,134,18,310
"84085",1084085,47,247,6,300
"84086",1084086,132,90,6,228
"84087",1084087,72,130,8,210
"84088",1084088,82,125,8,215
"84089",1084089,67,219,20,306
"84090",1084090,37,211,4,252
"84091",1084091,98,129,25,252
"84092",1084092,100,19,6,125
"84093",1084093,54,118,5,177
"84094",1084094,96,125,15,236
"84095",1084095,249,34,6,289
"84096",1084096,30,158,7,195
"84097",1084097,268,21,7,296
"84098",1084098,202,49,19,270
"84099",1084099,40,212,5,257
"84100",1084100,77,77,6,160
"84101",1084101,194,55,7,256
"84102",1084102,109,75,6,190
"84103",1084103,73,83,3,159
"84104",1084104,216,13,4,233
"84105",1084105,130,26,4,160
"84106",1084106,118,77,10,205
"84107",1084107,245,29,9,283
"84108",1084108,46,47,1,94
"84109",1084109,0,7,0,7
"84110",1084110,76,107,6,189
"84111",1084111,140,144,21,305
"84112",1084112,180,55,5,240
"84113",1084113,114,116,13,243
"84114",1084114,122,78,9,209
"84115",1084115,105,70,6,181
"84116",1084116,189,91,15,295
"84117",1084117,65,62,13,140
"84118",1084118,125,38,2,165
"84119",1084119,45,146,17,208
"84120",1084120,177,40,5,222
"84121",1084121,39,27,3,69
"84122",1084122,121,206,17,344
"84123",1084123,67,17,2,86
"84124",1084124,92,95,5,192
"84125",1084125,78,169,5,252
"84126",1084126,141,150,7,298
"84127",1084127,54,254,3,311
"84128",1084128,164,24,6,194
"84129",1084129,62,230,1,293
"84130",1084130,194,60,8,262
"84131",1084131,52,30,6,88
"84132",1084132,52,189,4,245
"84133",1084133,149,31,7,187
"84134",1084134,98,51,8,157
"84135",1084135,59,219,17,295
"84136",1084136,156,48,2,206
"84137",1084137,71,32,3,106
"84138",1084138,149,79,6,234
"84139",1084139,73,122,4,199
"84140",1084140,48,114,5,167
"84141",1084141,187,75,0,262
"84142",1084142,108,48,7,163
"84143",1084143,90,78,8,176
"84144",1084144,150,104,7,261
"84145",1084145,0,2,0,2
"84146",1084146,109,47,9,165
"84147",1084147,126,100,5,231
"84148",1084148,164,104,17,285
"84149",1084149,9,263,3,275
"84150",1084150,184,57,7,248
"84151",1084151,161,84,9,254
"84152",1084152,0,4,0,4
"84153",1084153,3,76,1,80
"84154",1084154,47,242,9,298
"84155",1084155,120,210,14,344
"84156",1084156,172,107,13,292
"84157",1084157,122,140,3,265
"84158",1084158,97,22,2,121
"84159",1084159,7,17,0,24
"84160",1084160,25,13,2,40
"84161",1084161,90,135,4,229
"84162",1084162,119,172,7,298
"84163",1084163,68,7,0,75
"84164",1084164,59,206,8,273
"84165",1084165,127,31,19,177
"84166",1084166,51,196,12,259
"84167",1084167,94,76,9,179
"84168",1084168,21,5,0,26
"84169",1084169,112,96,6,214
"84170",1084170,67,164,4,235
"84171",1084171,91,166,16,273
"84172",1084172,175,33,3,211
"84173",1084173,200,83,10,293
"84174",1084174,88,124,8,220
"84175",1084175,165,55,15,235
"84176",1084176,148,46,7,201
"84177",1084177,64,146,2,212
"84178",1084178,104,107,9,220
"84179",1084179,158,52,11,221
"84180",1084180,114,142,22,278
"84181",1084181,22,171,5,198
"84182",1084182,95,183,10,288
"84183",1084183,47,189,3,239
"84184",1084184,202,49,10,261
"84185",1084185,229,52,9,290
"84186",1084186,64,206,14,284
"84187",1084187,75,105,6,186
"84188",1084188,90,104,8,202
"84189",1084189,114,164,7,285
"84190",1084190,104,152,8,264
"84191",1084191,87,232,3,322
"84192",1084192,131,3,3,137
"84193",1084193,48,151,9,208
"84194",1084194,58,175,4,237
"84195",1084195,198,70,10,278
"84196",1084196,119,26,3,148
"84197",1084197,205,77,6,288
"84198",1084198,141,170,20,331
"84199",1084199,55,40,2,97
"84200",1084200,143,87,10,240
"84201",1084201,66,170,18,254
"84202",1084202,138,17,3,158
"84203",1084203,171,28,5,204
"84204",1084204,41,230,1,272
"84205",1084205,205,62,9,276
"84206",1084206,182,88,11,281
"84207",1084207,130,13,12,155
"84208",1084208,57,149,3,209
"84209",1084209,147,68,7,222
"84210",1084210,100,87,15,202
"84211",1084211,41,210,14,265
"84212",1084212,52,97,9,158
"84213",1084213,158,54,8,220
"84214",1084214,23,67,1,91
"84215",1084215,181,107,20,308
"84216",1084216,97,139,7,243
"84217",1084217,180,72,9,261
"84218",1084218,227,28,12,267
"84219",1084219,151,86,12,249
"84220",1084220,50,183,15,248
"84221",1084221,91,151,33,275
"84222",1084222,74,188,4,266
"84223",1084223,40,196,7,243
"84224",1084224,181,17,5,203
"84225",1084225,40,264,5,309
"84226",1084226,147,91,12,250
"84227",1084227,94,188,17,299
"84228",1084228,176,21,8,205
"84229",1084229,24,0,0,24
"84230",1084230,183,67,13,263
"84231",1084231,139,16,1,156
"84232",1084232,89,25,1,115
"84233",1084233,83,176,1,260
"84234",1084234,114,171,11,296
"84235",1084235,184,82,6,272
"84236",1084236,74,259,8,341
"84237",1084237,49,125,10,184
"84238",1084238,145,74,8,227
"84239",1084239,156,91,5,252
"84240",1084240,139,65,7,211
"84241",1084241,82,126,11,219
"84242",1084242,92,63,9,164
"84243",1084243,97,104,10,211
"84244",1084244,68,168,15,251
"84245",1084245,100,118,16,234
"84246",1084246,84,198,9,291
"84247",1084247,126,136,10,272
"84248",1084248,173,106,15,294
"84249",1084249,84,105,8,197
"84250",1084250,68,3,0,71
"84251",1084251,70,32,10,112
"84252",1084252,151,50,18,219
"84253",1084253,133,33,7,173
"84254",1084254,159,43,4,206
"84255",1084255,38,240,9,287
"84256",1084256,22,239,4,265
"84257",1084257,233,46,4,283
"84258",1084258,126,71,4,201
"84259",1084259,117,138,14,269
"84260",1084260,30,57,3,90
"84261",1084261,105,162,14,281
"84262",1084262,120,140,4,264
"84263",1084263,149,46,10,205
"84264",1084264,43,106,5,154
"84265",1084265,119,34,5,158
"84266",1084266,174,74,7,255
"84267",1084267,90,110,6,206
"84268",1084268,106,23,5,134
"84269",1084269,192,21,16,229
"84270",1084270,59,237,7,303
"84271",1084271,43,258,8,309
"84272",1084272,168,67,4,239
"84273",1084273,117,241,8,366
"84274",1084274,69,127,15,211
"84275",1084275,119,135,7,261
"84276",1084276,257,48,9,314
"84277",1084277,135,57,12,204
"84278",1084278,60,113,11,184
"84279",1084279,206,101,14,321
"84280",1084280,317,68,36,421
"84281",1084281,111,127,10,248
"84282",1084282,122,104,4,230
"84283",1084283,167,53,9,229
"84284",1084284,100,223,5,328
"84285",1084285,191,79,5,275
"84286",1084286,63,154,10,227
"84287",1084287,58,215,7,280
"84288",1084288,97,152,5,254
"84289",1084289,60,157,9,226
"84290",1084290,56,219,6,281
"84291",1084291,26,14,5,45
"84292",1084292,161,8,11,180
"84293",1084293,84,203,4,291
"84294",1084294,162,50,13,225
"84295",1084295,101,132,7,240
"84296",1084296,152,53,6,211
"84297",1084297,97,12,1,110
"84298",1084298,27,16,2,45
"84299",1084299,109,87,8,204
"84300",1084300,25,288,8,321
"84301",1084301,180,98,18,296
"84302",1084302,245,38,7,290
"84303",1084303,118,40,12,170
"84304",1084304,124,47,9,180
"84305",1084305,28,142,6,176
"84306",1084306,236,6,11,253
"84307",1084307,197,55,4,256
"84308",1084308,21,189,8,218
"84309",1084309,294,51,4,349
"84310",1084310,156,111,7,274
"84311",1084311,145,55,7,207
"84312",1084312,18,205,7,230
"84313",1084313,53,232,10,295
"84314",1084314,23,4,4,31
"84315",1084315,124,156,8,288
"84316",1084316,21,154,7,182
"84317",1084317,79,99,4,182
"84318",1084318,143,117,9,269
"84319",1084319,262,31,11,304
"84320",1084320,158,128,11,297
"84321",1084321,127,89,8,224
"84322",1084322,132,32,6,170
"84323",1084323,120,69,12,201
"84324",1084324,158,73,6,237
"84325",1084325,75,190,7,272
"84326",1084326,59,211,18,288
"84327",1084327,204,48,7,259
"84328",1084328,22,261,5,288
"84329",1084329,55,141,2,198
"84330",1084330,136,49,21,206
"84331",1084331,102,182,15,299
"84332",1084332,38,14,1,53
"84333",1084333,180,51,14,245
"84334",1084334,44,175,6,225
"84335",1084335,161,92,11,264
"84336",1084336,110,161,11,282
"84337",1084337,136,40,7,183
"84338",1084338,25,11,2,38
"84339",1084339,113,121,12,246
"84340",1084340,60,192,11,263
"84341",1084341,212,81,18,311
"84342",1084342,254,47,17,318
"84343",1084343,52,241,14,307
"84344",1084344,54,177,7,238
"84345",1084345,155,103,10,268
"84346",1084346,105,144,5,254
"84347",1084347,138,74,7,219
"84348",1084348,101,166,22,289
"84349",1084349,165,39,5,209
"84350",1084350,111,88,4,203
"84351",1084351,186,102,16,304
"84352",1084352,30,193,9,232
"84353",1084353,188,36,2,226
"84354",1084354,106,159,18,283
"84355",1084355,103,205,9,317
"84356",1084356,138,154,11,303
"84357",1084357,126,65,9,200
"84358",1084358,68,140,14,222
"84359",1084359,61,212,9,282
"84360",1084360,77,184,16,277
"84361",1084361,107,164,11,282
"84362",1084362,215,8,2,225
"84363",1084363,23,3,5,31
"84364",1084364,74,141,15,230
"84365",1084365,103,108,5,216
"84366",1084366,39,90,9,138
"84367",1084367,43,195,9,247
"84368",1084368,128,174,12,314
"84369",1084369,46,121,2,169
"84370",1084370,7,62,0,69
"84371",1084371,97,72,4,173
"84372",1084372,49,255,6,310
"84373",1084373,80,77,13,170
"84374",1084374,203,53,10,266
"84375",1084375,46,187,9,242
"84376",1084376,81,74,5,160
"84377",1084377,86,45,7,138
"84378",1084378,30,155,5,190
"84379",1084379,116,88,7,211
"84380",1084380,173,82,11,266
"84381",1084381,60,198,11,269
"84382",1084382,30,34,3,67
"84383",1084383,162,134,19,315
"84384",1084384,40,139,3,182
"84385",1084385,136,37,8,181
"84386",1084386,140,75,5,220
"84387",1084387,143,21,2,166
"84388",1084388,81,62,3,146
"84389",1084389,62,174,1,237
"84390",1084390,165,19,2,186
"84391",1084391,61,177,6,244
"84392",1084392,151,119,10,280
"84393",1084393,188,54,9,251
"84394",1084394,134,158,5,297
"84395",1084395,64,147,9,220
"84396",1084396,179,32,4,215
"84397",1084397,48,202,7,257
"84398",1084398,162,71,15,248
"84399",1084399,160,108,8,276
"84400",1084400,12,125,1,138
"84401",1084401,79,124,14,217
"84402",1084402,82,136,9,227
"84403",1084403,130,49,7,186
"84404",1084404,73,131,5,209
"84405",1084405,154,135,17,306
"84406",1084406,100,158,11,269
"84407",1084407,158,168,15,341
"84408",1084408,154,25,6,185
"84409",1084409,93,173,21,287
"84410",1084410,69,0,0,69
"84411",1084411,154,59,2,215
"84412",1084412,55,253,5,313
"84413",1084413,113,152,13,278
"84414",1084414,113,179,8,300
"84415",1084415,151,103,15,269
"84416",1084416,154,106,6,266
"84417",1084417,106,89,8,203
"84418",1084418,45,191,5,241
"84419",1084419,47,27,6,80
"84420",1084420,32,185,7,224
"84421",1084421,139,85,12,236
"84422",1084422,113,6,3,122
"84423",1084423,36,63,8,107
"84424",1084424,100,33,5,138
"84425",1084425,149,20,6,175
"84426",1084426,180,54,9,243
"84427",1084427,109,134,14,257
"84428",1084428,192,68,9,269
"84429",1084429,182,108,13,303
"84430",1084430,41,288,2,331
"84431",1084431,156,51,8,215
"84432",1084432,159,37,6,202
"84433",1084433,98,120,23,241
"84434",1084434,50,211,4,265
"84435",1084435,29,1,0,30
"84436",1084436,165,63,11,239
"84437",1084437,76,160,7,243
"84438",1084438,116,26,3,145
"84439",1084439,102,162,13,277
"84440",1084440,101,154,25,280
"84441",1084441,225,83,7,315
"84442",1084442,155,94,6,255
"84443",1084443,66,105,4,175
"84444",1084444,37,213,9,259
"84445",1084445,100,137,9,246
"84446",1084446,86,12,4,102
"84447",1084447,64,121,3,188
"84448",1084448,148,61,24,233
"84449",1084449,20,66,2,88
"84450",1084450,124,162,24,310
"84451",1084451,139,106,4,249
"84452",1084452,63,223,7,293
"84453",1084453,61,89,1,151
"84454",1084454,8,10,2,20
"84455",1084455,135,33,6,174
"84456",1084456,30,181,1,212
"84457",1084457,29,85,9,123
"84458",1084458,51,172,16,239
"84459",1084459,56,49,5,110
"84460",1084460,90,92,9,191
"84461",1084461,187,63,14,264
"84462",1084462,4,38,4,46
"84463",1084463,90,225,22,337
"84464",1084464,45,231,9,285
"84465",1084465,55,240,10,305
"84466",1084466,70,4,1,75
"84467",1084467,38,196,21,255
"84468",1084468,24,113,11,148
"84469",1084469,45,235,12,292
"84470",1084470,123,319,16,458
"84471",1084471,106,112,12,230
"84472",1084472,158,84,12,254
"84473",1084473,106,179,8,293
"84474",1084474,140,102,10,252
"84475",1084475,91,221,12,324
"84476",1084476,242,14,5,261
"84477",1084477,86,152,25,263
"84478",1084478,173,55,6,234
"84479",1084479,212,76,13,301
"84480",1084480,119,83,6,208
"84481",1084481,151,40,11,202
"84482",1084482,260,20,2,282
"84483",1084483,55,177,8,240
"84484",1084484,194,20,8,222
"84485",1084485,192,49,7,248
"84486",1084486,65,144,14,223
"84487",1084487,109,105,14,228
"84488",1084488,111,174,10,295
"84489",1084489,266,29,8,303
"84490",1084490,130,99,9,238
"84491",1084491,77,217,6,300
"84492",1084492,38,196,2,236
"84493",1084493,176,38,19,233
"84494",1084494,209,32,8,249
"84495",1084495,68,159,7,234
"84496",1084496,173,117,23,313
"84497",1084497,184,84,8,276
"84498",1084498,88,113,2,203
"84499",1084499,42,253,3,298
"84500",1084500,173,10,4,187
"84501",1084501,82,130,8,220
"84502",1084502,44,165,14,223
"84503",1084503,99,192,9,300
"84504",1084504,157,63,9,229
"84505",1084505,174,74,14,262
"84506",1084506,8,65,0,73
"84507",1084507,79,56,12,147
"84508",1084508,96,39,7,142
"84509",1084509,205,15,7,227
"84510",1084510,74,213,19,306
"84511",1084511,130,91,2,223
"84512",1084512,94,38,6,138
"84513",1084513,65,173,15,253
"84514",1084514,80,160,6,246
"84515",1084515,58,196,9,263
"84516",1084516,219,27,5,251
"84517",1084517,136,3,2,141
"84518",1084518,62,193,4,259
"84519",1084519,72,203,8,283
"84520",1084520,60,129,5,194
"84521",1084521,92,128,5,225
"84522",1084522,76,36,4,116
"84523",1084523,110,12,3,125
"84524",1084524,122,173,21,316
"84525",1084525,265,38,10,313
"84526",1084526,157,84,18,259
"84527",1084527,54,261,11,326
"84528",1084528,172,24,8,204
"84529",1084529,176,60,15,251
"84530",1084530,217,65,7,289
"84531",1084531,140,25,3,168
"84532",1084532,60,120,6,186
"84533",1084533,98,196,9,303
"84534",1084534,69,187,11,267
"84535",1084535,121,76,11,208
"84536",1084536,24,46,9,79
"84537",1084537,139,78,10,227
"84538",1084538,30,6,0,36
"84539",1084539,199,14,4,217
"84540",1084540,220,37,10,267
"84541",1084541,81,255,13,349
"84542",1084542,110,37,3,150
"84543",1084543,60,62,6,128
"84544",1084544,49,189,9,247
"84545",1084545,120,34,8,162
"84546",1084546,87,164,13,264
"84547",1084547,230,31,14,275
"84548",1084548,155,120,11,286
"84549",1084549,100,74,14,188
"84550",1084550,158,31,17,206
"84551",1084551,90,185,3,278
"84552",1084552,41,83,2,126
"84553",1084553,66,136,11,213
"84554",1084554,91,182,16,289
"84555",1084555,22,66,3,91
"84556",1084556,135,92,8,235
"84557",1084557,88,204,15,307
"84558",1084558,49,14,1,64
"84559",1084559,73,43,12,128
"84560",1084560,40,212,2,254
"84561",1084561,66,198,6,270
"84562",1084562,107,121,15,243
"84563",1084563,173,51,25,249
"84564",1084564,30,191,2,223
"84565",1084565,27,19,4,50
"84566",1084566,46,178,2,226
"84567",1084567,133,117,12,262
"84568",1084568,68,175,14,257
"84569",1084569,90,221,8,319
"84570",1084570,66,272,3,341
"84571",1084571,42,187,5,234
"84572",1084572,242,30,11,283
"84573",1084573,79,150,6,235
"84574",1084574,106,120,13,239
"84575",1084575,88,162,6,256
"84576",1084576,22,4,1,27
"84577",1084577,94,98,7,199
"84578",1084578,104,147,2,253
"84579",1084579,117,13,3,133
"84580",1084580,142,80,4,226
"84581",1084581,128,35,6,169
"84582",1084582,75,36,6,117
"84583",1084583,192,68,10,270
"84584",1084584,184,22,5,211
"84585",1084585,107,112,13,232
"84586",1084586,150,42,8,200
"84587",1084587,241,36,6,283
"84588",1084588,103,57,1,161
"84589",1084589,72,162,31,265
"84590",1084590,0,0,0,0
"84591",1084591,66,75,5,146
"84592",1084592,54,96,7,157
"84593",1084593,32,35,0,67
"84594",1084594,158,124,19,301
"84595",1084595,95,68,4,167
"84596",1084596,87,98,8,193
"84597",1084597,55,189,2,246
"84598",1084598,149,76,6,231
"84599",1084599,35,16,2,53
"84600",1084600,276,133,14,423
"84601",1084601,134,82,2,218
"84602",1084602,107,10,4,121
"84603",1084603,120,111,18,249
"84604",1084604,62,201,11,274
"84605",1084605,139,6,3,148
"84606",1084606,43,183,14,240
"84607",1084607,79,70,13,162
"84608",1084608,90,25,4,119
"84609",1084609,151,100,6,257
"84610",1084610,247,16,5,268
"84611",1084611,71,14,4,89
"84612",1084612,176,134,10,320
"84613",1084613,118,99,8,225
"84614",1084614,171,94,5,270
"84615",1084615,46,201,5,252
"84616",1084616,238,79,15,332
"84617",1084617,136,146,11,293
"84618",1084618,142,136,14,292
"84619",1084619,148,59,13,220
"84620",1084620,169,53,9,231
"84621",1084621,108,1,0,109
"84622",1084622,114,130,23,267
"84623",1084623,114,37,6,157
"84624",1084624,68,184,4,256
"84625",1084625,67,242,6,315
"84626",1084626,111,187,4,302
"84627",1084627,5,27,2,34
"84628",1084628,200,9,4,213
"84629",1084629,36,195,0,231
"84630",1084630,60,38,4,102
"84631",1084631,175,66,28,269
"84632",1084632,138,27,2,167
"84633",1084633,168,71,7,246
"84634",1084634,103,144,10,257
"84635",1084635,14,7,0,21
"84636",1084636,70,191,19,280
"84637",1084637,17,242,1,260
"84638",1084638,38,236,2,276
"84639",1084639,62,15,1,78
"84640",1084640,115,103,3,221
"84641",1084641,38,160,6,204
"84642",1084642,60,152,5,217
"84643",1084643,135,128,7,270
"84644",1084644,165,121,12,298
"84645",1084645,58,251,7,316
"84646",1084646,130,68,4,202
"84647",1084647,24,196,5,225
"84648",1084648,73,95,5,173
"84649",1084649,41,236,5,282
"84650",1084650,133,15,8,156
"84651",1084651,180,54,13,247
"84652",1084652,53,47,8,108
"84653",1084653,47,176,2,225
"84654",1084654,132,94,6,232
"84655",1084655,2,29,1,32
"84656",1084656,118,29,6,153
"84657",1084657,26,34,3,63
"84658",1084658,81,183,37,301
"84659",1084659,120,15,10,145
"84660",1084660,171,62,1,234
"84661",1084661,138,128,10,276
"84662",1084662,183,53,9,245
"84663",1084663,97,90,3,190
"84664",1084664,122,69,8,199
"84665",1084665,190,116,12,318
"84666",1084666,130,95,7,232
"84667",1084667,127,20,17,164
"84668",1084668,101,114,8,223
"84669",1084669,110,70,16,196
"84670",1084670,111,38,4,153
"84671",1084671,24,186,4,214
"84672",1084672,10,14,2,26
"84673",1084673,190,76,15,281
"84674",1084674,54,180,9,243
"84675",1084675,145,75,7,227
"84676",1084676,116,84,6,206
"84677",1084677,10,10,2,22
"84678",1084678,180,36,3,219
"84679",1084679,71,114,17,202
"84680",1084680,163,13,4,180
"84681",1084681,88,197,7,292
"84682",1084682,72,179,7,258
"84683",1084683,23,24,0,47
"84684",1084684,78,206,0,284
"84685",1084685,104,15,9,128
"84686",1084686,209,20,8,237
"84687",1084687,95,175,3,273
"84688",1084688,118,122,13,253
"84689",1084689,208,40,5,253
"84690",1084690,130,68,5,203
"84691",1084691,180,105,8,293
"84692",1084692,174,43,7,224
"84693",1084693,13,29,3,45
"84694",1084694,169,49,10,228
"84695",1084695,161,135,19,315
"84696",1084696,76,164,3,243
"84697",1084697,107,180,13,300
"84698",1084698,73,108,1,182
"84699",1084699,109,51,11,171
"84700",1084700,153,21,1,175
"84701",1084701,8,7,4,19
"84702",1084702,16,89,2,107
"84703",1084703,74,79,15,168
"84704",1084704,3,29,1,33
"84705",1084705,59,94,4,157
"84706",1084706,245,9,3,257
"84707",1084707,208,87,13,308
"84708",1084708,22,30,2,54
"84709",1084709,97,58,11,166
"84710",1084710,94,126,1,221
"84711",1084711,242,9,6,257
"84712",1084712,75,163,15,253
"84713",1084713,67,112,9,188
"84714",1084714,292,38,6,336
"84715",1084715,111,121,6,238
"84716",1084716,59,51,1,111
"84717",1084717,69,121,16,206
"84718",1084718,115,60,1,176
"84719",1084719,163,104,13,280
"84720",1084720,81,156,7,244
"84721",1084721,80,140,11,231
"84722",1084722,47,191,10,248
"84723",1084723,222,41,10,273
"84724",1084724,156,41,8,205
"84725",1084725,159,65,17,241
"84726",1084726,120,12,4,136
"84727",1084727,134,121,6,261
"84728",1084728,197,54,6,257
"84729",1084729,60,121,8,189
"84730",1084730,158,111,7,276
"84731",1084731,168,14,8,190
"84732",1084732,151,118,9,278
"84733",1084733,257,52,9,318
"84734",1084734,204,109,18,331
"84735",1084735,69,203,4,276
"84736",1084736,40,149,7,196
"84737",1084737,58,90,11,159
"84738",1084738,30,22,3,55
"84739",1084739,85,255,5,345
"84740",1084740,101,104,10,215
"84741",1084741,18,302,4,324
"84742",1084742,66,73,10,149
"84743",1084743,11,32,2,45
"84744",1084744,64,136,12,212
"84745",1084745,114,57,4,175
"84746",1084746,6,0,1,7
"84747",1084747,128,80,4,212
"84748",1084748,98,106,6,210
"84749",1084749,92,159,20,271
"84750",1084750,53,172,6,231
"84751",1084751,123,143,7,273
"84752",1084752,201,136,12,349
"84753",1084753,82,85,11,178
"84754",1084754,81,133,9,223
"84755",1084755,138,172,9,319
"84756",1084756,159,102,16,277
"84757",1084757,36,154,4,194
"84758",1084758,216,53,4,273
"84759",1084759,7,6,1,14
"84760",1084760,83,42,3,128
"84761",1084761,137,73,6,216
"84762",1084762,47,200,5,252
"84763",1084763,112,114,6,232
"84764",1084764,142,45,3,190
"84765",1084765,99,107,8,214
"84766",1084766,186,87,4,277
"84767",1084767,148,137,16,301
"84768",1084768,195,63,6,264
"84769",1084769,53,185,7,245
"84770",1084770,5,2,1,8
"84771",1084771,180,63,2,245
"84772",1084772,121,82,12,215
"84773",1084773,12,40,1,53
"84774",1084774,55,232,9,296
"84775",1084775,166,93,16,275
"84776",1084776,93,56,10,159
"84777",1084777,95,202,10,307
"84778",1084778,56,197,8,261
"84779",1084779,75,129,6,210
"84780",1084780,111,37,5,153
"84781",1084781,245,53,3,301
"84782",1084782,23,54,0,77
"84783",1084783,170,138,13,321
"84784",1084784,103,75,1,179
"84785",1084785,82,162,11,255
"84786",1084786,196,71,25,292
"84787",1084787,128,57,7,192
"84788",1084788,110,0,0,110
"84789",1084789,27,274,5,306
"84790",1084790,219,27,5,251
"84791",1084791,111,126,8,245
"84792",1084792,64,203,4,271
"84793",1084793,254,28,10,292
"84794",1084794,35,110,3,148
"84795",1084795,48,128,12,188
"84796",1084796,122,134,6,262
"84797",1084797,65,174,7,246
"84798",1084798,8,4,1,13
"84799",1084799,58,74,5,137
"84800",1084800,170,79,14,263
"84801",1084801,22,91,2,115
"84802",1084802,41,196,1,238
"84803",1084803,114,140,7,261
"84804",1084804,84,182,13,279
"84805",1084805,115,37,13,165
"84806",1084806,26,302,7,335
"84807",1084807,184,118,2,304
"84808",1084808,151,18,4,173
"84809",1084809,165,43,5,213
"84810",1084810,164,48,10,222
"84811",1084811,38,126,2,166
"84812",1084812,154,23,7,184
"84813",1084813,42,12,6,60
"84814",1084814,200,74,11,285
"84815",1084815,28,262,15,305
"84816",1084816,63,164,4,231
"84817",1084817,34,7,1,42
"84818",1084818,46,170,7,223
"84819",1084819,168,74,9,251
"84820",1084820,51,208,15,274
"84821",1084821,34,248,5,287
"84822",1084822,121,171,11,303
"84823",1084823,127,45,5,177
"84824",1084824,31,58,1,90
"84825",1084825,98,181,15,294
"84826",1084826,151,28,8,187
"84827",1084827,196,96,9,301
"84828",1084828,163,47,5,215
"84829",1084829,169,50,5,224
"84830",1084830,142,63,0,205
"84831",1084831,48,261,5,314
"84832",1084832,62,83,3,148
"84833",1084833,185,12,5,202
"84834",1084834,40,8,1,49
"84835",1084835,79,26,7,112
"84836",1084836,37,193,7,237
"84837",1084837,50,156,3,209
"84838",1084838,34,92,6,132
"84839",1084839,90,105,6,201
"84840",1084840,151,88,7,246
"84841",1084841,51,9,1,61
"84842",1084842,68,78,9,155
"84843",1084843,142,116,8,266
"84844",1084844,200,69,9,278
"84845",1084845,101,41,9,151
"84846",1084846,149,121,3,273
"84847",1084847,166,105,15,286
"84848",1084848,183,67,5,255
"84849",1084849,168,17,8,193
"84850",1084850,147,154,14,315
"84851",1084851,167,16,3,186
"84852",1084852,119,146,14,279
"84853",1084853,94,58,8,160
"84854",1084854,205,61,16,282
"84855",1084855,132,112,9,253
"84856",1084856,152,80,8,240
"84857",1084857,44,177,6,227
"84858",1084858,37,14,5,56
"84859",1084859,3,2,0,5
"84860",1084860,142,72,9,223
"84861",1084861,52,15,2,69
"84862",1084862,96,156,2,254
"84863",1084863,76,204,6,286
"84864",1084864,39,185,5,229
"84865",1084865,77,103,9,189
"84866",1084866,149,41,3,193
"84867",1084867,81,27,0,108
"84868",1084868,91,25,2,118
"84869",1084869,97,83,4,184
"84870",1084870,138,51,4,193
"84871",1084871,301,7,9,317
"84872",1084872,174,116,15,305
"84873",1084873,140,177,13,330
"84874",1084874,215,45,13,273
"84875",1084875,86,94,0,180
"84876",1084876,28,142,3,173
"84877",1084877,54,216,2,272
"84878",1084878,93,108,6,207
"84879",1084879,95,131,6,232
"84880",1084880,101,103,6,210
"84881",1084881,44,242,9,295
"84882",1084882,122,44,5,171
"84883",1084883,10,36,2,48
"84884",1084884,151,54,6,211
"84885",1084885,136,73,6,215
"84886",1084886,20,81,5,106
"84887",1084887,145,56,8,209
"84888",1084888,30,113,4,147
"84889",1084889,152,77,6,235
"84890",1084890,76,103,1,180
"84891",1084891,15,99,2,116
"84892",1084892,81,28,2,111
"84893",1084893,93,41,24,158
"84894",1084894,2,11,0,13
"84895",1084895,84,39,4,127
"84896",1084896,30,89,1,120
"84897",1084897,92,110,4,206
"84898",1084898,153,147,20,320
"84899",1084899,101,71,4,176
"84900",1084900,22,221,7,250
"84901",1084901,173,108,14,295
"84902",1084902,251,40,13,304
"84903",1084903,111,209,13,333
"84904",1084904,106,89,9,204
"84905",1084905,193,54,15,262
"84906",1084906,63,66,4,133
"84907",1084907,145,57,3,205
"84908",1084908,132,36,13,181
"84909",1084909,174,32,5,211
"84910",1084910,96,148,19,263
"84911",1084911,215,0,0,215
"84912",1084912,89,180,5,274
"84913",1084913,29,259,6,294
"84914",1084914,97,54,13,164
"84915",1084915,212,135,9,356
"84916",1084916,152,76,3,231
"84917",1084917,97,184,19,300
"84918",1084918,51,170,11,232
"84919",1084919,76,175,14,265
"84920",1084920,135,91,17,243
"84921",1084921,41,131,3,175
"84922",1084922,55,141,14,210
"84923",1084923,100,76,9,185
"84924",1084924,190,35,0,225
"84925",1084925,86,124,16,226
"84926",1084926,55,171,20,246
"84927",1084927,155,173,14,342
"84928",1084928,102,143,7,252
"84929",1084929,60,234,12,306
"84930",1084930,169,88,7,264
"84931",1084931,2,16,1,19
"84932",1084932,63,181,10,254
"84933",1084933,109,63,6,178
"84934",1084934,52,194,7,253
"84935",1084935,59,198,4,261
"84936",1084936,108,46,6,160
"84937",1084937,41,121,7,169
"84938",1084938,36,214,10,260
"84939",1084939,20,112,1,133
"84940",1084940,194,63,11,268
"84941",1084941,114,32,3,149
"84942",1084942,99,27,3,129
"84943",1084943,210,14,6,230
"84944",1084944,55,171,9,235
"84945",1084945,171,21,8,200
"84946",1084946,237,36,9,282
"84947",1084947,118,112,7,237
"84948",1084948,170,147,6,323
"84949",1084949,135,159,8,302
"84950",1084950,132,41,3,176
"84951",1084951,128,63,8,199
"84952",1084952,61,255,0,316
"84953",1084953,238,13,3,254
"84954",1084954,62,97,6,165
"84955",1084955,135,78,10,223
"84956",1084956,116,77,9,202
"84957",1084957,97,190,15,302
"84958",1084958,143,120,6,269
"84959",1084959,86,169,11,266
"84960",1084960,189,77,8,274
"84961",1084961,164,49,10,223
"84962",1084962,7,2,2,11
"84963",1084963,162,35,12,209
"84964",1084964,24,27,4,55
"84965",1084965,15,220,8,243
"84966",1084966,124,140,22,286
"84967",1084967,24,60,3,87
"84968",1084968,51,3,0,54
"84969",1084969,49,263,10,322
"84970",1084970,130,70,9,209
"84971",1084971,78,25,4,107
"84972",1084972,157,84,11,252
"84973",1084973,129,63,0,192
"84974",1084974,24,272,4,300
"84975",1084975,133,47,4,184
"84976",1084976,154,134,6,294
"84977",1084977,107,113,10,230
"84978",1084978,223,62,15,300
"84979",1084979,96,142,9,247
"84980",1084980,107,70,2,179
"84981",1084981,19,21,1,41
"84982",1084982,54,57,5,116
"84983",1084983,75,136,13,224
"84984",1084984,132,74,2,208
"84985",1084985,113,55,5,173
"84986",1084986,88,139,14,241
"84987",1084987,95,187,13,295
"84988",1084988,110,162,19,291
"84989",1084989,59,221,12,292
"84990",1084990,65,182,15,262
"84991",1084991,36,218,4,258
"84992",1084992,216,93,26,335
"84993",1084993,168,23,8,199
"84994",1084994,239,69,6,314
"84995",1084995,85,19,3,107
"84996",1084996,84,0,0,84
"84997",1084997,50,54,2,106
"84998",1084998,161,48,9,218
"84999",1084999,137,115,40,292
"85000",1085000,119,71,7,197
"85001",1085001,43,205,6,254
"85002",1085002,107,103,9,219
"85003",1085003,193,69,14,276
"85004",1085004,217,63,7,287
"85005",1085005,67,213,21,301
"85006",1085006,72,179,22,273
"85007",1085007,176,74,23,273
"85008",1085008,51,211,10,272
"85009",1085009,189,46,8,243
"85010",1085010,94,184,22,300
"85011",1085011,129,100,8,237
"85012",1085012,89,89,8,186
"85013",1085013,33,53,10,96
"85014",1085014,32,205,6,243
"85015",1085015,35,16,2,53
"85016",1085016,85,117,0,202
"85017",1085017,45,128,2,175
"85018",1085018,155,123,20,298
"85019",1085019,35,234,2,271
"85020",1085020,93,205,9,307
"85021",1085021,112,38,17,167
"85022",1085022,69,51,3,123
"85023",1085023,92,199,10,301
"85024",1085024,84,33,2,119
"85025",1085025,46,184,11,241
"85026",1085026,202,130,1,333
"85027",1085027,139,24,7,170
"85028",1085028,93,92,3,188
"85029",1085029,72,198,10,280
"85030",1085030,135,96,13,244
"85031",1085031,64,106,6,176
"85032",1085032,108,96,2,206
"85033",1085033,75,71,7,153
"85034",1085034,124,88,11,223
"85035",1085035,160,57,2,219
"85036",1085036,84,105,3,192
"85037",1085037,90,57,7,154
"85038",1085038,122,137,20,279
"85039",1085039,191,78,9,278
"85040",1085040,101,124,2,227
"85041",1085041,162,103,9,274
"85042",1085042,118,134,8,260
"85043",1085043,65,231,8,304
"85044",1085044,78,165,7,250
"85045",1085045,149,30,3,182
"85046",1085046,88,203,6,297
"85047",1085047,150,47,2,199
"85048",1085048,27,116,1,144
"85049",1085049,114,177,16,307
"85050",1085050,92,160,8,260
"85051",1085051,37,270,4,311
"85052",1085052,135,149,10,294
"85053",1085053,130,124,18,272
"85054",1085054,169,101,12,282
"85055",1085055,175,50,10,235
"85056",1085056,187,110,8,305
"85057",1085057,151,134,29,314
"85058",1085058,85,189,13,287
"85059",1085059,196,129,10,335
"85060",1085060,82,115,3,200
"85061",1085061,67,170,4,241
"85062",1085062,116,26,4,146
"85063",1085063,46,157,16,219
"85064",1085064,26,158,8,192
"85065",1085065,121,118,11,250
"85066",1085066,90,16,2,108
"85067",1085067,164,101,4,269
"85068",1085068,101,163,10,274
"85069",1085069,115,51,18,184
"85070",1085070,84,257,6,347
"85071",1085071,74,263,6,343
"85072",1085072,51,115,4,170
"85073",1085073,58,68,7,133
"85074",1085074,194,73,1,268
"85075",1085075,90,58,3,151
"85076",1085076,19,251,1,271
"85077",1085077,49,36,0,85
"85078",1085078,73,176,14,263
"85079",1085079,35,253,6,294
"85080",1085080,132,101,6,239
"85081",1085081,78,173,6,257
"85082",1085082,57,82,7,146
"85083",1085083,191,59,9,259
"85084",1085084,210,54,7,271
"85085",1085085,98,19,0,117
"85086",1085086,84,166,13,263
"85087",1085087,167,125,18,310
"85088",1085088,41,88,9,138
"85089",1085089,69,139,5,213
"85090",1085090,143,129,9,281
"85091",1085091,50,168,11,229
"85092",1085092,63,223,12,298
"85093",1085093,142,107,9,258
"85094",1085094,168,82,3,253
"85095",1085095,26,75,3,104
"85096",1085096,99,93,9,201
"85097",1085097,59,141,12,212
"85098",1085098,35,34,4,73
"85099",1085099,56,2,0,58
"85100",1085100,132,21,2,155
"85101",1085101,126,84,3,213
"85102",1085102,69,25,11,105
"85103",1085103,216,34,5,255
"85104",1085104,114,67,4,185
"85105",1085105,65,172,6,243
"85106",1085106,195,81,4,280
"85107",1085107,42,241,1,284
"85108",1085108,106,118,12,236
"85109",1085109,113,145,6,264
"85110",1085110,81,152,15,248
"85111",1085111,239,175,16,430
"85112",1085112,215,120,16,351
"85113",1085113,151,17,6,174
"85114",1085114,168,111,8,287
"85115",1085115,22,88,4,114
"85116",1085116,38,187,3,228
"85117",1085117,184,39,9,232
"85118",1085118,91,20,1,112
"85119",1085119,15,7,2,24
"85120",1085120,222,44,5,271
"85121",1085121,133,121,7,261
"85122",1085122,42,144,5,191
"85123",1085123,13,150,9,172
"85124",1085124,99,97,2,198
"85125",1085125,184,64,14,262
"85126",1085126,60,18,3,81
"85127",1085127,200,69,15,284
"85128",1085128,137,91,4,232
"85129",1085129,107,25,1,133
"85130",1085130,96,25,4,125
"85131",1085131,34,52,0,86
"85132",1085132,133,71,21,225
"85133",1085133,116,56,1,173
"85134",1085134,211,116,15,342
"85135",1085135,20,97,2,119
"85136",1085136,36,34,2,72
"85137",1085137,96,223,13,332
"85138",1085138,107,146,4,257
"85139",1085139,72,213,12,297
"85140",1085140,180,104,11,295
"85141",1085141,170,206,10,386
"85142",1085142,32,79,2,113
"85143",1085143,41,35,3,79
"85144",1085144,71,132,7,210
"85145",1085145,29,14,2,45
"85146",1085146,61,204,3,268
"85147",1085147,42,196,1,239
"85148",1085148,73,184,5,262
"85149",1085149,95,233,10,338
"85150",1085150,99,13,10,122
"85151",1085151,188,61,5,254
"85152",1085152,65,180,6,251
"85153",1085153,163,115,8,286
"85154",1085154,153,58,9,220
"85155",1085155,113,60,6,179
"85156",1085156,128,156,20,304
"85157",1085157,69,132,2,203
"85158",1085158,170,31,7,208
"85159",1085159,87,185,11,283
"85160",1085160,176,18,1,195
"85161",1085161,76,167,11,254
"85162",1085162,60,72,1,133
"85163",1085163,167,94,15,276
"85164",1085164,21,218,4,243
"85165",1085165,138,45,6,189
"85166",1085166,96,24,2,122
"85167",1085167,102,161,10,273
"85168",1085168,187,69,10,266
"85169",1085169,99,59,8,166
"85170",1085170,146,61,8,215
"85171",1085171,66,182,3,251
"85172",1085172,173,45,11,229
"85173",1085173,179,42,3,224
"85174",1085174,43,258,1,302
"85175",1085175,55,48,7,110
"85176",1085176,115,157,33,305
"85177",1085177,36,20,1,57
"85178",1085178,10,151,3,164
"85179",1085179,203,24,8,235
"85180",1085180,115,53,1,169
"85181",1085181,100,138,6,244
"85182",1085182,197,51,5,253
"85183",1085183,12,211,1,224
"85184",1085184,60,224,3,287
"85185",1085185,226,18,9,253
"85186",1085186,130,111,11,252
"85187",1085187,274,200,19,493
"85188",1085188,78,180,6,264
"85189",1085189,135,64,8,207
"85190",1085190,71,208,6,285
"85191",1085191,76,123,6,205
"85192",1085192,81,169,11,261
"85193",1085193,61,167,16,244
"85194",1085194,130,85,10,225
"85195",1085195,28,62,1,91
"85196",1085196,211,48,7,266
"85197",1085197,31,248,1,280
"85198",1085198,147,97,11,255
"85199",1085199,163,85,26,274
"85200",1085200,99,122,15,236
"85201",1085201,79,171,3,253
"85202",1085202,88,180,5,273
"85203",1085203,185,67,3,255
"85204",1085204,188,57,9,254
"85205",1085205,94,106,15,215
"85206",1085206,48,205,10,263
"85207",1085207,131,101,16,248
"85208",1085208,109,97,6,212
"85209",1085209,52,40,7,99
"85210",1085210,141,122,20,283
"85211",1085211,76,34,2,112
"85212",1085212,137,40,5,182
"85213",1085213,108,131,7,246
"85214",1085214,230,18,2,250
"85215",1085215,81,125,24,230
"85216",1085216,99,35,8,142
"85217",1085217,14,13,2,29
"85218",1085218,198,56,9,263
"85219",1085219,118,154,9,281
"85220",1085220,49,24,5,78
"85221",1085221,160,27,2,189
"85222",1085222,22,180,3,205
"85223",1085223,49,52,3,104
"85224",1085224,95,99,17,211
"85225",1085225,115,154,14,283
"85226",1085226,129,81,8,218
"85227",1085227,9,35,1,45
"85228",1085228,111,231,11,353
"85229",1085229,29,246,6,281
"85230",1085230,71,13,4,88
"85231",1085231,123,39,6,168
"85232",1085232,113,19,7,139
"85233",1085233,90,98,7,195
"85234",1085234,161,82,15,258
"85235",1085235,177,85,14,276
"85236",1085236,86,17,12,115
"85237",1085237,55,53,2,110
"85238",1085238,77,195,5,277
"85239",1085239,259,24,5,288
"85240",1085240,108,94,13,215
"85241",1085241,51,213,9,273
"85242",1085242,21,14,1,36
"85243",1085243,236,34,10,280
"85244",1085244,123,118,12,253
"85245",1085245,132,134,6,272
"85246",1085246,93,118,3,214
"85247",1085247,34,148,5,187
"85248",1085248,72,13,0,85
"85249",1085249,215,60,18,293
"85250",1085250,113,203,10,326
"85251",1085251,23,33,0,56
"85252",1085252,163,82,12,257
"85253",1085253,43,169,0,212
"85254",1085254,204,83,7,294
"85255",1085255,163,95,7,265
"85256",1085256,2,37,0,39
"85257",1085257,34,175,12,221
"85258",1085258,53,45,1,99
"85259",1085259,77,159,7,243
"85260",1085260,98,99,2,199
"85261",1085261,192,37,5,234
"85262",1085262,43,191,1,235
"85263",1085263,9,1,1,11
"85264",1085264,162,72,22,256
"85265",1085265,41,55,7,103
"85266",1085266,97,168,4,269
"85267",1085267,48,273,10,331
"85268",1085268,46,109,8,163
"85269",1085269,43,40,0,83
"85270",1085270,117,200,4,321
"85271",1085271,133,96,16,245
"85272",1085272,12,70,2,84
"85273",1085273,61,49,5,115
"85274",1085274,110,148,7,265
"85275",1085275,160,128,21,309
"85276",1085276,122,122,14,258
"85277",1085277,93,183,5,281
"85278",1085278,34,144,2,180
"85279",1085279,86,43,1,130
"85280",1085280,186,37,4,227
"85281",1085281,163,122,6,291
"85282",1085282,166,150,10,326
"85283",1085283,96,172,24,292
"85284",1085284,46,130,3,179
"85285",1085285,177,51,16,244
"85286",1085286,134,96,12,242
"85287",1085287,164,123,1,288
"85288",1085288,237,59,12,308
"85289",1085289,148,71,9,228
"85290",1085290,40,80,5,125
"85291",1085291,205,57,16,278
"85292",1085292,199,60,1,260
"85293",1085293,75,130,9,214
"85294",1085294,151,56,1,208
"85295",1085295,36,228,8,272
"85296",1085296,57,150,3,210
"85297",1085297,29,193,2,224
"85298",1085298,191,32,8,231
"85299",1085299,61,247,3,311
"85300",1085300,73,117,4,194
"85301",1085301,149,47,7,203
"85302",1085302,43,6,2,51
"85303",1085303,80,103,5,188
"85304",1085304,166,59,5,230
"85305",1085305,224,16,3,243
"85306",1085306,100,187,9,296
"85307",1085307,84,175,6,265
"85308",1085308,98,161,6,265
"85309",1085309,150,96,20,266
"85310",1085310,59,70,5,134
"85311",1085311,177,112,11,300
"85312",1085312,115,18,4,137
"85313",1085313,39,37,6,82
"85314",1085314,144,90,5,239
"85315",1085315,103,103,6,212
"85316",1085316,117,116,10,243
"85317",1085317,157,57,24,238
"85318",1085318,130,120,4,254
"85319",1085319,168,41,6,215
"85320",1085320,50,154,4,208
"85321",1085321,136,38,5,179
"85322",1085322,125,49,8,182
"85323",1085323,166,144,23,333
"85324",1085324,51,7,2,60
"85325",1085325,161,32,8,201
"85326",1085326,113,93,9,215
"85327",1085327,33,257,7,297
"85328",1085328,34,236,3,273
"85329",1085329,51,176,3,230
"85330",1085330,176,114,20,310
"85331",1085331,207,17,4,228
"85332",1085332,24,207,4,235
"85333",1085333,155,69,7,231
"85334",1085334,196,62,16,274
"85335",1085335,49,264,4,317
"85336",1085336,65,172,5,242
"85337",1085337,100,2,2,104
"85338",1085338,135,104,7,246
"85339",1085339,35,74,7,116
"85340",1085340,207,63,18,288
"85341",1085341,30,143,6,179
"85342",1085342,118,141,8,267
"85343",1085343,117,83,11,211
"85344",1085344,98,180,21,299
"85345",1085345,39,104,7,150
"85346",1085346,115,21,1,137
"85347",1085347,151,121,20,292
"85348",1085348,23,111,6,140
"85349",1085349,94,53,7,154
"85350",1085350,78,119,17,214
"85351",1085351,91,150,9,250
"85352",1085352,39,200,6,245
"85353",1085353,71,28,2,101
"85354",1085354,138,75,9,222
"85355",1085355,50,244,9,303
"85356",1085356,115,167,13,295
"85357",1085357,82,200,10,292
"85358",1085358,91,210,8,309
"85359",1085359,66,149,10,225
"85360",1085360,51,54,8,113
"85361",1085361,40,143,4,187
"85362",1085362,17,229,3,249
"85363",1085363,192,105,5,302
"85364",1085364,62,78,6,146
"85365",1085365,136,121,9,266
"85366",1085366,60,130,1,191
"85367",1085367,73,152,10,235
"85368",1085368,70,180,4,254
"85369",1085369,106,67,2,175
"85370",1085370,122,176,15,313
"85371",1085371,45,236,4,285
"85372",1085372,104,27,1,132
"85373",1085373,55,127,15,197
"85374",1085374,101,127,8,236
"85375",1085375,71,163,10,244
"85376",1085376,27,27,2,56
"85377",1085377,166,95,12,273
"85378",1085378,99,102,18,219
"85379",1085379,127,204,12,343
"85380",1085380,117,166,11,294
"85381",1085381,56,161,5,222
"85382",1085382,40,206,3,249
"85383",1085383,26,170,2,198
"85384",1085384,15,76,1,92
"85385",1085385,121,118,10,249
"85386",1085386,194,29,7,230
"85387",1085387,106,27,11,144
"85388",1085388,149,118,12,279
"85389",1085389,193,79,17,289
"85390",1085390,136,118,2,256
"85391",1085391,62,209,1,272
"85392",1085392,112,148,7,267
"85393",1085393,47,0,1,48
"85394",1085394,57,63,1,121
"85395",1085395,208,58,9,275
"85396",1085396,150,156,18,324
"85397",1085397,28,222,13,263
"85398",1085398,133,12,6,151
"85399",1085399,24,100,9,133
"85400",1085400,22,217,1,240
"85401",1085401,79,164,22,265
"85402",1085402,30,278,7,315
"85403",1085403,113,89,8,210
"85404",1085404,57,249,10,316
"85405",1085405,125,157,11,293
"85406",1085406,143,126,3,272
"85407",1085407,86,137,24,247
"85408",1085408,27,125,4,156
"85409",1085409,130,57,9,196
"85410",1085410,177,48,4,229
"85411",1085411,42,198,16,256
"85412",1085412,93,108,13,214
"85413",1085413,61,2,0,63
"85414",1085414,103,84,3,190
"85415",1085415,15,18,1,34
"85416",1085416,42,184,0,226
"85417",1085417,150,27,8,185
"85418",1085418,99,86,22,207
"85419",1085419,51,239,9,299
"85420",1085420,102,71,4,177
"85421",1085421,43,31,2,76
"85422",1085422,146,87,13,246
"85423",1085423,37,148,4,189
"85424",1085424,136,38,5,179
"85425",1085425,18,116,4,138
"85426",1085426,255,38,12,305
"85427",1085427,123,71,10,204
"85428",1085428,26,34,0,60
"85429",1085429,129,26,3,158
"85430",1085430,7,41,2,50
"85431",1085431,58,183,6,247
"85432",1085432,16,45,1,62
"85433",1085433,43,26,0,69
"85434",1085434,90,104,8,202
"85435",1085435,76,85,8,169
"85436",1085436,175,32,6,213
"85437",1085437,111,135,7,253
"85438",1085438,56,93,3,152
"85439",1085439,104,34,8,146
"85440",1085440,111,135,12,258
"85441",1085441,11,12,0,23
"85442",1085442,265,35,9,309
"85443",1085443,37,182,12,231
"85444",1085444,157,104,14,275
"85445",1085445,167,62,2,231
"85446",1085446,66,86,3,155
"85447",1085447,97,99,10,206
"85448",1085448,180,30,7,217
"85449",1085449,75,143,8,226
"85450",1085450,138,40,5,183
"85451",1085451,76,25,1,102
"85452",1085452,46,49,1,96
"85453",1085453,87,156,7,250
"85454",1085454,182,59,11,252
"85455",1085455,20,213,9,242
"85456",1085456,184,77,7,268
"85457",1085457,141,107,10,258
"85458",1085458,53,233,7,293
"85459",1085459,52,205,15,272
"85460",1085460,69,14,2,85
"85461",1085461,104,98,3,205
"85462",1085462,10,203,0,213
"85463",1085463,56,129,3,188
"85464",1085464,173,70,14,257
"85465",1085465,129,68,12,209
"85466",1085466,47,154,5,206
"85467",1085467,167,51,2,220
"85468",1085468,232,15,6,253
"85469",1085469,189,69,10,268
"85470",1085470,7,28,2,37
"85471",1085471,121,132,0,253
"85472",1085472,44,7,0,51
"85473",1085473,171,26,2,199
"85474",1085474,70,152,1,223
"85475",1085475,109,157,14,280
"85476",1085476,51,65,6,122
"85477",1085477,223,65,10,298
"85478",1085478,109,162,16,287
"85479",1085479,52,68,7,127
"85480",1085480,47,144,2,193
"85481",1085481,85,108,12,205
"85482",1085482,62,160,6,228
"85483",1085483,116,116,8,240
"85484",1085484,92,101,6,199
"85485",1085485,159,142,12,313
"85486",1085486,50,157,5,212
"85487",1085487,115,145,12,272
"85488",1085488,208,20,2,230
"85489",1085489,168,64,4,236
"85490",1085490,54,252,7,313
"85491",1085491,123,90,6,219
"85492",1085492,46,43,2,91
"85493",1085493,126,119,9,254
"85494",1085494,132,112,5,249
"85495",1085495,136,190,5,331
"85496",1085496,115,110,14,239
"85497",1085497,70,175,8,253
"85498",1085498,176,13,0,189
"85499",1085499,165,44,8,217
"85500",1085500,218,25,4,247
"85501",1085501,194,39,18,251
"85502",1085502,186,43,3,232
"85503",1085503,220,75,18,313
"85504",1085504,31,71,2,104
"85505",1085505,38,173,5,216
"85506",1085506,170,47,9,226
"85507",1085507,101,141,13,255
"85508",1085508,40,171,22,233
"85509",1085509,90,213,10,313
"85510",1085510,229,55,5,289
"85511",1085511,55,169,6,230
"85512",1085512,39,155,4,198
"85513",1085513,107,99,19,225
"85514",1085514,104,157,13,274
"85515",1085515,46,166,3,215
"85516",1085516,24,62,0,86
"85517",1085517,110,88,5,203
"85518",1085518,100,56,1,157
"85519",1085519,40,12,4,56
"85520",1085520,40,190,18,248
"85521",1085521,193,103,8,304
"85522",1085522,142,82,13,237
"85523",1085523,108,190,12,310
"85524",1085524,57,254,6,317
"85525",1085525,89,39,4,132
"85526",1085526,92,24,7,123
"85527",1085527,95,153,28,276
"85528",1085528,31,208,1,240
"85529",1085529,58,73,11,142
"85530",1085530,106,13,0,119
"85531",1085531,161,44,8,213
"85532",1085532,79,29,13,121
"85533",1085533,258,37,8,303
"85534",1085534,117,16,2,135
"85535",1085535,138,82,5,225
"85536",1085536,125,143,13,281
"85537",1085537,32,63,6,101
"85538",1085538,113,88,4,205
"85539",1085539,21,85,4,110
"85540",1085540,107,139,4,250
"85541",1085541,182,56,4,242
"85542",1085542,104,25,8,137
"85543",1085543,50,209,6,265
"85544",1085544,185,32,6,223
"85545",1085545,145,88,8,241
"85546",1085546,103,132,2,237
"85547",1085547,110,35,5,150
"85548",1085548,115,68,7,190
"85549",1085549,39,230,4,273
"85550",1085550,39,30,2,71
"85551",1085551,162,140,7,309
"85552",1085552,144,105,10,259
"85553",1085553,236,24,6,266
"85554",1085554,112,99,3,214
"85555",1085555,140,103,8,251
"85556",1085556,31,199,3,233
"85557",1085557,37,267,5,309
"85558",1085558,59,211,8,278
"85559",1085559,169,53,8,230
"85560",1085560,13,131,5,149
"85561",1085561,56,177,14,247
"85562",1085562,168,80,12,260
"85563",1085563,69,96,7,172
"85564",1085564,76,74,8,158
"85565",1085565,2,4,0,6
"85566",1085566,130,116,11,257
"85567",1085567,96,158,11,265
"85568",1085568,161,75,1,237
"85569",1085569,73,36,4,113
"85570",1085570,105,116,8,229
"85571",1085571,156,71,10,237
"85572",1085572,110,89,8,207
"85573",1085573,141,98,14,253
"85574",1085574,161,109,5,275
"85575",1085575,44,221,10,275
"85576",1085576,200,65,16,281
"85577",1085577,89,214,10,313
"85578",1085578,14,46,2,62
"85579",1085579,265,21,11,297
"85580",1085580,156,51,9,216
"85581",1085581,86,159,8,253
"85582",1085582,106,62,5,173
"85583",1085583,236,47,15,298
"85584",1085584,38,204,11,253
"85585",1085585,165,31,9,205
"85586",1085586,177,86,10,273
"85587",1085587,69,213,12,294
"85588",1085588,18,20,2,40
"85589",1085589,127,140,21,288
"85590",1085590,124,106,2,232
"85591",1085591,113,74,7,194
"85592",1085592,69,115,7,191
"85593",1085593,33,204,8,245
"85594",1085594,62,161,4,227
"85595",1085595,67,162,11,240
"85596",1085596,9,3,1,13
"85597",1085597,15,4,1,20
"85598",1085598,170,42,7,219
"85599",1085599,82,194,2,278
"85600",1085600,210,21,8,239
"85601",1085601,46,214,2,262
"85602",1085602,121,17,3,141
"85603",1085603,209,57,6,272
"85604",1085604,201,45,10,256
"85605",1085605,210,34,9,253
"85606",1085606,14,2,1,17
"85607",1085607,113,127,16,256
"85608",1085608,140,47,13,200
"85609",1085609,127,87,13,227
"85610",1085610,130,70,14,214
"85611",1085611,19,60,4,83
"85612",1085612,157,60,11,228
"85613",1085613,138,82,5,225
"85614",1085614,16,117,0,133
"85615",1085615,72,138,6,216
"85616",1085616,35,178,2,215
"85617",1085617,205,66,13,284
"85618",1085618,155,13,2,170
"85619",1085619,92,73,6,171
"85620",1085620,150,72,15,237
"85621",1085621,120,46,3,169
"85622",1085622,41,143,6,190
"85623",1085623,94,139,24,257
"85624",1085624,65,13,3,81
"85625",1085625,149,85,6,240
"85626",1085626,14,4,2,20
"85627",1085627,187,56,7,250
"85628",1085628,90,40,3,133
"85629",1085629,111,87,14,212
"85630",1085630,158,42,12,212
"85631",1085631,177,36,1,214
"85632",1085632,50,267,7,324
"85633",1085633,181,122,26,329
"85634",1085634,145,96,3,244
"85635",1085635,66,209,9,284
"85636",1085636,121,115,10,246
"85637",1085637,13,23,1,37
"85638",1085638,141,119,6,266
"85639",1085639,5,3,1,9
"85640",1085640,215,27,7,249
"85641",1085641,239,52,9,300
"85642",1085642,25,151,5,181
"85643",1085643,195,36,10,241
"85644",1085644,69,48,12,129
"85645",1085645,13,223,5,241
"85646",1085646,62,220,12,294
"85647",1085647,162,48,6,216
"85648",1085648,156,21,2,179
"85649",1085649,146,191,20,357
"85650",1085650,211,24,7,242
"85651",1085651,214,16,7,237
"85652",1085652,80,135,13,228
"85653",1085653,49,178,3,230
"85654",1085654,30,246,14,290
"85655",1085655,161,35,9,205
"85656",1085656,197,41,9,247
"85657",1085657,153,37,5,195
"85658",1085658,146,133,13,292
"85659",1085659,127,195,48,370
"85660",1085660,46,64,0,110
"85661",1085661,128,55,14,197
"85662",1085662,207,60,12,279
"85663",1085663,102,62,7,171
"85664",1085664,101,133,15,249
"85665",1085665,111,219,18,348
"85666",1085666,83,215,6,304
"85667",1085667,27,0,3,30
"85668",1085668,65,183,18,266
"85669",1085669,20,240,7,267
"85670",1085670,54,146,4,204
"85671",1085671,214,36,5,255
"85672",1085672,156,0,0,156
"85673",1085673,47,243,2,292
"85674",1085674,93,34,1,128
"85675",1085675,142,32,4,178
"85676",1085676,156,21,2,179
"85677",1085677,224,48,15,287
"85678",1085678,173,55,13,241
"85679",1085679,170,101,12,283
"85680",1085680,20,232,3,255
"85681",1085681,87,118,7,212
"85682",1085682,48,207,15,270
"85683",1085683,43,226,7,276
"85684",1085684,52,42,3,97
"85685",1085685,179,40,2,221
"85686",1085686,98,162,10,270
"85687",1085687,175,52,18,245
"85688",1085688,105,114,22,241
"85689",1085689,104,85,4,193
"85690",1085690,47,49,2,98
"85691",1085691,115,98,12,225
"85692",1085692,24,76,8,108
"85693",1085693,184,5,1,190
"85694",1085694,48,182,2,232
"85695",1085695,127,55,10,192
"85696",1085696,80,117,6,203
"85697",1085697,13,213,4,230
"85698",1085698,80,172,24,276
"85699",1085699,104,43,2,149
"85700",1085700,130,14,2,146
"85701",1085701,22,102,6,130
"85702",1085702,116,68,6,190
"85703",1085703,123,95,8,226
"85704",1085704,14,54,0,68
"85705",1085705,49,50,4,103
"85706",1085706,18,240,5,263
"85707",1085707,171,40,15,226
"85708",1085708,136,24,3,163
"85709",1085709,163,77,11,251
"85710",1085710,69,103,12,184
"85711",1085711,178,48,12,238
"85712",1085712,32,158,4,194
"85713",1085713,74,44,7,125
"85714",1085714,179,36,10,225
"85715",1085715,224,88,12,324
"85716",1085716,167,140,12,319
"85717",1085717,78,101,4,183
"85718",1085718,76,201,4,281
"85719",1085719,70,48,7,125
"85720",1085720,182,109,12,303
"85721",1085721,10,11,1,22
"85722",1085722,113,134,9,256
"85723",1085723,64,221,13,298
"85724",1085724,41,8,3,52
"85725",1085725,136,115,2,253
"85726",1085726,175,32,6,213
"85727",1085727,46,247,9,302
"85728",1085728,27,201,5,233
"85729",1085729,150,9,4,163
"85730",1085730,48,220,11,279
"85731",1085731,170,52,14,236
"85732",1085732,6,8,0,14
"85733",1085733,155,154,14,323
"85734",1085734,184,17,9,210
"85735",1085735,97,27,3,127
"85736",1085736,116,152,12,280
"85737",1085737,53,94,8,155
"85738",1085738,97,133,12,242
"85739",1085739,54,47,5,106
"85740",1085740,80,245,7,332
"85741",1085741,7,4,1,12
"85742",1085742,24,17,3,44
"85743",1085743,78,83,5,166
"85744",1085744,118,74,5,197
"85745",1085745,133,61,4,198
"85746",1085746,197,12,10,219
"85747",1085747,193,16,6,215
"85748",1085748,230,18,11,259
"85749",1085749,122,10,4,136
"85750",1085750,49,207,12,268
"85751",1085751,110,151,9,270
"85752",1085752,67,103,5,175
"85753",1085753,146,110,15,271
"85754",1085754,47,4,0,51
"85755",1085755,74,69,3,146
"85756",1085756,168,93,9,270
"85757",1085757,137,50,11,198
"85758",1085758,231,10,4,245
"85759",1085759,96,156,22,274
"85760",1085760,248,21,15,284
"85761",1085761,168,59,15,242
"85762",1085762,148,68,9,225
"85763",1085763,119,176,17,312
"85764",1085764,151,76,9,236
"85765",1085765,77,82,8,167
"85766",1085766,220,29,4,253
"85767",1085767,34,244,11,289
"85768",1085768,99,103,5,207
"85769",1085769,266,17,18,301
"85770",1085770,124,131,6,261
"85771",1085771,73,214,8,295
"85772",1085772,73,233,11,317
"85773",1085773,194,34,6,234
"85774",1085774,147,143,7,297
"85775",1085775,165,22,7,194
"85776",1085776,193,108,14,315
"85777",1085777,162,109,10,281
"85778",1085778,140,39,6,185
"85779",1085779,69,211,13,293
"85780",1085780,100,115,10,225
"85781",1085781,188,34,4,226
"85782",1085782,104,115,19,238
"85783",1085783,172,36,5,213
"85784",1085784,102,187,7,296
"85785",1085785,98,15,2,115
"85786",1085786,214,35,10,259
"85787",1085787,131,159,13,303
"85788",1085788,131,114,8,253
"85789",1085789,23,174,3,200
"85790",1085790,251,11,2,264
"85791",1085791,97,45,15,157
"85792",1085792,224,17,7,248
"85793",1085793,74,207,4,285
"85794",1085794,86,117,12,215
"85795",1085795,40,223,10,273
"85796",1085796,96,61,8,165
"85797",1085797,46,238,6,290
"85798",1085798,94,147,21,262
"85799",1085799,145,60,11,216
"85800",1085800,167,111,14,292
"85801",1085801,171,112,7,290
"85802",1085802,153,127,18,298
"85803",1085803,114,66,0,180
"85804",1085804,46,145,3,194
"85805",1085805,29,160,7,196
"85806",1085806,95,42,3,140
"85807",1085807,102,143,7,252
"85808",1085808,104,138,10,252
"85809",1085809,153,115,7,275
"85810",1085810,61,184,3,248
"85811",1085811,90,145,1,236
"85812",1085812,46,89,2,137
"85813",1085813,89,149,12,250
"85814",1085814,64,78,12,154
"85815",1085815,156,28,6,190
"85816",1085816,119,44,11,174
"85817",1085817,170,82,4,256
"85818",1085818,94,159,23,276
"85819",1085819,9,269,5,283
"85820",1085820,80,43,7,130
"85821",1085821,136,1,2,139
"85822",1085822,128,40,6,174
"85823",1085823,171,127,22,320
"85824",1085824,7,6,1,14
"85825",1085825,23,199,4,226
"85826",1085826,12,0,1,13
"85827",1085827,70,202,7,279
"85828",1085828,174,15,11,200
"85829",1085829,85,146,4,235
"85830",1085830,196,44,16,256
"85831",1085831,79,207,8,294
"85832",1085832,191,13,5,209
"85833",1085833,44,212,10,266
"85834",1085834,109,183,18,310
"85835",1085835,159,36,5,200
"85836",1085836,153,66,18,237
"85837",1085837,112,89,13,214
"85838",1085838,57,27,8,92
"85839",1085839,12,78,2,92
"85840",1085840,31,248,7,286
"85841",1085841,117,77,6,200
"85842",1085842,49,192,3,244
"85843",1085843,101,82,12,195
"85844",1085844,172,81,7,260
"85845",1085845,213,54,14,281
"85846",1085846,176,64,20,260
"85847",1085847,136,97,15,248
"85848",1085848,109,66,10,185
"85849",1085849,133,64,14,211
"85850",1085850,60,261,2,323
"85851",1085851,100,51,6,157
"85852",1085852,114,114,6,234
"85853",1085853,163,66,5,234
"85854",1085854,229,57,13,299
"85855",1085855,120,25,7,152
"85856",1085856,86,152,10,248
"85857",1085857,145,135,11,291
"85858",1085858,167,37,9,213
"85859",1085859,175,64,5,244
"85860",1085860,79,226,16,321
"85861",1085861,81,82,12,175
"85862",1085862,372,1,7,380
"85863",1085863,118,34,10,162
"85864",1085864,72,83,7,162
"85865",1085865,141,53,7,201
"85866",1085866,23,290,6,319
"85867",1085867,70,80,8,158
"85868",1085868,80,177,9,266
"85869",1085869,107,78,5,190
"85870",1085870,163,128,19,310
"85871",1085871,96,15,3,114
"85872",1085872,159,5,0,164
"85873",1085873,127,102,10,239
"85874",1085874,121,168,6,295
"85875",1085875,125,155,14,294
"85876",1085876,153,91,7,251
"85877",1085877,143,67,5,215
"85878",1085878,157,35,7,199
"85879",1085879,49,186,10,245
"85880",1085880,117,134,6,257
"85881",1085881,97,153,13,263
"85882",1085882,102,175,5,282
"85883",1085883,91,128,12,231
"85884",1085884,42,109,9,160
"85885",1085885,166,50,0,216
"85886",1085886,126,164,4,294
"85887",1085887,119,59,8,186
"85888",1085888,43,102,5,150
"85889",1085889,79,201,8,288
"85890",1085890,55,204,13,272
"85891",1085891,205,64,28,297
"85892",1085892,53,208,15,276
"85893",1085893,146,77,5,228
"85894",1085894,29,194,1,224
"85895",1085895,161,46,2,209
"85896",1085896,187,19,8,214
"85897",1085897,71,82,13,166
"85898",1085898,147,96,19,262
"85899",1085899,160,34,7,201
"85900",1085900,149,32,3,184
"85901",1085901,55,161,10,226
"85902",1085902,65,146,5,216
"85903",1085903,203,79,14,296
"85904",1085904,201,91,22,314
"85905",1085905,146,73,3,222
"85906",1085906,77,170,2,249
"85907",1085907,114,159,2,275
"85908",1085908,204,29,8,241
"85909",1085909,87,89,7,183
"85910",1085910,137,22,5,164
"85911",1085911,95,156,17,268
"85912",1085912,168,85,9,262
"85913",1085913,41,76,8,125
"85914",1085914,87,43,9,139
"85915",1085915,131,76,4,211
"85916",1085916,137,112,19,268
"85917",1085917,4,12,0,16
"85918",1085918,66,172,12,250
"85919",1085919,148,93,15,256
"85920",1085920,93,173,11,277
"85921",1085921,128,48,12,188
"85922",1085922,43,220,8,271
"85923",1085923,38,147,3,188
"85924",1085924,164,64,14,242
"85925",1085925,85,30,9,124
"85926",1085926,71,159,5,235
"85927",1085927,58,210,5,273
"85928",1085928,65,40,4,109
"85929",1085929,87,42,3,132
"85930",1085930,83,80,8,171
"85931",1085931,87,186,8,281
"85932",1085932,230,95,12,337
"85933",1085933,50,34,6,90
"85934",1085934,153,137,10,300
"85935",1085935,166,102,7,275
"85936",1085936,50,249,6,305
"85937",1085937,134,70,4,208
"85938",1085938,19,175,2,196
"85939",1085939,96,199,6,301
"85940",1085940,135,131,13,279
"85941",1085941,148,90,14,252
"85942",1085942,172,105,13,290
"85943",1085943,9,3,0,12
"85944",1085944,91,50,7,148
"85945",1085945,89,163,13,265
"85946",1085946,23,207,6,236
"85947",1085947,67,100,5,172
"85948",1085948,61,149,7,217
"85949",1085949,11,5,1,17
"85950",1085950,158,96,15,269
"85951",1085951,193,33,7,233
"85952",1085952,205,104,6,315
"85953",1085953,19,7,0,26
"85954",1085954,115,193,14,322
"85955",1085955,207,96,22,325
"85956",1085956,38,214,2,254
"85957",1085957,211,74,18,303
"85958",1085958,64,218,4,286
"85959",1085959,95,115,12,222
"85960",1085960,1,3,0,4
"85961",1085961,127,56,10,193
"85962",1085962,111,105,2,218
"85963",1085963,123,71,4,198
"85964",1085964,6,55,0,61
"85965",1085965,142,100,13,255
"85966",1085966,112,111,6,229
"85967",1085967,41,239,7,287
"85968",1085968,197,56,21,274
"85969",1085969,218,65,20,303
"85970",1085970,81,119,10,210
"85971",1085971,96,122,6,224
"85972",1085972,169,40,4,213
"85973",1085973,92,218,10,320
"85974",1085974,28,132,1,161
"85975",1085975,155,22,6,183
"85976",1085976,114,136,16,266
"85977",1085977,27,171,5,203
"85978",1085978,59,114,2,175
"85979",1085979,127,137,12,276
"85980",1085980,145,88,13,246
"85981",1085981,90,16,6,112
"85982",1085982,62,90,6,158
"85983",1085983,192,45,2,239
"85984",1085984,182,94,13,289
"85985",1085985,189,70,8,267
"85986",1085986,66,213,6,285
"85987",1085987,64,246,6,316
"85988",1085988,42,220,7,269
"85989",1085989,50,278,7,335
"85990",1085990,213,41,4,258
"85991",1085991,133,19,5,157
"85992",1085992,138,77,6,221
"85993",1085993,25,3,0,28
"85994",1085994,98,93,6,197
"85995",1085995,144,47,8,199
"85996",1085996,61,201,4,266
"85997",1085997,76,169,14,259
"85998",1085998,148,79,8,235
"85999",1085999,98,217,8,323
"86000",1086000,79,223,23,325
"86001",1086001,123,40,6,169
"86002",1086002,95,118,10,223
"86003",1086003,101,146,6,253
"86004",1086004,119,109,13,241
"86005",1086005,89,188,14,291
"86006",1086006,40,134,5,179
"86007",1086007,181,19,10,210
"86008",1086008,177,41,10,228
"86009",1086009,133,89,5,227
"86010",1086010,17,182,5,204
"86011",1086011,20,175,8,203
"86012",1086012,230,39,13,282
"86013",1086013,107,100,15,222
"86014",1086014,154,41,4,199
"86015",1086015,52,248,7,307
"86016",1086016,237,58,14,309
"86017",1086017,168,62,0,230
"86018",1086018,122,54,4,180
"86019",1086019,149,31,5,185
"86020",1086020,128,151,8,287
"86021",1086021,13,152,0,165
"86022",1086022,123,110,16,249
"86023",1086023,156,97,11,264
"86024",1086024,63,2,0,65
"86025",1086025,56,13,2,71
"86026",1086026,5,11,0,16
"86027",1086027,175,100,8,283
"86028",1086028,71,240,12,323
"86029",1086029,140,90,15,245
"86030",1086030,81,106,5,192
"86031",1086031,130,91,13,234
"86032",1086032,190,110,20,320
"86033",1086033,75,187,14,276
"86034",1086034,88,19,3,110
"86035",1086035,151,55,5,211
"86036",1086036,100,3,1,104
"86037",1086037,68,191,2,261
"86038",1086038,102,59,6,167
"86039",1086039,122,80,6,208
"86040",1086040,87,73,5,165
"86041",1086041,32,238,2,272
"86042",1086042,101,59,3,163
"86043",1086043,14,0,1,15
"86044",1086044,126,91,13,230
"86045",1086045,231,18,10,259
"86046",1086046,38,205,6,249
"86047",1086047,26,21,0,47
"86048",1086048,177,95,9,281
"86049",1086049,222,74,15,311
"86050",1086050,170,106,15,291
"86051",1086051,73,277,14,364
"86052",1086052,55,246,2,303
"86053",1086053,233,44,19,296
"86054",1086054,183,23,5,211
"86055",1086055,154,90,21,265
"86056",1086056,49,269,1,319
"86057",1086057,227,27,10,264
"86058",1086058,210,45,4,259
"86059",1086059,23,208,3,234
"86060",1086060,134,187,16,337
"86061",1086061,99,165,5,269
"86062",1086062,121,56,5,182
"86063",1086063,224,44,7,275
"86064",1086064,34,313,7,354
"86065",1086065,91,184,12,287
"86066",1086066,198,123,14,335
"86067",1086067,130,46,4,180
"86068",1086068,24,16,1,41
"86069",1086069,138,13,4,155
"86070",1086070,123,69,17,209
"86071",1086071,148,39,3,190
"86072",1086072,80,17,1,98
"86073",1086073,136,60,4,200
"86074",1086074,193,92,21,306
"86075",1086075,150,50,4,204
"86076",1086076,123,90,19,232
"86077",1086077,64,37,3,104
"86078",1086078,199,76,11,286
"86079",1086079,90,79,2,171
"86080",1086080,196,28,7,231
"86081",1086081,19,187,5,211
"86082",1086082,252,37,10,299
"86083",1086083,123,95,9,227
"86084",1086084,108,152,12,272
"86085",1086085,31,103,7,141
"86086",1086086,120,22,4,146
"86087",1086087,116,21,3,140
"86088",1086088,68,219,9,296
"86089",1086089,75,204,10,289
"86090",1086090,206,56,11,273
"86091",1086091,141,115,3,259
"86092",1086092,251,18,5,274
"86093",1086093,141,131,10,282
"86094",1086094,122,180,11,313
"86095",1086095,211,79,14,304
"86096",1086096,219,38,11,268
"86097",1086097,130,18,7,155
"86098",1086098,232,25,2,259
"86099",1086099,90,84,9,183
"86100",1086100,50,145,8,203
"86101",1086101,163,50,4,217
"86102",1086102,170,101,9,280
"86103",1086103,75,42,10,127
"86104",1086104,69,130,7,206
"86105",1086105,227,45,8,280
"86106",1086106,145,78,6,229
"86107",1086107,106,114,3,223
"86108",1086108,20,237,2,259
"86109",1086109,161,39,5,205
"86110",1086110,146,210,24,380
"86111",1086111,29,257,4,290
"86112",1086112,54,228,2,284
"86113",1086113,117,104,17,238
"86114",1086114,107,119,13,239
"86115",1086115,260,22,5,287
"86116",1086116,165,41,14,220
"86117",1086117,1,8,1,10
"86118",1086118,62,23,3,88
"86119",1086119,139,114,14,267
"86120",1086120,206,99,13,318
"86121",1086121,21,183,5,209
"86122",1086122,53,157,4,214
"86123",1086123,105,187,10,302
"86124",1086124,158,17,4,179
"86125",1086125,92,182,11,285
"86126",1086126,83,111,4,198
"86127",1086127,109,60,12,181
"86128",1086128,170,48,7,225
"86129",1086129,24,96,3,123
"86130",1086130,208,61,21,290
"86131",1086131,49,252,14,315
"86132",1086132,151,66,3,220
"86133",1086133,11,182,5,198
"86134",1086134,38,4,1,43
"86135",1086135,58,175,5,238
"86136",1086136,123,103,16,242
"86137",1086137,191,24,8,223
"86138",1086138,193,84,11,288
"86139",1086139,209,47,4,260
"86140",1086140,175,86,13,274
"86141",1086141,155,86,6,247
"86142",1086142,198,30,8,236
"86143",1086143,124,15,3,142
"86144",1086144,100,46,7,153
"86145",1086145,82,160,22,264
"86146",1086146,93,199,13,305
"86147",1086147,71,182,10,263
"86148",1086148,36,22,3,61
"86149",1086149,57,181,1,239
"86150",1086150,41,230,11,282
"86151",1086151,168,21,6,195
"86152",1086152,155,115,13,283
"86153",1086153,84,88,13,185
"86154",1086154,123,155,6,284
"86155",1086155,23,178,3,204
"86156",1086156,145,46,9,200
"86157",1086157,100,98,16,214
"86158",1086158,128,167,18,313
"86159",1086159,153,49,13,215
"86160",1086160,120,168,22,310
"86161",1086161,156,48,6,210
"86162",1086162,46,202,14,262
"86163",1086163,103,142,30,275
"86164",1086164,106,10,2,118
"86165",1086165,191,63,12,266
"86166",1086166,236,54,9,299
"86167",1086167,235,9,0,244
"86168",1086168,60,7,0,67
"86169",1086169,176,134,20,330
"86170",1086170,11,7,0,18
"86171",1086171,33,228,4,265
"86172",1086172,135,114,20,269
"86173",1086173,172,42,8,222
"86174",1086174,48,215,4,267
"86175",1086175,40,222,10,272
"86176",1086176,97,117,1,215
"86177",1086177,56,186,8,250
"86178",1086178,214,64,3,281
"86179",1086179,164,90,15,269
"86180",1086180,126,71,8,205
"86181",1086181,117,136,5,258
"86182",1086182,144,39,5,188
"86183",1086183,62,275,13,350
"86184",1086184,139,115,13,267
"86185",1086185,68,152,4,224
"86186",1086186,88,138,9,235
"86187",1086187,190,78,9,277
"86188",1086188,135,98,9,242
"86189",1086189,24,228,5,257
"86190",1086190,205,87,30,322
"86191",1086191,101,62,2,165
"86192",1086192,117,169,21,307
"86193",1086193,168,90,13,271
"86194",1086194,154,57,8,219
"86195",1086195,15,90,3,108
"86196",1086196,37,171,4,212
"86197",1086197,181,16,8,205
"86198",1086198,69,171,3,243
"86199",1086199,94,191,9,294
"86200",1086200,226,20,15,261
"86201",1086201,190,90,10,290
"86202",1086202,106,116,8,230
"86203",1086203,85,214,9,308
"86204",1086204,207,56,13,276
"86205",1086205,74,89,7,170
"86206",1086206,68,123,17,208
"86207",1086207,40,151,3,194
"86208",1086208,46,225,1,272
"86209",1086209,29,3,2,34
"86210",1086210,139,129,8,276
"86211",1086211,6,183,1,190
"86212",1086212,149,108,11,268
"86213",1086213,71,102,9,182
"86214",1086214,110,104,5,219
"86215",1086215,90,192,6,288
"86216",1086216,157,47,5,209
"86217",1086217,122,179,17,318
"86218",1086218,161,80,1,242
"86219",1086219,219,32,12,263
"86220",1086220,61,104,2,167
"86221",1086221,141,56,13,210
"86222",1086222,164,101,16,281
"86223",1086223,176,39,8,223
"86224",1086224,124,66,9,199
"86225",1086225,73,166,2,241
"86226",1086226,174,23,5,202
"86227",1086227,41,95,4,140
"86228",1086228,54,161,8,223
"86229",1086229,26,156,8,190
"86230",1086230,139,21,6,166
"86231",1086231,84,44,7,135
"86232",1086232,123,170,17,310
"86233",1086233,129,276,23,428
"86234",1086234,46,221,2,269
"86235",1086235,212,54,10,276
"86236",1086236,95,131,8,234
"86237",1086237,188,52,5,245
"86238",1086238,131,13,15,159
"86239",1086239,209,95,8,312
"86240",1086240,46,220,9,275
"86241",1086241,27,249,9,285
"86242",1086242,131,81,8,220
"86243",1086243,183,14,4,201
"86244",1086244,1,7,2,10
"86245",1086245,73,165,21,259
"86246",1086246,128,125,11,264
"86247",1086247,74,145,8,227
"86248",1086248,159,66,6,231
"86249",1086249,54,140,4,198
"86250",1086250,67,180,6,253
"86251",1086251,208,81,12,301
"86252",1086252,133,55,3,191
"86253",1086253,98,87,14,199
"86254",1086254,12,8,0,20
"86255",1086255,53,86,4,143
"86256",1086256,33,37,2,72
"86257",1086257,120,30,8,158
"86258",1086258,70,29,1,100
"86259",1086259,75,97,6,178
"86260",1086260,99,162,3,264
"86261",1086261,59,190,5,254
"86262",1086262,195,87,9,291
"86263",1086263,92,0,4,96
"86264",1086264,63,182,7,252
"86265",1086265,149,144,4,297
"86266",1086266,162,24,5,191
"86267",1086267,53,191,17,261
"86268",1086268,61,223,7,291
"86269",1086269,99,92,1,192
"86270",1086270,198,40,13,251
"86271",1086271,124,133,24,281
"86272",1086272,136,128,5,269
"86273",1086273,48,190,3,241
"86274",1086274,137,69,0,206
"86275",1086275,95,222,2,319
"86276",1086276,46,184,8,238
"86277",1086277,29,77,0,106
"86278",1086278,107,85,13,205
"86279",1086279,75,71,3,149
"86280",1086280,137,102,5,244
"86281",1086281,91,219,9,319
"86282",1086282,158,19,5,182
"86283",1086283,64,148,11,223
"86284",1086284,68,169,6,243
"86285",1086285,209,63,27,299
"86286",1086286,118,156,11,285
"86287",1086287,60,251,7,318
"86288",1086288,21,6,0,27
"86289",1086289,168,25,4,197
"86290",1086290,64,186,1,251
"86291",1086291,108,26,5,139
"86292",1086292,50,244,7,301
"86293",1086293,211,17,5,233
"86294",1086294,143,59,6,208
"86295",1086295,145,100,15,260
"86296",1086296,124,59,4,187
"86297",1086297,123,93,12,228
"86298",1086298,14,3,0,17
"86299",1086299,112,33,8,153
"86300",1086300,119,56,11,186
"86301",1086301,67,175,4,246
"86302",1086302,243,61,11,315
"86303",1086303,51,183,2,236
"86304",1086304,153,89,19,261
"86305",1086305,24,15,2,41
"86306",1086306,152,44,7,203
"86307",1086307,75,80,1,156
"86308",1086308,16,46,3,65
"86309",1086309,82,147,11,240
"86310",1086310,118,62,21,201
"86311",1086311,13,22,2,37
"86312",1086312,109,89,12,210
"86313",1086313,46,277,6,329
"86314",1086314,107,94,8,209
"86315",1086315,94,59,7,160
"86316",1086316,149,116,7,272
"86317",1086317,88,236,11,335
"86318",1086318,191,82,7,280
"86319",1086319,234,39,12,285
"86320",1086320,33,304,4,341
"86321",1086321,106,107,9,222
"86322",1086322,52,225,4,281
"86323",1086323,238,26,3,267
"86324",1086324,51,202,4,257
"86325",1086325,145,234,13,392
"86326",1086326,149,86,7,242
"86327",1086327,186,77,11,274
"86328",1086328,101,103,15,219
"86329",1086329,143,95,10,248
"86330",1086330,52,100,3,155
"86331",1086331,181,14,4,199
"86332",1086332,89,13,2,104
"86333",1086333,220,26,4,250
"86334",1086334,114,91,5,210
"86335",1086335,135,171,11,317
"86336",1086336,34,164,4,202
"86337",1086337,144,24,5,173
"86338",1086338,88,135,8,231
"86339",1086339,109,155,11,275
"86340",1086340,41,271,5,317
"86341",1086341,113,21,1,135
"86342",1086342,64,210,5,279
"86343",1086343,143,24,7,174
"86344",1086344,28,42,5,75
"86345",1086345,10,4,0,14
"86346",1086346,117,182,11,310
"86347",1086347,144,161,8,313
"86348",1086348,54,184,12,250
"86349",1086349,128,108,7,243
"86350",1086350,222,19,3,244
"86351",1086351,61,192,12,265
"86352",1086352,61,4,0,65
"86353",1086353,114,124,8,246
"86354",1086354,122,71,7,200
"86355",1086355,143,26,2,171
"86356",1086356,10,33,3,46
"86357",1086357,122,31,5,158
"86358",1086358,254,51,9,314
"86359",1086359,59,233,18,310
"86360",1086360,143,75,7,225
"86361",1086361,82,188,6,276
"86362",1086362,174,119,15,308
"86363",1086363,23,114,7,144
"86364",1086364,90,58,12,160
"86365",1086365,81,203,2,286
"86366",1086366,211,94,3,308
"86367",1086367,81,124,7,212
"86368",1086368,157,59,10,226
"86369",1086369,76,79,4,159
"86370",1086370,120,123,11,254
"86371",1086371,39,155,8,202
"86372",1086372,24,296,10,330
"86373",1086373,58,77,5,140
"86374",1086374,130,59,7,196
"86375",1086375,168,106,19,293
"86376",1086376,57,229,14,300
"86377",1086377,10,26,2,38
"86378",1086378,46,219,10,275
"86379",1086379,97,227,11,335
"86380",1086380,6,72,1,79
"86381",1086381,11,27,1,39
"86382",1086382,38,114,0,152
"86383",1086383,3,51,0,54
"86384",1086384,69,92,14,175
"86385",1086385,131,87,1,219
"86386",1086386,106,175,7,288
"86387",1086387,52,151,6,209
"86388",1086388,131,139,14,284
"86389",1086389,140,51,10,201
"86390",1086390,15,5,1,21
"86391",1086391,95,126,2,223
"86392",1086392,198,15,8,221
"86393",1086393,30,20,2,52
"86394",1086394,100,107,13,220
"86395",1086395,219,66,12,297
"86396",1086396,163,21,3,187
"86397",1086397,220,48,6,274
"86398",1086398,100,125,20,245
"86399",1086399,139,74,3,216
"86400",1086400,36,103,5,144
"86401",1086401,124,93,5,222
"86402",1086402,98,13,4,115
"86403",1086403,83,1,1,85
"86404",1086404,203,50,20,273
"86405",1086405,91,158,11,260
"86406",1086406,75,100,10,185
"86407",1086407,74,195,4,273
"86408",1086408,69,199,8,276
"86409",1086409,42,176,10,228
"86410",1086410,13,118,1,132
"86411",1086411,58,207,6,271
"86412",1086412,151,121,2,274
"86413",1086413,166,99,3,268
"86414",1086414,43,221,3,267
"86415",1086415,6,229,1,236
"86416",1086416,127,111,15,253
"86417",1086417,153,128,6,287
"86418",1086418,139,174,9,322
"86419",1086419,4,69,4,77
"86420",1086420,84,189,9,282
"86421",1086421,171,141,11,323
"86422",1086422,117,176,4,297
"86423",1086423,87,174,9,270
"86424",1086424,156,59,1,216
"86425",1086425,27,215,3,245
"86426",1086426,118,89,10,217
"86427",1086427,56,166,9,231
"86428",1086428,211,31,12,254
"86429",1086429,29,276,5,310
"86430",1086430,54,183,5,242
"86431",1086431,125,171,10,306
"86432",1086432,85,53,6,144
"86433",1086433,48,221,4,273
"86434",1086434,73,29,6,108
"86435",1086435,173,67,9,249
"86436",1086436,88,146,11,245
"86437",1086437,66,14,1,81
"86438",1086438,24,112,4,140
"86439",1086439,41,27,0,68
"86440",1086440,115,101,6,222
"86441",1086441,79,157,15,251
"86442",1086442,62,258,0,320
"86443",1086443,203,57,12,272
"86444",1086444,210,39,10,259
"86445",1086445,82,173,9,264
"86446",1086446,110,28,0,138
"86447",1086447,26,270,5,301
"86448",1086448,141,91,6,238
"86449",1086449,233,17,6,256
"86450",1086450,64,162,7,233
"86451",1086451,164,58,6,228
"86452",1086452,109,133,21,263
"86453",1086453,72,138,15,225
"86454",1086454,7,5,0,12
"86455",1086455,170,53,3,226
"86456",1086456,120,89,6,215
"86457",1086457,216,122,10,348
"86458",1086458,224,31,7,262
"86459",1086459,135,81,9,225
"86460",1086460,128,79,10,217
"86461",1086461,167,38,7,212
"86462",1086462,133,116,10,259
"86463",1086463,93,100,2,195
"86464",1086464,64,76,5,145
"86465",1086465,99,44,5,148
"86466",1086466,163,107,12,282
"86467",1086467,89,69,13,171
"86468",1086468,102,43,6,151
"86469",1086469,108,157,15,280
"86470",1086470,158,51,7,216
"86471",1086471,66,49,7,122
"86472",1086472,85,67,2,154
"86473",1086473,169,87,12,268
"86474",1086474,151,68,11,230
"86475",1086475,32,313,12,357
"86476",1086476,91,156,8,255
"86477",1086477,154,101,7,262
"86478",1086478,50,170,11,231
"86479",1086479,68,247,12,327
"86480",1086480,63,48,2,113
"86481",1086481,172,38,6,216
"86482",1086482,81,208,5,294
"86483",1086483,91,118,5,214
"86484",1086484,3,116,2,121
"86485",1086485,129,104,12,245
"86486",1086486,91,23,2,116
"86487",1086487,93,120,12,225
"86488",1086488,40,182,22,244
"86489",1086489,123,123,9,255
"86490",1086490,9,16,0,25
"86491",1086491,31,210,9,250
"86492",1086492,215,92,15,322
"86493",1086493,93,69,8,170
"86494",1086494,125,85,14,224
"86495",1086495,45,146,8,199
"86496",1086496,92,139,11,242
"86497",1086497,49,26,2,77
"86498",1086498,182,197,11,390
"86499",1086499,64,91,8,163
"86500",1086500,1,1,0,2
"86501",1086501,228,26,8,262
"86502",1086502,178,115,21,314
"86503",1086503,22,166,3,191
"86504",1086504,78,84,1,163
"86505",1086505,141,125,14,280
"86506",1086506,43,106,3,152
"86507",1086507,57,23,2,82
"86508",1086508,81,218,3,302
"86509",1086509,31,240,6,277
"86510",1086510,104,175,7,286
"86511",1086511,60,59,7,126
"86512",1086512,44,5,1,50
"86513",1086513,207,50,2,259
"86514",1086514,167,75,16,258
"86515",1086515,41,223,4,268
"86516",1086516,66,138,17,221
"86517",1086517,57,220,17,294
"86518",1086518,180,100,15,295
"86519",1086519,100,202,11,313
"86520",1086520,70,144,11,225
"86521",1086521,132,113,12,257
"86522",1086522,17,10,2,29
"86523",1086523,155,109,7,271
"86524",1086524,90,137,6,233
"86525",1086525,192,20,4,216
"86526",1086526,206,45,5,256
"86527",1086527,59,178,6,243
"86528",1086528,89,48,7,144
"86529",1086529,159,115,11,285
"86530",1086530,94,168,10,272
"86531",1086531,224,64,12,300
"86532",1086532,153,67,6,226
"86533",1086533,261,5,4,270
"86534",1086534,153,124,4,281
"86535",1086535,19,170,5,194
"86536",1086536,49,256,4,309
"86537",1086537,67,29,1,97
"86538",1086538,110,197,8,315
"86539",1086539,63,18,0,81
"86540",1086540,31,160,8,199
"86541",1086541,56,246,15,317
"86542",1086542,155,66,2,223
"86543",1086543,93,71,3,167
"86544",1086544,156,40,16,212
"86545",1086545,114,186,3,303
"86546",1086546,83,166,8,257
"86547",1086547,20,238,4,262
"86548",1086548,199,37,9,245
"86549",1086549,187,15,14,216
"86550",1086550,93,154,17,264
"86551",1086551,72,93,0,165
"86552",1086552,115,75,4,194
"86553",1086553,15,5,1,21
"86554",1086554,87,146,4,237
"86555",1086555,85,139,9,233
"86556",1086556,51,26,6,83
"86557",1086557,83,49,3,135
"86558",1086558,12,16,1,29
"86559",1086559,91,62,14,167
"86560",1086560,127,7,0,134
"86561",1086561,99,125,20,244
"86562",1086562,109,151,14,274
"86563",1086563,139,38,10,187
"86564",1086564,94,91,4,189
"86565",1086565,247,63,12,322
"86566",1086566,73,182,21,276
"86567",1086567,104,54,10,168
"86568",1086568,86,180,6,272
"86569",1086569,98,160,14,272
"86570",1086570,102,86,1,189
"86571",1086571,160,123,10,293
"86572",1086572,131,98,12,241
"86573",1086573,172,127,2,301
"86574",1086574,167,67,10,244
"86575",1086575,108,79,8,195
"86576",1086576,138,175,5,318
"86577",1086577,119,24,13,156
"86578",1086578,148,73,11,232
"86579",1086579,89,85,1,175
"86580",1086580,101,192,5,298
"86581",1086581,152,35,4,191
"86582",1086582,52,230,7,289
"86583",1086583,165,61,3,229
"86584",1086584,20,157,4,181
"86585",1086585,206,56,10,272
"86586",1086586,74,193,11,278
"86587",1086587,61,216,11,288
"86588",1086588,51,199,5,255
"86589",1086589,59,24,1,84
"86590",1086590,34,109,8,151
"86591",1086591,195,227,10,432
"86592",1086592,209,83,12,304
"86593",1086593,83,73,7,163
"86594",1086594,47,306,8,361
"86595",1086595,66,181,13,260
"86596",1086596,162,59,13,234
"86597",1086597,109,163,7,279
"86598",1086598,182,125,21,328
"86599",1086599,177,79,6,262
"86600",1086600,115,125,3,243
"86601",1086601,167,104,14,285
"86602",1086602,64,209,1,274
"86603",1086603,126,154,15,295
"86604",1086604,56,155,22,233
"86605",1086605,123,143,6,272
"86606",1086606,122,55,8,185
"86607",1086607,167,63,7,237
"86608",1086608,151,114,5,270
"86609",1086609,85,64,3,152
"86610",1086610,108,81,8,197
"86611",1086611,161,160,16,337
"86612",1086612,136,49,9,194
"86613",1086613,64,120,12,196
"86614",1086614,238,80,4,322
"86615",1086615,158,51,8,217
"86616",1086616,98,67,7,172
"86617",1086617,28,203,2,233
"86618",1086618,116,23,2,141
"86619",1086619,206,127,7,340
"86620",1086620,125,193,7,325
"86621",1086621,94,184,8,286
"86622",1086622,142,72,6,220
"86623",1086623,70,192,3,265
"86624",1086624,92,132,2,226
"86625",1086625,169,76,6,251
"86626",1086626,48,157,12,217
"86627",1086627,183,41,8,232
"86628",1086628,188,78,14,280
"86629",1086629,200,31,13,244
"86630",1086630,342,65,14,421
"86631",1086631,65,169,13,247
"86632",1086632,157,25,6,188
"86633",1086633,54,181,8,243
"86634",1086634,77,48,15,140
"86635",1086635,113,192,18,323
"86636",1086636,143,76,3,222
"86637",1086637,157,76,11,244
"86638",1086638,141,128,7,276
"86639",1086639,95,88,9,192
"86640",1086640,78,155,27,260
"86641",1086641,229,32,9,270
"86642",1086642,119,118,6,243
"86643",1086643,16,270,5,291
"86644",1086644,229,4,2,235
"86645",1086645,184,72,9,265
"86646",1086646,103,48,2,153
"86647",1086647,193,26,9,228
"86648",1086648,114,195,12,321
"86649",1086649,60,207,13,280
"86650",1086650,125,53,11,189
"86651",1086651,90,184,8,282
"86652",1086652,6,13,0,19
"86653",1086653,27,0,2,29
"86654",1086654,52,136,8,196
"86655",1086655,105,65,9,179
"86656",1086656,214,58,11,283
"86657",1086657,156,135,15,306
"86658",1086658,33,15,2,50
"86659",1086659,42,153,4,199
"86660",1086660,77,113,5,195
"86661",1086661,82,162,10,254
"86662",1086662,48,286,9,343
"86663",1086663,119,47,6,172
"86664",1086664,4,41,0,45
"86665",1086665,93,109,6,208
"86666",1086666,170,23,6,199
"86667",1086667,199,58,11,268
"86668",1086668,10,32,1,43
"86669",1086669,121,11,2,134
"86670",1086670,125,102,6,233
"86671",1086671,231,41,10,282
"86672",1086672,256,18,24,298
"86673",1086673,120,97,18,235
"86674",1086674,151,66,4,221
"86675",1086675,45,74,8,127
"86676",1086676,69,54,3,126
"86677",1086677,58,238,10,306
"86678",1086678,121,97,7,225
"86679",1086679,197,104,18,319
"86680",1086680,46,103,9,158
"86681",1086681,142,113,13,268
"86682",1086682,78,12,3,93
"86683",1086683,114,86,11,211
"86684",1086684,125,64,8,197
"86685",1086685,89,121,5,215
"86686",1086686,46,239,3,288
"86687",1086687,93,104,10,207
"86688",1086688,98,89,5,192
"86689",1086689,64,124,6,194
"86690",1086690,139,107,3,249
"86691",1086691,187,22,9,218
"86692",1086692,63,43,3,109
"86693",1086693,93,177,6,276
"86694",1086694,38,171,7,216
"86695",1086695,25,97,2,124
"86696",1086696,140,104,15,259
"86697",1086697,132,50,12,194
"86698",1086698,65,246,10,321
"86699",1086699,26,15,5,46
"86700",1086700,161,56,16,233
"86701",1086701,54,212,5,271
"86702",1086702,32,213,5,250
"86703",1086703,66,157,6,229
"86704",1086704,138,94,4,236
"86705",1086705,25,158,8,191
"86706",1086706,185,21,3,209
"86707",1086707,119,114,21,254
"86708",1086708,92,156,5,253
"86709",1086709,66,159,4,229
"86710",1086710,145,108,11,264
"86711",1086711,201,46,6,253
"86712",1086712,45,217,10,272
"86713",1086713,124,174,16,314
"86714",1086714,157,134,5,296
"86715",1086715,106,181,3,290
"86716",1086716,151,5,4,160
"86717",1086717,103,89,4,196
"86718",1086718,187,43,11,241
"86719",1086719,31,194,8,233
"86720",1086720,153,93,11,257
"86721",1086721,43,255,4,302
"86722",1086722,101,136,7,244
"86723",1086723,75,128,5,208
"86724",1086724,187,40,6,233
"86725",1086725,102,65,12,179
"86726",1086726,62,46,5,113
"86727",1086727,125,42,12,179
"86728",1086728,6,98,1,105
"86729",1086729,61,242,17,320
"86730",1086730,114,81,15,210
"86731",1086731,159,60,7,226
"86732",1086732,16,10,0,26
"86733",1086733,24,288,2,314
"86734",1086734,114,108,8,230
"86735",1086735,51,172,6,229
"86736",1086736,181,20,6,207
"86737",1086737,26,281,3,310
"86738",1086738,127,22,2,151
"86739",1086739,18,68,3,89
"86740",1086740,101,50,4,155
"86741",1086741,53,185,7,245
"86742",1086742,182,59,11,252
"86743",1086743,226,59,19,304
"86744",1086744,93,76,11,180
"86745",1086745,67,196,5,268
"86746",1086746,175,18,2,195
"86747",1086747,63,254,14,331
"86748",1086748,71,103,6,180
"86749",1086749,71,2,2,75
"86750",1086750,12,10,0,22
"86751",1086751,108,72,1,181
"86752",1086752,75,40,11,126
"86753",1086753,41,183,7,231
"86754",1086754,158,119,8,285
"86755",1086755,102,98,15,215
"86756",1086756,69,108,4,181
"86757",1086757,124,137,10,271
"86758",1086758,94,139,12,245
"86759",1086759,105,41,1,147
"86760",1086760,201,36,5,242
"86761",1086761,7,2,1,10
"86762",1086762,59,176,13,248
"86763",1086763,110,145,4,259
"86764",1086764,101,164,13,278
"86765",1086765,58,174,2,234
"86766",1086766,68,87,12,167
"86767",1086767,364,49,7,420
"86768",1086768,132,128,22,282
"86769",1086769,97,149,13,259
"86770",1086770,66,202,7,275
"86771",1086771,45,196,9,250
"86772",1086772,106,63,4,173
"86773",1086773,131,193,17,341
"86774",1086774,63,0,3,66
"86775",1086775,76,134,5,215
"86776",1086776,11,184,4,199
"86777",1086777,209,52,11,272
"86778",1086778,90,146,15,251
"86779",1086779,56,248,3,307
"86780",1086780,165,54,3,222
"86781",1086781,197,63,6,266
"86782",1086782,46,17,4,67
"86783",1086783,191,66,0,257
"86784",1086784,72,29,0,101
"86785",1086785,98,64,10,172
"86786",1086786,166,88,10,264
"86787",1086787,44,70,1,115
"86788",1086788,64,143,8,215
"86789",1086789,118,85,4,207
"86790",1086790,47,174,5,226
"86791",1086791,161,71,8,240
"86792",1086792,71,103,5,179
"86793",1086793,157,62,7,226
"86794",1086794,18,225,6,249
"86795",1086795,71,27,4,102
"86796",1086796,99,219,6,324
"86797",1086797,170,91,8,269
"86798",1086798,169,88,10,267
"86799",1086799,157,72,4,233
"86800",1086800,188,36,11,235
"86801",1086801,166,83,9,258
"86802",1086802,58,100,2,160
"86803",1086803,80,191,6,277
"86804",1086804,132,93,7,232
"86805",1086805,152,45,3,200
"86806",1086806,27,94,4,125
"86807",1086807,193,51,1,245
"86808",1086808,47,7,5,59
"86809",1086809,33,142,1,176
"86810",1086810,15,332,6,353
"86811",1086811,139,43,5,187
"86812",1086812,94,237,6,337
"86813",1086813,26,199,3,228
"86814",1086814,149,41,6,196
"86815",1086815,100,173,8,281
"86816",1086816,28,284,1,313
"86817",1086817,71,37,3,111
"86818",1086818,150,75,6,231
"86819",1086819,105,222,10,337
"86820",1086820,74,156,7,237
"86821",1086821,5,2,0,7
"86822",1086822,96,62,8,166
"86823",1086823,46,154,3,203
"86824",1086824,147,89,8,244
"86825",1086825,183,67,8,258
"86826",1086826,120,47,8,175
"86827",1086827,42,172,4,218
"86828",1086828,63,199,12,274
"86829",1086829,145,62,4,211
"86830",1086830,93,140,13,246
"86831",1086831,57,15,3,75
"86832",1086832,225,81,10,316
"86833",1086833,152,92,11,255
"86834",1086834,82,176,6,264
"86835",1086835,150,26,3,179
"86836",1086836,224,62,9,295
"86837",1086837,40,222,5,267
"86838",1086838,56,235,6,297
"86839",1086839,67,158,5,230
"86840",1086840,105,38,3,146
"86841",1086841,50,190,13,253
"86842",1086842,162,34,5,201
"86843",1086843,25,24,7,56
"86844",1086844,143,15,4,162
"86845",1086845,253,45,44,342
"86846",1086846,68,235,1,304
"86847",1086847,52,16,3,71
"86848",1086848,164,31,0,195
"86849",1086849,250,57,12,319
"86850",1086850,92,47,3,142
"86851",1086851,208,51,17,276
"86852",1086852,25,141,2,168
"86853",1086853,86,193,11,290
"86854",1086854,122,66,7,195
"86855",1086855,33,0,0,33
"86856",1086856,110,136,14,260
"86857",1086857,106,207,6,319
"86858",1086858,140,136,4,280
"86859",1086859,26,245,5,276
"86860",1086860,37,233,5,275
"86861",1086861,193,22,5,220
"86862",1086862,159,137,5,301
"86863",1086863,61,56,8,125
"86864",1086864,39,74,3,116
"86865",1086865,94,35,5,134
"86866",1086866,124,223,30,377
"86867",1086867,85,168,2,255
"86868",1086868,92,150,12,254
"86869",1086869,6,2,2,10
"86870",1086870,36,139,0,175
"86871",1086871,139,48,11,198
"86872",1086872,43,233,9,285
"86873",1086873,177,108,12,297
"86874",1086874,145,21,4,170
"86875",1086875,262,10,19,291
"86876",1086876,198,43,13,254
"86877",1086877,183,114,10,307
"86878",1086878,197,117,23,337
"86879",1086879,173,45,5,223
"86880",1086880,183,92,24,299
"86881",1086881,189,90,8,287
"86882",1086882,121,46,2,169
"86883",1086883,141,89,1,231
"86884",1086884,142,13,3,158
"86885",1086885,139,32,8,179
"86886",1086886,158,38,15,211
"86887",1086887,20,222,3,245
"86888",1086888,79,91,11,181
"86889",1086889,49,95,3,147
"86890",1086890,86,214,8,308
"86891",1086891,85,96,15,196
"86892",1086892,74,88,5,167
"86893",1086893,90,94,5,189
"86894",1086894,155,106,6,267
"86895",1086895,132,60,2,194
"86896",1086896,41,192,8,241
"86897",1086897,122,78,5,205
"86898",1086898,293,3,9,305
"86899",1086899,57,286,4,347
"86900",1086900,158,50,12,220
"86901",1086901,134,54,3,191
"86902",1086902,54,32,3,89
"86903",1086903,179,60,12,251
"86904",1086904,45,113,8,166
"86905",1086905,108,215,21,344
"86906",1086906,133,91,6,230
"86907",1086907,205,71,4,280
"86908",1086908,16,6,0,22
"86909",1086909,220,24,7,251
"86910",1086910,162,55,6,223
"86911",1086911,28,7,2,37
"86912",1086912,130,126,9,265
"86913",1086913,169,77,11,257
"86914",1086914,152,74,5,231
"86915",1086915,89,84,12,185
"86916",1086916,55,108,3,166
"86917",1086917,91,177,9,277
"86918",1086918,116,60,2,178
"86919",1086919,53,111,4,168
"86920",1086920,26,6,2,34
"86921",1086921,134,32,6,172
"86922",1086922,146,97,9,252
"86923",1086923,133,53,1,187
"86924",1086924,57,235,13,305
"86925",1086925,133,49,7,189
"86926",1086926,158,59,5,222
"86927",1086927,60,178,11,249
"86928",1086928,86,220,19,325
"86929",1086929,29,12,3,44
"86930",1086930,145,14,6,165
"86931",1086931,75,115,7,197
"86932",1086932,66,172,4,242
"86933",1086933,145,30,5,180
"86934",1086934,43,253,8,304
"86935",1086935,194,107,12,313
"86936",1086936,125,375,18,518
"86937",1086937,237,40,14,291
"86938",1086938,219,43,10,272
"86939",1086939,130,118,4,252
"86940",1086940,85,50,1,136
"86941",1086941,61,202,6,269
"86942",1086942,89,159,12,260
"86943",1086943,62,164,5,231
"86944",1086944,162,65,13,240
"86945",1086945,63,82,5,150
"86946",1086946,92,212,6,310
"86947",1086947,34,215,2,251
"86948",1086948,64,124,3,191
"86949",1086949,8,2,0,10
"86950",1086950,136,92,7,235
"86951",1086951,196,46,8,250
"86952",1086952,174,71,4,249
"86953",1086953,51,151,6,208
"86954",1086954,84,202,10,296
"86955",1086955,57,151,6,214
"86956",1086956,205,16,6,227
"86957",1086957,30,179,8,217
"86958",1086958,122,158,12,292
"86959",1086959,100,80,12,192
"86960",1086960,127,55,6,188
"86961",1086961,42,190,4,236
"86962",1086962,157,87,8,252
"86963",1086963,37,186,8,231
"86964",1086964,36,152,5,193
"86965",1086965,74,102,0,176
"86966",1086966,96,112,3,211
"86967",1086967,165,71,5,241
"86968",1086968,84,203,8,295
"86969",1086969,115,59,9,183
"86970",1086970,31,207,8,246
"86971",1086971,24,151,3,178
"86972",1086972,33,12,4,49
"86973",1086973,212,37,8,257
"86974",1086974,130,146,9,285
"86975",1086975,143,114,12,269
"86976",1086976,24,73,6,103
"86977",1086977,208,47,9,264
"86978",1086978,61,183,23,267
"86979",1086979,161,81,19,261
"86980",1086980,66,140,11,217
"86981",1086981,78,238,4,320
"86982",1086982,60,148,11,219
"86983",1086983,22,65,3,90
"86984",1086984,52,147,4,203
"86985",1086985,76,136,7,219
"86986",1086986,178,65,17,260
"86987",1086987,26,149,6,181
"86988",1086988,74,109,3,186
"86989",1086989,68,119,11,198
"86990",1086990,35,242,7,284
"86991",1086991,191,62,7,260
"86992",1086992,84,63,15,162
"86993",1086993,190,61,10,261
"86994",1086994,25,277,7,309
"86995",1086995,36,213,3,252
"86996",1086996,37,198,4,239
"86997",1086997,57,18,0,75
"86998",1086998,145,60,5,210
"86999",1086999,159,92,15,266
"87000",1087000,120,164,15,299
"87001",1087001,193,23,4,220
"87002",1087002,205,30,15,250
"87003",1087003,54,155,13,222
"87004",1087004,82,203,6,291
"87005",1087005,47,112,23,182
"87006",1087006,18,102,2,122
"87007",1087007,142,67,8,217
"87008",1087008,20,213,2,235
"87009",1087009,146,35,9,190
"87010",1087010,59,73,1,133
"87011",1087011,159,132,11,302
"87012",1087012,162,150,18,330
"87013",1087013,100,4,2,106
"87014",1087014,162,83,9,254
"87015",1087015,185,47,10,242
"87016",1087016,245,34,10,289
"87017",1087017,124,133,9,266
"87018",1087018,66,27,2,95
"87019",1087019,112,32,12,156
"87020",1087020,63,202,5,270
"87021",1087021,37,268,3,308
"87022",1087022,104,41,6,151
"87023",1087023,107,65,4,176
"87024",1087024,30,120,5,155
"87025",1087025,110,63,9,182
"87026",1087026,216,20,9,245
"87027",1087027,87,221,17,325
"87028",1087028,72,140,2,214
"87029",1087029,141,23,5,169
"87030",1087030,104,44,5,153
"87031",1087031,100,179,9,288
"87032",1087032,37,3,1,41
"87033",1087033,126,147,12,285
"87034",1087034,150,38,7,195
"87035",1087035,62,170,11,243
"87036",1087036,130,110,12,252
"87037",1087037,132,15,2,149
"87038",1087038,138,96,3,237
"87039",1087039,121,87,20,228
"87040",1087040,17,262,1,280
"87041",1087041,155,49,7,211
"87042",1087042,134,99,9,242
"87043",1087043,146,68,6,220
"87044",1087044,99,159,9,267
"87045",1087045,60,122,3,185
"87046",1087046,32,74,6,112
"87047",1087047,123,136,10,269
"87048",1087048,142,93,17,252
"87049",1087049,58,246,6,310
"87050",1087050,151,163,6,320
"87051",1087051,131,39,4,174
"87052",1087052,113,57,23,193
"87053",1087053,93,49,8,150
"87054",1087054,11,10,6,27
"87055",1087055,111,115,22,248
"87056",1087056,139,79,18,236
"87057",1087057,88,171,4,263
"87058",1087058,19,162,4,185
"87059",1087059,132,65,8,205
"87060",1087060,59,199,5,263
"87061",1087061,203,81,11,295
"87062",1087062,286,37,16,339
"87063",1087063,130,85,20,235
"87064",1087064,56,12,3,71
"87065",1087065,120,116,8,244
"87066",1087066,109,22,8,139
"87067",1087067,75,209,13,297
"87068",1087068,193,35,7,235
"87069",1087069,52,9,0,61
"87070",1087070,40,258,9,307
"87071",1087071,166,36,8,210
"87072",1087072,136,119,4,259
"87073",1087073,83,204,12,299
"87074",1087074,65,209,15,289
"87075",1087075,119,117,8,244
"87076",1087076,65,174,21,260
"87077",1087077,105,71,7,183
"87078",1087078,115,10,3,128
"87079",1087079,202,69,8,279
"87080",1087080,124,74,4,202
"87081",1087081,243,8,2,253
"87082",1087082,148,203,10,361
"87083",1087083,137,147,13,297
"87084",1087084,144,75,6,225
"87085",1087085,33,248,3,284
"87086",1087086,60,253,4,317
"87087",1087087,28,188,5,221
"87088",1087088,69,238,7,314
"87089",1087089,54,40,0,94
"87090",1087090,156,57,3,216
"87091",1087091,27,61,2,90
"87092",1087092,116,159,10,285
"87093",1087093,46,91,6,143
"87094",1087094,51,173,5,229
"87095",1087095,83,182,5,270
"87096",1087096,198,41,16,255
"87097",1087097,116,198,15,329
"87098",1087098,89,130,4,223
"87099",1087099,158,137,8,303
"87100",1087100,143,137,8,288
"87101",1087101,101,187,9,297
"87102",1087102,113,88,15,216
"87103",1087103,267,6,1,274
"87104",1087104,66,69,6,141
"87105",1087105,85,147,16,248
"87106",1087106,235,74,18,327
"87107",1087107,17,26,3,46
"87108",1087108,95,100,8,203
"87109",1087109,159,60,8,227
"87110",1087110,122,27,4,153
"87111",1087111,48,85,0,133
"87112",1087112,66,174,13,253
"87113",1087113,22,253,4,279
"87114",1087114,58,169,4,231
"87115",1087115,42,202,5,249
"87116",1087116,57,75,5,137
"87117",1087117,106,13,2,121
"87118",1087118,105,138,4,247
"87119",1087119,138,145,11,294
"87120",1087120,28,177,13,218
"87121",1087121,132,136,14,282
"87122",1087122,77,230,2,309
"87123",1087123,107,115,5,227
"87124",1087124,98,105,17,220
"87125",1087125,71,187,4,262
"87126",1087126,65,60,4,129
"87127",1087127,104,44,4,152
"87128",1087128,132,86,4,222
"87129",1087129,66,146,9,221
"87130",1087130,24,219,3,246
"87131",1087131,116,151,8,275
"87132",1087132,57,197,7,261
"87133",1087133,98,106,8,212
"87134",1087134,86,91,11,188
"87135",1087135,215,85,7,307
"87136",1087136,103,197,6,306
"87137",1087137,41,68,6,115
"87138",1087138,168,70,4,242
"87139",1087139,25,234,11,270
"87140",1087140,249,25,9,283
"87141",1087141,195,79,22,296
"87142",1087142,167,103,17,287
"87143",1087143,81,12,2,95
"87144",1087144,135,144,10,289
"87145",1087145,26,38,5,69
"87146",1087146,102,154,9,265
"87147",1087147,150,72,11,233
"87148",1087148,219,18,4,241
"87149",1087149,122,73,9,204
"87150",1087150,297,66,4,367
"87151",1087151,133,41,4,178
"87152",1087152,30,200,0,230
"87153",1087153,177,52,12,241
"87154",1087154,14,5,0,19
"87155",1087155,116,81,2,199
"87156",1087156,63,192,7,262
"87157",1087157,250,69,9,328
"87158",1087158,78,191,9,278
"87159",1087159,98,187,26,311
"87160",1087160,82,55,12,149
"87161",1087161,124,162,11,297
"87162",1087162,82,88,4,174
"87163",1087163,237,18,12,267
"87164",1087164,94,167,15,276
"87165",1087165,203,51,9,263
"87166",1087166,50,19,3,72
"87167",1087167,187,21,4,212
"87168",1087168,234,33,9,276
"87169",1087169,159,29,3,191
"87170",1087170,187,27,9,223
"87171",1087171,158,68,13,239
"87172",1087172,52,173,5,230
"87173",1087173,19,101,3,123
"87174",1087174,94,139,4,237
"87175",1087175,191,136,9,336
"87176",1087176,22,9,0,31
"87177",1087177,41,176,3,220
"87178",1087178,86,97,10,193
"87179",1087179,69,165,9,243
"87180",1087180,181,84,8,273
"87181",1087181,169,38,5,212
"87182",1087182,29,254,1,284
"87183",1087183,113,201,9,323
"87184",1087184,14,5,2,21
"87185",1087185,136,126,23,285
"87186",1087186,50,219,2,271
"87187",1087187,158,10,2,170
"87188",1087188,81,97,2,180
"87189",1087189,109,154,9,272
"87190",1087190,40,260,11,311
"87191",1087191,123,21,4,148
"87192",1087192,43,190,10,243
"87193",1087193,161,55,6,222
"87194",1087194,114,16,3,133
"87195",1087195,242,47,2,291
"87196",1087196,69,176,11,256
"87197",1087197,178,29,4,211
"87198",1087198,76,113,7,196
"87199",1087199,16,165,5,186
"87200",1087200,120,94,2,216
"87201",1087201,118,29,14,161
"87202",1087202,135,24,6,165
"87203",1087203,131,91,18,240
"87204",1087204,103,144,6,253
"87205",1087205,136,57,6,199
"87206",1087206,31,13,4,48
"87207",1087207,81,17,4,102
"87208",1087208,226,4,15,245
"87209",1087209,21,138,4,163
"87210",1087210,105,8,3,116
"87211",1087211,118,76,4,198
"87212",1087212,98,169,7,274
"87213",1087213,8,1,1,10
"87214",1087214,114,153,7,274
"87215",1087215,201,88,15,304
"87216",1087216,185,87,19,291
"87217",1087217,227,23,7,257
"87218",1087218,212,71,6,289
"87219",1087219,29,52,2,83
"87220",1087220,142,65,5,212
"87221",1087221,100,137,18,255
"87222",1087222,107,71,6,184
"87223",1087223,144,79,9,232
"87224",1087224,172,71,19,262
"87225",1087225,53,13,1,67
"87226",1087226,40,276,5,321
"87227",1087227,55,157,13,225
"87228",1087228,168,70,14,252
"87229",1087229,61,210,13,284
"87230",1087230,82,62,6,150
"87231",1087231,54,155,8,217
"87232",1087232,87,91,8,186
"87233",1087233,88,35,10,133
"87234",1087234,110,98,9,217
"87235",1087235,111,161,8,280
"87236",1087236,75,165,8,248
"87237",1087237,107,61,10,178
"87238",1087238,118,56,5,179
"87239",1087239,134,82,2,218
"87240",1087240,82,240,18,340
"87241",1087241,52,191,4,247
"87242",1087242,149,50,1,200
"87243",1087243,100,40,4,144
"87244",1087244,64,47,2,113
"87245",1087245,172,116,7,295
"87246",1087246,201,130,10,341
"87247",1087247,104,121,2,227
"87248",1087248,195,91,21,307
"87249",1087249,105,142,14,261
"87250",1087250,62,175,9,246
"87251",1087251,8,3,0,11
"87252",1087252,148,27,5,180
"87253",1087253,15,224,5,244
"87254",1087254,139,35,8,182
"87255",1087255,195,77,6,278
"87256",1087256,97,131,5,233
"87257",1087257,171,22,0,193
"87258",1087258,55,115,7,177
"87259",1087259,233,79,14,326
"87260",1087260,86,74,2,162
"87261",1087261,129,193,22,344
"87262",1087262,124,32,6,162
"87263",1087263,68,177,4,249
"87264",1087264,59,154,3,216
"87265",1087265,186,83,13,282
"87266",1087266,126,134,9,269
"87267",1087267,131,17,1,149
"87268",1087268,97,189,5,291
"87269",1087269,154,94,12,260
"87270",1087270,107,180,15,302
"87271",1087271,27,275,1,303
"87272",1087272,105,179,22,306
"87273",1087273,117,112,15,244
"87274",1087274,130,58,4,192
"87275",1087275,143,19,7,169
"87276",1087276,66,195,6,267
"87277",1087277,13,5,3,21
"87278",1087278,224,44,4,272
"87279",1087279,43,43,0,86
"87280",1087280,185,9,5,199
"87281",1087281,125,107,2,234
"87282",1087282,27,148,4,179
"87283",1087283,172,139,13,324
"87284",1087284,26,164,8,198
"87285",1087285,177,53,9,239
"87286",1087286,190,25,11,226
"87287",1087287,65,138,5,208
"87288",1087288,68,57,1,126
"87289",1087289,101,173,22,296
"87290",1087290,92,103,22,217
"87291",1087291,69,134,9,212
"87292",1087292,10,293,3,306
"87293",1087293,151,22,11,184
"87294",1087294,59,267,3,329
"87295",1087295,101,32,8,141
"87296",1087296,60,62,4,126
"87297",1087297,167,56,5,228
"87298",1087298,24,188,0,212
"87299",1087299,159,78,3,240
"87300",1087300,198,76,8,282
"87301",1087301,9,103,2,114
"87302",1087302,143,55,5,203
"87303",1087303,46,288,3,337
"87304",1087304,93,213,12,318
"87305",1087305,191,93,8,292
"87306",1087306,153,134,18,305
"87307",1087307,130,146,13,289
"87308",1087308,185,103,7,295
"87309",1087309,30,23,0,53
"87310",1087310,110,13,2,125
"87311",1087311,183,102,4,289
"87312",1087312,121,72,3,196
"87313",1087313,89,156,13,258
"87314",1087314,171,100,10,281
"87315",1087315,88,35,9,132
"87316",1087316,44,271,3,318
"87317",1087317,38,111,2,151
"87318",1087318,233,32,4,269
"87319",1087319,138,61,8,207
"87320",1087320,172,45,3,220
"87321",1087321,50,187,8,245
"87322",1087322,170,90,4,264
"87323",1087323,133,112,8,253
"87324",1087324,44,238,5,287
"87325",1087325,132,32,4,168
"87326",1087326,110,23,5,138
"87327",1087327,80,182,15,277
"87328",1087328,99,42,7,148
"87329",1087329,100,95,1,196
"87330",1087330,283,33,9,325
"87331",1087331,94,66,9,169
"87332",1087332,57,207,5,269
"87333",1087333,24,82,5,111
"87334",1087334,49,129,5,183
"87335",1087335,97,161,7,265
"87336",1087336,107,147,11,265
"87337",1087337,110,121,7,238
"87338",1087338,76,102,4,182
"87339",1087339,130,18,4,152
"87340",1087340,199,38,11,248
"87341",1087341,29,223,4,256
"87342",1087342,157,78,3,238
"87343",1087343,192,49,6,247
"87344",1087344,37,197,4,238
"87345",1087345,6,59,1,66
"87346",1087346,200,12,6,218
"87347",1087347,43,197,3,243
"87348",1087348,172,34,3,209
"87349",1087349,124,21,3,148
"87350",1087350,56,223,1,280
"87351",1087351,189,33,18,240
"87352",1087352,50,270,9,329
"87353",1087353,72,49,6,127
"87354",1087354,84,145,19,248
"87355",1087355,145,96,7,248
"87356",1087356,56,140,8,204
"87357",1087357,111,163,16,290
"87358",1087358,54,106,10,170
"87359",1087359,124,63,4,191
"87360",1087360,19,98,3,120
"87361",1087361,59,196,3,258
"87362",1087362,121,43,12,176
"87363",1087363,40,12,4,56
"87364",1087364,136,130,7,273
"87365",1087365,197,27,10,234
"87366",1087366,119,114,8,241
"87367",1087367,167,94,1,262
"87368",1087368,90,218,3,311
"87369",1087369,230,57,14,301
"87370",1087370,208,27,8,243
"87371",1087371,168,73,11,252
"87372",1087372,121,166,9,296
"87373",1087373,14,11,1,26
"87374",1087374,235,49,5,289
"87375",1087375,152,105,4,261
"87376",1087376,156,40,4,200
"87377",1087377,163,53,7,223
"87378",1087378,230,60,7,297
"87379",1087379,57,222,16,295
"87380",1087380,136,191,21,348
"87381",1087381,131,113,7,251
"87382",1087382,121,96,21,238
"87383",1087383,108,47,2,157
"87384",1087384,60,206,13,279
"87385",1087385,52,128,7,187
"87386",1087386,91,202,17,310
"87387",1087387,33,159,11,203
"87388",1087388,65,60,7,132
"87389",1087389,176,30,7,213
"87390",1087390,169,119,13,301
"87391",1087391,168,114,14,296
"87392",1087392,23,217,2,242
"87393",1087393,5,0,1,6
"87394",1087394,108,132,8,248
"87395",1087395,114,178,9,301
"87396",1087396,70,230,10,310
"87397",1087397,157,102,7,266
"87398",1087398,134,123,4,261
"87399",1087399,53,196,1,250
"87400",1087400,81,178,3,262
"87401",1087401,16,45,4,65
"87402",1087402,5,72,1,78
"87403",1087403,197,26,6,229
"87404",1087404,148,32,6,186
"87405",1087405,177,59,7,243
"87406",1087406,188,47,5,240
"87407",1087407,164,27,7,198
"87408",1087408,85,181,10,276
"87409",1087409,151,79,0,230
"87410",1087410,36,6,3,45
"87411",1087411,46,215,12,273
"87412",1087412,9,9,1,19
"87413",1087413,71,111,5,187
"87414",1087414,172,150,17,339
"87415",1087415,1,5,0,6
"87416",1087416,79,90,17,186
"87417",1087417,68,163,7,238
"87418",1087418,69,264,11,344
"87419",1087419,304,10,13,327
"87420",1087420,68,84,9,161
"87421",1087421,1,1,0,2
"87422",1087422,161,33,5,199
"87423",1087423,103,43,4,150
"87424",1087424,110,15,4,129
"87425",1087425,176,45,9,230
"87426",1087426,61,286,8,355
"87427",1087427,128,148,19,295
"87428",1087428,40,46,5,91
"87429",1087429,31,207,4,242
"87430",1087430,133,62,6,201
"87431",1087431,43,263,5,311
"87432",1087432,170,120,12,302
"87433",1087433,199,70,20,289
"87434",1087434,176,44,11,231
"87435",1087435,164,113,26,303
"87436",1087436,9,66,2,77
"87437",1087437,154,84,9,247
"87438",1087438,75,154,9,238
"87439",1087439,75,187,20,282
"87440",1087440,179,148,9,336
"87441",1087441,202,46,11,259
"87442",1087442,8,7,0,15
"87443",1087443,90,193,17,300
"87444",1087444,166,29,5,200
"87445",1087445,151,23,6,180
"87446",1087446,63,23,1,87
"87447",1087447,220,89,8,317
"87448",1087448,144,104,17,265
"87449",1087449,53,44,1,98
"87450",1087450,75,136,5,216
"87451",1087451,83,3,0,86
"87452",1087452,59,161,11,231
"87453",1087453,181,49,1,231
"87454",1087454,31,165,5,201
"87455",1087455,68,182,16,266
"87456",1087456,101,178,5,284
"87457",1087457,92,138,10,240
"87458",1087458,45,208,6,259
"87459",1087459,117,98,21,236
"87460",1087460,200,99,17,316
"87461",1087461,258,49,10,317
"87462",1087462,74,221,6,301
"87463",1087463,202,47,7,256
"87464",1087464,185,35,6,226
"87465",1087465,105,18,2,125
"87466",1087466,23,0,0,23
"87467",1087467,138,22,5,165
"87468",1087468,65,189,10,264
"87469",1087469,229,26,14,269
"87470",1087470,132,71,6,209
"87471",1087471,117,142,17,276
"87472",1087472,153,15,1,169
"87473",1087473,74,175,16,265
"87474",1087474,241,95,11,347
"87475",1087475,166,122,6,294
"87476",1087476,23,239,6,268
"87477",1087477,139,131,11,281
"87478",1087478,46,204,11,261
"87479",1087479,80,114,20,214
"87480",1087480,116,164,4,284
"87481",1087481,58,57,3,118
"87482",1087482,52,153,6,211
"87483",1087483,197,51,11,259
"87484",1087484,22,199,2,223
"87485",1087485,164,135,12,311
"87486",1087486,106,38,3,147
"87487",1087487,146,91,17,254
"87488",1087488,129,143,12,284
"87489",1087489,124,150,15,289
"87490",1087490,56,210,4,270
"87491",1087491,129,56,8,193
"87492",1087492,211,62,8,281
"87493",1087493,27,253,10,290
"87494",1087494,109,29,10,148
"87495",1087495,74,186,14,274
"87496",1087496,190,92,8,290
"87497",1087497,44,82,4,130
"87498",1087498,86,101,7,194
"87499",1087499,74,159,4,237
"87500",1087500,52,159,11,222
"87501",1087501,139,43,3,185
"87502",1087502,123,107,3,233
"87503",1087503,35,250,8,293
"87504",1087504,64,148,9,221
"87505",1087505,95,37,4,136
"87506",1087506,64,281,4,349
"87507",1087507,75,263,17,355
"87508",1087508,146,94,5,245
"87509",1087509,76,43,6,125
"87510",1087510,117,192,9,318
"87511",1087511,103,143,13,259
"87512",1087512,133,19,5,157
"87513",1087513,261,263,26,550
"87514",1087514,134,63,3,200
"87515",1087515,17,69,1,87
"87516",1087516,78,213,6,297
"87517",1087517,33,176,7,216
"87518",1087518,52,228,6,286
"87519",1087519,83,87,5,175
"87520",1087520,122,162,5,289
"87521",1087521,64,169,14,247
"87522",1087522,209,83,13,305
"87523",1087523,146,91,7,244
"87524",1087524,65,101,9,175
"87525",1087525,245,229,26,500
"87526",1087526,4,22,0,26
"87527",1087527,23,181,3,207
"87528",1087528,80,220,8,308
"87529",1087529,175,221,8,404
"87530",1087530,165,132,6,303
"87531",1087531,11,9,0,20
"87532",1087532,70,65,4,139
"87533",1087533,66,252,5,323
"87534",1087534,147,27,8,182
"87535",1087535,80,163,7,250
"87536",1087536,90,20,2,112
"87537",1087537,128,56,2,186
"87538",1087538,13,17,2,32
"87539",1087539,35,22,0,57
"87540",1087540,26,116,5,147
"87541",1087541,108,51,8,167
"87542",1087542,53,77,2,132
"87543",1087543,100,47,9,156
"87544",1087544,211,31,18,260
"87545",1087545,57,268,5,330
"87546",1087546,128,190,8,326
"87547",1087547,68,168,3,239
"87548",1087548,28,42,4,74
"87549",1087549,124,133,10,267
"87550",1087550,34,235,8,277
"87551",1087551,18,169,13,200
"87552",1087552,31,245,5,281
"87553",1087553,75,105,4,184
"87554",1087554,167,9,5,181
"87555",1087555,138,78,8,224
"87556",1087556,90,140,9,239
"87557",1087557,94,149,5,248
"87558",1087558,99,166,5,270
"87559",1087559,74,146,5,225
"87560",1087560,123,43,7,173
"87561",1087561,97,11,0,108
"87562",1087562,99,128,12,239
"87563",1087563,106,56,6,168
"87564",1087564,96,127,5,228
"87565",1087565,143,67,21,231
"87566",1087566,96,154,4,254
"87567",1087567,147,5,14,166
"87568",1087568,108,26,4,138
"87569",1087569,8,1,1,10
"87570",1087570,58,260,9,327
"87571",1087571,37,142,2,181
"87572",1087572,124,42,7,173
"87573",1087573,116,60,12,188
"87574",1087574,18,60,1,79
"87575",1087575,126,20,3,149
"87576",1087576,33,223,11,267
"87577",1087577,49,17,4,70
"87578",1087578,92,10,1,103
"87579",1087579,55,119,8,182
"87580",1087580,125,48,5,178
"87581",1087581,197,21,9,227
"87582",1087582,17,55,5,77
"87583",1087583,160,78,8,246
"87584",1087584,39,13,1,53
"87585",1087585,42,188,3,233
"87586",1087586,32,36,5,73
"87587",1087587,152,68,11,231
"87588",1087588,307,92,10,409
"87589",1087589,101,183,10,294
"87590",1087590,151,51,4,206
"87591",1087591,46,101,3,150
"87592",1087592,150,84,12,246
"87593",1087593,82,16,6,104
"87594",1087594,19,200,3,222
"87595",1087595,107,97,3,207
"87596",1087596,123,96,9,228
"87597",1087597,158,41,8,207
"87598",1087598,157,28,4,189
"87599",1087599,161,220,19,400
"87600",1087600,146,46,10,202
"87601",1087601,8,133,0,141
"87602",1087602,103,41,13,157
"87603",1087603,129,144,14,287
"87604",1087604,56,250,1,307
"87605",1087605,158,19,3,180
"87606",1087606,54,27,6,87
"87607",1087607,6,35,0,41
"87608",1087608,171,101,5,277
"87609",1087609,215,30,2,247
"87610",1087610,164,77,13,254
"87611",1087611,12,47,0,59
"87612",1087612,91,30,2,123
"87613",1087613,181,34,7,222
"87614",1087614,155,55,6,216
"87615",1087615,201,71,9,281
"87616",1087616,135,27,8,170
"87617",1087617,46,240,4,290
"87618",1087618,135,108,10,253
"87619",1087619,173,22,1,196
"87620",1087620,107,92,4,203
"87621",1087621,50,175,4,229
"87622",1087622,244,26,7,277
"87623",1087623,50,199,6,255
"87624",1087624,43,193,11,247
"87625",1087625,104,134,20,258
"87626",1087626,22,129,3,154
"87627",1087627,110,129,11,250
"87628",1087628,64,222,9,295
"87629",1087629,133,54,4,191
"87630",1087630,183,79,6,268
"87631",1087631,164,87,19,270
"87632",1087632,106,68,3,177
"87633",1087633,137,82,10,229
"87634",1087634,158,170,10,338
"87635",1087635,76,43,5,124
"87636",1087636,131,70,20,221
"87637",1087637,122,69,10,201
"87638",1087638,84,210,12,306
"87639",1087639,205,89,12,306
"87640",1087640,81,121,3,205
"87641",1087641,170,101,17,288
"87642",1087642,101,150,11,262
"87643",1087643,98,92,4,194
"87644",1087644,53,85,6,144
"87645",1087645,141,101,16,258
"87646",1087646,266,41,11,318
"87647",1087647,82,6,2,90
"87648",1087648,213,36,5,254
"87649",1087649,42,108,10,160
"87650",1087650,118,179,12,309
"87651",1087651,170,135,13,318
"87652",1087652,163,139,18,320
"87653",1087653,58,248,3,309
"87654",1087654,47,27,4,78
"87655",1087655,4,46,3,53
"87656",1087656,81,48,7,136
"87657",1087657,105,129,14,248
"87658",1087658,129,186,15,330
"87659",1087659,102,93,7,202
"87660",1087660,217,68,20,305
"87661",1087661,49,184,21,254
"87662",1087662,152,29,7,188
"87663",1087663,151,64,8,223
"87664",1087664,68,237,14,319
"87665",1087665,39,152,18,209
"87666",1087666,164,93,20,277
"87667",1087667,149,150,7,306
"87668",1087668,171,33,6,210
"87669",1087669,166,104,12,282
"87670",1087670,93,148,6,247
"87671",1087671,38,162,13,213
"87672",1087672,138,129,21,288
"87673",1087673,103,184,18,305
"87674",1087674,115,82,5,202
"87675",1087675,33,133,12,178
"87676",1087676,94,64,6,164
"87677",1087677,117,102,10,229
"87678",1087678,202,23,7,232
"87679",1087679,106,45,5,156
"87680",1087680,80,140,12,232
"87681",1087681,158,49,6,213
"87682",1087682,131,134,14,279
"87683",1087683,154,43,15,212
"87684",1087684,77,218,9,304
"87685",1087685,134,197,9,340
"87686",1087686,79,214,19,312
"87687",1087687,203,10,7,220
"87688",1087688,76,206,2,284
"87689",1087689,99,232,15,346
"87690",1087690,43,259,0,302
"87691",1087691,144,95,10,249
"87692",1087692,200,123,2,325
"87693",1087693,87,135,14,236
"87694",1087694,94,131,7,232
"87695",1087695,21,42,1,64
"87696",1087696,74,199,9,282
"87697",1087697,149,80,3,232
"87698",1087698,146,99,3,248
"87699",1087699,151,11,1,163
"87700",1087700,82,93,20,195
"87701",1087701,143,25,8,176
"87702",1087702,48,264,5,317
"87703",1087703,84,122,2,208
"87704",1087704,150,138,11,299
"87705",1087705,136,14,14,164
"87706",1087706,71,9,3,83
"87707",1087707,143,88,0,231
"87708",1087708,99,43,11,153
"87709",1087709,88,41,8,137
"87710",1087710,73,90,14,177
"87711",1087711,162,29,1,192
"87712",1087712,69,37,8,114
"87713",1087713,40,35,7,82
"87714",1087714,60,254,4,318
"87715",1087715,66,82,0,148
"87716",1087716,276,34,15,325
"87717",1087717,111,18,5,134
"87718",1087718,83,169,11,263
"87719",1087719,63,246,15,324
"87720",1087720,203,17,5,225
"87721",1087721,18,255,2,275
"87722",1087722,122,125,9,256
"87723",1087723,185,86,6,277
"87724",1087724,91,97,13,201
"87725",1087725,173,72,12,257
"87726",1087726,183,17,10,210
"87727",1087727,55,42,3,100
"87728",1087728,215,36,19,270
"87729",1087729,139,49,9,197
"87730",1087730,183,49,4,236
"87731",1087731,104,281,20,405
"87732",1087732,233,76,22,331
"87733",1087733,73,153,23,249
"87734",1087734,177,127,20,324
"87735",1087735,70,169,14,253
"87736",1087736,94,126,1,221
"87737",1087737,136,127,13,276
"87738",1087738,125,56,3,184
"87739",1087739,62,116,2,180
"87740",1087740,161,118,10,289
"87741",1087741,154,50,11,215
"87742",1087742,5,3,1,9
"87743",1087743,206,81,15,302
"87744",1087744,34,257,5,296
"87745",1087745,75,187,5,267
"87746",1087746,81,133,19,233
"87747",1087747,62,151,7,220
"87748",1087748,122,82,9,213
"87749",1087749,183,78,6,267
"87750",1087750,31,92,8,131
"87751",1087751,138,21,2,161
"87752",1087752,140,111,12,263
"87753",1087753,100,89,20,209
"87754",1087754,224,25,10,259
"87755",1087755,157,7,2,166
"87756",1087756,30,53,2,85
"87757",1087757,120,166,15,301
"87758",1087758,122,100,7,229
"87759",1087759,113,119,24,256
"87760",1087760,97,208,29,334
"87761",1087761,63,242,10,315
"87762",1087762,104,140,8,252
"87763",1087763,7,11,3,21
"87764",1087764,133,25,5,163
"87765",1087765,82,77,4,163
"87766",1087766,68,165,5,238
"87767",1087767,152,76,3,231
"87768",1087768,8,19,0,27
"87769",1087769,93,152,8,253
"87770",1087770,81,120,11,212
"87771",1087771,19,179,5,203
"87772",1087772,86,180,10,276
"87773",1087773,12,7,0,19
"87774",1087774,107,184,8,299
"87775",1087775,76,120,8,204
"87776",1087776,68,16,5,89
"87777",1087777,101,9,3,113
"87778",1087778,83,145,5,233
"87779",1087779,27,145,7,179
"87780",1087780,103,44,10,157
"87781",1087781,169,95,7,271
"87782",1087782,135,165,5,305
"87783",1087783,71,39,7,117
"87784",1087784,57,20,3,80
"87785",1087785,293,7,7,307
"87786",1087786,149,63,1,213
"87787",1087787,27,254,0,281
"87788",1087788,70,154,11,235
"87789",1087789,122,110,17,249
"87790",1087790,15,238,3,256
"87791",1087791,95,67,13,175
"87792",1087792,286,7,5,298
"87793",1087793,27,23,1,51
"87794",1087794,83,201,7,291
"87795",1087795,120,21,1,142
"87796",1087796,53,249,6,308
"87797",1087797,119,42,7,168
"87798",1087798,86,99,5,190
"87799",1087799,15,97,0,112
"87800",1087800,89,66,7,162
"87801",1087801,62,250,14,326
"87802",1087802,179,70,2,251
"87803",1087803,123,75,3,201
"87804",1087804,12,67,1,80
"87805",1087805,88,166,10,264
"87806",1087806,177,24,5,206
"87807",1087807,247,17,7,271
"87808",1087808,111,105,9,225
"87809",1087809,163,149,13,325
"87810",1087810,109,103,15,227
"87811",1087811,124,126,13,263
"87812",1087812,70,90,3,163
"87813",1087813,186,47,9,242
"87814",1087814,182,33,4,219
"87815",1087815,22,9,1,32
"87816",1087816,144,143,10,297
"87817",1087817,200,37,9,246
"87818",1087818,64,218,4,286
"87819",1087819,116,178,4,298
"87820",1087820,114,16,6,136
"87821",1087821,43,132,6,181
"87822",1087822,68,69,6,143
"87823",1087823,166,80,5,251
"87824",1087824,116,147,3,266
"87825",1087825,253,38,7,298
"87826",1087826,101,67,17,185
"87827",1087827,104,136,24,264
"87828",1087828,34,48,0,82
"87829",1087829,133,143,12,288
"87830",1087830,153,29,6,188
"87831",1087831,202,80,23,305
"87832",1087832,33,156,5,194
"87833",1087833,68,177,4,249
"87834",1087834,40,130,7,177
"87835",1087835,58,198,2,258
"87836",1087836,129,91,10,230
"87837",1087837,89,210,2,301
"87838",1087838,114,25,3,142
"87839",1087839,122,50,15,187
"87840",1087840,137,104,9,250
"87841",1087841,40,49,3,92
"87842",1087842,53,204,11,268
"87843",1087843,49,68,5,122
"87844",1087844,203,25,5,233
"87845",1087845,30,155,2,187
"87846",1087846,25,266,1,292
"87847",1087847,46,155,3,204
"87848",1087848,47,139,5,191
"87849",1087849,70,144,4,218
"87850",1087850,163,32,3,198
"87851",1087851,20,24,1,45
"87852",1087852,203,50,8,261
"87853",1087853,51,216,5,272
"87854",1087854,83,47,4,134
"87855",1087855,99,168,6,273
"87856",1087856,197,46,13,256
"87857",1087857,19,213,7,239
"87858",1087858,145,31,9,185
"87859",1087859,142,81,12,235
"87860",1087860,143,98,13,254
"87861",1087861,132,69,18,219
"87862",1087862,110,35,4,149
"87863",1087863,238,57,10,305
"87864",1087864,48,12,3,63
"87865",1087865,151,110,6,267
"87866",1087866,122,107,5,234
"87867",1087867,157,57,7,221
"87868",1087868,140,5,10,155
"87869",1087869,88,180,6,274
"87870",1087870,9,97,1,107
"87871",1087871,116,19,1,136
"87872",1087872,10,2,0,12
"87873",1087873,82,40,9,131
"87874",1087874,113,152,19,284
"87875",1087875,82,198,4,284
"87876",1087876,120,108,12,240
"87877",1087877,97,12,2,111
"87878",1087878,86,97,7,190
"87879",1087879,62,122,1,185
"87880",1087880,50,155,7,212
"87881",1087881,46,192,17,255
"87882",1087882,161,66,8,235
"87883",1087883,151,82,19,252
"87884",1087884,144,117,4,265
"87885",1087885,56,182,8,246
"87886",1087886,98,88,11,197
"87887",1087887,88,80,9,177
"87888",1087888,163,105,3,271
"87889",1087889,209,110,13,332
"87890",1087890,125,20,4,149
"87891",1087891,158,63,8,229
"87892",1087892,205,113,11,329
"87893",1087893,177,52,8,237
"87894",1087894,117,189,5,311
"87895",1087895,46,208,2,256
"87896",1087896,216,20,7,243
"87897",1087897,109,177,13,299
"87898",1087898,231,11,9,251
"87899",1087899,89,179,5,273
"87900",1087900,5,2,1,8
"87901",1087901,45,175,3,223
"87902",1087902,56,181,9,246
"87903",1087903,252,40,13,305
"87904",1087904,79,159,5,243
"87905",1087905,241,18,7,266
"87906",1087906,126,81,9,216
"87907",1087907,22,8,0,30
"87908",1087908,213,35,3,251
"87909",1087909,220,46,6,272
"87910",1087910,138,113,7,258
"87911",1087911,257,26,5,288
"87912",1087912,6,74,1,81
"87913",1087913,28,179,12,219
"87914",1087914,171,139,6,316
"87915",1087915,50,187,9,246
"87916",1087916,150,105,5,260
"87917",1087917,61,147,13,221
"87918",1087918,126,121,7,254
"87919",1087919,39,197,0,236
"87920",1087920,296,8,5,309
"87921",1087921,8,2,1,11
"87922",1087922,235,59,7,301
"87923",1087923,116,49,6,171
"87924",1087924,172,53,9,234
"87925",1087925,141,37,9,187
"87926",1087926,124,154,5,283
"87927",1087927,164,25,1,190
"87928",1087928,105,126,10,241
"87929",1087929,94,32,4,130
"87930",1087930,95,154,9,258
"87931",1087931,147,51,6,204
"87932",1087932,72,153,9,234
"87933",1087933,100,160,20,280
"87934",1087934,224,79,3,306
"87935",1087935,154,60,13,227
"87936",1087936,115,169,5,289
"87937",1087937,65,137,6,208
"87938",1087938,145,50,3,198
"87939",1087939,146,17,4,167
"87940",1087940,193,63,12,268
"87941",1087941,120,21,0,141
"87942",1087942,155,35,1,191
"87943",1087943,66,99,8,173
"87944",1087944,84,165,16,265
"87945",1087945,26,199,15,240
"87946",1087946,241,9,2,252
"87947",1087947,105,111,7,223
"87948",1087948,113,108,5,226
"87949",1087949,9,55,0,64
"87950",1087950,137,79,6,222
"87951",1087951,129,153,6,288
"87952",1087952,15,4,1,20
"87953",1087953,114,77,3,194
"87954",1087954,99,35,4,138
"87955",1087955,102,107,7,216
"87956",1087956,94,119,9,222
"87957",1087957,66,92,10,168
"87958",1087958,79,87,12,178
"87959",1087959,138,34,7,179
"87960",1087960,171,66,4,241
"87961",1087961,62,118,15,195
"87962",1087962,140,33,5,178
"87963",1087963,183,98,10,291
"87964",1087964,114,31,4,149
"87965",1087965,107,141,6,254
"87966",1087966,80,137,12,229
"87967",1087967,222,32,8,262
"87968",1087968,106,169,14,289
"87969",1087969,1,9,0,10
"87970",1087970,52,223,9,284
"87971",1087971,213,32,6,251
"87972",1087972,175,99,12,286
"87973",1087973,243,8,0,251
"87974",1087974,42,90,2,134
"87975",1087975,35,272,1,308
"87976",1087976,18,109,2,129
"87977",1087977,77,137,15,229
"87978",1087978,60,164,17,241
"87979",1087979,187,102,9,298
"87980",1087980,206,87,15,308
"87981",1087981,121,72,5,198
"87982",1087982,128,47,6,181
"87983",1087983,149,62,9,220
"87984",1087984,145,145,15,305
"87985",1087985,147,108,8,263
"87986",1087986,78,189,5,272
"87987",1087987,62,82,3,147
"87988",1087988,66,62,3,131
"87989",1087989,56,88,5,149
"87990",1087990,67,145,4,216
"87991",1087991,110,165,8,283
"87992",1087992,104,160,4,268
"87993",1087993,62,200,7,269
"87994",1087994,202,0,2,204
"87995",1087995,89,122,18,229
"87996",1087996,33,262,3,298
"87997",1087997,22,234,4,260
"87998",1087998,185,123,12,320
"87999",1087999,61,266,3,330
"88000",1088000,90,107,5,202
"88001",1088001,112,150,21,283
"88002",1088002,30,16,0,46
"88003",1088003,64,194,0,258
"88004",1088004,129,82,8,219
"88005",1088005,52,98,3,153
"88006",1088006,79,163,4,246
"88007",1088007,60,133,5,198
"88008",1088008,52,272,7,331
"88009",1088009,51,31,1,83
"88010",1088010,165,70,9,244
"88011",1088011,116,133,11,260
"88012",1088012,91,195,3,289
"88013",1088013,141,51,9,201
"88014",1088014,102,80,4,186
"88015",1088015,24,21,2,47
"88016",1088016,129,56,16,201
"88017",1088017,297,84,16,397
"88018",1088018,103,102,5,210
"88019",1088019,171,66,10,247
"88020",1088020,115,89,6,210
"88021",1088021,58,253,7,318
"88022",1088022,118,23,8,149
"88023",1088023,154,65,4,223
"88024",1088024,89,77,1,167
"88025",1088025,107,24,1,132
"88026",1088026,112,18,2,132
"88027",1088027,126,22,3,151
"88028",1088028,65,241,2,308
"88029",1088029,26,252,4,282
"88030",1088030,112,165,6,283
"88031",1088031,82,150,6,238
"88032",1088032,157,131,22,310
"88033",1088033,197,106,6,309
"88034",1088034,137,37,5,179
"88035",1088035,142,149,13,304
"88036",1088036,109,53,3,165
"88037",1088037,35,182,7,224
"88038",1088038,93,101,17,211
"88039",1088039,79,291,18,388
"88040",1088040,70,190,11,271
"88041",1088041,149,45,5,199
"88042",1088042,198,54,22,274
"88043",1088043,136,108,4,248
"88044",1088044,42,151,13,206
"88045",1088045,9,94,1,104
"88046",1088046,89,8,0,97
"88047",1088047,172,29,14,215
"88048",1088048,93,122,11,226
"88049",1088049,115,89,13,217
"88050",1088050,91,40,4,135
"88051",1088051,135,81,11,227
"88052",1088052,76,215,0,291
"88053",1088053,255,46,12,313
"88054",1088054,95,133,7,235
"88055",1088055,110,32,2,144
"88056",1088056,180,93,1,274
"88057",1088057,99,5,6,110
"88058",1088058,129,82,13,224
"88059",1088059,245,13,7,265
"88060",1088060,54,36,1,91
"88061",1088061,47,14,0,61
"88062",1088062,113,73,3,189
"88063",1088063,214,47,9,270
"88064",1088064,44,66,3,113
"88065",1088065,172,67,2,241
"88066",1088066,59,68,2,129
"88067",1088067,206,13,6,225
"88068",1088068,56,259,9,324
"88069",1088069,201,35,5,241
"88070",1088070,264,40,9,313
"88071",1088071,15,54,1,70
"88072",1088072,129,49,4,182
"88073",1088073,109,192,5,306
"88074",1088074,170,36,8,214
"88075",1088075,69,89,1,159
"88076",1088076,83,141,2,226
"88077",1088077,155,58,15,228
"88078",1088078,132,44,8,184
"88079",1088079,22,118,3,143
"88080",1088080,151,83,8,242
"88081",1088081,16,8,0,24
"88082",1088082,43,99,1,143
"88083",1088083,146,130,7,283
"88084",1088084,173,69,11,253
"88085",1088085,77,102,3,182
"88086",1088086,76,47,4,127
"88087",1088087,131,16,2,149
"88088",1088088,164,40,13,217
"88089",1088089,121,40,8,169
"88090",1088090,64,100,6,170
"88091",1088091,184,25,5,214
"88092",1088092,56,188,20,264
"88093",1088093,67,185,2,254
"88094",1088094,38,198,3,239
"88095",1088095,107,89,15,211
"88096",1088096,164,52,9,225
"88097",1088097,127,33,7,167
"88098",1088098,152,79,16,247
"88099",1088099,69,50,2,121
"88100",1088100,13,0,1,14
"88101",1088101,166,115,13,294
"88102",1088102,14,21,2,37
"88103",1088103,129,125,8,262
"88104",1088104,121,126,3,250
"88105",1088105,44,215,4,263
"88106",1088106,29,208,1,238
"88107",1088107,75,161,5,241
"88108",1088108,140,59,2,201
"88109",1088109,47,115,15,177
"88110",1088110,93,156,16,265
"88111",1088111,44,106,3,153
"88112",1088112,89,153,10,252
"88113",1088113,74,150,3,227
"88114",1088114,200,60,8,268
"88115",1088115,188,95,3,286
"88116",1088116,75,35,4,114
"88117",1088117,82,41,3,126
"88118",1088118,164,51,7,222
"88119",1088119,150,122,5,277
"88120",1088120,65,134,2,201
"88121",1088121,45,52,3,100
"88122",1088122,222,27,5,254
"88123",1088123,131,168,15,314
"88124",1088124,19,180,2,201
"88125",1088125,50,232,6,288
"88126",1088126,64,192,3,259
"88127",1088127,88,169,14,271
"88128",1088128,258,40,8,306
"88129",1088129,91,165,1,257
"88130",1088130,99,191,3,293
"88131",1088131,223,73,16,312
"88132",1088132,214,54,10,278
"88133",1088133,89,156,6,251
"88134",1088134,56,195,5,256
"88135",1088135,152,64,5,221
"88136",1088136,154,154,5,313
"88137",1088137,215,18,6,239
"88138",1088138,90,144,5,239
"88139",1088139,137,100,6,243
"88140",1088140,21,92,1,114
"88141",1088141,150,112,11,273
"88142",1088142,167,94,5,266
"88143",1088143,82,188,13,283
"88144",1088144,116,74,7,197
"88145",1088145,82,166,10,258
"88146",1088146,154,25,13,192
"88147",1088147,33,20,6,59
"88148",1088148,110,109,4,223
"88149",1088149,166,69,11,246
"88150",1088150,135,111,5,251
"88151",1088151,191,9,18,218
"88152",1088152,166,89,1,256
"88153",1088153,114,70,8,192
"88154",1088154,110,170,5,285
"88155",1088155,179,81,18,278
"88156",1088156,163,51,2,216
"88157",1088157,154,63,2,219
"88158",1088158,122,56,5,183
"88159",1088159,102,194,8,304
"88160",1088160,65,57,8,130
"88161",1088161,23,41,3,67
"88162",1088162,83,202,11,296
"88163",1088163,103,5,3,111
"88164",1088164,123,120,19,262
"88165",1088165,93,53,4,150
"88166",1088166,66,258,6,330
"88167",1088167,30,174,3,207
"88168",1088168,151,73,10,234
"88169",1088169,152,85,9,246
"88170",1088170,201,18,5,224
"88171",1088171,110,40,9,159
"88172",1088172,137,69,7,213
"88173",1088173,110,61,12,183
"88174",1088174,43,183,3,229
"88175",1088175,163,70,12,245
"88176",1088176,146,48,9,203
"88177",1088177,123,93,9,225
"88178",1088178,66,288,8,362
"88179",1088179,62,94,12,168
"88180",1088180,49,117,9,175
"88181",1088181,88,189,8,285
"88182",1088182,228,70,17,315
"88183",1088183,54,162,7,223
"88184",1088184,119,136,10,265
"88185",1088185,24,226,1,251
"88186",1088186,192,17,6,215
"88187",1088187,34,68,1,103
"88188",1088188,106,61,6,173
"88189",1088189,108,133,17,258
"88190",1088190,139,78,5,222
"88191",1088191,89,58,3,150
"88192",1088192,159,34,9,202
"88193",1088193,108,102,10,220
"88194",1088194,42,155,3,200
"88195",1088195,178,59,7,244
"88196",1088196,97,65,1,163
"88197",1088197,163,6,6,175
"88198",1088198,133,150,5,288
"88199",1088199,64,118,3,185
"88200",1088200,145,155,16,316
"88201",1088201,60,254,3,317
"88202",1088202,60,170,5,235
"88203",1088203,206,106,15,327
"88204",1088204,150,120,4,274
"88205",1088205,37,137,7,181
"88206",1088206,95,79,4,178
"88207",1088207,5,3,2,10
"88208",1088208,82,134,7,223
"88209",1088209,93,187,13,293
"88210",1088210,214,53,10,277
"88211",1088211,150,45,10,205
"88212",1088212,168,52,9,229
"88213",1088213,74,83,2,159
"88214",1088214,141,105,8,254
"88215",1088215,179,149,15,343
"88216",1088216,35,190,4,229
"88217",1088217,19,38,5,62
"88218",1088218,253,78,11,342
"88219",1088219,41,187,6,234
"88220",1088220,145,53,5,203
"88221",1088221,57,154,5,216
"88222",1088222,105,32,1,138
"88223",1088223,78,160,6,244
"88224",1088224,196,87,9,292
"88225",1088225,7,6,1,14
"88226",1088226,223,33,10,266
"88227",1088227,108,78,0,186
"88228",1088228,106,75,8,189
"88229",1088229,168,21,1,190
"88230",1088230,175,146,7,328
"88231",1088231,180,115,9,304
"88232",1088232,142,106,11,259
"88233",1088233,130,112,6,248
"88234",1088234,64,109,20,193
"88235",1088235,274,19,12,305
"88236",1088236,71,111,1,183
"88237",1088237,132,49,5,186
"88238",1088238,82,186,15,283
"88239",1088239,100,175,8,283
"88240",1088240,193,67,11,271
"88241",1088241,82,182,20,284
"88242",1088242,114,83,8,205
"88243",1088243,402,89,16,507
"88244",1088244,144,137,8,289
"88245",1088245,133,147,9,289
"88246",1088246,147,108,7,262
"88247",1088247,6,21,1,28
"88248",1088248,78,51,7,136
"88249",1088249,61,132,5,198
"88250",1088250,196,54,23,273
"88251",1088251,190,24,2,216
"88252",1088252,111,120,7,238
"88253",1088253,83,66,11,160
"88254",1088254,89,87,8,184
"88255",1088255,161,32,2,195
"88256",1088256,215,29,4,248
"88257",1088257,110,122,5,237
"88258",1088258,39,120,4,163
"88259",1088259,93,165,5,263
"88260",1088260,189,36,8,233
"88261",1088261,24,187,2,213
"88262",1088262,143,35,16,194
"88263",1088263,157,33,9,199
"88264",1088264,45,173,17,235
"88265",1088265,31,208,6,245
"88266",1088266,70,52,2,124
"88267",1088267,52,235,7,294
"88268",1088268,6,15,0,21
"88269",1088269,191,50,20,261
"88270",1088270,26,8,0,34
"88271",1088271,51,120,6,177
"88272",1088272,141,51,3,195
"88273",1088273,109,82,9,200
"88274",1088274,110,130,13,253
"88275",1088275,147,96,11,254
"88276",1088276,8,13,1,22
"88277",1088277,253,57,10,320
"88278",1088278,14,6,2,22
"88279",1088279,62,226,9,297
"88280",1088280,151,86,16,253
"88281",1088281,239,230,26,495
"88282",1088282,29,185,3,217
"88283",1088283,4,24,1,29
"88284",1088284,40,262,7,309
"88285",1088285,5,7,1,13
"88286",1088286,163,14,0,177
"88287",1088287,73,100,10,183
"88288",1088288,96,67,13,176
"88289",1088289,153,95,13,261
"88290",1088290,7,33,0,40
"88291",1088291,95,171,14,280
"88292",1088292,29,9,3,41
"88293",1088293,73,147,7,227
"88294",1088294,279,100,5,384
"88295",1088295,238,88,7,333
"88296",1088296,183,43,7,233
"88297",1088297,210,23,6,239
"88298",1088298,101,70,4,175
"88299",1088299,97,53,1,151
"88300",1088300,113,149,3,265
"88301",1088301,102,89,5,196
"88302",1088302,42,27,9,78
"88303",1088303,145,70,3,218
"88304",1088304,18,17,3,38
"88305",1088305,119,134,4,257
"88306",1088306,46,81,2,129
"88307",1088307,21,14,3,38
"88308",1088308,258,18,14,290
"88309",1088309,97,126,5,228
"88310",1088310,196,80,12,288
"88311",1088311,175,112,15,302
"88312",1088312,223,5,9,237
"88313",1088313,51,153,3,207
"88314",1088314,146,112,12,270
"88315",1088315,42,204,5,251
"88316",1088316,54,119,6,179
"88317",1088317,57,243,13,313
"88318",1088318,74,155,12,241
"88319",1088319,305,4,11,320
"88320",1088320,57,214,4,275
"88321",1088321,154,68,4,226
"88322",1088322,56,188,4,248
"88323",1088323,36,14,2,52
"88324",1088324,124,123,8,255
"88325",1088325,129,18,1,148
"88326",1088326,70,182,11,263
"88327",1088327,161,134,15,310
"88328",1088328,56,178,10,244
"88329",1088329,40,209,7,256
"88330",1088330,125,106,5,236
"88331",1088331,152,127,9,288
"88332",1088332,164,88,1,253
"88333",1088333,78,146,12,236
"88334",1088334,45,199,6,250
"88335",1088335,240,38,5,283
"88336",1088336,216,28,10,254
"88337",1088337,73,22,4,99
"88338",1088338,12,66,1,79
"88339",1088339,157,140,20,317
"88340",1088340,98,191,5,294
"88341",1088341,56,244,4,304
"88342",1088342,29,288,4,321
"88343",1088343,157,17,3,177
"88344",1088344,45,53,3,101
"88345",1088345,18,24,4,46
"88346",1088346,25,23,0,48
"88347",1088347,74,198,2,274
"88348",1088348,126,51,9,186
"88349",1088349,59,145,5,209
"88350",1088350,97,9,4,110
"88351",1088351,154,20,8,182
"88352",1088352,115,103,2,220
"88353",1088353,163,99,17,279
"88354",1088354,181,63,6,250
"88355",1088355,48,14,4,66
"88356",1088356,178,15,4,197
"88357",1088357,158,105,23,286
"88358",1088358,32,207,3,242
"88359",1088359,168,89,9,266
"88360",1088360,53,242,4,299
"88361",1088361,111,91,15,217
"88362",1088362,159,36,5,200
"88363",1088363,118,129,18,265
"88364",1088364,151,76,7,234
"88365",1088365,113,65,10,188
"88366",1088366,72,6,1,79
"88367",1088367,44,38,5,87
"88368",1088368,96,212,16,324
"88369",1088369,35,147,2,184
"88370",1088370,112,59,13,184
"88371",1088371,93,126,7,226
"88372",1088372,100,148,7,255
"88373",1088373,108,153,20,281
"88374",1088374,75,214,11,300
"88375",1088375,103,49,8,160
"88376",1088376,154,60,7,221
"88377",1088377,93,201,5,299
"88378",1088378,168,67,13,248
"88379",1088379,86,50,2,138
"88380",1088380,142,55,7,204
"88381",1088381,163,123,8,294
"88382",1088382,70,157,10,237
"88383",1088383,78,139,3,220
"88384",1088384,177,69,4,250
"88385",1088385,73,230,15,318
"88386",1088386,4,4,0,8
"88387",1088387,16,23,3,42
"88388",1088388,195,12,6,213
"88389",1088389,145,138,4,287
"88390",1088390,14,233,6,253
"88391",1088391,158,167,6,331
"88392",1088392,62,137,19,218
"88393",1088393,196,27,10,233
"88394",1088394,153,102,7,262
"88395",1088395,58,171,10,239
"88396",1088396,83,19,2,104
"88397",1088397,135,52,35,222
"88398",1088398,100,192,7,299
"88399",1088399,148,10,3,161
"88400",1088400,19,66,0,85
"88401",1088401,136,50,7,193
"88402",1088402,136,116,10,262
"88403",1088403,154,152,16,322
"88404",1088404,68,81,3,152
"88405",1088405,170,32,9,211
"88406",1088406,73,205,14,292
"88407",1088407,29,45,2,76
"88408",1088408,99,66,5,170
"88409",1088409,78,90,13,181
"88410",1088410,135,87,8,230
"88411",1088411,179,16,1,196
"88412",1088412,122,167,2,291
"88413",1088413,122,59,12,193
"88414",1088414,26,215,2,243
"88415",1088415,63,8,1,72
"88416",1088416,51,90,5,146
"88417",1088417,49,119,4,172
"88418",1088418,130,43,10,183
"88419",1088419,159,114,21,294
"88420",1088420,208,259,13,480
"88421",1088421,63,91,5,159
"88422",1088422,128,42,6,176
"88423",1088423,46,229,6,281
"88424",1088424,120,112,4,236
"88425",1088425,90,149,10,249
"88426",1088426,61,115,3,179
"88427",1088427,141,163,6,310
"88428",1088428,41,290,5,336
"88429",1088429,52,216,4,272
"88430",1088430,162,61,20,243
"88431",1088431,121,30,1,152
"88432",1088432,114,109,5,228
"88433",1088433,56,10,3,69
"88434",1088434,159,148,8,315
"88435",1088435,172,47,6,225
"88436",1088436,178,47,7,232
"88437",1088437,124,39,2,165
"88438",1088438,111,76,8,195
"88439",1088439,183,110,11,304
"88440",1088440,83,89,9,181
"88441",1088441,64,170,4,238
"88442",1088442,164,64,11,239
"88443",1088443,162,67,8,237
"88444",1088444,95,191,21,307
"88445",1088445,48,177,18,243
"88446",1088446,81,146,12,239
"88447",1088447,75,68,1,144
"88448",1088448,65,179,21,265
"88449",1088449,117,75,13,205
"88450",1088450,58,250,4,312
"88451",1088451,148,41,14,203
"88452",1088452,100,75,4,179
"88453",1088453,127,34,6,167
"88454",1088454,42,246,10,298
"88455",1088455,154,59,9,222
"88456",1088456,211,21,10,242
"88457",1088457,173,73,7,253
"88458",1088458,145,72,2,219
"88459",1088459,169,48,7,224
"88460",1088460,98,23,0,121
"88461",1088461,94,31,1,126
"88462",1088462,108,32,2,142
"88463",1088463,12,17,0,29
"88464",1088464,173,79,6,258
"88465",1088465,36,212,0,248
"88466",1088466,101,148,8,257
"88467",1088467,54,46,7,107
"88468",1088468,150,18,3,171
"88469",1088469,9,79,1,89
"88470",1088470,34,154,7,195
"88471",1088471,119,52,8,179
"88472",1088472,24,5,1,30
"88473",1088473,85,104,5,194
"88474",1088474,86,65,0,151
"88475",1088475,24,55,2,81
"88476",1088476,143,34,5,182
"88477",1088477,145,68,3,216
"88478",1088478,152,64,7,223
"88479",1088479,55,110,6,171
"88480",1088480,229,73,16,318
"88481",1088481,188,91,10,289
"88482",1088482,62,126,6,194
"88483",1088483,66,178,9,253
"88484",1088484,80,149,14,243
"88485",1088485,83,90,9,182
"88486",1088486,53,49,1,103
"88487",1088487,136,87,7,230
"88488",1088488,141,79,6,226
"88489",1088489,108,59,0,167
"88490",1088490,96,143,11,250
"88491",1088491,48,70,4,122
"88492",1088492,185,70,9,264
"88493",1088493,170,110,9,289
"88494",1088494,41,232,3,276
"88495",1088495,50,240,2,292
"88496",1088496,165,22,7,194
"88497",1088497,205,130,13,348
"88498",1088498,210,70,20,300
"88499",1088499,165,85,7,257
"88500",1088500,73,150,7,230
"88501",1088501,125,163,13,301
"88502",1088502,144,37,4,185
"88503",1088503,98,191,11,300
"88504",1088504,173,75,21,269
"88505",1088505,211,53,4,268
"88506",1088506,64,207,6,277
"88507",1088507,97,165,11,273
"88508",1088508,34,105,4,143
"88509",1088509,48,219,6,273
"88510",1088510,171,86,18,275
"88511",1088511,156,59,5,220
"88512",1088512,84,166,20,270
"88513",1088513,102,234,11,347
"88514",1088514,94,74,10,178
"88515",1088515,241,27,10,278
"88516",1088516,93,158,9,260
"88517",1088517,80,244,9,333
"88518",1088518,82,204,19,305
"88519",1088519,5,12,1,18
"88520",1088520,217,76,19,312
"88521",1088521,253,8,3,264
"88522",1088522,46,57,1,104
"88523",1088523,79,203,0,282
"88524",1088524,190,17,3,210
"88525",1088525,96,138,14,248
"88526",1088526,74,76,3,153
"88527",1088527,107,120,22,249
"88528",1088528,76,130,4,210
"88529",1088529,42,10,2,54
"88530",1088530,82,97,14,193
"88531",1088531,18,64,5,87
"88532",1088532,66,202,13,281
"88533",1088533,143,71,9,223
"88534",1088534,37,197,4,238
"88535",1088535,116,181,8,305
"88536",1088536,78,186,7,271
"88537",1088537,132,61,19,212
"88538",1088538,171,91,5,267
"88539",1088539,152,87,13,252
"88540",1088540,3,223,5,231
"88541",1088541,124,84,16,224
"88542",1088542,118,185,4,307
"88543",1088543,58,254,10,322
"88544",1088544,97,39,4,140
"88545",1088545,106,72,2,180
"88546",1088546,81,116,1,198
"88547",1088547,124,17,7,148
"88548",1088548,190,24,14,228
"88549",1088549,192,82,5,279
"88550",1088550,177,21,2,200
"88551",1088551,77,27,1,105
"88552",1088552,65,187,5,257
"88553",1088553,131,66,2,199
"88554",1088554,3,4,0,7
"88555",1088555,143,24,3,170
"88556",1088556,158,72,10,240
"88557",1088557,94,0,0,94
"88558",1088558,87,129,3,219
"88559",1088559,132,55,12,199
"88560",1088560,43,117,5,165
"88561",1088561,23,232,6,261
"88562",1088562,96,125,11,232
"88563",1088563,151,98,2,251
"88564",1088564,152,62,12,226
"88565",1088565,167,24,9,200
"88566",1088566,131,24,5,160
"88567",1088567,62,22,1,85
"88568",1088568,105,166,11,282
"88569",1088569,199,92,14,305
"88570",1088570,28,59,5,92
"88571",1088571,57,208,10,275
"88572",1088572,66,148,10,224
"88573",1088573,237,43,8,288
"88574",1088574,139,147,11,297
"88575",1088575,169,76,8,253
"88576",1088576,119,74,9,202
"88577",1088577,135,83,12,230
"88578",1088578,205,73,12,290
"88579",1088579,290,61,7,358
"88580",1088580,174,77,14,265
"88581",1088581,92,72,2,166
"88582",1088582,69,25,1,95
"88583",1088583,114,160,7,281
"88584",1088584,90,166,8,264
"88585",1088585,117,174,8,299
"88586",1088586,90,184,15,289
"88587",1088587,175,68,7,250
"88588",1088588,53,143,6,202
"88589",1088589,101,153,7,261
"88590",1088590,94,68,5,167
"88591",1088591,30,230,9,269
"88592",1088592,21,270,3,294
"88593",1088593,199,27,10,236
"88594",1088594,99,60,9,168
"88595",1088595,165,22,7,194
"88596",1088596,174,6,5,185
"88597",1088597,65,2,0,67
"88598",1088598,126,49,5,180
"88599",1088599,147,15,1,163
"88600",1088600,173,43,10,226
"88601",1088601,187,61,15,263
"88602",1088602,211,48,10,269
"88603",1088603,98,44,7,149
"88604",1088604,118,28,4,150
"88605",1088605,93,111,14,218
"88606",1088606,74,82,6,162
"88607",1088607,35,65,2,102
"88608",1088608,43,140,3,186
"88609",1088609,127,37,5,169
"88610",1088610,54,91,4,149
"88611",1088611,136,79,5,220
"88612",1088612,44,136,5,185
"88613",1088613,133,63,11,207
"88614",1088614,40,221,6,267
"88615",1088615,123,83,14,220
"88616",1088616,82,165,10,257
"88617",1088617,67,186,12,265
"88618",1088618,141,120,8,269
"88619",1088619,36,223,2,261
"88620",1088620,46,234,13,293
"88621",1088621,41,125,3,169
"88622",1088622,112,95,2,209
"88623",1088623,217,35,11,263
"88624",1088624,141,116,4,261
"88625",1088625,89,31,2,122
"88626",1088626,57,234,3,294
"88627",1088627,107,84,15,206
"88628",1088628,57,153,7,217
"88629",1088629,35,236,8,279
"88630",1088630,96,88,13,197
"88631",1088631,136,74,13,223
"88632",1088632,137,193,7,337
"88633",1088633,146,51,4,201
"88634",1088634,29,222,6,257
"88635",1088635,197,55,11,263
"88636",1088636,161,53,0,214
"88637",1088637,172,70,8,250
"88638",1088638,35,149,9,193
"88639",1088639,105,127,12,244
"88640",1088640,239,67,7,313
"88641",1088641,32,191,5,228
"88642",1088642,96,140,11,247
"88643",1088643,184,51,13,248
"88644",1088644,123,18,3,144
"88645",1088645,100,124,15,239
"88646",1088646,105,171,6,282
"88647",1088647,142,35,3,180
"88648",1088648,133,82,6,221
"88649",1088649,4,28,0,32
"88650",1088650,161,51,5,217
"88651",1088651,168,45,10,223
"88652",1088652,49,24,1,74
"88653",1088653,104,44,1,149
"88654",1088654,26,286,5,317
"88655",1088655,147,71,11,229
"88656",1088656,231,70,18,319
"88657",1088657,28,3,0,31
"88658",1088658,93,195,5,293
"88659",1088659,104,4,2,110
"88660",1088660,110,146,24,280
"88661",1088661,137,28,2,167
"88662",1088662,212,26,5,243
"88663",1088663,122,85,3,210
"88664",1088664,220,14,8,242
"88665",1088665,138,44,5,187
"88666",1088666,79,162,23,264
"88667",1088667,81,145,5,231
"88668",1088668,49,231,12,292
"88669",1088669,107,80,7,194
"88670",1088670,127,55,5,187
"88671",1088671,44,196,12,252
"88672",1088672,158,136,15,309
"88673",1088673,98,52,10,160
"88674",1088674,95,154,13,262
"88675",1088675,179,57,10,246
"88676",1088676,39,6,0,45
"88677",1088677,122,207,13,342
"88678",1088678,37,242,10,289
"88679",1088679,221,52,7,280
"88680",1088680,105,169,2,276
"88681",1088681,9,12,0,21
"88682",1088682,147,47,7,201
"88683",1088683,72,100,1,173
"88684",1088684,54,258,5,317
"88685",1088685,122,24,4,150
"88686",1088686,131,150,10,291
"88687",1088687,65,15,6,86
"88688",1088688,188,47,9,244
"88689",1088689,139,20,4,163
"88690",1088690,92,180,5,277
"88691",1088691,98,164,8,270
"88692",1088692,218,26,6,250
"88693",1088693,52,138,6,196
"88694",1088694,78,117,4,199
"88695",1088695,167,9,1,177
"88696",1088696,77,121,0,198
"88697",1088697,51,30,1,82
"88698",1088698,24,245,1,270
"88699",1088699,128,108,8,244
"88700",1088700,81,44,11,136
"88701",1088701,28,297,6,331
"88702",1088702,80,150,21,251
"88703",1088703,200,46,4,250
"88704",1088704,60,61,4,125
"88705",1088705,157,103,14,274
"88706",1088706,67,209,13,289
"88707",1088707,98,96,13,207
"88708",1088708,55,134,4,193
"88709",1088709,149,22,3,174
"88710",1088710,105,63,6,174
"88711",1088711,23,152,9,184
"88712",1088712,56,214,3,273
"88713",1088713,108,167,25,300
"88714",1088714,76,77,8,161
"88715",1088715,185,41,3,229
"88716",1088716,219,51,5,275
"88717",1088717,154,88,7,249
"88718",1088718,172,86,6,264
"88719",1088719,90,102,11,203
"88720",1088720,41,208,14,263
"88721",1088721,127,28,3,158
"88722",1088722,129,146,14,289
"88723",1088723,80,146,11,237
"88724",1088724,132,92,20,244
"88725",1088725,63,35,5,103
"88726",1088726,146,134,9,289
"88727",1088727,174,43,8,225
"88728",1088728,37,135,4,176
"88729",1088729,112,36,5,153
"88730",1088730,184,24,4,212
"88731",1088731,82,132,12,226
"88732",1088732,201,50,9,260
"88733",1088733,41,65,2,108
"88734",1088734,95,27,3,125
"88735",1088735,66,9,1,76
"88736",1088736,64,169,3,236
"88737",1088737,98,167,30,295
"88738",1088738,96,201,6,303
"88739",1088739,88,75,10,173
"88740",1088740,162,38,5,205
"88741",1088741,72,110,3,185
"88742",1088742,81,99,17,197
"88743",1088743,98,121,22,241
"88744",1088744,175,75,10,260
"88745",1088745,60,37,3,100
"88746",1088746,52,190,1,243
"88747",1088747,156,8,2,166
"88748",1088748,17,0,2,19
"88749",1088749,31,248,2,281
"88750",1088750,23,214,5,242
"88751",1088751,0,12,0,12
"88752",1088752,199,38,1,238
"88753",1088753,69,56,4,129
"88754",1088754,60,209,8,277
"88755",1088755,26,185,4,215
"88756",1088756,71,235,11,317
"88757",1088757,80,98,2,180
"88758",1088758,8,15,1,24
"88759",1088759,107,125,6,238
"88760",1088760,40,288,1,329
"88761",1088761,130,138,5,273
"88762",1088762,127,88,14,229
"88763",1088763,60,124,15,199
"88764",1088764,220,102,13,335
"88765",1088765,185,75,12,272
"88766",1088766,46,49,5,100
"88767",1088767,64,13,2,79
"88768",1088768,40,182,9,231
"88769",1088769,102,114,4,220
"88770",1088770,90,134,8,232
"88771",1088771,286,37,7,330
"88772",1088772,185,93,4,282
"88773",1088773,22,64,2,88
"88774",1088774,86,34,5,125
"88775",1088775,21,190,3,214
"88776",1088776,91,137,3,231
"88777",1088777,238,43,9,290
"88778",1088778,147,84,4,235
"88779",1088779,183,92,11,286
"88780",1088780,95,76,10,181
"88781",1088781,152,45,5,202
"88782",1088782,147,161,13,321
"88783",1088783,115,100,4,219
"88784",1088784,99,35,1,135
"88785",1088785,108,35,12,155
"88786",1088786,212,43,3,258
"88787",1088787,115,42,1,158
"88788",1088788,98,91,10,199
"88789",1088789,54,262,5,321
"88790",1088790,171,109,13,293
"88791",1088791,131,137,15,283
"88792",1088792,107,142,12,261
"88793",1088793,180,104,11,295
"88794",1088794,43,167,9,219
"88795",1088795,172,51,10,233
"88796",1088796,89,185,7,281
"88797",1088797,165,115,16,296
"88798",1088798,167,86,10,263
"88799",1088799,47,188,18,253
"88800",1088800,88,77,5,170
"88801",1088801,22,67,3,92
"88802",1088802,20,9,1,30
"88803",1088803,69,62,2,133
"88804",1088804,232,36,10,278
"88805",1088805,162,91,7,260
"88806",1088806,76,194,15,285
"88807",1088807,158,118,14,290
"88808",1088808,60,51,2,113
"88809",1088809,61,208,5,274
"88810",1088810,70,221,11,302
"88811",1088811,183,67,3,253
"88812",1088812,124,76,4,204
"88813",1088813,119,188,13,320
"88814",1088814,271,12,4,287
"88815",1088815,107,135,17,259
"88816",1088816,207,44,11,262
"88817",1088817,178,61,7,246
"88818",1088818,20,282,4,306
"88819",1088819,8,234,1,243
"88820",1088820,112,107,2,221
"88821",1088821,109,147,14,270
"88822",1088822,116,105,13,234
"88823",1088823,114,110,6,230
"88824",1088824,182,86,10,278
"88825",1088825,220,110,15,345
"88826",1088826,65,176,15,256
"88827",1088827,53,8,12,73
"88828",1088828,150,58,14,222
"88829",1088829,105,181,10,296
"88830",1088830,94,53,4,151
"88831",1088831,76,140,25,241
"88832",1088832,117,98,3,218
"88833",1088833,38,120,8,166
"88834",1088834,55,174,3,232
"88835",1088835,33,0,1,34
"88836",1088836,96,138,13,247
"88837",1088837,114,65,1,180
"88838",1088838,118,163,11,292
"88839",1088839,167,123,14,304
"88840",1088840,58,35,4,97
"88841",1088841,102,108,12,222
"88842",1088842,31,199,4,234
"88843",1088843,57,155,2,214
"88844",1088844,40,143,10,193
"88845",1088845,45,129,3,177
"88846",1088846,174,79,2,255
"88847",1088847,66,103,9,178
"88848",1088848,38,2,6,46
"88849",1088849,159,135,20,314
"88850",1088850,30,183,6,219
"88851",1088851,28,231,2,261
"88852",1088852,39,49,0,88
"88853",1088853,125,87,10,222
"88854",1088854,177,61,7,245
"88855",1088855,146,50,14,210
"88856",1088856,4,2,0,6
"88857",1088857,77,180,13,270
"88858",1088858,23,164,4,191
"88859",1088859,69,227,6,302
"88860",1088860,156,59,13,228
"88861",1088861,18,0,0,18
"88862",1088862,181,78,6,265
"88863",1088863,152,98,7,257
"88864",1088864,135,148,6,289
"88865",1088865,104,133,22,259
"88866",1088866,73,41,6,120
"88867",1088867,22,205,1,228
"88868",1088868,38,106,3,147
"88869",1088869,75,38,7,120
"88870",1088870,53,149,5,207
"88871",1088871,87,8,3,98
"88872",1088872,244,19,7,270
"88873",1088873,153,77,5,235
"88874",1088874,21,222,5,248
"88875",1088875,67,243,8,318
"88876",1088876,101,154,4,259
"88877",1088877,138,140,15,293
"88878",1088878,146,102,3,251
"88879",1088879,158,43,4,205
"88880",1088880,53,183,6,242
"88881",1088881,165,35,6,206
"88882",1088882,169,74,6,249
"88883",1088883,68,98,3,169
"88884",1088884,51,45,7,103
"88885",1088885,43,154,4,201
"88886",1088886,111,122,14,247
"88887",1088887,208,37,11,256
"88888",1088888,89,164,2,255
"88889",1088889,133,57,2,192
"88890",1088890,153,63,6,222
"88891",1088891,57,86,3,146
"88892",1088892,21,205,8,234
"88893",1088893,108,28,4,140
"88894",1088894,107,185,16,308
"88895",1088895,10,38,4,52
"88896",1088896,143,58,8,209
"88897",1088897,46,38,1,85
"88898",1088898,196,64,9,269
"88899",1088899,221,19,5,245
"88900",1088900,90,141,25,256
"88901",1088901,175,36,5,216
"88902",1088902,174,13,1,188
"88903",1088903,15,0,0,15
"88904",1088904,179,34,7,220
"88905",1088905,195,49,8,252
"88906",1088906,23,56,3,82
"88907",1088907,206,55,9,270
"88908",1088908,62,159,24,245
"88909",1088909,77,2,0,79
"88910",1088910,134,58,15,207
"88911",1088911,190,29,5,224
"88912",1088912,109,111,12,232
"88913",1088913,102,106,13,221
"88914",1088914,84,8,6,98
"88915",1088915,0,0,0,0
"88916",1088916,67,114,6,187
"88917",1088917,166,78,6,250
"88918",1088918,40,185,5,230
"88919",1088919,101,73,3,177
"88920",1088920,130,50,6,186
"88921",1088921,148,12,5,165
"88922",1088922,112,83,7,202
"88923",1088923,153,117,23,293
"88924",1088924,124,135,11,270
"88925",1088925,155,50,6,211
"88926",1088926,27,178,4,209
"88927",1088927,67,13,3,83
"88928",1088928,75,59,1,135
"88929",1088929,48,187,10,245
"88930",1088930,72,31,1,104
"88931",1088931,127,107,18,252
"88932",1088932,90,197,7,294
"88933",1088933,139,110,7,256
"88934",1088934,149,141,24,314
"88935",1088935,137,6,0,143
"88936",1088936,14,52,5,71
"88937",1088937,28,0,0,28
"88938",1088938,77,55,5,137
"88939",1088939,54,169,2,225
"88940",1088940,200,22,8,230
"88941",1088941,121,133,6,260
"88942",1088942,109,157,11,277
"88943",1088943,143,47,11,201
"88944",1088944,157,56,7,220
"88945",1088945,200,30,7,237
"88946",1088946,154,131,2,287
"88947",1088947,46,183,6,235
"88948",1088948,26,21,5,52
"88949",1088949,100,159,16,275
"88950",1088950,126,354,4,484
"88951",1088951,159,98,3,260
"88952",1088952,221,31,4,256
"88953",1088953,92,194,6,292
"88954",1088954,136,131,31,298
"88955",1088955,147,74,10,231
"88956",1088956,162,138,11,311
"88957",1088957,150,94,10,254
"88958",1088958,188,90,4,282
"88959",1088959,73,109,1,183
"88960",1088960,42,213,4,259
"88961",1088961,197,107,6,310
"88962",1088962,29,219,6,254
"88963",1088963,139,83,10,232
"88964",1088964,245,31,11,287
"88965",1088965,183,108,13,304
"88966",1088966,30,33,4,67
"88967",1088967,102,217,11,330
"88968",1088968,151,78,4,233
"88969",1088969,144,75,11,230
"88970",1088970,110,141,10,261
"88971",1088971,66,263,3,332
"88972",1088972,42,266,9,317
"88973",1088973,49,101,2,152
"88974",1088974,113,98,6,217
"88975",1088975,120,38,5,163
"88976",1088976,43,27,7,77
"88977",1088977,172,53,8,233
"88978",1088978,83,100,5,188
"88979",1088979,38,19,1,58
"88980",1088980,170,74,16,260
"88981",1088981,102,75,11,188
"88982",1088982,145,70,9,224
"88983",1088983,78,73,20,171
"88984",1088984,190,55,8,253
"88985",1088985,53,189,9,251
"88986",1088986,87,189,8,284
"88987",1088987,197,66,18,281
"88988",1088988,105,88,19,212
"88989",1088989,69,100,13,182
"88990",1088990,159,79,7,245
"88991",1088991,77,217,6,300
"88992",1088992,135,158,20,313
"88993",1088993,239,17,6,262
"88994",1088994,112,65,11,188
"88995",1088995,212,86,7,305
"88996",1088996,114,81,8,203
"88997",1088997,110,96,11,217
"88998",1088998,118,104,12,234
"88999",1088999,105,26,1,132
"89000",1089000,67,155,16,238
"89001",1089001,111,176,12,299
"89002",1089002,35,191,4,230
"89003",1089003,186,77,3,266
"89004",1089004,205,80,4,289
"89005",1089005,25,0,2,27
"89006",1089006,38,139,4,181
"89007",1089007,121,41,7,169
"89008",1089008,142,69,4,215
"89009",1089009,118,101,9,228
"89010",1089010,88,167,14,269
"89011",1089011,46,5,0,51
"89012",1089012,254,230,27,511
"89013",1089013,123,75,5,203
"89014",1089014,148,76,8,232
"89015",1089015,57,101,2,160
"89016",1089016,124,120,10,254
"89017",1089017,200,91,7,298
"89018",1089018,78,163,17,258
"89019",1089019,70,132,5,207
"89020",1089020,118,71,8,197
"89021",1089021,40,49,2,91
"89022",1089022,104,52,7,163
"89023",1089023,103,71,2,176
"89024",1089024,145,130,2,277
"89025",1089025,93,203,7,303
"89026",1089026,98,72,1,171
"89027",1089027,251,8,5,264
"89028",1089028,173,37,7,217
"89029",1089029,112,166,8,286
"89030",1089030,154,45,10,209
"89031",1089031,35,248,4,287
"89032",1089032,117,118,20,255
"89033",1089033,93,221,13,327
"89034",1089034,70,51,10,131
"89035",1089035,83,193,32,308
"89036",1089036,200,34,6,240
"89037",1089037,68,166,6,240
"89038",1089038,44,22,6,72
"89039",1089039,29,217,1,247
"89040",1089040,50,214,6,270
"89041",1089041,64,166,9,239
"89042",1089042,177,93,7,277
"89043",1089043,183,4,4,191
"89044",1089044,75,5,2,82
"89045",1089045,163,75,8,246
"89046",1089046,27,190,6,223
"89047",1089047,159,54,6,219
"89048",1089048,108,94,6,208
"89049",1089049,97,62,9,168
"89050",1089050,180,93,10,283
"89051",1089051,49,37,4,90
"89052",1089052,200,8,5,213
"89053",1089053,39,145,0,184
"89054",1089054,80,182,7,269
"89055",1089055,72,176,8,256
"89056",1089056,91,94,11,196
"89057",1089057,9,261,2,272
"89058",1089058,97,165,8,270
"89059",1089059,189,14,8,211
"89060",1089060,26,149,8,183
"89061",1089061,104,70,4,178
"89062",1089062,97,0,0,97
"89063",1089063,70,182,7,259
"89064",1089064,200,54,21,275
"89065",1089065,204,65,8,277
"89066",1089066,11,32,4,47
"89067",1089067,77,193,3,273
"89068",1089068,32,263,8,303
"89069",1089069,186,56,8,250
"89070",1089070,155,104,7,266
"89071",1089071,26,137,2,165
"89072",1089072,54,187,8,249
"89073",1089073,26,214,3,243
"89074",1089074,161,90,9,260
"89075",1089075,49,17,4,70
"89076",1089076,44,99,7,150
"89077",1089077,115,105,3,223
"89078",1089078,9,1,0,10
"89079",1089079,104,73,17,194
"89080",1089080,75,47,16,138
"89081",1089081,41,264,4,309
"89082",1089082,165,72,9,246
"89083",1089083,148,69,9,226
"89084",1089084,28,91,6,125
"89085",1089085,5,0,0,5
"89086",1089086,156,59,3,218
"89087",1089087,92,50,8,150
"89088",1089088,128,4,6,138
"89089",1089089,52,284,8,344
"89090",1089090,72,58,5,135
"89091",1089091,181,84,17,282
"89092",1089092,157,36,3,196
"89093",1089093,157,57,13,227
"89094",1089094,164,56,14,234
"89095",1089095,53,219,4,276
"89096",1089096,171,50,13,234
"89097",1089097,116,44,8,168
"89098",1089098,149,127,15,291
"89099",1089099,108,68,4,180
"89100",1089100,141,25,3,169
"89101",1089101,104,175,13,292
"89102",1089102,161,135,23,319
"89103",1089103,108,138,12,258
"89104",1089104,165,142,2,309
"89105",1089105,47,17,3,67
"89106",1089106,77,183,17,277
"89107",1089107,71,175,1,247
"89108",1089108,68,26,3,97
"89109",1089109,204,107,14,325
"89110",1089110,23,217,5,245
"89111",1089111,27,34,1,62
"89112",1089112,216,49,8,273
"89113",1089113,127,44,13,184
"89114",1089114,159,63,9,231
"89115",1089115,56,114,12,182
"89116",1089116,196,35,7,238
"89117",1089117,186,51,6,243
"89118",1089118,216,50,10,276
"89119",1089119,190,52,3,245
"89120",1089120,178,125,14,317
"89121",1089121,89,21,4,114
"89122",1089122,117,51,11,179
"89123",1089123,51,182,2,235
"89124",1089124,154,83,5,242
"89125",1089125,125,129,10,264
"89126",1089126,126,45,11,182
"89127",1089127,105,161,3,269
"89128",1089128,93,91,11,195
"89129",1089129,75,147,10,232
"89130",1089130,256,12,3,271
"89131",1089131,160,36,5,201
"89132",1089132,104,126,10,240
"89133",1089133,5,22,1,28
"89134",1089134,155,17,7,179
"89135",1089135,158,57,1,216
"89136",1089136,72,198,15,285
"89137",1089137,131,112,22,265
"89138",1089138,77,105,19,201
"89139",1089139,94,186,4,284
"89140",1089140,228,32,4,264
"89141",1089141,82,112,3,197
"89142",1089142,44,41,2,87
"89143",1089143,228,53,15,296
"89144",1089144,147,173,10,330
"89145",1089145,161,29,2,192
"89146",1089146,94,47,3,144
"89147",1089147,47,194,9,250
"89148",1089148,115,130,29,274
"89149",1089149,220,1,10,231
"89150",1089150,22,8,1,31
"89151",1089151,215,53,13,281
"89152",1089152,173,50,3,226
"89153",1089153,183,73,11,267
"89154",1089154,114,147,4,265
"89155",1089155,2,4,0,6
"89156",1089156,224,83,13,320
"89157",1089157,117,62,11,190
"89158",1089158,120,199,7,326
"89159",1089159,87,23,1,111
"89160",1089160,5,7,0,12
"89161",1089161,213,27,9,249
"89162",1089162,84,97,8,189
"89163",1089163,118,172,5,295
"89164",1089164,17,275,3,295
"89165",1089165,142,147,15,304
"89166",1089166,164,83,4,251
"89167",1089167,218,48,14,280
"89168",1089168,118,74,23,215
"89169",1089169,104,55,5,164
"89170",1089170,60,190,11,261
"89171",1089171,72,113,12,197
"89172",1089172,135,124,15,274
"89173",1089173,131,74,5,210
"89174",1089174,96,221,7,324
"89175",1089175,97,188,8,293
"89176",1089176,262,32,13,307
"89177",1089177,144,147,14,305
"89178",1089178,15,110,1,126
"89179",1089179,61,241,8,310
"89180",1089180,3,70,1,74
"89181",1089181,69,97,7,173
"89182",1089182,180,51,10,241
"89183",1089183,173,70,9,252
"89184",1089184,46,160,12,218
"89185",1089185,144,84,3,231
"89186",1089186,136,84,6,226
"89187",1089187,194,25,6,225
"89188",1089188,135,49,20,204
"89189",1089189,128,103,14,245
"89190",1089190,213,36,8,257
"89191",1089191,187,54,21,262
"89192",1089192,188,22,5,215
"89193",1089193,65,30,2,97
"89194",1089194,125,113,10,248
"89195",1089195,190,59,6,255
"89196",1089196,8,79,1,88
"89197",1089197,164,36,2,202
"89198",1089198,113,155,5,273
"89199",1089199,2,18,0,20
"89200",1089200,80,286,3,369
"89201",1089201,38,201,5,244
"89202",1089202,116,76,2,194
"89203",1089203,176,7,2,185
"89204",1089204,146,54,11,211
"89205",1089205,71,195,1,267
"89206",1089206,86,15,3,104
"89207",1089207,44,280,10,334
"89208",1089208,46,230,5,281
"89209",1089209,7,14,0,21
"89210",1089210,102,14,4,120
"89211",1089211,138,26,3,167
"89212",1089212,78,65,2,145
"89213",1089213,177,43,14,234
"89214",1089214,48,145,3,196
"89215",1089215,105,220,15,340
"89216",1089216,88,192,13,293
"89217",1089217,111,138,13,262
"89218",1089218,180,55,8,243
"89219",1089219,187,52,11,250
"89220",1089220,283,15,4,302
"89221",1089221,146,78,4,228
"89222",1089222,93,145,6,244
"89223",1089223,136,133,3,272
"89224",1089224,128,97,6,231
"89225",1089225,193,50,9,252
"89226",1089226,17,296,5,318
"89227",1089227,113,93,10,216
"89228",1089228,152,66,17,235
"89229",1089229,91,110,3,204
"89230",1089230,116,173,12,301
"89231",1089231,85,50,0,135
"89232",1089232,133,87,17,237
"89233",1089233,36,4,2,42
"89234",1089234,33,143,8,184
"89235",1089235,109,97,13,219
"89236",1089236,121,119,3,243
"89237",1089237,153,91,8,252
"89238",1089238,81,196,8,285
"89239",1089239,173,103,14,290
"89240",1089240,68,162,4,234
"89241",1089241,246,39,7,292
"89242",1089242,139,100,7,246
"89243",1089243,150,56,6,212
"89244",1089244,108,29,5,142
"89245",1089245,95,132,14,241
"89246",1089246,143,23,7,173
"89247",1089247,190,39,5,234
"89248",1089248,46,233,8,287
"89249",1089249,161,138,18,317
"89250",1089250,43,49,4,96
"89251",1089251,31,248,1,280
"89252",1089252,231,53,7,291
"89253",1089253,14,228,6,248
"89254",1089254,169,123,20,312
"89255",1089255,130,26,7,163
"89256",1089256,191,21,5,217
"89257",1089257,146,59,3,208
"89258",1089258,48,171,11,230
"89259",1089259,23,17,4,44
"89260",1089260,52,177,5,234
"89261",1089261,66,94,10,170
"89262",1089262,93,184,9,286
"89263",1089263,106,82,9,197
"89264",1089264,257,63,14,334
"89265",1089265,138,25,13,176
"89266",1089266,100,122,5,227
"89267",1089267,119,155,9,283
"89268",1089268,1,55,1,57
"89269",1089269,131,61,6,198
"89270",1089270,70,196,12,278
"89271",1089271,132,79,11,222
"89272",1089272,223,30,6,259
"89273",1089273,116,103,5,224
"89274",1089274,79,165,16,260
"89275",1089275,32,187,2,221
"89276",1089276,105,113,5,223
"89277",1089277,214,38,7,259
"89278",1089278,133,176,18,327
"89279",1089279,23,1,1,25
"89280",1089280,114,152,8,274
"89281",1089281,216,80,11,307
"89282",1089282,97,337,13,447
"89283",1089283,214,34,14,262
"89284",1089284,42,22,7,71
"89285",1089285,111,155,8,274
"89286",1089286,110,114,9,233
"89287",1089287,50,23,0,73
"89288",1089288,146,118,10,274
"89289",1089289,166,87,12,265
"89290",1089290,149,8,4,161
"89291",1089291,11,6,1,18
"89292",1089292,102,99,4,205
"89293",1089293,129,84,9,222
"89294",1089294,95,18,6,119
"89295",1089295,79,220,7,306
"89296",1089296,128,197,11,336
"89297",1089297,189,34,12,235
"89298",1089298,206,82,7,295
"89299",1089299,55,113,3,171
"89300",1089300,194,71,7,272
"89301",1089301,121,167,8,296
"89302",1089302,126,47,2,175
"89303",1089303,103,180,15,298
"89304",1089304,133,55,3,191
"89305",1089305,175,7,0,182
"89306",1089306,28,131,5,164
"89307",1089307,54,27,0,81
"89308",1089308,104,102,1,207
"89309",1089309,75,68,6,149
"89310",1089310,150,94,4,248
"89311",1089311,135,110,13,258
"89312",1089312,46,30,1,77
"89313",1089313,185,82,14,281
"89314",1089314,233,12,11,256
"89315",1089315,154,112,16,282
"89316",1089316,64,228,11,303
"89317",1089317,174,36,8,218
"89318",1089318,90,59,0,149
"89319",1089319,159,26,4,189
"89320",1089320,105,15,2,122
"89321",1089321,129,82,16,227
"89322",1089322,192,31,9,232
"89323",1089323,11,67,3,81
"89324",1089324,57,82,4,143
"89325",1089325,181,75,7,263
"89326",1089326,109,174,6,289
"89327",1089327,85,123,15,223
"89328",1089328,147,121,16,284
"89329",1089329,28,166,5,199
"89330",1089330,22,314,2,338
"89331",1089331,36,178,6,220
"89332",1089332,114,129,7,250
"89333",1089333,153,75,19,247
"89334",1089334,137,110,10,257
"89335",1089335,115,129,10,254
"89336",1089336,210,15,17,242
"89337",1089337,180,20,7,207
"89338",1089338,92,197,10,299
"89339",1089339,173,79,14,266
"89340",1089340,114,155,4,273
"89341",1089341,89,103,9,201
"89342",1089342,66,151,27,244
"89343",1089343,131,165,18,314
"89344",1089344,185,35,7,227
"89345",1089345,133,122,15,270
"89346",1089346,38,130,0,168
"89347",1089347,88,236,17,341
"89348",1089348,66,185,10,261
"89349",1089349,94,207,11,312
"89350",1089350,92,205,7,304
"89351",1089351,106,180,9,295
"89352",1089352,133,54,4,191
"89353",1089353,72,64,7,143
"89354",1089354,99,158,5,262
"89355",1089355,178,52,7,237
"89356",1089356,139,47,5,191
"89357",1089357,104,103,11,218
"89358",1089358,53,163,16,232
"89359",1089359,215,61,13,289
"89360",1089360,118,99,6,223
"89361",1089361,40,216,3,259
"89362",1089362,120,23,9,152
"89363",1089363,50,34,2,86
"89364",1089364,174,111,15,300
"89365",1089365,91,142,5,238
"89366",1089366,182,1,1,184
"89367",1089367,72,22,7,101
"89368",1089368,150,7,0,157
"89369",1089369,120,107,5,232
"89370",1089370,164,36,14,214
"89371",1089371,142,110,27,279
"89372",1089372,58,205,14,277
"89373",1089373,54,76,13,143
"89374",1089374,87,146,5,238
"89375",1089375,86,127,15,228
"89376",1089376,4,4,0,8
"89377",1089377,177,64,17,258
"89378",1089378,132,87,2,221
"89379",1089379,203,41,2,246
"89380",1089380,109,11,2,122
"89381",1089381,19,78,6,103
"89382",1089382,80,158,9,247
"89383",1089383,88,104,8,200
"89384",1089384,179,59,7,245
"89385",1089385,8,10,0,18
"89386",1089386,68,182,6,256
"89387",1089387,153,79,5,237
"89388",1089388,38,46,4,88
"89389",1089389,30,220,7,257
"89390",1089390,59,113,3,175
"89391",1089391,104,151,2,257
"89392",1089392,47,138,5,190
"89393",1089393,210,29,4,243
"89394",1089394,74,115,4,193
"89395",1089395,126,167,27,320
"89396",1089396,94,150,4,248
"89397",1089397,110,168,7,285
"89398",1089398,227,14,4,245
"89399",1089399,243,127,13,383
"89400",1089400,104,172,14,290
"89401",1089401,127,41,4,172
"89402",1089402,55,222,18,295
"89403",1089403,140,50,6,196
"89404",1089404,103,33,3,139
"89405",1089405,155,9,8,172
"89406",1089406,202,62,10,274
"89407",1089407,42,198,4,244
"89408",1089408,147,120,10,277
"89409",1089409,129,143,8,280
"89410",1089410,133,83,6,222
"89411",1089411,187,102,7,296
"89412",1089412,209,65,6,280
"89413",1089413,125,135,10,270
"89414",1089414,124,36,9,169
"89415",1089415,130,126,41,297
"89416",1089416,50,126,6,182
"89417",1089417,89,59,3,151
"89418",1089418,153,8,4,165
"89419",1089419,213,32,9,254
"89420",1089420,149,145,21,315
"89421",1089421,200,55,11,266
"89422",1089422,107,28,3,138
"89423",1089423,100,60,5,165
"89424",1089424,14,57,1,72
"89425",1089425,169,86,25,280
"89426",1089426,29,179,3,211
"89427",1089427,103,69,16,188
"89428",1089428,58,86,2,146
"89429",1089429,172,108,13,293
"89430",1089430,185,75,10,270
"89431",1089431,58,262,8,328
"89432",1089432,155,107,7,269
"89433",1089433,56,249,14,319
"89434",1089434,279,0,1,280
"89435",1089435,38,293,14,345
"89436",1089436,47,276,14,337
"89437",1089437,187,34,7,228
"89438",1089438,90,163,2,255
"89439",1089439,33,23,0,56
"89440",1089440,153,143,25,321
"89441",1089441,91,190,4,285
"89442",1089442,26,141,3,170
"89443",1089443,124,93,14,231
"89444",1089444,87,43,8,138
"89445",1089445,76,145,11,232
"89446",1089446,56,344,11,411
"89447",1089447,97,32,1,130
"89448",1089448,72,175,17,264
"89449",1089449,197,92,14,303
"89450",1089450,132,75,2,209
"89451",1089451,199,62,11,272
"89452",1089452,140,92,4,236
"89453",1089453,99,156,18,273
"89454",1089454,45,127,13,185
"89455",1089455,88,215,10,313
"89456",1089456,197,9,0,206
"89457",1089457,93,192,15,300
"89458",1089458,130,160,9,299
"89459",1089459,145,108,13,266
"89460",1089460,126,87,2,215
"89461",1089461,71,231,5,307
"89462",1089462,69,177,3,249
"89463",1089463,155,57,4,216
"89464",1089464,38,1,0,39
"89465",1089465,170,84,14,268
"89466",1089466,89,143,23,255
"89467",1089467,11,6,0,17
"89468",1089468,159,45,2,206
"89469",1089469,22,257,3,282
"89470",1089470,196,20,8,224
"89471",1089471,114,67,9,190
"89472",1089472,201,18,5,224
"89473",1089473,148,126,21,295
"89474",1089474,119,100,8,227
"89475",1089475,92,199,6,297
"89476",1089476,42,267,3,312
"89477",1089477,121,66,17,204
"89478",1089478,165,37,6,208
"89479",1089479,129,94,4,227
"89480",1089480,203,41,14,258
"89481",1089481,149,129,5,283
"89482",1089482,151,66,2,219
"89483",1089483,145,99,6,250
"89484",1089484,136,130,8,274
"89485",1089485,93,219,11,323
"89486",1089486,63,69,10,142
"89487",1089487,154,93,16,263
"89488",1089488,53,46,3,102
"89489",1089489,199,65,8,272
"89490",1089490,79,203,6,288
"89491",1089491,61,200,4,265
"89492",1089492,225,43,9,277
"89493",1089493,202,58,6,266
"89494",1089494,140,30,8,178
"89495",1089495,166,197,39,402
"89496",1089496,188,65,4,257
"89497",1089497,43,25,0,68
"89498",1089498,110,68,6,184
"89499",1089499,115,30,1,146
"89500",1089500,70,243,2,315
"89501",1089501,158,61,5,224
"89502",1089502,186,45,8,239
"89503",1089503,119,181,11,311
"89504",1089504,94,74,16,184
"89505",1089505,63,173,9,245
"89506",1089506,35,236,5,276
"89507",1089507,7,5,1,13
"89508",1089508,205,71,11,287
"89509",1089509,64,248,4,316
"89510",1089510,155,100,6,261
"89511",1089511,100,58,8,166
"89512",1089512,14,113,2,129
"89513",1089513,198,38,9,245
"89514",1089514,35,219,5,259
"89515",1089515,66,197,2,265
"89516",1089516,1,26,1,28
"89517",1089517,136,24,2,162
"89518",1089518,41,203,7,251
"89519",1089519,45,211,8,264
"89520",1089520,190,112,8,310
"89521",1089521,215,29,9,253
"89522",1089522,26,97,1,124
"89523",1089523,177,54,3,234
"89524",1089524,27,10,2,39
"89525",1089525,94,138,6,238
"89526",1089526,182,73,12,267
"89527",1089527,74,135,2,211
"89528",1089528,43,150,6,199
"89529",1089529,169,56,4,229
"89530",1089530,148,109,14,271
"89531",1089531,23,164,0,187
"89532",1089532,191,65,7,263
"89533",1089533,79,159,11,249
"89534",1089534,60,173,16,249
"89535",1089535,184,61,17,262
"89536",1089536,104,79,8,191
"89537",1089537,263,34,17,314
"89538",1089538,41,147,3,191
"89539",1089539,124,163,10,297
"89540",1089540,77,253,1,331
"89541",1089541,155,139,3,297
"89542",1089542,9,2,1,12
"89543",1089543,55,139,19,213
"89544",1089544,75,168,9,252
"89545",1089545,112,107,19,238
"89546",1089546,117,36,2,155
"89547",1089547,202,107,4,313
"89548",1089548,28,74,4,106
"89549",1089549,44,206,12,262
"89550",1089550,147,83,4,234
"89551",1089551,158,41,4,203
"89552",1089552,53,171,8,232
"89553",1089553,216,24,3,243
"89554",1089554,76,185,4,265
"89555",1089555,184,42,9,235
"89556",1089556,120,77,18,215
"89557",1089557,97,7,3,107
"89558",1089558,39,93,2,134
"89559",1089559,153,39,5,197
"89560",1089560,217,25,3,245
"89561",1089561,72,131,6,209
"89562",1089562,150,157,6,313
"89563",1089563,245,27,5,277
"89564",1089564,50,89,17,156
"89565",1089565,42,176,7,225
"89566",1089566,177,67,5,249
"89567",1089567,52,175,2,229
"89568",1089568,102,119,11,232
"89569",1089569,130,98,5,233
"89570",1089570,18,148,3,169
"89571",1089571,9,88,2,99
"89572",1089572,215,17,9,241
"89573",1089573,163,98,14,275
"89574",1089574,78,101,6,185
"89575",1089575,94,7,4,105
"89576",1089576,112,174,7,293
"89577",1089577,165,82,5,252
"89578",1089578,28,32,4,64
"89579",1089579,32,268,3,303
"89580",1089580,15,0,2,17
"89581",1089581,39,302,5,346
"89582",1089582,183,12,1,196
"89583",1089583,131,72,10,213
"89584",1089584,133,96,3,232
"89585",1089585,147,77,5,229
"89586",1089586,136,44,12,192
"89587",1089587,191,63,18,272
"89588",1089588,103,86,8,197
"89589",1089589,37,77,1,115
"89590",1089590,107,197,8,312
"89591",1089591,136,19,3,158
"89592",1089592,179,35,8,222
"89593",1089593,12,2,0,14
"89594",1089594,90,85,2,177
"89595",1089595,77,94,7,178
"89596",1089596,88,171,7,266
"89597",1089597,97,167,9,273
"89598",1089598,129,121,6,256
"89599",1089599,111,112,12,235
"89600",1089600,2,24,0,26
"89601",1089601,67,51,4,122
"89602",1089602,113,52,14,179
"89603",1089603,29,226,1,256
"89604",1089604,90,187,7,284
"89605",1089605,174,63,7,244
"89606",1089606,179,75,9,263
"89607",1089607,55,244,0,299
"89608",1089608,281,16,3,300
"89609",1089609,73,157,3,233
"89610",1089610,91,102,10,203
"89611",1089611,192,4,6,202
"89612",1089612,93,73,4,170
"89613",1089613,29,175,6,210
"89614",1089614,65,200,12,277
"89615",1089615,81,50,4,135
"89616",1089616,120,63,5,188
"89617",1089617,79,165,8,252
"89618",1089618,118,172,8,298
"89619",1089619,22,215,10,247
"89620",1089620,93,50,9,152
"89621",1089621,181,30,14,225
"89622",1089622,119,74,8,201
"89623",1089623,33,23,4,60
"89624",1089624,78,14,4,96
"89625",1089625,24,24,1,49
"89626",1089626,190,66,8,264
"89627",1089627,100,87,0,187
"89628",1089628,120,51,14,185
"89629",1089629,61,188,0,249
"89630",1089630,106,113,8,227
"89631",1089631,136,81,6,223
"89632",1089632,231,134,12,377
"89633",1089633,191,118,4,313
"89634",1089634,158,59,9,226
"89635",1089635,210,49,11,270
"89636",1089636,95,154,13,262
"89637",1089637,49,1,2,52
"89638",1089638,101,32,6,139
"89639",1089639,60,180,13,253
"89640",1089640,196,40,8,244
"89641",1089641,148,72,2,222
"89642",1089642,69,205,4,278
"89643",1089643,116,117,6,239
"89644",1089644,36,28,3,67
"89645",1089645,145,100,20,265
"89646",1089646,194,41,7,242
"89647",1089647,189,48,6,243
"89648",1089648,166,95,7,268
"89649",1089649,2,4,0,6
"89650",1089650,159,71,4,234
"89651",1089651,97,48,4,149
"89652",1089652,175,26,2,203
"89653",1089653,107,126,9,242
"89654",1089654,66,199,21,286
"89655",1089655,132,100,4,236
"89656",1089656,145,64,14,223
"89657",1089657,67,127,5,199
"89658",1089658,38,7,2,47
"89659",1089659,162,93,12,267
"89660",1089660,57,82,7,146
"89661",1089661,49,145,11,205
"89662",1089662,219,36,8,263
"89663",1089663,45,26,1,72
"89664",1089664,76,44,3,123
"89665",1089665,52,64,1,117
"89666",1089666,103,50,3,156
"89667",1089667,134,73,2,209
"89668",1089668,70,114,6,190
"89669",1089669,161,122,7,290
"89670",1089670,114,67,3,184
"89671",1089671,99,157,5,261
"89672",1089672,129,145,15,289
"89673",1089673,136,83,13,232
"89674",1089674,41,195,2,238
"89675",1089675,67,177,1,245
"89676",1089676,57,102,0,159
"89677",1089677,122,121,5,248
"89678",1089678,158,78,19,255
"89679",1089679,82,188,14,284
"89680",1089680,51,8,2,61
"89681",1089681,206,34,4,244
"89682",1089682,206,92,17,315
"89683",1089683,127,114,11,252
"89684",1089684,34,14,2,50
"89685",1089685,81,97,4,182
"89686",1089686,140,27,7,174
"89687",1089687,172,17,5,194
"89688",1089688,63,161,6,230
"89689",1089689,161,33,8,202
"89690",1089690,10,33,2,45
"89691",1089691,31,285,2,318
"89692",1089692,60,172,2,234
"89693",1089693,55,257,10,322
"89694",1089694,12,67,0,79
"89695",1089695,123,154,23,300
"89696",1089696,122,162,16,300
"89697",1089697,81,159,6,246
"89698",1089698,144,18,8,170
"89699",1089699,26,121,2,149
"89700",1089700,130,122,4,256
"89701",1089701,47,183,3,233
"89702",1089702,172,79,14,265
"89703",1089703,18,75,2,95
"89704",1089704,121,16,7,144
"89705",1089705,101,46,13,160
"89706",1089706,46,151,2,199
"89707",1089707,102,63,7,172
"89708",1089708,213,47,10,270
"89709",1089709,50,160,3,213
"89710",1089710,175,139,7,321
"89711",1089711,79,162,6,247
"89712",1089712,116,41,8,165
"89713",1089713,187,64,10,261
"89714",1089714,148,110,7,265
"89715",1089715,46,69,3,118
"89716",1089716,159,50,7,216
"89717",1089717,203,83,18,304
"89718",1089718,62,226,15,303
"89719",1089719,61,186,6,253
"89720",1089720,125,16,4,145
"89721",1089721,61,242,10,313
"89722",1089722,221,86,17,324
"89723",1089723,129,102,12,243
"89724",1089724,55,214,6,275
"89725",1089725,85,148,6,239
"89726",1089726,122,104,10,236
"89727",1089727,131,53,1,185
"89728",1089728,134,0,0,134
"89729",1089729,9,232,3,244
"89730",1089730,153,100,5,258
"89731",1089731,51,71,8,130
"89732",1089732,85,179,16,280
"89733",1089733,148,136,14,298
"89734",1089734,122,143,15,280
"89735",1089735,59,141,7,207
"89736",1089736,90,137,3,230
"89737",1089737,91,137,8,236
"89738",1089738,87,104,8,199
"89739",1089739,81,164,4,249
"89740",1089740,218,223,12,453
"89741",1089741,218,21,6,245
"89742",1089742,37,241,6,284
"89743",1089743,126,149,9,284
"89744",1089744,40,166,4,210
"89745",1089745,203,78,6,287
"89746",1089746,116,137,26,279
"89747",1089747,80,76,2,158
"89748",1089748,75,136,0,211
"89749",1089749,121,60,12,193
"89750",1089750,105,78,5,188
"89751",1089751,146,85,9,240
"89752",1089752,163,3,6,172
"89753",1089753,90,70,8,168
"89754",1089754,24,161,4,189
"89755",1089755,192,47,5,244
"89756",1089756,79,159,0,238
"89757",1089757,97,143,22,262
"89758",1089758,76,29,4,109
"89759",1089759,187,46,2,235
"89760",1089760,58,123,4,185
"89761",1089761,119,43,2,164
"89762",1089762,149,40,4,193
"89763",1089763,55,12,0,67
"89764",1089764,36,97,2,135
"89765",1089765,130,74,11,215
"89766",1089766,18,203,2,223
"89767",1089767,147,196,8,351
"89768",1089768,60,159,10,229
"89769",1089769,40,223,3,266
"89770",1089770,183,57,8,248
"89771",1089771,79,195,7,281
"89772",1089772,52,182,5,239
"89773",1089773,167,111,13,291
"89774",1089774,281,9,4,294
"89775",1089775,11,266,4,281
"89776",1089776,80,159,9,248
"89777",1089777,307,4,7,318
"89778",1089778,65,95,2,162
"89779",1089779,29,206,3,238
"89780",1089780,35,170,5,210
"89781",1089781,87,57,0,144
"89782",1089782,82,66,6,154
"89783",1089783,209,82,10,301
"89784",1089784,49,100,5,154
"89785",1089785,183,94,3,280
"89786",1089786,207,50,5,262
"89787",1089787,169,40,5,214
"89788",1089788,167,72,7,246
"89789",1089789,68,174,1,243
"89790",1089790,160,62,2,224
"89791",1089791,109,33,2,144
"89792",1089792,62,235,5,302
"89793",1089793,115,37,0,152
"89794",1089794,216,5,7,228
"89795",1089795,180,78,14,272
"89796",1089796,58,22,1,81
"89797",1089797,118,49,8,175
"89798",1089798,175,52,14,241
"89799",1089799,209,42,6,257
"89800",1089800,42,240,2,284
"89801",1089801,97,159,15,271
"89802",1089802,75,179,19,273
"89803",1089803,177,84,5,266
"89804",1089804,127,155,13,295
"89805",1089805,219,33,13,265
"89806",1089806,75,66,3,144
"89807",1089807,128,39,8,175
"89808",1089808,87,177,14,278
"89809",1089809,134,95,7,236
"89810",1089810,41,165,4,210
"89811",1089811,169,49,7,225
"89812",1089812,99,90,0,189
"89813",1089813,40,127,7,174
"89814",1089814,165,62,5,232
"89815",1089815,146,136,8,290
"89816",1089816,109,67,8,184
"89817",1089817,129,35,9,173
"89818",1089818,110,95,19,224
"89819",1089819,68,179,16,263
"89820",1089820,176,27,12,215
"89821",1089821,29,17,0,46
"89822",1089822,164,67,18,249
"89823",1089823,133,44,7,184
"89824",1089824,139,131,13,283
"89825",1089825,116,128,17,261
"89826",1089826,188,54,5,247
"89827",1089827,98,90,7,195
"89828",1089828,82,126,16,224
"89829",1089829,66,23,0,89
"89830",1089830,81,39,3,123
"89831",1089831,107,149,22,278
"89832",1089832,101,176,13,290
"89833",1089833,199,44,4,247
"89834",1089834,86,162,5,253
"89835",1089835,186,21,6,213
"89836",1089836,23,4,3,30
"89837",1089837,267,17,9,293
"89838",1089838,71,17,12,100
"89839",1089839,92,235,7,334
"89840",1089840,106,148,12,266
"89841",1089841,66,91,10,167
"89842",1089842,128,136,22,286
"89843",1089843,114,30,5,149
"89844",1089844,146,59,0,205
"89845",1089845,178,75,3,256
"89846",1089846,51,247,8,306
"89847",1089847,102,113,5,220
"89848",1089848,109,110,16,235
"89849",1089849,44,72,2,118
"89850",1089850,51,23,2,76
"89851",1089851,49,1,0,50
"89852",1089852,159,97,15,271
"89853",1089853,127,155,15,297
"89854",1089854,244,19,7,270
"89855",1089855,83,82,12,177
"89856",1089856,199,112,12,323
"89857",1089857,239,18,6,263
"89858",1089858,112,135,38,285
"89859",1089859,35,241,5,281
"89860",1089860,149,88,7,244
"89861",1089861,134,100,22,256
"89862",1089862,171,139,8,318
"89863",1089863,231,23,5,259
"89864",1089864,200,115,20,335
"89865",1089865,95,74,5,174
"89866",1089866,172,88,7,267
"89867",1089867,83,209,14,306
"89868",1089868,155,105,10,270
"89869",1089869,106,81,11,198
"89870",1089870,78,93,1,172
"89871",1089871,88,172,16,276
"89872",1089872,183,27,8,218
"89873",1089873,35,241,7,283
"89874",1089874,193,41,9,243
"89875",1089875,25,30,3,58
"89876",1089876,62,66,4,132
"89877",1089877,209,20,8,237
"89878",1089878,113,146,19,278
"89879",1089879,128,50,3,181
"89880",1089880,192,123,10,325
"89881",1089881,264,110,14,388
"89882",1089882,70,110,2,182
"89883",1089883,134,106,11,251
"89884",1089884,148,30,8,186
"89885",1089885,66,172,5,243
"89886",1089886,87,230,3,320
"89887",1089887,80,23,5,108
"89888",1089888,14,0,0,14
"89889",1089889,145,141,7,293
"89890",1089890,80,170,5,255
"89891",1089891,152,42,6,200
"89892",1089892,66,181,3,250
"89893",1089893,56,137,6,199
"89894",1089894,191,124,5,320
"89895",1089895,45,59,6,110
"89896",1089896,58,215,4,277
"89897",1089897,30,163,0,193
"89898",1089898,92,161,9,262
"89899",1089899,91,60,6,157
"89900",1089900,4,16,0,20
"89901",1089901,91,168,6,265
"89902",1089902,58,140,11,209
"89903",1089903,194,75,13,282
"89904",1089904,245,13,11,269
"89905",1089905,159,345,18,522
"89906",1089906,76,238,9,323
"89907",1089907,82,112,8,202
"89908",1089908,49,155,17,221
"89909",1089909,125,51,4,180
"89910",1089910,37,103,6,146
"89911",1089911,153,80,9,242
"89912",1089912,223,33,11,267
"89913",1089913,150,99,4,253
"89914",1089914,189,68,10,267
"89915",1089915,28,52,6,86
"89916",1089916,33,197,3,233
"89917",1089917,110,121,10,241
"89918",1089918,54,216,14,284
"89919",1089919,131,27,2,160
"89920",1089920,144,176,8,328
"89921",1089921,118,126,4,248
"89922",1089922,114,34,1,149
"89923",1089923,103,86,9,198
"89924",1089924,133,84,2,219
"89925",1089925,114,149,18,281
"89926",1089926,84,124,20,228
"89927",1089927,104,111,5,220
"89928",1089928,133,19,0,152
"89929",1089929,258,45,10,313
"89930",1089930,24,5,0,29
"89931",1089931,77,76,3,156
"89932",1089932,30,133,4,167
"89933",1089933,95,145,4,244
"89934",1089934,78,170,10,258
"89935",1089935,34,257,7,298
"89936",1089936,94,144,5,243
"89937",1089937,170,68,3,241
"89938",1089938,156,124,21,301
"89939",1089939,116,102,12,230
"89940",1089940,7,13,0,20
"89941",1089941,224,27,6,257
"89942",1089942,84,115,16,215
"89943",1089943,75,79,4,158
"89944",1089944,46,159,10,215
"89945",1089945,86,192,5,283
"89946",1089946,33,81,2,116
"89947",1089947,116,85,7,208
"89948",1089948,150,190,14,354
"89949",1089949,114,62,4,180
"89950",1089950,225,36,17,278
"89951",1089951,12,111,0,123
"89952",1089952,90,140,4,234
"89953",1089953,27,240,4,271
"89954",1089954,156,99,7,262
"89955",1089955,178,35,4,217
"89956",1089956,100,131,12,243
"89957",1089957,185,32,3,220
"89958",1089958,70,71,5,146
"89959",1089959,86,176,4,266
"89960",1089960,170,3,4,177
"89961",1089961,109,88,10,207
"89962",1089962,58,192,0,250
"89963",1089963,156,67,5,228
"89964",1089964,196,25,7,228
"89965",1089965,176,44,14,234
"89966",1089966,151,96,8,255
"89967",1089967,109,37,3,149
"89968",1089968,138,123,32,293
"89969",1089969,147,65,3,215
"89970",1089970,182,45,14,241
"89971",1089971,123,145,12,280
"89972",1089972,108,95,14,217
"89973",1089973,38,257,6,301
"89974",1089974,130,89,4,223
"89975",1089975,89,43,4,136
"89976",1089976,62,84,6,152
"89977",1089977,56,154,10,220
"89978",1089978,164,86,8,258
"89979",1089979,82,93,4,179
"89980",1089980,130,91,8,229
"89981",1089981,76,160,11,247
"89982",1089982,163,32,10,205
"89983",1089983,37,148,11,196
"89984",1089984,138,135,3,276
"89985",1089985,179,66,7,252
"89986",1089986,90,167,8,265
"89987",1089987,98,163,4,265
"89988",1089988,271,8,20,299
"89989",1089989,37,277,13,327
"89990",1089990,67,44,3,114
"89991",1089991,77,157,21,255
"89992",1089992,51,31,4,86
"89993",1089993,101,42,6,149
"89994",1089994,147,36,3,186
"89995",1089995,192,55,9,256
"89996",1089996,192,9,6,207
"89997",1089997,68,99,11,178
"89998",1089998,45,131,22,198
"89999",1089999,34,199,13,246
"90000",1090000,164,22,7,193
"90001",1090001,210,41,7,258
"90002",1090002,71,191,21,283
"90003",1090003,81,180,1,262
"90004",1090004,86,127,4,217
"90005",1090005,124,78,5,207
"90006",1090006,229,40,14,283
"90007",1090007,114,102,6,222
"90008",1090008,228,8,0,236
"90009",1090009,85,156,12,253
"90010",1090010,18,101,4,123
"90011",1090011,255,43,13,311
"90012",1090012,103,206,8,317
"90013",1090013,32,114,0,146
"90014",1090014,289,5,4,298
"90015",1090015,171,52,11,234
"90016",1090016,60,224,7,291
"90017",1090017,54,17,2,73
"90018",1090018,25,17,1,43
"90019",1090019,186,13,0,199
"90020",1090020,143,95,8,246
"90021",1090021,41,242,10,293
"90022",1090022,193,68,7,268
"90023",1090023,118,36,8,162
"90024",1090024,98,99,4,201
"90025",1090025,188,13,4,205
"90026",1090026,89,138,16,243
"90027",1090027,50,17,3,70
"90028",1090028,7,11,1,19
"90029",1090029,157,146,25,328
"90030",1090030,244,32,11,287
"90031",1090031,150,178,13,341
"90032",1090032,188,95,7,290
"90033",1090033,189,43,6,238
"90034",1090034,113,101,13,227
"90035",1090035,34,83,9,126
"90036",1090036,38,204,2,244
"90037",1090037,228,53,8,289
"90038",1090038,80,68,6,154
"90039",1090039,152,125,14,291
"90040",1090040,108,192,11,311
"90041",1090041,144,72,4,220
"90042",1090042,92,83,0,175
"90043",1090043,68,0,0,68
"90044",1090044,167,54,9,230
"90045",1090045,194,64,9,267
"90046",1090046,51,158,6,215
"90047",1090047,140,39,13,192
"90048",1090048,205,16,52,273
"90049",1090049,48,48,5,101
"90050",1090050,59,155,6,220
"90051",1090051,91,207,9,307
"90052",1090052,6,24,0,30
"90053",1090053,117,140,19,276
"90054",1090054,74,194,7,275
"90055",1090055,1,3,0,4
"90056",1090056,49,94,7,150
"90057",1090057,102,36,6,144
"90058",1090058,112,166,15,293
"90059",1090059,67,144,7,218
"90060",1090060,63,145,12,220
"90061",1090061,116,4,1,121
"90062",1090062,113,154,11,278
"90063",1090063,260,51,12,323
"90064",1090064,158,70,3,231
"90065",1090065,79,142,9,230
"90066",1090066,228,16,4,248
"90067",1090067,190,88,17,295
"90068",1090068,86,171,14,271
"90069",1090069,230,64,12,306
"90070",1090070,134,13,4,151
"90071",1090071,73,105,15,193
"90072",1090072,19,137,2,158
"90073",1090073,158,87,14,259
"90074",1090074,139,122,3,264
"90075",1090075,124,126,7,257
"90076",1090076,56,102,8,166
"90077",1090077,112,48,8,168
"90078",1090078,134,47,4,185
"90079",1090079,34,27,1,62
"90080",1090080,76,51,5,132
"90081",1090081,154,11,4,169
"90082",1090082,162,20,5,187
"90083",1090083,126,53,5,184
"90084",1090084,76,80,0,156
"90085",1090085,91,34,5,130
"90086",1090086,90,188,8,286
"90087",1090087,93,181,6,280
"90088",1090088,147,151,4,302
"90089",1090089,146,41,8,195
"90090",1090090,114,120,6,240
"90091",1090091,142,59,12,213
"90092",1090092,190,17,3,210
"90093",1090093,44,221,14,279
"90094",1090094,223,22,6,251
"90095",1090095,103,182,11,296
"90096",1090096,107,91,9,207
"90097",1090097,202,28,8,238
"90098",1090098,41,248,2,291
"90099",1090099,125,58,3,186
"90100",1090100,124,77,2,203
"90101",1090101,69,133,8,210
"90102",1090102,72,146,8,226
"90103",1090103,41,89,4,134
"90104",1090104,185,71,15,271
"90105",1090105,90,34,3,127
"90106",1090106,115,95,8,218
"90107",1090107,166,55,6,227
"90108",1090108,135,172,9,316
"90109",1090109,110,168,17,295
"90110",1090110,34,239,10,283
"90111",1090111,30,137,5,172
"90112",1090112,36,58,4,98
"90113",1090113,213,45,16,274
"90114",1090114,134,27,1,162
"90115",1090115,112,37,3,152
"90116",1090116,109,145,5,259
"90117",1090117,124,67,1,192
"90118",1090118,102,215,4,321
"90119",1090119,51,187,6,244
"90120",1090120,107,17,5,129
"90121",1090121,133,26,7,166
"90122",1090122,186,263,24,473
"90123",1090123,29,186,11,226
"90124",1090124,68,242,2,312
"90125",1090125,73,87,12,172
"90126",1090126,75,201,5,281
"90127",1090127,110,87,1,198
"90128",1090128,147,17,4,168
"90129",1090129,181,83,3,267
"90130",1090130,166,85,5,256
"90131",1090131,223,40,10,273
"90132",1090132,97,36,9,142
"90133",1090133,159,15,18,192
"90134",1090134,96,175,1,272
"90135",1090135,163,69,9,241
"90136",1090136,162,21,5,188
"90137",1090137,112,85,0,197
"90138",1090138,163,64,2,229
"90139",1090139,93,169,8,270
"90140",1090140,23,106,2,131
"90141",1090141,100,122,6,228
"90142",1090142,192,17,8,217
"90143",1090143,64,30,3,97
"90144",1090144,202,38,7,247
"90145",1090145,190,318,20,528
"90146",1090146,125,25,6,156
"90147",1090147,201,65,7,273
"90148",1090148,156,111,18,285
"90149",1090149,148,146,18,312
"90150",1090150,106,139,12,257
"90151",1090151,189,62,7,258
"90152",1090152,85,197,9,291
"90153",1090153,169,99,22,290
"90154",1090154,33,343,5,381
"90155",1090155,92,159,14,265
"90156",1090156,109,152,14,275
"90157",1090157,110,20,5,135
"90158",1090158,88,195,13,296
"90159",1090159,13,7,1,21
"90160",1090160,200,36,14,250
"90161",1090161,132,144,22,298
"90162",1090162,67,62,5,134
"90163",1090163,149,66,11,226
"90164",1090164,238,17,8,263
"90165",1090165,104,183,9,296
"90166",1090166,108,91,7,206
"90167",1090167,82,186,13,281
"90168",1090168,58,211,8,277
"90169",1090169,38,230,2,270
"90170",1090170,183,61,1,245
"90171",1090171,111,64,1,176
"90172",1090172,56,212,4,272
"90173",1090173,72,192,11,275
"90174",1090174,148,50,14,212
"90175",1090175,4,14,0,18
"90176",1090176,170,33,10,213
"90177",1090177,118,71,12,201
"90178",1090178,157,83,13,253
"90179",1090179,82,207,5,294
"90180",1090180,186,107,9,302
"90181",1090181,179,13,5,197
"90182",1090182,208,72,22,302
"90183",1090183,181,41,10,232
"90184",1090184,2,0,0,2
"90185",1090185,78,143,5,226
"90186",1090186,122,48,1,171
"90187",1090187,135,8,9,152
"90188",1090188,132,102,12,246
"90189",1090189,171,105,10,286
"90190",1090190,100,201,7,308
"90191",1090191,175,27,7,209
"90192",1090192,95,89,9,193
"90193",1090193,17,271,5,293
"90194",1090194,130,139,3,272
"90195",1090195,121,117,14,252
"90196",1090196,68,181,1,250
"90197",1090197,184,135,15,334
"90198",1090198,48,165,3,216
"90199",1090199,56,238,17,311
"90200",1090200,183,144,18,345
"90201",1090201,288,21,11,320
"90202",1090202,127,153,6,286
"90203",1090203,35,197,4,236
"90204",1090204,52,158,6,216
"90205",1090205,88,142,13,243
"90206",1090206,29,240,3,272
"90207",1090207,167,31,4,202
"90208",1090208,109,162,4,275
"90209",1090209,180,62,10,252
"90210",1090210,255,60,17,332
"90211",1090211,134,163,6,303
"90212",1090212,77,147,6,230
"90213",1090213,20,210,3,233
"90214",1090214,229,20,8,257
"90215",1090215,119,170,4,293
"90216",1090216,76,103,2,181
"90217",1090217,211,33,6,250
"90218",1090218,86,186,8,280
"90219",1090219,184,68,6,258
"90220",1090220,156,19,0,175
"90221",1090221,27,81,6,114
"90222",1090222,220,92,20,332
"90223",1090223,21,76,1,98
"90224",1090224,127,131,12,270
"90225",1090225,133,50,14,197
"90226",1090226,71,214,10,295
"90227",1090227,137,58,5,200
"90228",1090228,73,139,3,215
"90229",1090229,159,20,1,180
"90230",1090230,163,102,7,272
"90231",1090231,39,288,14,341
"90232",1090232,64,12,3,79
"90233",1090233,77,189,20,286
"90234",1090234,160,60,12,232
"90235",1090235,75,14,2,91
"90236",1090236,87,119,9,215
"90237",1090237,115,55,6,176
"90238",1090238,88,47,6,141
"90239",1090239,185,53,3,241
"90240",1090240,162,93,8,263
"90241",1090241,142,39,6,187
"90242",1090242,34,10,0,44
"90243",1090243,72,200,19,291
"90244",1090244,122,148,19,289
"90245",1090245,117,41,13,171
"90246",1090246,139,103,11,253
"90247",1090247,109,143,6,258
"90248",1090248,22,230,3,255
"90249",1090249,50,241,6,297
"90250",1090250,77,69,0,146
"90251",1090251,18,46,1,65
"90252",1090252,129,75,10,214
"90253",1090253,202,20,2,224
"90254",1090254,133,91,7,231
"90255",1090255,174,119,20,313
"90256",1090256,36,90,7,133
"90257",1090257,6,91,3,100
"90258",1090258,56,134,6,196
"90259",1090259,103,93,14,210
"90260",1090260,85,116,10,211
"90261",1090261,149,57,5,211
"90262",1090262,44,245,3,292
"90263",1090263,77,192,11,280
"90264",1090264,244,16,6,266
"90265",1090265,128,123,6,257
"90266",1090266,49,152,4,205
"90267",1090267,84,195,11,290
"90268",1090268,72,29,4,105
"90269",1090269,134,204,6,344
"90270",1090270,167,106,4,277
"90271",1090271,139,39,5,183
"90272",1090272,151,148,11,310
"90273",1090273,87,91,6,184
"90274",1090274,33,49,11,93
"90275",1090275,80,186,7,273
"90276",1090276,55,123,3,181
"90277",1090277,214,23,7,244
"90278",1090278,163,91,5,259
"90279",1090279,140,148,7,295
"90280",1090280,183,72,8,263
"90281",1090281,151,35,7,193
"90282",1090282,181,103,11,295
"90283",1090283,227,24,4,255
"90284",1090284,141,85,6,232
"90285",1090285,42,205,4,251
"90286",1090286,71,162,13,246
"90287",1090287,212,29,5,246
"90288",1090288,214,26,2,242
"90289",1090289,60,20,1,81
"90290",1090290,34,24,6,64
"90291",1090291,166,70,16,252
"90292",1090292,62,175,14,251
"90293",1090293,22,228,0,250
"90294",1090294,183,47,5,235
"90295",1090295,85,93,5,183
"90296",1090296,199,27,4,230
"90297",1090297,41,170,7,218
"90298",1090298,58,252,11,321
"90299",1090299,158,147,18,323
"90300",1090300,135,150,18,303
"90301",1090301,103,143,10,256
"90302",1090302,110,95,12,217
"90303",1090303,152,47,5,204
"90304",1090304,38,132,7,177
"90305",1090305,128,121,6,255
"90306",1090306,58,181,24,263
"90307",1090307,169,15,6,190
"90308",1090308,155,157,11,323
"90309",1090309,56,31,7,94
"90310",1090310,93,133,7,233
"90311",1090311,62,225,2,289
"90312",1090312,132,42,2,176
"90313",1090313,121,66,5,192
"90314",1090314,105,185,4,294
"90315",1090315,196,77,4,277
"90316",1090316,18,327,15,360
"90317",1090317,173,105,13,291
"90318",1090318,207,27,4,238
"90319",1090319,157,49,1,207
"90320",1090320,91,92,1,184
"90321",1090321,65,197,5,267
"90322",1090322,106,110,5,221
"90323",1090323,136,153,21,310
"90324",1090324,28,156,12,196
"90325",1090325,195,41,9,245
"90326",1090326,85,34,10,129
"90327",1090327,401,37,13,451
"90328",1090328,48,181,17,246
"90329",1090329,173,76,12,261
"90330",1090330,23,38,1,62
"90331",1090331,23,97,9,129
"90332",1090332,109,30,0,139
"90333",1090333,150,97,10,257
"90334",1090334,188,140,4,332
"90335",1090335,45,223,9,277
"90336",1090336,219,44,9,272
"90337",1090337,194,35,6,235
"90338",1090338,89,76,11,176
"90339",1090339,95,113,6,214
"90340",1090340,91,185,18,294
"90341",1090341,53,92,7,152
"90342",1090342,208,63,11,282
"90343",1090343,156,51,8,215
"90344",1090344,76,67,4,147
"90345",1090345,138,65,10,213
"90346",1090346,148,59,3,210
"90347",1090347,156,12,0,168
"90348",1090348,95,130,4,229
"90349",1090349,148,37,7,192
"90350",1090350,25,62,5,92
"90351",1090351,145,51,8,204
"90352",1090352,32,52,2,86
"90353",1090353,20,3,1,24
"90354",1090354,149,43,14,206
"90355",1090355,89,40,6,135
"90356",1090356,6,195,1,202
"90357",1090357,89,142,10,241
"90358",1090358,13,223,1,237
"90359",1090359,89,18,2,109
"90360",1090360,113,111,27,251
"90361",1090361,186,33,5,224
"90362",1090362,34,95,4,133
"90363",1090363,119,56,20,195
"90364",1090364,110,164,14,288
"90365",1090365,135,29,12,176
"90366",1090366,23,33,1,57
"90367",1090367,88,169,17,274
"90368",1090368,25,260,3,288
"90369",1090369,225,55,13,293
"90370",1090370,125,93,10,228
"90371",1090371,126,10,1,137
"90372",1090372,146,46,9,201
"90373",1090373,210,38,6,254
"90374",1090374,80,4,4,88
"90375",1090375,50,96,4,150
"90376",1090376,105,233,13,351
"90377",1090377,140,63,10,213
"90378",1090378,86,143,11,240
"90379",1090379,132,26,3,161
"90380",1090380,114,184,7,305
"90381",1090381,31,108,5,144
"90382",1090382,177,59,14,250
"90383",1090383,82,136,3,221
"90384",1090384,162,41,5,208
"90385",1090385,126,52,6,184
"90386",1090386,183,22,4,209
"90387",1090387,40,42,4,86
"90388",1090388,163,118,6,287
"90389",1090389,95,133,9,237
"90390",1090390,144,59,8,211
"90391",1090391,97,120,5,222
"90392",1090392,51,151,7,209
"90393",1090393,141,126,6,273
"90394",1090394,58,241,6,305
"90395",1090395,203,20,10,233
"90396",1090396,46,135,3,184
"90397",1090397,170,79,1,250
"90398",1090398,99,204,6,309
"90399",1090399,214,70,4,288
"90400",1090400,171,113,14,298
"90401",1090401,39,185,8,232
"90402",1090402,135,118,10,263
"90403",1090403,1,1,0,2
"90404",1090404,89,91,7,187
"90405",1090405,142,72,15,229
"90406",1090406,93,147,3,243
"90407",1090407,39,207,1,247
"90408",1090408,42,211,8,261
"90409",1090409,123,76,4,203
"90410",1090410,138,118,11,267
"90411",1090411,82,185,5,272
"90412",1090412,143,119,19,281
"90413",1090413,170,97,16,283
"90414",1090414,101,32,2,135
"90415",1090415,166,68,9,243
"90416",1090416,158,165,11,334
"90417",1090417,90,175,4,269
"90418",1090418,123,58,2,183
"90419",1090419,64,155,11,230
"90420",1090420,54,219,7,280
"90421",1090421,212,71,15,298
"90422",1090422,152,100,14,266
"90423",1090423,104,28,7,139
"90424",1090424,152,143,23,318
"90425",1090425,122,123,3,248
"90426",1090426,75,151,8,234
"90427",1090427,16,21,1,38
"90428",1090428,54,221,5,280
"90429",1090429,138,91,16,245
"90430",1090430,116,102,20,238
"90431",1090431,78,104,4,186
"90432",1090432,53,225,7,285
"90433",1090433,179,18,0,197
"90434",1090434,142,58,10,210
"90435",1090435,219,23,8,250
"90436",1090436,114,36,4,154
"90437",1090437,55,5,2,62
"90438",1090438,178,32,5,215
"90439",1090439,35,2,0,37
"90440",1090440,64,187,13,264
"90441",1090441,72,216,13,301
"90442",1090442,153,70,8,231
"90443",1090443,141,117,16,274
"90444",1090444,110,169,24,303
"90445",1090445,70,180,17,267
"90446",1090446,164,51,16,231
"90447",1090447,179,118,15,312
"90448",1090448,159,152,17,328
"90449",1090449,116,28,5,149
"90450",1090450,149,96,6,251
"90451",1090451,116,44,17,177
"90452",1090452,137,62,8,207
"90453",1090453,119,109,2,230
"90454",1090454,54,84,9,147
"90455",1090455,168,20,3,191
"90456",1090456,89,0,0,89
"90457",1090457,148,71,4,223
"90458",1090458,19,36,1,56
"90459",1090459,21,0,0,21
"90460",1090460,107,33,9,149
"90461",1090461,146,85,12,243
"90462",1090462,106,226,8,340
"90463",1090463,96,119,9,224
"90464",1090464,20,24,2,46
"90465",1090465,149,45,18,212
"90466",1090466,85,25,9,119
"90467",1090467,161,24,5,190
"90468",1090468,62,165,5,232
"90469",1090469,139,12,3,154
"90470",1090470,56,115,11,182
"90471",1090471,146,54,16,216
"90472",1090472,194,83,7,284
"90473",1090473,44,259,9,312
"90474",1090474,83,189,5,277
"90475",1090475,137,42,10,189
"90476",1090476,37,205,7,249
"90477",1090477,81,148,16,245
"90478",1090478,138,73,10,221
"90479",1090479,63,67,7,137
"90480",1090480,149,71,8,228
"90481",1090481,156,72,17,245
"90482",1090482,170,67,13,250
"90483",1090483,51,173,17,241
"90484",1090484,140,163,7,310
"90485",1090485,217,52,12,281
"90486",1090486,29,77,3,109
"90487",1090487,190,16,4,210
"90488",1090488,2,5,0,7
"90489",1090489,189,40,13,242
"90490",1090490,60,95,1,156
"90491",1090491,58,173,2,233
"90492",1090492,94,211,7,312
"90493",1090493,177,106,1,284
"90494",1090494,191,90,26,307
"90495",1090495,134,82,4,220
"90496",1090496,127,104,19,250
"90497",1090497,74,100,3,177
"90498",1090498,83,108,4,195
"90499",1090499,209,7,3,219
"90500",1090500,97,128,13,238
"90501",1090501,91,153,9,253
"90502",1090502,230,19,3,252
"90503",1090503,182,5,2,189
"90504",1090504,196,23,10,229
"90505",1090505,11,6,1,18
"90506",1090506,209,64,15,288
"90507",1090507,108,116,1,225
"90508",1090508,155,83,12,250
"90509",1090509,81,214,6,301
"90510",1090510,90,183,9,282
"90511",1090511,16,96,2,114
"90512",1090512,132,98,1,231
"90513",1090513,56,192,10,258
"90514",1090514,118,78,8,204
"90515",1090515,57,144,2,203
"90516",1090516,132,85,9,226
"90517",1090517,114,171,11,296
"90518",1090518,225,98,16,339
"90519",1090519,246,53,10,309
"90520",1090520,161,50,10,221
"90521",1090521,147,71,1,219
"90522",1090522,90,212,3,305
"90523",1090523,174,79,8,261
"90524",1090524,42,251,9,302
"90525",1090525,83,21,2,106
"90526",1090526,166,130,8,304
"90527",1090527,158,104,9,271
"90528",1090528,145,82,8,235
"90529",1090529,72,154,5,231
"90530",1090530,254,20,14,288
"90531",1090531,90,135,17,242
"90532",1090532,54,118,4,176
"90533",1090533,138,95,10,243
"90534",1090534,36,113,12,161
"90535",1090535,49,66,2,117
"90536",1090536,103,88,9,200
"90537",1090537,47,289,3,339
"90538",1090538,125,134,16,275
"90539",1090539,174,28,9,211
"90540",1090540,194,75,14,283
"90541",1090541,213,85,14,312
"90542",1090542,79,191,9,279
"90543",1090543,49,89,6,144
"90544",1090544,102,193,7,302
"90545",1090545,162,78,10,250
"90546",1090546,67,188,8,263
"90547",1090547,172,55,4,231
"90548",1090548,161,19,5,185
"90549",1090549,58,215,2,275
"90550",1090550,14,173,4,191
"90551",1090551,91,144,0,235
"90552",1090552,1,6,0,7
"90553",1090553,50,194,5,249
"90554",1090554,50,220,18,288
"90555",1090555,56,232,4,292
"90556",1090556,62,130,9,201
"90557",1090557,77,70,12,159
"90558",1090558,157,105,1,263
"90559",1090559,30,139,1,170
"90560",1090560,19,135,3,157
"90561",1090561,46,205,9,260
"90562",1090562,106,106,27,239
"90563",1090563,143,142,13,298
"90564",1090564,90,101,18,209
"90565",1090565,94,183,9,286
"90566",1090566,66,151,13,230
"90567",1090567,204,23,3,230
"90568",1090568,33,120,4,157
"90569",1090569,73,63,4,140
"90570",1090570,218,19,9,246
"90571",1090571,77,188,6,271
"90572",1090572,205,37,6,248
"90573",1090573,225,25,5,255
"90574",1090574,88,130,1,219
"90575",1090575,91,170,8,269
"90576",1090576,96,118,12,226
"90577",1090577,174,69,13,256
"90578",1090578,189,24,4,217
"90579",1090579,98,89,10,197
"90580",1090580,16,38,2,56
"90581",1090581,220,17,8,245
"90582",1090582,88,95,6,189
"90583",1090583,192,42,8,242
"90584",1090584,115,111,15,241
"90585",1090585,191,81,6,278
"90586",1090586,154,42,1,197
"90587",1090587,112,220,11,343
"90588",1090588,188,28,8,224
"90589",1090589,109,77,15,201
"90590",1090590,188,90,23,301
"90591",1090591,70,106,9,185
"90592",1090592,75,146,7,228
"90593",1090593,41,11,2,54
"90594",1090594,149,143,13,305
"90595",1090595,58,186,16,260
"90596",1090596,56,249,7,312
"90597",1090597,7,222,3,232
"90598",1090598,90,237,13,340
"90599",1090599,154,135,6,295
"90600",1090600,146,146,9,301
"90601",1090601,120,55,12,187
"90602",1090602,141,42,2,185
"90603",1090603,167,86,6,259
"90604",1090604,12,108,3,123
"90605",1090605,108,47,12,167
"90606",1090606,112,60,9,181
"90607",1090607,135,94,9,238
"90608",1090608,169,80,18,267
"90609",1090609,119,126,3,248
"90610",1090610,96,141,8,245
"90611",1090611,132,123,6,261
"90612",1090612,110,120,5,235
"90613",1090613,112,36,5,153
"90614",1090614,39,93,5,137
"90615",1090615,70,57,7,134
"90616",1090616,166,92,9,267
"90617",1090617,160,59,7,226
"90618",1090618,48,10,2,60
"90619",1090619,116,162,8,286
"90620",1090620,133,89,19,241
"90621",1090621,128,161,8,297
"90622",1090622,123,36,6,165
"90623",1090623,113,64,7,184
"90624",1090624,115,102,11,228
"90625",1090625,149,21,3,173
"90626",1090626,70,193,26,289
"90627",1090627,137,95,8,240
"90628",1090628,62,185,5,252
"90629",1090629,208,32,13,253
"90630",1090630,44,157,12,213
"90631",1090631,3,0,1,4
"90632",1090632,25,16,0,41
"90633",1090633,167,89,13,269
"90634",1090634,103,147,10,260
"90635",1090635,40,241,6,287
"90636",1090636,85,143,4,232
"90637",1090637,184,98,2,284
"90638",1090638,52,214,6,272
"90639",1090639,177,48,4,229
"90640",1090640,19,47,11,77
"90641",1090641,39,168,13,220
"90642",1090642,71,59,7,137
"90643",1090643,135,57,4,196
"90644",1090644,65,247,12,324
"90645",1090645,103,185,4,292
"90646",1090646,38,137,10,185
"90647",1090647,65,265,4,334
"90648",1090648,18,53,2,73
"90649",1090649,72,148,7,227
"90650",1090650,164,30,1,195
"90651",1090651,56,57,5,118
"90652",1090652,7,35,1,43
"90653",1090653,168,39,3,210
"90654",1090654,59,211,20,290
"90655",1090655,182,96,10,288
"90656",1090656,36,59,5,100
"90657",1090657,148,82,11,241
"90658",1090658,117,51,6,174
"90659",1090659,67,151,1,219
"90660",1090660,183,75,8,266
"90661",1090661,126,101,8,235
"90662",1090662,44,225,10,279
"90663",1090663,12,166,1,179
"90664",1090664,149,51,15,215
"90665",1090665,78,147,7,232
"90666",1090666,64,78,2,144
"90667",1090667,29,13,0,42
"90668",1090668,131,117,7,255
"90669",1090669,117,43,5,165
"90670",1090670,170,141,22,333
"90671",1090671,92,120,2,214
"90672",1090672,142,111,5,258
"90673",1090673,30,284,5,319
"90674",1090674,233,23,6,262
"90675",1090675,98,135,12,245
"90676",1090676,37,201,5,243
"90677",1090677,151,110,5,266
"90678",1090678,109,85,10,204
"90679",1090679,192,78,21,291
"90680",1090680,207,47,4,258
"90681",1090681,182,74,7,263
"90682",1090682,134,82,6,222
"90683",1090683,84,165,21,270
"90684",1090684,136,88,4,228
"90685",1090685,96,31,11,138
"90686",1090686,132,146,16,294
"90687",1090687,31,185,3,219
"90688",1090688,11,7,0,18
"90689",1090689,39,156,10,205
"90690",1090690,175,80,4,259
"90691",1090691,20,191,3,214
"90692",1090692,135,28,4,167
"90693",1090693,192,20,6,218
"90694",1090694,32,190,0,222
"90695",1090695,139,40,5,184
"90696",1090696,37,78,4,119
"90697",1090697,131,81,13,225
"90698",1090698,2,32,0,34
"90699",1090699,82,131,6,219
"90700",1090700,34,52,4,90
"90701",1090701,73,116,16,205
"90702",1090702,149,72,11,232
"90703",1090703,101,69,6,176
"90704",1090704,145,55,8,208
"90705",1090705,155,83,10,248
"90706",1090706,76,189,10,275
"90707",1090707,107,93,5,205
"90708",1090708,134,68,11,213
"90709",1090709,235,65,9,309
"90710",1090710,152,63,11,226
"90711",1090711,60,205,14,279
"90712",1090712,13,2,1,16
"90713",1090713,22,206,9,237
"90714",1090714,106,182,7,295
"90715",1090715,145,136,13,294
"90716",1090716,131,154,10,295
"90717",1090717,104,191,15,310
"90718",1090718,59,158,5,222
"90719",1090719,210,79,6,295
"90720",1090720,18,164,8,190
"90721",1090721,120,49,4,173
"90722",1090722,9,16,0,25
"90723",1090723,124,100,11,235
"90724",1090724,69,230,4,303
"90725",1090725,261,41,13,315
"90726",1090726,110,68,1,179
"90727",1090727,212,83,13,308
"90728",1090728,116,114,13,243
"90729",1090729,9,214,8,231
"90730",1090730,130,69,8,207
"90731",1090731,102,153,12,267
"90732",1090732,190,69,10,269
"90733",1090733,74,105,3,182
"90734",1090734,163,18,3,184
"90735",1090735,50,181,6,237
"90736",1090736,105,132,15,252
"90737",1090737,189,103,17,309
"90738",1090738,1,17,0,18
"90739",1090739,221,63,11,295
"90740",1090740,71,142,10,223
"90741",1090741,82,234,6,322
"90742",1090742,67,163,21,251
"90743",1090743,189,70,6,265
"90744",1090744,60,212,7,279
"90745",1090745,37,204,7,248
"90746",1090746,95,111,15,221
"90747",1090747,93,105,11,209
"90748",1090748,31,204,3,238
"90749",1090749,164,64,15,243
"90750",1090750,125,107,12,244
"90751",1090751,38,198,4,240
"90752",1090752,148,96,5,249
"90753",1090753,2,41,1,44
"90754",1090754,125,108,3,236
"90755",1090755,165,34,3,202
"90756",1090756,36,159,2,197
"90757",1090757,101,121,7,229
"90758",1090758,75,171,9,255
"90759",1090759,140,107,14,261
"90760",1090760,168,127,9,304
"90761",1090761,69,95,10,174
"90762",1090762,100,176,20,296
"90763",1090763,166,100,16,282
"90764",1090764,82,215,12,309
"90765",1090765,31,234,5,270
"90766",1090766,106,161,7,274
"90767",1090767,95,237,12,344
"90768",1090768,144,76,7,227
"90769",1090769,70,84,9,163
"90770",1090770,107,121,9,237
"90771",1090771,55,193,3,251
"90772",1090772,121,92,7,220
"90773",1090773,66,135,6,207
"90774",1090774,171,32,2,205
"90775",1090775,89,76,4,169
"90776",1090776,31,151,2,184
"90777",1090777,9,14,1,24
"90778",1090778,63,117,13,193
"90779",1090779,129,124,15,268
"90780",1090780,92,174,25,291
"90781",1090781,193,49,13,255
"90782",1090782,177,148,12,337
"90783",1090783,62,231,3,296
"90784",1090784,128,41,6,175
"90785",1090785,78,48,2,128
"90786",1090786,184,84,5,273
"90787",1090787,129,144,21,294
"90788",1090788,2,5,0,7
"90789",1090789,62,96,7,165
"90790",1090790,171,106,12,289
"90791",1090791,120,61,11,192
"90792",1090792,97,22,2,121
"90793",1090793,48,209,4,261
"90794",1090794,179,34,9,222
"90795",1090795,103,168,11,282
"90796",1090796,17,20,1,38
"90797",1090797,199,62,1,262
"90798",1090798,143,182,10,335
"90799",1090799,184,97,3,284
"90800",1090800,144,115,12,271
"90801",1090801,183,49,9,241
"90802",1090802,86,85,2,173
"90803",1090803,138,68,5,211
"90804",1090804,56,188,7,251
"90805",1090805,69,196,26,291
"90806",1090806,177,52,6,235
"90807",1090807,148,114,9,271
"90808",1090808,60,13,3,76
"90809",1090809,69,156,24,249
"90810",1090810,61,0,0,61
"90811",1090811,96,72,14,182
"90812",1090812,42,252,2,296
"90813",1090813,34,149,5,188
"90814",1090814,17,24,4,45
"90815",1090815,51,87,3,141
"90816",1090816,98,28,1,127
"90817",1090817,153,111,6,270
"90818",1090818,33,174,6,213
"90819",1090819,84,194,13,291
"90820",1090820,130,12,7,149
"90821",1090821,10,3,0,13
"90822",1090822,35,245,6,286
"90823",1090823,53,112,3,168
"90824",1090824,147,98,22,267
"90825",1090825,87,179,5,271
"90826",1090826,130,162,14,306
"90827",1090827,88,133,16,237
"90828",1090828,89,180,10,279
"90829",1090829,130,96,11,237
"90830",1090830,81,100,5,186
"90831",1090831,138,56,8,202
"90832",1090832,121,126,9,256
"90833",1090833,139,38,7,184
"90834",1090834,43,17,2,62
"90835",1090835,6,10,2,18
"90836",1090836,30,38,7,75
"90837",1090837,226,34,4,264
"90838",1090838,103,68,3,174
"90839",1090839,193,18,2,213
"90840",1090840,161,74,5,240
"90841",1090841,18,165,5,188
"90842",1090842,139,78,10,227
"90843",1090843,61,152,23,236
"90844",1090844,51,79,5,135
"90845",1090845,163,79,9,251
"90846",1090846,178,96,3,277
"90847",1090847,204,71,15,290
"90848",1090848,185,61,13,259
"90849",1090849,149,11,7,167
"90850",1090850,67,83,13,163
"90851",1090851,73,172,12,257
"90852",1090852,189,45,16,250
"90853",1090853,71,203,6,280
"90854",1090854,30,87,7,124
"90855",1090855,13,332,4,349
"90856",1090856,50,27,3,80
"90857",1090857,83,194,4,281
"90858",1090858,51,175,4,230
"90859",1090859,135,176,2,313
"90860",1090860,83,173,14,270
"90861",1090861,192,56,20,268
"90862",1090862,148,43,4,195
"90863",1090863,187,60,6,253
"90864",1090864,81,108,5,194
"90865",1090865,73,77,4,154
"90866",1090866,145,66,16,227
"90867",1090867,141,109,14,264
"90868",1090868,172,48,8,228
"90869",1090869,96,109,6,211
"90870",1090870,140,58,5,203
"90871",1090871,29,163,10,202
"90872",1090872,65,125,5,195
"90873",1090873,98,72,6,176
"90874",1090874,232,40,14,286
"90875",1090875,190,125,11,326
"90876",1090876,36,131,14,181
"90877",1090877,67,76,3,146
"90878",1090878,221,71,6,298
"90879",1090879,74,204,8,286
"90880",1090880,26,233,4,263
"90881",1090881,202,26,8,236
"90882",1090882,53,188,5,246
"90883",1090883,65,72,5,142
"90884",1090884,15,123,2,140
"90885",1090885,58,46,3,107
"90886",1090886,32,166,5,203
"90887",1090887,129,103,14,246
"90888",1090888,188,44,11,243
"90889",1090889,117,42,3,162
"90890",1090890,41,158,3,202
"90891",1090891,121,93,13,227
"90892",1090892,94,114,5,213
"90893",1090893,66,78,11,155
"90894",1090894,138,55,6,199
"90895",1090895,135,98,12,245
"90896",1090896,126,66,4,196
"90897",1090897,105,55,4,164
"90898",1090898,21,241,7,269
"90899",1090899,137,172,7,316
"90900",1090900,47,164,2,213
"90901",1090901,127,193,2,322
"90902",1090902,173,126,12,311
"90903",1090903,157,112,21,290
"90904",1090904,76,168,7,251
"90905",1090905,219,21,13,253
"90906",1090906,149,28,5,182
"90907",1090907,232,8,4,244
"90908",1090908,60,158,26,244
"90909",1090909,112,77,12,201
"90910",1090910,160,133,6,299
"90911",1090911,144,51,5,200
"90912",1090912,161,80,9,250
"90913",1090913,117,57,4,178
"90914",1090914,129,53,11,193
"90915",1090915,99,30,2,131
"90916",1090916,139,164,3,306
"90917",1090917,246,32,8,286
"90918",1090918,166,57,7,230
"90919",1090919,71,190,13,274
"90920",1090920,40,227,10,277
"90921",1090921,147,104,15,266
"90922",1090922,35,37,3,75
"90923",1090923,161,50,11,222
"90924",1090924,182,45,11,238
"90925",1090925,78,104,7,189
"90926",1090926,94,204,6,304
"90927",1090927,37,68,2,107
"90928",1090928,79,146,25,250
"90929",1090929,131,153,15,299
"90930",1090930,206,72,10,288
"90931",1090931,170,28,6,204
"90932",1090932,79,183,21,283
"90933",1090933,20,58,2,80
"90934",1090934,157,96,14,267
"90935",1090935,146,52,6,204
"90936",1090936,57,118,11,186
"90937",1090937,170,109,9,288
"90938",1090938,41,242,4,287
"90939",1090939,63,194,8,265
"90940",1090940,29,4,2,35
"90941",1090941,102,15,7,124
"90942",1090942,144,134,10,288
"90943",1090943,25,220,1,246
"90944",1090944,69,184,6,259
"90945",1090945,140,121,9,270
"90946",1090946,129,147,10,286
"90947",1090947,96,104,4,204
"90948",1090948,59,84,4,147
"90949",1090949,49,63,8,120
"90950",1090950,163,91,2,256
"90951",1090951,124,95,10,229
"90952",1090952,45,92,2,139
"90953",1090953,171,33,6,210
"90954",1090954,102,86,3,191
"90955",1090955,180,118,22,320
"90956",1090956,98,151,11,260
"90957",1090957,21,160,2,183
"90958",1090958,56,85,3,144
"90959",1090959,113,112,16,241
"90960",1090960,72,165,6,243
"90961",1090961,122,123,3,248
"90962",1090962,226,44,8,278
"90963",1090963,167,62,5,234
"90964",1090964,133,80,11,224
"90965",1090965,152,54,9,215
"90966",1090966,80,207,10,297
"90967",1090967,133,116,10,259
"90968",1090968,45,39,5,89
"90969",1090969,193,51,6,250
"90970",1090970,81,18,3,102
"90971",1090971,163,54,14,231
"90972",1090972,55,0,1,56
"90973",1090973,205,23,8,236
"90974",1090974,127,63,14,204
"90975",1090975,43,126,1,170
"90976",1090976,40,33,2,75
"90977",1090977,105,155,14,274
"90978",1090978,167,92,5,264
"90979",1090979,130,67,9,206
"90980",1090980,43,233,5,281
"90981",1090981,80,108,2,190
"90982",1090982,103,150,12,265
"90983",1090983,175,64,3,242
"90984",1090984,77,252,14,343
"90985",1090985,87,41,7,135
"90986",1090986,85,205,12,302
"90987",1090987,218,28,7,253
"90988",1090988,128,20,2,150
"90989",1090989,177,37,5,219
"90990",1090990,30,13,1,44
"90991",1090991,65,129,7,201
"90992",1090992,24,15,1,40
"90993",1090993,19,202,3,224
"90994",1090994,53,189,2,244
"90995",1090995,72,94,8,174
"90996",1090996,74,141,9,224
"90997",1090997,155,14,1,170
"90998",1090998,200,112,13,325
"90999",1090999,143,19,9,171
"91000",1091000,119,84,5,208
"91001",1091001,143,79,9,231
"91002",1091002,66,55,2,123
"91003",1091003,131,140,12,283
"91004",1091004,123,93,3,219
"91005",1091005,20,337,1,358
"91006",1091006,50,5,1,56
"91007",1091007,79,201,8,288
"91008",1091008,49,251,2,302
"91009",1091009,40,188,2,230
"91010",1091010,228,23,6,257
"91011",1091011,58,27,2,87
"91012",1091012,25,159,2,186
"91013",1091013,88,123,7,218
"91014",1091014,175,136,18,329
"91015",1091015,205,14,6,225
"91016",1091016,175,123,11,309
"91017",1091017,74,28,3,105
"91018",1091018,53,258,3,314
"91019",1091019,70,191,4,265
"91020",1091020,140,54,4,198
"91021",1091021,154,122,11,287
"91022",1091022,107,30,6,143
"91023",1091023,216,51,8,275
"91024",1091024,105,117,3,225
"91025",1091025,111,112,2,225
"91026",1091026,214,18,5,237
"91027",1091027,194,41,13,248
"91028",1091028,117,67,6,190
"91029",1091029,53,21,3,77
"91030",1091030,16,6,0,22
"91031",1091031,7,47,0,54
"91032",1091032,124,108,4,236
"91033",1091033,70,12,4,86
"91034",1091034,55,236,5,296
"91035",1091035,231,67,18,316
"91036",1091036,63,26,5,94
"91037",1091037,204,52,10,266
"91038",1091038,143,136,7,286
"91039",1091039,156,85,14,255
"91040",1091040,102,177,8,287
"91041",1091041,124,47,5,176
"91042",1091042,94,46,12,152
"91043",1091043,105,32,5,142
"91044",1091044,213,186,11,410
"91045",1091045,114,174,12,300
"91046",1091046,155,38,5,198
"91047",1091047,80,176,13,269
"91048",1091048,177,127,8,312
"91049",1091049,211,76,24,311
"91050",1091050,39,171,15,225
"91051",1091051,139,152,15,306
"91052",1091052,194,97,12,303
"91053",1091053,80,178,2,260
"91054",1091054,149,140,3,292
"91055",1091055,184,48,21,253
"91056",1091056,107,167,13,287
"91057",1091057,51,170,1,222
"91058",1091058,84,177,12,273
"91059",1091059,131,162,12,305
"91060",1091060,48,255,8,311
"91061",1091061,33,68,1,102
"91062",1091062,76,182,2,260
"91063",1091063,148,90,8,246
"91064",1091064,114,97,15,226
"91065",1091065,138,135,2,275
"91066",1091066,144,114,11,269
"91067",1091067,32,268,3,303
"91068",1091068,166,67,10,243
"91069",1091069,244,22,9,275
"91070",1091070,15,282,12,309
"91071",1091071,177,41,9,227
"91072",1091072,93,8,2,103
"91073",1091073,43,212,4,259
"91074",1091074,70,96,7,173
"91075",1091075,147,34,4,185
"91076",1091076,172,258,25,455
"91077",1091077,13,90,0,103
"91078",1091078,98,13,8,119
"91079",1091079,24,167,4,195
"91080",1091080,251,56,10,317
"91081",1091081,144,90,5,239
"91082",1091082,74,198,6,278
"91083",1091083,147,37,6,190
"91084",1091084,46,112,3,161
"91085",1091085,39,76,2,117
"91086",1091086,82,173,23,278
"91087",1091087,53,241,9,303
"91088",1091088,152,132,3,287
"91089",1091089,79,94,14,187
"91090",1091090,166,35,8,209
"91091",1091091,28,147,7,182
"91092",1091092,118,177,12,307
"91093",1091093,41,210,4,255
"91094",1091094,163,115,10,288
"91095",1091095,80,213,21,314
"91096",1091096,177,60,8,245
"91097",1091097,22,5,1,28
"91098",1091098,137,40,8,185
"91099",1091099,62,140,4,206
"91100",1091100,238,22,6,266
"91101",1091101,90,52,5,147
"91102",1091102,106,91,7,204
"91103",1091103,125,20,2,147
"91104",1091104,113,198,21,332
"91105",1091105,98,56,6,160
"91106",1091106,156,150,6,312
"91107",1091107,135,78,3,216
"91108",1091108,163,94,3,260
"91109",1091109,242,36,4,282
"91110",1091110,168,72,16,256
"91111",1091111,80,35,6,121
"91112",1091112,5,122,4,131
"91113",1091113,94,160,26,280
"91114",1091114,168,28,11,207
"91115",1091115,211,29,11,251
"91116",1091116,191,28,8,227
"91117",1091117,61,15,0,76
"91118",1091118,109,165,9,283
"91119",1091119,116,47,5,168
"91120",1091120,192,44,1,237
"91121",1091121,215,79,12,306
"91122",1091122,156,140,14,310
"91123",1091123,18,15,3,36
"91124",1091124,84,109,7,200
"91125",1091125,67,187,5,259
"91126",1091126,113,92,0,205
"91127",1091127,213,110,9,332
"91128",1091128,109,103,1,213
"91129",1091129,70,158,5,233
"91130",1091130,130,102,8,240
"91131",1091131,79,86,12,177
"91132",1091132,153,28,6,187
"91133",1091133,90,111,2,203
"91134",1091134,42,129,6,177
"91135",1091135,135,92,10,237
"91136",1091136,104,146,6,256
"91137",1091137,147,74,13,234
"91138",1091138,105,155,10,270
"91139",1091139,114,109,12,235
"91140",1091140,98,27,5,130
"91141",1091141,48,199,7,254
"91142",1091142,59,109,17,185
"91143",1091143,41,204,2,247
"91144",1091144,211,31,9,251
"91145",1091145,43,122,2,167
"91146",1091146,51,148,5,204
"91147",1091147,90,82,6,178
"91148",1091148,95,149,17,261
"91149",1091149,138,96,9,243
"91150",1091150,82,98,6,186
"91151",1091151,147,77,15,239
"91152",1091152,126,43,3,172
"91153",1091153,111,53,8,172
"91154",1091154,106,106,7,219
"91155",1091155,42,91,4,137
"91156",1091156,167,68,6,241
"91157",1091157,75,125,8,208
"91158",1091158,42,255,1,298
"91159",1091159,68,193,7,268
"91160",1091160,63,173,9,245
"91161",1091161,51,29,4,84
"91162",1091162,194,219,44,457
"91163",1091163,122,90,9,221
"91164",1091164,59,16,4,79
"91165",1091165,177,66,9,252
"91166",1091166,118,104,16,238
"91167",1091167,188,76,16,280
"91168",1091168,193,63,12,268
"91169",1091169,54,37,4,95
"91170",1091170,192,57,8,257
"91171",1091171,38,106,6,150
"91172",1091172,192,113,16,321
"91173",1091173,118,64,7,189
"91174",1091174,34,166,4,204
"91175",1091175,60,42,7,109
"91176",1091176,78,248,7,333
"91177",1091177,126,63,5,194
"91178",1091178,50,243,0,293
"91179",1091179,111,1,2,114
"91180",1091180,245,31,3,279
"91181",1091181,136,93,14,243
"91182",1091182,120,153,8,281
"91183",1091183,23,91,2,116
"91184",1091184,111,132,14,257
"91185",1091185,177,118,4,299
"91186",1091186,15,124,1,140
"91187",1091187,18,43,5,66
"91188",1091188,85,8,2,95
"91189",1091189,106,23,6,135
"91190",1091190,54,247,9,310
"91191",1091191,100,119,8,227
"91192",1091192,120,117,9,246
"91193",1091193,16,23,0,39
"91194",1091194,127,70,12,209
"91195",1091195,214,28,20,262
"91196",1091196,101,189,4,294
"91197",1091197,195,65,4,264
"91198",1091198,32,103,11,146
"91199",1091199,86,112,3,201
"91200",1091200,50,276,7,333
"91201",1091201,98,115,6,219
"91202",1091202,42,270,4,316
"91203",1091203,65,210,16,291
"91204",1091204,205,35,13,253
"91205",1091205,78,244,11,333
"91206",1091206,179,86,21,286
"91207",1091207,122,75,8,205
"91208",1091208,97,191,11,299
"91209",1091209,68,233,4,305
"91210",1091210,169,9,6,184
"91211",1091211,151,61,6,218
"91212",1091212,32,83,3,118
"91213",1091213,135,71,9,215
"91214",1091214,66,256,9,331
"91215",1091215,73,190,13,276
"91216",1091216,103,162,16,281
"91217",1091217,49,259,8,316
"91218",1091218,119,59,12,190
"91219",1091219,108,44,8,160
"91220",1091220,63,232,10,305
"91221",1091221,103,129,5,237
"91222",1091222,6,29,2,37
"91223",1091223,90,144,5,239
"91224",1091224,85,173,8,266
"91225",1091225,139,149,11,299
"91226",1091226,160,26,5,191
"91227",1091227,65,47,7,119
"91228",1091228,152,57,4,213
"91229",1091229,100,179,16,295
"91230",1091230,42,252,18,312
"91231",1091231,45,18,4,67
"91232",1091232,59,146,9,214
"91233",1091233,75,52,3,130
"91234",1091234,47,242,12,301
"91235",1091235,19,38,1,58
"91236",1091236,37,112,4,153
"91237",1091237,68,209,20,297
"91238",1091238,83,216,4,303
"91239",1091239,202,85,10,297
"91240",1091240,163,48,4,215
"91241",1091241,82,130,13,225
"91242",1091242,118,147,9,274
"91243",1091243,184,28,4,216
"91244",1091244,191,27,4,222
"91245",1091245,91,1,2,94
"91246",1091246,168,27,1,196
"91247",1091247,247,16,3,266
"91248",1091248,2,29,1,32
"91249",1091249,42,20,4,66
"91250",1091250,75,171,15,261
"91251",1091251,24,181,7,212
"91252",1091252,88,196,8,292
"91253",1091253,173,39,4,216
"91254",1091254,177,60,7,244
"91255",1091255,158,31,8,197
"91256",1091256,148,28,5,181
"91257",1091257,170,49,8,227
"91258",1091258,68,106,7,181
"91259",1091259,55,89,7,151
"91260",1091260,84,18,2,104
"91261",1091261,97,187,8,292
"91262",1091262,71,251,3,325
"91263",1091263,181,37,5,223
"91264",1091264,73,239,4,316
"91265",1091265,124,68,1,193
"91266",1091266,46,45,1,92
"91267",1091267,195,60,5,260
"91268",1091268,136,34,2,172
"91269",1091269,48,253,2,303
"91270",1091270,140,63,11,214
"91271",1091271,101,87,12,200
"91272",1091272,260,44,10,314
"91273",1091273,140,76,15,231
"91274",1091274,63,149,3,215
"91275",1091275,53,146,6,205
"91276",1091276,146,47,10,203
"91277",1091277,99,132,9,240
"91278",1091278,95,159,6,260
"91279",1091279,155,89,9,253
"91280",1091280,27,254,4,285
"91281",1091281,22,252,2,276
"91282",1091282,139,144,14,297
"91283",1091283,173,113,15,301
"91284",1091284,135,74,3,212
"91285",1091285,94,21,7,122
"91286",1091286,109,41,2,152
"91287",1091287,107,33,3,143
"91288",1091288,60,200,8,268
"91289",1091289,162,35,5,202
"91290",1091290,94,46,12,152
"91291",1091291,185,85,11,281
"91292",1091292,74,20,5,99
"91293",1091293,84,88,3,175
"91294",1091294,11,0,0,11
"91295",1091295,68,159,16,243
"91296",1091296,91,77,11,179
"91297",1091297,32,7,1,40
"91298",1091298,117,85,11,213
"91299",1091299,85,243,13,341
"91300",1091300,135,109,6,250
"91301",1091301,111,76,15,202
"91302",1091302,213,28,3,244
"91303",1091303,81,89,7,177
"91304",1091304,169,27,7,203
"91305",1091305,192,53,14,259
"91306",1091306,225,24,3,252
"91307",1091307,42,197,2,241
"91308",1091308,112,72,17,201
"91309",1091309,106,141,19,266
"91310",1091310,66,136,9,211
"91311",1091311,48,237,12,297
"91312",1091312,173,117,7,297
"91313",1091313,123,49,8,180
"91314",1091314,184,20,7,211
"91315",1091315,112,131,6,249
"91316",1091316,128,147,7,282
"91317",1091317,106,45,6,157
"91318",1091318,236,19,9,264
"91319",1091319,199,21,4,224
"91320",1091320,138,141,18,297
"91321",1091321,143,40,6,189
"91322",1091322,49,16,2,67
"91323",1091323,151,14,12,177
"91324",1091324,212,22,13,247
"91325",1091325,136,139,18,293
"91326",1091326,86,189,5,280
"91327",1091327,57,161,14,232
"91328",1091328,67,127,12,206
"91329",1091329,37,10,1,48
"91330",1091330,140,76,8,224
"91331",1091331,117,42,2,161
"91332",1091332,224,74,12,310
"91333",1091333,41,137,3,181
"91334",1091334,117,115,5,237
"91335",1091335,161,5,1,167
"91336",1091336,79,92,6,177
"91337",1091337,92,53,2,147
"91338",1091338,57,188,10,255
"91339",1091339,39,102,11,152
"91340",1091340,87,136,9,232
"91341",1091341,42,201,6,249
"91342",1091342,206,68,14,288
"91343",1091343,172,31,7,210
"91344",1091344,65,124,25,214
"91345",1091345,51,133,1,185
"91346",1091346,186,202,9,397
"91347",1091347,128,123,13,264
"91348",1091348,109,59,7,175
"91349",1091349,195,71,6,272
"91350",1091350,51,209,8,268
"91351",1091351,8,5,0,13
"91352",1091352,210,106,20,336
"91353",1091353,155,22,5,182
"91354",1091354,32,137,5,174
"91355",1091355,27,189,8,224
"91356",1091356,144,69,8,221
"91357",1091357,5,17,1,23
"91358",1091358,104,303,17,424
"91359",1091359,158,30,10,198
"91360",1091360,128,107,9,244
"91361",1091361,21,196,1,218
"91362",1091362,105,43,6,154
"91363",1091363,41,195,20,256
"91364",1091364,100,190,3,293
"91365",1091365,86,53,12,151
"91366",1091366,111,147,15,273
"91367",1091367,0,17,1,18
"91368",1091368,208,69,10,287
"91369",1091369,170,60,12,242
"91370",1091370,200,14,2,216
"91371",1091371,54,31,3,88
"91372",1091372,193,28,6,227
"91373",1091373,222,7,3,232
"91374",1091374,58,151,6,215
"91375",1091375,239,42,10,291
"91376",1091376,50,209,11,270
"91377",1091377,132,89,2,223
"91378",1091378,77,178,9,264
"91379",1091379,46,156,5,207
"91380",1091380,140,123,16,279
"91381",1091381,146,71,9,226
"91382",1091382,204,87,15,306
"91383",1091383,6,1,0,7
"91384",1091384,121,82,13,216
"91385",1091385,84,81,9,174
"91386",1091386,138,51,5,194
"91387",1091387,107,131,5,243
"91388",1091388,119,189,13,321
"91389",1091389,139,1,3,143
"91390",1091390,74,182,1,257
"91391",1091391,13,190,3,206
"91392",1091392,31,265,8,304
"91393",1091393,240,75,14,329
"91394",1091394,89,125,0,214
"91395",1091395,75,32,6,113
"91396",1091396,46,208,12,266
"91397",1091397,81,187,17,285
"91398",1091398,139,119,7,265
"91399",1091399,115,92,2,209
"91400",1091400,253,16,9,278
"91401",1091401,46,8,1,55
"91402",1091402,147,52,2,201
"91403",1091403,13,291,11,315
"91404",1091404,91,151,6,248
"91405",1091405,125,52,3,180
"91406",1091406,26,75,2,103
"91407",1091407,66,139,4,209
"91408",1091408,121,35,7,163
"91409",1091409,117,164,20,301
"91410",1091410,74,224,10,308
"91411",1091411,194,48,16,258
"91412",1091412,50,88,2,140
"91413",1091413,57,271,2,330
"91414",1091414,31,244,6,281
"91415",1091415,173,44,19,236
"91416",1091416,47,232,3,282
"91417",1091417,20,42,4,66
"91418",1091418,159,122,23,304
"91419",1091419,147,11,3,161
"91420",1091420,175,53,4,232
"91421",1091421,140,57,12,209
"91422",1091422,153,105,6,264
"91423",1091423,187,90,12,289
"91424",1091424,100,126,10,236
"91425",1091425,232,26,3,261
"91426",1091426,68,37,5,110
"91427",1091427,30,243,13,286
"91428",1091428,128,126,10,264
"91429",1091429,137,26,0,163
"91430",1091430,117,59,3,179
"91431",1091431,86,122,13,221
"91432",1091432,123,108,18,249
"91433",1091433,213,49,31,293
"91434",1091434,58,221,10,289
"91435",1091435,70,248,7,325
"91436",1091436,112,106,8,226
"91437",1091437,165,116,11,292
"91438",1091438,46,190,13,249
"91439",1091439,149,176,6,331
"91440",1091440,120,60,4,184
"91441",1091441,201,91,15,307
"91442",1091442,210,70,16,296
"91443",1091443,68,42,4,114
"91444",1091444,113,190,9,312
"91445",1091445,9,8,1,18
"91446",1091446,158,80,14,252
"91447",1091447,10,4,1,15
"91448",1091448,148,177,20,345
"91449",1091449,143,88,5,236
"91450",1091450,169,55,8,232
"91451",1091451,38,71,7,116
"91452",1091452,107,148,2,257
"91453",1091453,58,135,2,195
"91454",1091454,24,344,4,372
"91455",1091455,182,29,3,214
"91456",1091456,203,21,2,226
"91457",1091457,25,223,3,251
"91458",1091458,191,124,8,323
"91459",1091459,95,109,8,212
"91460",1091460,103,167,21,291
"91461",1091461,218,19,7,244
"91462",1091462,88,163,6,257
"91463",1091463,42,216,5,263
"91464",1091464,105,114,9,228
"91465",1091465,59,32,1,92
"91466",1091466,39,148,5,192
"91467",1091467,11,10,1,22
"91468",1091468,61,169,32,262
"91469",1091469,105,138,13,256
"91470",1091470,189,26,3,218
"91471",1091471,103,111,13,227
"91472",1091472,214,58,4,276
"91473",1091473,13,92,4,109
"91474",1091474,173,55,18,246
"91475",1091475,128,53,9,190
"91476",1091476,129,65,8,202
"91477",1091477,4,84,1,89
"91478",1091478,150,24,6,180
"91479",1091479,95,189,7,291
"91480",1091480,160,58,8,226
"91481",1091481,174,49,11,234
"91482",1091482,159,64,10,233
"91483",1091483,218,47,15,280
"91484",1091484,43,186,7,236
"91485",1091485,116,134,10,260
"91486",1091486,136,43,8,187
"91487",1091487,85,118,1,204
"91488",1091488,94,247,11,352
"91489",1091489,126,34,2,162
"91490",1091490,279,24,2,305
"91491",1091491,70,117,2,189
"91492",1091492,16,186,2,204
"91493",1091493,171,6,0,177
"91494",1091494,74,87,16,177
"91495",1091495,146,60,6,212
"91496",1091496,113,38,8,159
"91497",1091497,111,100,3,214
"91498",1091498,188,42,3,233
"91499",1091499,145,90,11,246
"91500",1091500,157,160,6,323
"91501",1091501,255,11,7,273
"91502",1091502,123,113,5,241
"91503",1091503,85,94,6,185
"91504",1091504,181,124,10,315
"91505",1091505,105,124,8,237
"91506",1091506,141,51,7,199
"91507",1091507,40,123,12,175
"91508",1091508,72,176,5,253
"91509",1091509,188,41,5,234
"91510",1091510,151,112,31,294
"91511",1091511,154,25,2,181
"91512",1091512,146,121,4,271
"91513",1091513,131,151,14,296
"91514",1091514,160,88,7,255
"91515",1091515,169,36,11,216
"91516",1091516,74,123,3,200
"91517",1091517,107,39,10,156
"91518",1091518,171,79,13,263
"91519",1091519,121,94,17,232
"91520",1091520,65,114,4,183
"91521",1091521,92,125,7,224
"91522",1091522,55,231,6,292
"91523",1091523,48,133,4,185
"91524",1091524,57,211,13,281
"91525",1091525,203,66,25,294
"91526",1091526,143,110,7,260
"91527",1091527,88,189,18,295
"91528",1091528,124,170,14,308
"91529",1091529,149,73,2,224
"91530",1091530,25,83,0,108
"91531",1091531,65,213,10,288
"91532",1091532,174,100,14,288
"91533",1091533,55,171,15,241
"91534",1091534,102,215,6,323
"91535",1091535,169,91,9,269
"91536",1091536,33,20,2,55
"91537",1091537,110,72,16,198
"91538",1091538,172,23,7,202
"91539",1091539,123,68,6,197
"91540",1091540,146,16,5,167
"91541",1091541,35,287,6,328
"91542",1091542,59,163,25,247
"91543",1091543,117,106,19,242
"91544",1091544,170,43,4,217
"91545",1091545,180,23,8,211
"91546",1091546,38,206,5,249
"91547",1091547,79,99,15,193
"91548",1091548,45,235,10,290
"91549",1091549,196,32,5,233
"91550",1091550,231,73,13,317
"91551",1091551,55,246,4,305
"91552",1091552,193,33,7,233
"91553",1091553,187,32,1,220
"91554",1091554,83,109,4,196
"91555",1091555,133,161,7,301
"91556",1091556,37,155,3,195
"91557",1091557,135,70,0,205
"91558",1091558,64,83,4,151
"91559",1091559,107,148,15,270
"91560",1091560,18,181,4,203
"91561",1091561,7,85,1,93
"91562",1091562,40,198,15,253
"91563",1091563,208,62,9,279
"91564",1091564,138,23,4,165
"91565",1091565,70,199,6,275
"91566",1091566,182,116,12,310
"91567",1091567,122,61,13,196
"91568",1091568,156,149,17,322
"91569",1091569,147,63,0,210
"91570",1091570,146,66,9,221
"91571",1091571,129,52,4,185
"91572",1091572,74,73,3,150
"91573",1091573,202,56,3,261
"91574",1091574,120,201,21,342
"91575",1091575,156,146,9,311
"91576",1091576,25,155,5,185
"91577",1091577,123,148,10,281
"91578",1091578,61,245,15,321
"91579",1091579,96,205,20,321
"91580",1091580,93,79,9,181
"91581",1091581,138,48,8,194
"91582",1091582,99,59,11,169
"91583",1091583,112,53,8,173
"91584",1091584,130,85,10,225
"91585",1091585,128,49,5,182
"91586",1091586,87,21,1,109
"91587",1091587,19,7,1,27
"91588",1091588,181,84,6,271
"91589",1091589,126,122,3,251
"91590",1091590,20,158,4,182
"91591",1091591,88,99,10,197
"91592",1091592,140,94,5,239
"91593",1091593,169,31,4,204
"91594",1091594,72,110,3,185
"91595",1091595,176,51,3,230
"91596",1091596,66,136,17,219
"91597",1091597,66,21,1,88
"91598",1091598,121,62,1,184
"91599",1091599,67,58,14,139
"91600",1091600,177,83,22,282
"91601",1091601,34,137,3,174
"91602",1091602,175,91,10,276
"91603",1091603,89,14,6,109
"91604",1091604,81,164,9,254
"91605",1091605,4,84,1,89
"91606",1091606,132,67,5,204
"91607",1091607,78,201,24,303
"91608",1091608,211,31,12,254
"91609",1091609,83,91,1,175
"91610",1091610,172,19,8,199
"91611",1091611,157,40,3,200
"91612",1091612,156,132,13,301
"91613",1091613,130,51,10,191
"91614",1091614,115,151,12,278
"91615",1091615,39,245,4,288
"91616",1091616,7,81,0,88
"91617",1091617,33,260,10,303
"91618",1091618,152,122,20,294
"91619",1091619,150,44,9,203
"91620",1091620,164,39,11,214
"91621",1091621,225,37,6,268
"91622",1091622,152,80,15,247
"91623",1091623,124,53,4,181
"91624",1091624,47,166,4,217
"91625",1091625,249,218,34,501
"91626",1091626,235,17,1,253
"91627",1091627,10,77,1,88
"91628",1091628,32,238,6,276
"91629",1091629,58,248,6,312
"91630",1091630,159,25,4,188
"91631",1091631,61,39,5,105
"91632",1091632,141,66,9,216
"91633",1091633,53,121,6,180
"91634",1091634,55,84,2,141
"91635",1091635,171,33,11,215
"91636",1091636,57,246,9,312
"91637",1091637,138,112,20,270
"91638",1091638,99,45,1,145
"91639",1091639,93,91,5,189
"91640",1091640,17,7,0,24
"91641",1091641,36,146,2,184
"91642",1091642,180,114,13,307
"91643",1091643,60,205,11,276
"91644",1091644,134,126,13,273
"91645",1091645,179,49,17,245
"91646",1091646,77,81,10,168
"91647",1091647,183,44,17,244
"91648",1091648,51,113,15,179
"91649",1091649,71,249,10,330
"91650",1091650,78,67,4,149
"91651",1091651,85,109,12,206
"91652",1091652,128,105,5,238
"91653",1091653,122,91,8,221
"91654",1091654,200,38,11,249
"91655",1091655,152,48,8,208
"91656",1091656,81,184,6,271
"91657",1091657,137,25,3,165
"91658",1091658,64,202,6,272
"91659",1091659,111,8,3,122
"91660",1091660,196,25,7,228
"91661",1091661,169,100,5,274
"91662",1091662,211,25,12,248
"91663",1091663,43,189,6,238
"91664",1091664,132,131,16,279
"91665",1091665,22,165,6,193
"91666",1091666,3,2,0,5
"91667",1091667,23,186,2,211
"91668",1091668,172,70,9,251
"91669",1091669,97,84,6,187
"91670",1091670,151,80,19,250
"91671",1091671,244,47,10,301
"91672",1091672,53,242,4,299
"91673",1091673,115,153,10,278
"91674",1091674,7,13,0,20
"91675",1091675,81,20,4,105
"91676",1091676,79,170,11,260
"91677",1091677,89,48,2,139
"91678",1091678,120,24,9,153
"91679",1091679,165,25,3,193
"91680",1091680,70,183,5,258
"91681",1091681,164,71,8,243
"91682",1091682,82,217,4,303
"91683",1091683,179,42,9,230
"91684",1091684,205,89,9,303
"91685",1091685,166,82,12,260
"91686",1091686,101,202,22,325
"91687",1091687,140,126,18,284
"91688",1091688,167,51,1,219
"91689",1091689,102,71,4,177
"91690",1091690,54,67,3,124
"91691",1091691,157,13,3,173
"91692",1091692,72,145,13,230
"91693",1091693,61,117,6,184
"91694",1091694,61,218,7,286
"91695",1091695,114,96,14,224
"91696",1091696,54,172,4,230
"91697",1091697,138,69,11,218
"91698",1091698,148,29,6,183
"91699",1091699,141,19,7,167
"91700",1091700,92,36,4,132
"91701",1091701,30,55,1,86
"91702",1091702,60,126,22,208
"91703",1091703,115,109,15,239
"91704",1091704,156,159,8,323
"91705",1091705,29,22,3,54
"91706",1091706,220,17,11,248
"91707",1091707,155,65,10,230
"91708",1091708,179,14,7,200
"91709",1091709,86,131,5,222
"91710",1091710,157,68,13,238
"91711",1091711,111,228,10,349
"91712",1091712,82,200,12,294
"91713",1091713,164,44,3,211
"91714",1091714,44,247,5,296
"91715",1091715,144,110,7,261
"91716",1091716,187,26,12,225
"91717",1091717,198,31,9,238
"91718",1091718,132,114,18,264
"91719",1091719,126,117,15,258
"91720",1091720,33,200,7,240
"91721",1091721,185,58,8,251
"91722",1091722,63,166,3,232
"91723",1091723,136,94,8,238
"91724",1091724,148,51,7,206
"91725",1091725,130,142,14,286
"91726",1091726,49,240,7,296
"91727",1091727,185,135,9,329
"91728",1091728,102,140,5,247
"91729",1091729,112,66,17,195
"91730",1091730,63,114,16,193
"91731",1091731,166,137,23,326
"91732",1091732,94,180,11,285
"91733",1091733,139,91,4,234
"91734",1091734,175,49,16,240
"91735",1091735,37,271,5,313
"91736",1091736,193,21,4,218
"91737",1091737,225,22,4,251
"91738",1091738,176,97,20,293
"91739",1091739,215,75,7,297
"91740",1091740,193,26,12,231
"91741",1091741,123,89,4,216
"91742",1091742,34,42,0,76
"91743",1091743,163,50,3,216
"91744",1091744,72,162,6,240
"91745",1091745,84,179,8,271
"91746",1091746,55,256,4,315
"91747",1091747,56,242,6,304
"91748",1091748,149,123,7,279
"91749",1091749,53,190,2,245
"91750",1091750,93,101,7,201
"91751",1091751,92,58,5,155
"91752",1091752,4,3,0,7
"91753",1091753,0,7,1,8
"91754",1091754,34,211,6,251
"91755",1091755,79,64,3,146
"91756",1091756,201,72,17,290
"91757",1091757,65,271,12,348
"91758",1091758,106,58,7,171
"91759",1091759,61,138,13,212
"91760",1091760,191,43,9,243
"91761",1091761,17,64,5,86
"91762",1091762,117,144,13,274
"91763",1091763,83,174,11,268
"91764",1091764,93,180,11,284
"91765",1091765,115,72,11,198
"91766",1091766,50,84,2,136
"91767",1091767,41,174,3,218
"91768",1091768,190,81,18,289
"91769",1091769,32,3,0,35
"91770",1091770,88,118,8,214
"91771",1091771,166,87,17,270
"91772",1091772,55,226,8,289
"91773",1091773,47,242,8,297
"91774",1091774,119,12,4,135
"91775",1091775,80,72,10,162
"91776",1091776,238,88,16,342
"91777",1091777,119,17,3,139
"91778",1091778,116,148,11,275
"91779",1091779,74,218,11,303
"91780",1091780,20,83,3,106
"91781",1091781,32,297,8,337
"91782",1091782,118,37,4,159
"91783",1091783,110,90,13,213
"91784",1091784,29,91,2,122
"91785",1091785,86,147,3,236
"91786",1091786,44,87,7,138
"91787",1091787,193,47,7,247
"91788",1091788,217,43,12,272
"91789",1091789,41,152,14,207
"91790",1091790,143,40,15,198
"91791",1091791,48,61,9,118
"91792",1091792,101,139,6,246
"91793",1091793,163,34,5,202
"91794",1091794,199,15,4,218
"91795",1091795,80,75,19,174
"91796",1091796,59,73,8,140
"91797",1091797,127,78,7,212
"91798",1091798,67,45,12,124
"91799",1091799,61,250,6,317
"91800",1091800,146,58,14,218
"91801",1091801,139,26,8,173
"91802",1091802,17,133,4,154
"91803",1091803,106,40,2,148
"91804",1091804,163,24,5,192
"91805",1091805,73,183,9,265
"91806",1091806,66,120,7,193
"91807",1091807,130,69,14,213
"91808",1091808,106,177,11,294
"91809",1091809,12,38,5,55
"91810",1091810,137,45,9,191
"91811",1091811,164,103,12,279
"91812",1091812,116,36,6,158
"91813",1091813,31,192,5,228
"91814",1091814,114,128,7,249
"91815",1091815,36,188,8,232
"91816",1091816,183,61,9,253
"91817",1091817,112,104,14,230
"91818",1091818,44,201,4,249
"91819",1091819,130,49,4,183
"91820",1091820,202,42,5,249
"91821",1091821,85,110,14,209
"91822",1091822,38,148,5,191
"91823",1091823,156,54,5,215
"91824",1091824,148,25,2,175
"91825",1091825,43,153,5,201
"91826",1091826,255,4,3,262
"91827",1091827,155,68,11,234
"91828",1091828,111,21,2,134
"91829",1091829,78,21,4,103
"91830",1091830,22,118,4,144
"91831",1091831,79,132,9,220
"91832",1091832,63,117,15,195
"91833",1091833,14,17,1,32
"91834",1091834,213,59,6,278
"91835",1091835,182,77,15,274
"91836",1091836,207,76,23,306
"91837",1091837,154,22,1,177
"91838",1091838,67,180,9,256
"91839",1091839,158,111,11,280
"91840",1091840,29,43,1,73
"91841",1091841,133,145,15,293
"91842",1091842,87,30,15,132
"91843",1091843,178,132,11,321
"91844",1091844,171,45,6,222
"91845",1091845,103,103,12,218
"91846",1091846,75,131,1,207
"91847",1091847,32,221,9,262
"91848",1091848,46,158,2,206
"91849",1091849,68,223,11,302
"91850",1091850,137,114,10,261
"91851",1091851,32,99,4,135
"91852",1091852,77,152,3,232
"91853",1091853,63,112,9,184
"91854",1091854,76,89,16,181
"91855",1091855,68,167,11,246
"91856",1091856,148,46,10,204
"91857",1091857,133,49,11,193
"91858",1091858,210,49,9,268
"91859",1091859,69,115,3,187
"91860",1091860,101,92,14,207
"91861",1091861,163,79,10,252
"91862",1091862,1,1,0,2
"91863",1091863,55,209,1,265
"91864",1091864,158,85,5,248
"91865",1091865,113,23,9,145
"91866",1091866,248,23,4,275
"91867",1091867,29,36,4,69
"91868",1091868,94,17,3,114
"91869",1091869,212,25,6,243
"91870",1091870,121,29,5,155
"91871",1091871,209,52,10,271
"91872",1091872,85,156,25,266
"91873",1091873,83,179,6,268
"91874",1091874,91,145,11,247
"91875",1091875,53,225,18,296
"91876",1091876,199,90,3,292
"91877",1091877,62,196,2,260
"91878",1091878,79,119,16,214
"91879",1091879,110,108,11,229
"91880",1091880,85,223,8,316
"91881",1091881,96,248,13,357
"91882",1091882,168,53,7,228
"91883",1091883,188,144,16,348
"91884",1091884,59,256,10,325
"91885",1091885,50,148,6,204
"91886",1091886,146,128,7,281
"91887",1091887,102,57,7,166
"91888",1091888,167,34,1,202
"91889",1091889,18,3,0,21
"91890",1091890,160,108,10,278
"91891",1091891,129,140,3,272
"91892",1091892,74,200,6,280
"91893",1091893,157,45,9,211
"91894",1091894,57,192,2,251
"91895",1091895,52,231,11,294
"91896",1091896,176,97,9,282
"91897",1091897,51,277,11,339
"91898",1091898,178,68,12,258
"91899",1091899,154,109,13,276
"91900",1091900,79,195,13,287
"91901",1091901,129,141,7,277
"91902",1091902,160,62,7,229
"91903",1091903,184,73,12,269
"91904",1091904,78,65,2,145
"91905",1091905,170,54,7,231
"91906",1091906,48,143,7,198
"91907",1091907,62,244,3,309
"91908",1091908,122,69,9,200
"91909",1091909,25,13,2,40
"91910",1091910,193,86,20,299
"91911",1091911,169,49,9,227
"91912",1091912,197,39,9,245
"91913",1091913,21,139,13,173
"91914",1091914,164,86,3,253
"91915",1091915,50,212,9,271
"91916",1091916,73,197,15,285
"91917",1091917,223,38,11,272
"91918",1091918,135,49,13,197
"91919",1091919,155,91,5,251
"91920",1091920,40,53,8,101
"91921",1091921,128,15,18,161
"91922",1091922,127,108,11,246
"91923",1091923,47,76,2,125
"91924",1091924,175,33,16,224
"91925",1091925,165,72,14,251
"91926",1091926,55,188,10,253
"91927",1091927,241,53,10,304
"91928",1091928,94,51,8,153
"91929",1091929,63,201,3,267
"91930",1091930,66,202,7,275
"91931",1091931,110,193,6,309
"91932",1091932,94,183,19,296
"91933",1091933,53,188,14,255
"91934",1091934,140,10,4,154
"91935",1091935,100,50,12,162
"91936",1091936,138,41,5,184
"91937",1091937,237,11,4,252
"91938",1091938,149,91,7,247
"91939",1091939,41,216,4,261
"91940",1091940,72,203,1,276
"91941",1091941,97,35,2,134
"91942",1091942,161,129,21,311
"91943",1091943,56,219,2,277
"91944",1091944,146,92,6,244
"91945",1091945,55,201,0,256
"91946",1091946,88,107,11,206
"91947",1091947,34,158,6,198
"91948",1091948,107,12,1,120
"91949",1091949,81,229,9,319
"91950",1091950,184,35,6,225
"91951",1091951,144,38,5,187
"91952",1091952,56,22,4,82
"91953",1091953,43,208,4,255
"91954",1091954,98,185,12,295
"91955",1091955,105,160,13,278
"91956",1091956,65,187,7,259
"91957",1091957,29,111,11,151
"91958",1091958,164,44,11,219
"91959",1091959,6,13,0,19
"91960",1091960,17,75,1,93
"91961",1091961,52,191,4,247
"91962",1091962,169,112,31,312
"91963",1091963,96,74,2,172
"91964",1091964,160,52,15,227
"91965",1091965,178,39,5,222
"91966",1091966,127,95,9,231
"91967",1091967,232,63,13,308
"91968",1091968,74,187,7,268
"91969",1091969,26,257,3,286
"91970",1091970,162,112,7,281
"91971",1091971,79,107,2,188
"91972",1091972,99,39,2,140
"91973",1091973,177,63,8,248
"91974",1091974,219,89,8,316
"91975",1091975,46,99,2,147
"91976",1091976,200,28,8,236
"91977",1091977,146,68,5,219
"91978",1091978,28,123,11,162
"91979",1091979,270,36,9,315
"91980",1091980,71,180,6,257
"91981",1091981,108,154,10,272
"91982",1091982,129,25,5,159
"91983",1091983,158,128,21,307
"91984",1091984,172,49,4,225
"91985",1091985,80,27,2,109
"91986",1091986,115,32,11,158
"91987",1091987,40,223,0,263
"91988",1091988,92,193,6,291
"91989",1091989,149,147,9,305
"91990",1091990,135,28,4,167
"91991",1091991,106,42,15,163
"91992",1091992,158,67,15,240
"91993",1091993,201,28,5,234
"91994",1091994,75,35,4,114
"91995",1091995,59,243,21,323
"91996",1091996,21,5,0,26
"91997",1091997,124,179,1,304
"91998",1091998,49,52,7,108
"91999",1091999,95,71,7,173
"92000",1092000,161,99,9,269
"92001",1092001,87,200,13,300
"92002",1092002,210,13,6,229
"92003",1092003,167,33,5,205
"92004",1092004,83,159,4,246
"92005",1092005,53,26,1,80
"92006",1092006,235,73,5,313
"92007",1092007,30,208,1,239
"92008",1092008,212,47,9,268
"92009",1092009,85,147,16,248
"92010",1092010,74,11,1,86
"92011",1092011,57,31,3,91
"92012",1092012,143,137,11,291
"92013",1092013,162,34,7,203
"92014",1092014,99,214,9,322
"92015",1092015,97,129,1,227
"92016",1092016,91,256,9,356
"92017",1092017,70,106,4,180
"92018",1092018,149,82,4,235
"92019",1092019,160,11,4,175
"92020",1092020,74,137,6,217
"92021",1092021,80,255,16,351
"92022",1092022,128,112,11,251
"92023",1092023,59,225,0,284
"92024",1092024,119,32,3,154
"92025",1092025,29,331,1,361
"92026",1092026,230,24,4,258
"92027",1092027,27,289,3,319
"92028",1092028,3,4,0,7
"92029",1092029,88,193,14,295
"92030",1092030,34,0,2,36
"92031",1092031,89,211,4,304
"92032",1092032,97,185,13,295
"92033",1092033,123,115,11,249
"92034",1092034,143,74,10,227
"92035",1092035,152,91,17,260
"92036",1092036,15,26,1,42
"92037",1092037,118,196,9,323
"92038",1092038,125,123,20,268
"92039",1092039,230,39,8,277
"92040",1092040,5,17,0,22
"92041",1092041,155,45,9,209
"92042",1092042,149,158,16,323
"92043",1092043,207,309,34,550
"92044",1092044,39,103,4,146
"92045",1092045,81,136,6,223
"92046",1092046,93,146,26,265
"92047",1092047,213,63,15,291
"92048",1092048,47,261,2,310
"92049",1092049,202,37,8,247
"92050",1092050,132,158,13,303
"92051",1092051,263,41,13,317
"92052",1092052,68,231,11,310
"92053",1092053,82,216,17,315
"92054",1092054,72,217,7,296
"92055",1092055,176,10,0,186
"92056",1092056,146,66,10,222
"92057",1092057,89,70,4,163
"92058",1092058,250,31,6,287
"92059",1092059,160,102,12,274
"92060",1092060,244,26,5,275
"92061",1092061,141,24,10,175
"92062",1092062,53,232,1,286
"92063",1092063,165,13,6,184
"92064",1092064,101,104,12,217
"92065",1092065,179,129,6,314
"92066",1092066,12,193,4,209
"92067",1092067,44,153,4,201
"92068",1092068,145,32,7,184
"92069",1092069,105,75,7,187
"92070",1092070,40,0,1,41
"92071",1092071,78,152,14,244
"92072",1092072,64,140,7,211
"92073",1092073,82,221,3,306
"92074",1092074,217,43,7,267
"92075",1092075,99,45,6,150
"92076",1092076,54,117,5,176
"92077",1092077,6,26,2,34
"92078",1092078,3,12,0,15
"92079",1092079,55,91,18,164
"92080",1092080,207,41,5,253
"92081",1092081,130,104,10,244
"92082",1092082,185,85,5,275
"92083",1092083,128,28,5,161
"92084",1092084,130,102,5,237
"92085",1092085,101,64,1,166
"92086",1092086,132,153,6,291
"92087",1092087,23,136,3,162
"92088",1092088,69,206,7,282
"92089",1092089,120,175,10,305
"92090",1092090,38,244,1,283
"92091",1092091,55,271,7,333
"92092",1092092,134,85,2,221
"92093",1092093,33,155,15,203
"92094",1092094,6,11,0,17
"92095",1092095,103,35,3,141
"92096",1092096,138,41,5,184
"92097",1092097,36,113,1,150
"92098",1092098,94,47,10,151
"92099",1092099,32,155,4,191
"92100",1092100,155,18,4,177
"92101",1092101,164,58,5,227
"92102",1092102,190,37,4,231
"92103",1092103,160,65,4,229
"92104",1092104,54,135,1,190
"92105",1092105,75,39,6,120
"92106",1092106,187,39,9,235
"92107",1092107,63,162,11,236
"92108",1092108,9,4,1,14
"92109",1092109,68,149,20,237
"92110",1092110,170,49,9,228
"92111",1092111,27,211,4,242
"92112",1092112,206,24,4,234
"92113",1092113,125,48,13,186
"92114",1092114,48,269,3,320
"92115",1092115,106,85,2,193
"92116",1092116,53,166,11,230
"92117",1092117,52,147,10,209
"92118",1092118,210,40,9,259
"92119",1092119,50,134,10,194
"92120",1092120,117,63,6,186
"92121",1092121,134,85,3,222
"92122",1092122,29,211,6,246
"92123",1092123,26,264,9,299
"92124",1092124,96,214,15,325
"92125",1092125,89,47,5,141
"92126",1092126,149,61,8,218
"92127",1092127,230,60,12,302
"92128",1092128,217,15,4,236
"92129",1092129,76,125,5,206
"92130",1092130,23,183,6,212
"92131",1092131,55,41,11,107
"92132",1092132,169,133,9,311
"92133",1092133,82,36,7,125
"92134",1092134,52,192,0,244
"92135",1092135,111,178,13,302
"92136",1092136,191,15,7,213
"92137",1092137,89,38,9,136
"92138",1092138,3,8,0,11
"92139",1092139,88,12,2,102
"92140",1092140,168,33,6,207
"92141",1092141,55,88,9,152
"92142",1092142,89,180,11,280
"92143",1092143,83,94,5,182
"92144",1092144,153,32,2,187
"92145",1092145,155,161,11,327
"92146",1092146,46,190,10,246
"92147",1092147,60,243,3,306
"92148",1092148,50,115,2,167
"92149",1092149,110,49,10,169
"92150",1092150,84,113,9,206
"92151",1092151,170,99,19,288
"92152",1092152,82,111,6,199
"92153",1092153,99,213,18,330
"92154",1092154,54,114,1,169
"92155",1092155,158,78,6,242
"92156",1092156,151,134,13,298
"92157",1092157,149,144,9,302
"92158",1092158,86,96,4,186
"92159",1092159,53,229,9,291
"92160",1092160,131,18,5,154
"92161",1092161,65,96,7,168
"92162",1092162,139,43,3,185
"92163",1092163,70,167,13,250
"92164",1092164,198,48,15,261
"92165",1092165,120,52,15,187
"92166",1092166,68,150,15,233
"92167",1092167,63,248,3,314
"92168",1092168,130,49,7,186
"92169",1092169,60,214,8,282
"92170",1092170,79,75,11,165
"92171",1092171,47,164,4,215
"92172",1092172,164,36,15,215
"92173",1092173,148,116,3,267
"92174",1092174,68,226,7,301
"92175",1092175,55,251,3,309
"92176",1092176,153,97,10,260
"92177",1092177,33,62,1,96
"92178",1092178,78,99,2,179
"92179",1092179,320,1,10,331
"92180",1092180,253,9,6,268
"92181",1092181,35,191,1,227
"92182",1092182,174,48,11,233
"92183",1092183,112,143,6,261
"92184",1092184,36,232,3,271
"92185",1092185,72,180,8,260
"92186",1092186,39,30,3,72
"92187",1092187,131,35,4,170
"92188",1092188,194,66,9,269
"92189",1092189,119,80,12,211
"92190",1092190,68,170,3,241
"92191",1092191,59,113,17,189
"92192",1092192,74,64,7,145
"92193",1092193,199,66,15,280
"92194",1092194,160,36,10,206
"92195",1092195,119,77,8,204
"92196",1092196,144,76,10,230
"92197",1092197,124,70,10,204
"92198",1092198,187,45,5,237
"92199",1092199,84,90,5,179
"92200",1092200,83,88,12,183
"92201",1092201,106,41,5,152
"92202",1092202,171,55,6,232
"92203",1092203,53,130,6,189
"92204",1092204,153,54,3,210
"92205",1092205,144,95,6,245
"92206",1092206,154,155,15,324
"92207",1092207,99,177,9,285
"92208",1092208,159,119,12,290
"92209",1092209,177,78,5,260
"92210",1092210,41,32,2,75
"92211",1092211,152,173,15,340
"92212",1092212,131,152,8,291
"92213",1092213,89,67,1,157
"92214",1092214,102,20,5,127
"92215",1092215,135,90,4,229
"92216",1092216,179,31,7,217
"92217",1092217,15,28,1,44
"92218",1092218,65,186,4,255
"92219",1092219,82,148,8,238
"92220",1092220,149,102,12,263
"92221",1092221,100,46,11,157
"92222",1092222,75,221,20,316
"92223",1092223,57,184,7,248
"92224",1092224,178,52,3,233
"92225",1092225,237,107,15,359
"92226",1092226,51,252,4,307
"92227",1092227,121,178,15,314
"92228",1092228,70,221,4,295
"92229",1092229,160,27,2,189
"92230",1092230,127,121,7,255
"92231",1092231,62,141,13,216
"92232",1092232,12,140,0,152
"92233",1092233,2,20,0,22
"92234",1092234,22,217,4,243
"92235",1092235,160,27,2,189
"92236",1092236,99,154,13,266
"92237",1092237,65,192,17,274
"92238",1092238,27,140,9,176
"92239",1092239,52,20,8,80
"92240",1092240,59,43,4,106
"92241",1092241,101,145,8,254
"92242",1092242,99,130,5,234
"92243",1092243,24,80,7,111
"92244",1092244,135,37,5,177
"92245",1092245,45,249,2,296
"92246",1092246,27,23,1,51
"92247",1092247,17,42,3,62
"92248",1092248,180,130,13,323
"92249",1092249,105,163,12,280
"92250",1092250,125,17,5,147
"92251",1092251,41,213,1,255
"92252",1092252,188,60,6,254
"92253",1092253,88,105,5,198
"92254",1092254,136,57,2,195
"92255",1092255,110,100,7,217
"92256",1092256,52,212,22,286
"92257",1092257,14,131,1,146
"92258",1092258,168,30,4,202
"92259",1092259,153,12,2,167
"92260",1092260,39,198,3,240
"92261",1092261,176,72,1,249
"92262",1092262,145,148,31,324
"92263",1092263,173,105,8,286
"92264",1092264,63,100,6,169
"92265",1092265,107,66,10,183
"92266",1092266,185,83,23,291
"92267",1092267,62,141,8,211
"92268",1092268,123,52,5,180
"92269",1092269,147,48,17,212
"92270",1092270,232,49,14,295
"92271",1092271,191,84,5,280
"92272",1092272,102,52,15,169
"92273",1092273,168,52,11,231
"92274",1092274,110,128,17,255
"92275",1092275,145,41,15,201
"92276",1092276,21,252,2,275
"92277",1092277,62,151,11,224
"92278",1092278,142,73,6,221
"92279",1092279,108,167,19,294
"92280",1092280,54,111,2,167
"92281",1092281,174,7,4,185
"92282",1092282,24,196,2,222
"92283",1092283,11,20,0,31
"92284",1092284,87,169,15,271
"92285",1092285,82,131,6,219
"92286",1092286,43,199,2,244
"92287",1092287,220,92,18,330
"92288",1092288,151,112,13,276
"92289",1092289,87,66,2,155
"92290",1092290,205,61,11,277
"92291",1092291,132,19,4,155
"92292",1092292,44,159,10,213
"92293",1092293,38,114,7,159
"92294",1092294,138,5,3,146
"92295",1092295,188,54,2,244
"92296",1092296,178,95,7,280
"92297",1092297,206,11,5,222
"92298",1092298,93,188,8,289
"92299",1092299,150,138,9,297
"92300",1092300,72,105,2,179
"92301",1092301,60,215,7,282
"92302",1092302,162,89,10,261
"92303",1092303,162,99,13,274
"92304",1092304,103,154,8,265
"92305",1092305,108,62,3,173
"92306",1092306,154,14,8,176
"92307",1092307,98,137,9,244
"92308",1092308,129,125,17,271
"92309",1092309,174,79,15,268
"92310",1092310,135,158,17,310
"92311",1092311,71,196,4,271
"92312",1092312,20,159,2,181
"92313",1092313,133,26,1,160
"92314",1092314,56,185,7,248
"92315",1092315,229,35,7,271
"92316",1092316,65,53,2,120
"92317",1092317,136,132,12,280
"92318",1092318,97,94,19,210
"92319",1092319,74,209,26,309
"92320",1092320,170,53,8,231
"92321",1092321,137,179,17,333
"92322",1092322,106,112,13,231
"92323",1092323,78,84,12,174
"92324",1092324,65,221,4,290
"92325",1092325,99,39,5,143
"92326",1092326,51,232,2,285
"92327",1092327,192,112,8,312
"92328",1092328,180,20,5,205
"92329",1092329,60,203,6,269
"92330",1092330,173,34,2,209
"92331",1092331,85,185,17,287
"92332",1092332,72,200,3,275
"92333",1092333,181,33,9,223
"92334",1092334,143,36,5,184
"92335",1092335,132,120,3,255
"92336",1092336,78,55,2,135
"92337",1092337,136,52,11,199
"92338",1092338,67,227,6,300
"92339",1092339,37,141,3,181
"92340",1092340,121,97,8,226
"92341",1092341,59,120,6,185
"92342",1092342,114,37,4,155
"92343",1092343,80,185,9,274
"92344",1092344,102,113,19,234
"92345",1092345,143,115,4,262
"92346",1092346,145,57,8,210
"92347",1092347,110,52,10,172
"92348",1092348,74,162,4,240
"92349",1092349,130,100,2,232
"92350",1092350,147,250,31,428
"92351",1092351,119,60,8,187
"92352",1092352,127,86,3,216
"92353",1092353,199,20,4,223
"92354",1092354,147,65,4,216
"92355",1092355,67,90,0,157
"92356",1092356,27,246,4,277
"92357",1092357,81,14,2,97
"92358",1092358,44,197,3,244
"92359",1092359,21,202,4,227
"92360",1092360,65,68,7,140
"92361",1092361,149,105,3,257
"92362",1092362,253,41,5,299
"92363",1092363,32,128,9,169
"92364",1092364,245,26,7,278
"92365",1092365,174,75,5,254
"92366",1092366,19,38,2,59
"92367",1092367,105,182,23,310
"92368",1092368,161,7,5,173
"92369",1092369,42,157,8,207
"92370",1092370,122,58,7,187
"92371",1092371,156,148,21,325
"92372",1092372,35,139,8,182
"92373",1092373,8,85,4,97
"92374",1092374,48,51,4,103
"92375",1092375,19,186,10,215
"92376",1092376,78,81,2,161
"92377",1092377,54,40,4,98
"92378",1092378,71,13,1,85
"92379",1092379,64,213,5,282
"92380",1092380,30,175,4,209
"92381",1092381,80,186,7,273
"92382",1092382,1,53,2,56
"92383",1092383,202,31,7,240
"92384",1092384,39,108,11,158
"92385",1092385,21,98,1,120
"92386",1092386,221,73,5,299
"92387",1092387,12,3,0,15
"92388",1092388,181,135,11,327
"92389",1092389,74,130,4,208
"92390",1092390,78,191,5,274
"92391",1092391,22,154,7,183
"92392",1092392,162,47,4,213
"92393",1092393,261,42,12,315
"92394",1092394,137,119,10,266
"92395",1092395,116,132,15,263
"92396",1092396,44,236,4,284
"92397",1092397,79,184,7,270
"92398",1092398,166,52,4,222
"92399",1092399,32,255,4,291
"92400",1092400,100,68,4,172
"92401",1092401,61,233,17,311
"92402",1092402,138,9,1,148
"92403",1092403,71,0,0,71
"92404",1092404,56,210,6,272
"92405",1092405,33,153,6,192
"92406",1092406,191,116,16,323
"92407",1092407,13,9,2,24
"92408",1092408,55,197,10,262
"92409",1092409,106,39,8,153
"92410",1092410,107,43,9,159
"92411",1092411,168,125,10,303
"92412",1092412,6,38,0,44
"92413",1092413,129,78,4,211
"92414",1092414,42,235,5,282
"92415",1092415,191,47,15,253
"92416",1092416,216,99,7,322
"92417",1092417,124,59,4,187
"92418",1092418,178,27,6,211
"92419",1092419,141,58,8,207
"92420",1092420,94,62,6,162
"92421",1092421,145,139,10,294
"92422",1092422,26,255,4,285
"92423",1092423,15,59,2,76
"92424",1092424,157,66,14,237
"92425",1092425,39,263,5,307
"92426",1092426,182,71,12,265
"92427",1092427,83,148,6,237
"92428",1092428,27,0,0,27
"92429",1092429,64,154,23,241
"92430",1092430,77,78,7,162
"92431",1092431,49,143,6,198
"92432",1092432,25,146,6,177
"92433",1092433,76,216,10,302
"92434",1092434,66,111,12,189
"92435",1092435,2,8,0,10
"92436",1092436,138,97,8,243
"92437",1092437,154,87,3,244
"92438",1092438,154,170,4,328
"92439",1092439,234,32,5,271
"92440",1092440,8,0,0,8
"92441",1092441,55,135,10,200
"92442",1092442,42,104,6,152
"92443",1092443,82,167,9,258
"92444",1092444,240,24,8,272
"92445",1092445,195,101,15,311
"92446",1092446,221,68,16,305
"92447",1092447,53,165,6,224
"92448",1092448,202,20,6,228
"92449",1092449,117,63,6,186
"92450",1092450,149,26,8,183
"92451",1092451,175,74,10,259
"92452",1092452,96,138,12,246
"92453",1092453,20,17,2,39
"92454",1092454,90,30,5,125
"92455",1092455,9,1,1,11
"92456",1092456,61,211,13,285
"92457",1092457,139,2,4,145
"92458",1092458,102,71,7,180
"92459",1092459,95,76,5,176
"92460",1092460,156,105,7,268
"92461",1092461,7,20,1,28
"92462",1092462,147,32,5,184
"92463",1092463,185,63,8,256
"92464",1092464,45,25,8,78
"92465",1092465,121,115,4,240
"92466",1092466,61,157,6,224
"92467",1092467,113,185,6,304
"92468",1092468,11,202,7,220
"92469",1092469,153,106,7,266
"92470",1092470,147,111,4,262
"92471",1092471,113,14,1,128
"92472",1092472,251,1,1,253
"92473",1092473,106,55,15,176
"92474",1092474,78,148,29,255
"92475",1092475,25,265,7,297
"92476",1092476,125,52,2,179
"92477",1092477,48,57,11,116
"92478",1092478,132,97,14,243
"92479",1092479,205,56,14,275
"92480",1092480,133,51,15,199
"92481",1092481,193,59,7,259
"92482",1092482,28,111,1,140
"92483",1092483,52,250,6,308
"92484",1092484,8,21,0,29
"92485",1092485,69,186,7,262
"92486",1092486,83,77,12,172
"92487",1092487,78,144,3,225
"92488",1092488,176,27,11,214
"92489",1092489,119,119,8,246
"92490",1092490,57,200,5,262
"92491",1092491,150,21,6,177
"92492",1092492,54,153,2,209
"92493",1092493,110,219,10,339
"92494",1092494,167,50,14,231
"92495",1092495,193,24,13,230
"92496",1092496,175,82,5,262
"92497",1092497,93,71,6,170
"92498",1092498,121,180,14,315
"92499",1092499,68,150,8,226
"92500",1092500,106,80,5,191
"92501",1092501,72,165,6,243
"92502",1092502,80,77,19,176
"92503",1092503,75,181,5,261
"92504",1092504,98,161,9,268
"92505",1092505,85,13,1,99
"92506",1092506,57,28,1,86
"92507",1092507,83,54,3,140
"92508",1092508,153,83,12,248
"92509",1092509,217,17,12,246
"92510",1092510,85,100,9,194
"92511",1092511,25,264,0,289
"92512",1092512,54,197,9,260
"92513",1092513,17,7,1,25
"92514",1092514,157,84,16,257
"92515",1092515,82,13,4,99
"92516",1092516,53,274,10,337
"92517",1092517,133,47,4,184
"92518",1092518,55,158,7,220
"92519",1092519,8,241,2,251
"92520",1092520,117,279,21,417
"92521",1092521,34,81,8,123
"92522",1092522,58,266,19,343
"92523",1092523,100,212,3,315
"92524",1092524,73,143,4,220
"92525",1092525,203,67,4,274
"92526",1092526,130,112,12,254
"92527",1092527,213,33,0,246
"92528",1092528,172,57,8,237
"92529",1092529,113,180,9,302
"92530",1092530,122,42,4,168
"92531",1092531,103,144,9,256
"92532",1092532,57,268,1,326
"92533",1092533,11,48,3,62
"92534",1092534,87,178,15,280
"92535",1092535,196,72,18,286
"92536",1092536,197,78,15,290
"92537",1092537,119,52,8,179
"92538",1092538,152,137,15,304
"92539",1092539,34,53,0,87
"92540",1092540,108,72,2,182
"92541",1092541,41,258,1,300
"92542",1092542,10,44,3,57
"92543",1092543,156,150,6,312
"92544",1092544,39,104,2,145
"92545",1092545,170,37,14,221
"92546",1092546,78,152,6,236
"92547",1092547,191,29,4,224
"92548",1092548,65,256,7,328
"92549",1092549,121,100,3,224
"92550",1092550,118,141,5,264
"92551",1092551,123,180,19,322
"92552",1092552,89,186,6,281
"92553",1092553,183,52,10,245
"92554",1092554,106,58,7,171
"92555",1092555,116,30,1,147
"92556",1092556,80,71,14,165
"92557",1092557,63,3,1,67
"92558",1092558,25,138,2,165
"92559",1092559,81,206,10,297
"92560",1092560,29,167,5,201
"92561",1092561,111,36,11,158
"92562",1092562,162,112,15,289
"92563",1092563,22,252,7,281
"92564",1092564,157,87,12,256
"92565",1092565,201,32,4,237
"92566",1092566,129,141,9,279
"92567",1092567,117,60,5,182
"92568",1092568,99,36,8,143
"92569",1092569,147,112,10,269
"92570",1092570,145,19,2,166
"92571",1092571,82,154,11,247
"92572",1092572,144,114,11,269
"92573",1092573,96,107,14,217
"92574",1092574,35,35,2,72
"92575",1092575,49,179,14,242
"92576",1092576,139,140,22,301
"92577",1092577,119,115,4,238
"92578",1092578,51,155,4,210
"92579",1092579,90,0,0,90
"92580",1092580,26,299,4,329
"92581",1092581,157,22,4,183
"92582",1092582,107,159,10,276
"92583",1092583,105,200,7,312
"92584",1092584,191,48,1,240
"92585",1092585,37,95,6,138
"92586",1092586,96,3,1,100
"92587",1092587,86,126,8,220
"92588",1092588,166,46,6,218
"92589",1092589,84,166,4,254
"92590",1092590,158,39,5,202
"92591",1092591,80,78,3,161
"92592",1092592,19,198,4,221
"92593",1092593,198,91,14,303
"92594",1092594,111,34,0,145
"92595",1092595,53,197,3,253
"92596",1092596,143,75,5,223
"92597",1092597,46,151,11,208
"92598",1092598,145,40,11,196
"92599",1092599,98,121,9,228
"92600",1092600,60,59,4,123
"92601",1092601,50,170,8,228
"92602",1092602,104,25,1,130
"92603",1092603,130,90,13,233
"92604",1092604,129,117,13,259
"92605",1092605,51,176,5,232
"92606",1092606,162,97,12,271
"92607",1092607,51,66,6,123
"92608",1092608,231,10,2,243
"92609",1092609,35,233,3,271
"92610",1092610,92,150,14,256
"92611",1092611,88,58,5,151
"92612",1092612,204,72,8,284
"92613",1092613,68,76,3,147
"92614",1092614,44,165,6,215
"92615",1092615,190,41,6,237
"92616",1092616,192,67,9,268
"92617",1092617,133,155,10,298
"92618",1092618,44,185,20,249
"92619",1092619,79,64,10,153
"92620",1092620,146,124,10,280
"92621",1092621,148,26,3,177
"92622",1092622,157,45,6,208
"92623",1092623,102,180,9,291
"92624",1092624,101,148,8,257
"92625",1092625,135,60,6,201
"92626",1092626,41,228,6,275
"92627",1092627,111,44,2,157
"92628",1092628,67,212,5,284
"92629",1092629,83,154,27,264
"92630",1092630,162,65,12,239
"92631",1092631,140,91,9,240
"92632",1092632,25,40,4,69
"92633",1092633,153,113,10,276
"92634",1092634,33,12,0,45
"92635",1092635,130,96,6,232
"92636",1092636,176,82,9,267
"92637",1092637,60,134,11,205
"92638",1092638,285,25,7,317
"92639",1092639,40,164,7,211
"92640",1092640,59,90,1,150
"92641",1092641,95,188,6,289
"92642",1092642,79,142,7,228
"92643",1092643,30,276,2,308
"92644",1092644,154,73,14,241
"92645",1092645,123,110,25,258
"92646",1092646,242,31,8,281
"92647",1092647,126,135,18,279
"92648",1092648,150,50,4,204
"92649",1092649,31,108,7,146
"92650",1092650,33,96,3,132
"92651",1092651,95,118,5,218
"92652",1092652,162,58,18,238
"92653",1092653,133,130,11,274
"92654",1092654,148,35,10,193
"92655",1092655,7,3,2,12
"92656",1092656,162,88,15,265
"92657",1092657,102,37,8,147
"92658",1092658,119,112,3,234
"92659",1092659,164,106,17,287
"92660",1092660,198,116,10,324
"92661",1092661,154,62,13,229
"92662",1092662,44,231,7,282
"92663",1092663,90,59,7,156
"92664",1092664,140,133,7,280
"92665",1092665,183,16,3,202
"92666",1092666,87,183,15,285
"92667",1092667,136,142,21,299
"92668",1092668,81,145,14,240
"92669",1092669,226,40,9,275
"92670",1092670,264,31,20,315
"92671",1092671,115,85,4,204
"92672",1092672,32,152,5,189
"92673",1092673,51,226,4,281
"92674",1092674,170,89,10,269
"92675",1092675,73,242,5,320
"92676",1092676,41,25,10,76
"92677",1092677,138,52,5,195
"92678",1092678,92,34,6,132
"92679",1092679,94,50,9,153
"92680",1092680,21,261,8,290
"92681",1092681,48,262,2,312
"92682",1092682,75,64,9,148
"92683",1092683,156,78,5,239
"92684",1092684,100,127,6,233
"92685",1092685,59,181,14,254
"92686",1092686,117,79,4,200
"92687",1092687,77,99,6,182
"92688",1092688,69,101,2,172
"92689",1092689,158,40,11,209
"92690",1092690,81,190,10,281
"92691",1092691,143,81,11,235
"92692",1092692,178,60,12,250
"92693",1092693,67,148,5,220
"92694",1092694,111,50,6,167
"92695",1092695,156,64,5,225
"92696",1092696,55,171,8,234
"92697",1092697,93,80,2,175
"92698",1092698,11,71,1,83
"92699",1092699,117,107,9,233
"92700",1092700,55,35,1,91
"92701",1092701,58,174,11,243
"92702",1092702,92,134,22,248
"92703",1092703,109,69,9,187
"92704",1092704,148,157,9,314
"92705",1092705,62,59,3,124
"92706",1092706,43,250,11,304
"92707",1092707,174,17,5,196
"92708",1092708,212,32,4,248
"92709",1092709,99,96,11,206
"92710",1092710,81,192,3,276
"92711",1092711,182,49,11,242
"92712",1092712,0,0,0,0
"92713",1092713,43,235,9,287
"92714",1092714,248,49,10,307
"92715",1092715,84,112,3,199
"92716",1092716,173,22,8,203
"92717",1092717,69,211,12,292
"92718",1092718,90,137,5,232
"92719",1092719,203,18,7,228
"92720",1092720,123,110,16,249
"92721",1092721,78,174,16,268
"92722",1092722,69,174,3,246
"92723",1092723,108,107,3,218
"92724",1092724,113,112,15,240
"92725",1092725,48,218,7,273
"92726",1092726,82,264,5,351
"92727",1092727,7,0,0,7
"92728",1092728,20,152,9,181
"92729",1092729,198,44,2,244
"92730",1092730,35,260,11,306
"92731",1092731,68,179,6,253
"92732",1092732,192,47,11,250
"92733",1092733,107,4,6,117
"92734",1092734,110,85,4,199
"92735",1092735,177,116,13,306
"92736",1092736,176,16,7,199
"92737",1092737,119,103,5,227
"92738",1092738,47,96,5,148
"92739",1092739,8,117,1,126
"92740",1092740,29,120,12,161
"92741",1092741,180,43,11,234
"92742",1092742,151,71,7,229
"92743",1092743,139,31,6,176
"92744",1092744,49,19,2,70
"92745",1092745,6,6,1,13
"92746",1092746,161,78,10,249
"92747",1092747,78,61,6,145
"92748",1092748,77,216,6,299
"92749",1092749,90,141,14,245
"92750",1092750,152,209,22,383
"92751",1092751,111,111,13,235
"92752",1092752,136,66,8,210
"92753",1092753,16,89,0,105
"92754",1092754,180,82,9,271
"92755",1092755,146,73,12,231
"92756",1092756,139,142,11,292
"92757",1092757,242,29,3,274
"92758",1092758,87,141,3,231
"92759",1092759,124,104,7,235
"92760",1092760,94,136,24,254
"92761",1092761,48,247,5,300
"92762",1092762,79,181,9,269
"92763",1092763,49,15,1,65
"92764",1092764,112,35,7,154
"92765",1092765,27,230,7,264
"92766",1092766,88,20,3,111
"92767",1092767,142,96,5,243
"92768",1092768,85,67,3,155
"92769",1092769,129,56,11,196
"92770",1092770,55,179,6,240
"92771",1092771,139,138,5,282
"92772",1092772,178,33,8,219
"92773",1092773,164,34,9,207
"92774",1092774,13,73,3,89
"92775",1092775,51,84,3,138
"92776",1092776,2,7,0,9
"92777",1092777,144,54,5,203
"92778",1092778,31,198,3,232
"92779",1092779,41,265,7,313
"92780",1092780,32,113,3,148
"92781",1092781,69,48,2,119
"92782",1092782,251,21,3,275
"92783",1092783,55,233,9,297
"92784",1092784,30,231,3,264
"92785",1092785,215,73,13,301
"92786",1092786,239,75,10,324
"92787",1092787,76,184,9,269
"92788",1092788,86,116,4,206
"92789",1092789,184,78,3,265
"92790",1092790,18,19,2,39
"92791",1092791,214,83,13,310
"92792",1092792,124,110,14,248
"92793",1092793,140,48,4,192
"92794",1092794,32,209,12,253
"92795",1092795,147,114,14,275
"92796",1092796,34,274,5,313
"92797",1092797,41,265,5,311
"92798",1092798,224,45,10,279
"92799",1092799,82,244,13,339
"92800",1092800,21,142,4,167
"92801",1092801,82,133,13,228
"92802",1092802,35,201,3,239
"92803",1092803,171,110,10,291
"92804",1092804,97,43,0,140
"92805",1092805,170,88,4,262
"92806",1092806,25,273,2,300
"92807",1092807,82,154,11,247
"92808",1092808,48,244,17,309
"92809",1092809,163,134,12,309
"92810",1092810,16,31,5,52
"92811",1092811,51,120,18,189
"92812",1092812,137,156,20,313
"92813",1092813,39,142,2,183
"92814",1092814,191,16,6,213
"92815",1092815,120,121,2,243
"92816",1092816,70,214,6,290
"92817",1092817,77,102,6,185
"92818",1092818,63,158,2,223
"92819",1092819,216,20,5,241
"92820",1092820,165,46,7,218
"92821",1092821,147,46,9,202
"92822",1092822,158,118,15,291
"92823",1092823,181,36,10,227
"92824",1092824,74,207,6,287
"92825",1092825,17,5,2,24
"92826",1092826,107,55,2,164
"92827",1092827,103,227,25,355
"92828",1092828,51,191,9,251
"92829",1092829,115,23,3,141
"92830",1092830,35,207,3,245
"92831",1092831,112,168,4,284
"92832",1092832,20,14,1,35
"92833",1092833,160,126,5,291
"92834",1092834,100,180,8,288
"92835",1092835,99,73,11,183
"92836",1092836,77,0,0,77
"92837",1092837,94,68,7,169
"92838",1092838,143,83,11,237
"92839",1092839,207,91,9,307
"92840",1092840,85,86,21,192
"92841",1092841,137,33,3,173
"92842",1092842,57,149,9,215
"92843",1092843,113,50,2,165
"92844",1092844,210,30,13,253
"92845",1092845,107,93,8,208
"92846",1092846,7,2,0,9
"92847",1092847,35,301,6,342
"92848",1092848,19,118,0,137
"92849",1092849,151,22,5,178
"92850",1092850,77,101,0,178
"92851",1092851,114,162,10,286
"92852",1092852,144,115,7,266
"92853",1092853,143,72,6,221
"92854",1092854,86,119,6,211
"92855",1092855,109,145,27,281
"92856",1092856,2,14,1,17
"92857",1092857,55,149,23,227
"92858",1092858,71,113,3,187
"92859",1092859,151,84,4,239
"92860",1092860,26,51,1,78
"92861",1092861,61,156,22,239
"92862",1092862,39,202,4,245
"92863",1092863,132,110,5,247
"92864",1092864,29,266,9,304
"92865",1092865,96,111,14,221
"92866",1092866,151,151,3,305
"92867",1092867,177,9,4,190
"92868",1092868,36,109,4,149
"92869",1092869,123,165,18,306
"92870",1092870,46,115,0,161
"92871",1092871,138,87,3,228
"92872",1092872,14,18,2,34
"92873",1092873,141,47,5,193
"92874",1092874,75,188,10,273
"92875",1092875,87,186,8,281
"92876",1092876,225,22,8,255
"92877",1092877,124,84,6,214
"92878",1092878,137,93,7,237
"92879",1092879,123,76,4,203
"92880",1092880,191,32,12,235
"92881",1092881,23,256,9,288
"92882",1092882,62,142,2,206
"92883",1092883,127,99,10,236
"92884",1092884,115,60,5,180
"92885",1092885,37,191,3,231
"92886",1092886,186,53,10,249
"92887",1092887,99,81,2,182
"92888",1092888,175,22,8,205
"92889",1092889,83,139,2,224
"92890",1092890,97,90,12,199
"92891",1092891,87,224,16,327
"92892",1092892,183,106,17,306
"92893",1092893,112,94,15,221
"92894",1092894,201,97,11,309
"92895",1092895,46,46,4,96
"92896",1092896,86,130,2,218
"92897",1092897,132,122,31,285
"92898",1092898,165,57,3,225
"92899",1092899,234,32,8,274
"92900",1092900,63,240,3,306
"92901",1092901,13,71,4,88
"92902",1092902,81,160,3,244
"92903",1092903,35,249,4,288
"92904",1092904,142,98,7,247
"92905",1092905,46,136,4,186
"92906",1092906,70,12,3,85
"92907",1092907,171,58,8,237
"92908",1092908,202,64,17,283
"92909",1092909,113,68,18,199
"92910",1092910,14,26,2,42
"92911",1092911,41,46,3,90
"92912",1092912,49,215,11,275
"92913",1092913,92,86,6,184
"92914",1092914,76,160,14,250
"92915",1092915,68,85,9,162
"92916",1092916,211,13,3,227
"92917",1092917,154,37,4,195
"92918",1092918,205,18,11,234
"92919",1092919,47,28,3,78
"92920",1092920,120,72,9,201
"92921",1092921,114,20,7,141
"92922",1092922,45,58,10,113
"92923",1092923,78,57,4,139
"92924",1092924,176,20,6,202
"92925",1092925,93,38,9,140
"92926",1092926,84,129,5,218
"92927",1092927,180,36,5,221
"92928",1092928,66,202,13,281
"92929",1092929,102,90,10,202
"92930",1092930,30,96,1,127
"92931",1092931,215,22,10,247
"92932",1092932,182,171,11,364
"92933",1092933,175,115,23,313
"92934",1092934,128,145,25,298
"92935",1092935,230,26,7,263
"92936",1092936,198,81,18,297
"92937",1092937,162,85,7,254
"92938",1092938,76,158,26,260
"92939",1092939,212,89,14,315
"92940",1092940,95,57,1,153
"92941",1092941,133,78,9,220
"92942",1092942,52,68,4,124
"92943",1092943,33,130,2,165
"92944",1092944,166,62,8,236
"92945",1092945,35,40,0,75
"92946",1092946,16,14,1,31
"92947",1092947,82,0,0,82
"92948",1092948,107,61,11,179
"92949",1092949,145,145,11,301
"92950",1092950,45,172,4,221
"92951",1092951,154,32,10,196
"92952",1092952,67,78,1,146
"92953",1092953,100,169,18,287
"92954",1092954,110,213,12,335
"92955",1092955,124,105,2,231
"92956",1092956,251,10,6,267
"92957",1092957,72,70,0,142
"92958",1092958,173,30,3,206
"92959",1092959,88,183,9,280
"92960",1092960,42,221,19,282
"92961",1092961,52,13,4,69
"92962",1092962,10,6,0,16
"92963",1092963,39,2,2,43
"92964",1092964,134,156,6,296
"92965",1092965,205,26,9,240
"92966",1092966,146,82,6,234
"92967",1092967,69,138,18,225
"92968",1092968,111,197,10,318
"92969",1092969,62,101,1,164
"92970",1092970,91,121,8,220
"92971",1092971,102,114,11,227
"92972",1092972,110,33,7,150
"92973",1092973,73,168,17,258
"92974",1092974,19,179,8,206
"92975",1092975,226,23,4,253
"92976",1092976,183,17,6,206
"92977",1092977,177,99,11,287
"92978",1092978,78,105,10,193
"92979",1092979,63,103,1,167
"92980",1092980,80,121,1,202
"92981",1092981,47,251,5,303
"92982",1092982,109,102,12,223
"92983",1092983,52,247,3,302
"92984",1092984,122,152,18,292
"92985",1092985,78,157,2,237
"92986",1092986,15,69,5,89
"92987",1092987,136,42,4,182
"92988",1092988,184,48,10,242
"92989",1092989,141,95,14,250
"92990",1092990,45,82,5,132
"92991",1092991,78,183,6,267
"92992",1092992,128,89,5,222
"92993",1092993,102,126,5,233
"92994",1092994,49,204,5,258
"92995",1092995,194,79,7,280
"92996",1092996,135,41,6,182
"92997",1092997,107,148,16,271
"92998",1092998,84,156,13,253
"92999",1092999,98,88,5,191
"93000",1093000,125,159,10,294
"93001",1093001,56,199,5,260
"93002",1093002,52,223,10,285
"93003",1093003,265,49,4,318
"93004",1093004,57,204,29,290
"93005",1093005,91,145,18,254
"93006",1093006,113,121,3,237
"93007",1093007,17,13,1,31
"93008",1093008,39,35,2,76
"93009",1093009,62,232,3,297
"93010",1093010,35,54,2,91
"93011",1093011,172,39,8,219
"93012",1093012,27,250,4,281
"93013",1093013,99,110,3,212
"93014",1093014,209,42,9,260
"93015",1093015,83,142,6,231
"93016",1093016,140,127,12,279
"93017",1093017,73,60,12,145
"93018",1093018,208,51,8,267
"93019",1093019,144,111,13,268
"93020",1093020,149,131,14,294
"93021",1093021,149,79,20,248
"93022",1093022,47,226,2,275
"93023",1093023,52,140,6,198
"93024",1093024,170,60,3,233
"93025",1093025,148,59,2,209
"93026",1093026,97,144,11,252
"93027",1093027,70,77,3,150
"93028",1093028,107,70,15,192
"93029",1093029,60,171,4,235
"93030",1093030,53,80,5,138
"93031",1093031,53,183,11,247
"93032",1093032,67,190,17,274
"93033",1093033,86,223,9,318
"93034",1093034,163,49,7,219
"93035",1093035,4,5,1,10
"93036",1093036,105,165,12,282
"93037",1093037,153,29,6,188
"93038",1093038,32,317,1,350
"93039",1093039,136,122,14,272
"93040",1093040,155,63,13,231
"93041",1093041,151,36,6,193
"93042",1093042,163,107,11,281
"93043",1093043,121,92,18,231
"93044",1093044,106,40,3,149
"93045",1093045,174,140,6,320
"93046",1093046,171,62,26,259
"93047",1093047,139,78,17,234
"93048",1093048,126,120,7,253
"93049",1093049,33,141,8,182
"93050",1093050,88,18,7,113
"93051",1093051,162,87,5,254
"93052",1093052,50,189,9,248
"93053",1093053,100,39,10,149
"93054",1093054,187,55,4,246
"93055",1093055,120,70,7,197
"93056",1093056,93,114,4,211
"93057",1093057,52,220,9,281
"93058",1093058,198,33,6,237
"93059",1093059,114,61,4,179
"93060",1093060,47,221,4,272
"93061",1093061,39,51,4,94
"93062",1093062,52,211,9,272
"93063",1093063,25,17,1,43
"93064",1093064,119,113,4,236
"93065",1093065,81,21,5,107
"93066",1093066,60,123,11,194
"93067",1093067,117,11,3,131
"93068",1093068,179,16,9,204
"93069",1093069,104,163,11,278
"93070",1093070,184,51,5,240
"93071",1093071,47,80,5,132
"93072",1093072,128,50,4,182
"93073",1093073,27,37,4,68
"93074",1093074,38,242,1,281
"93075",1093075,5,103,2,110
"93076",1093076,149,38,19,206
"93077",1093077,83,17,3,103
"93078",1093078,198,24,10,232
"93079",1093079,40,78,4,122
"93080",1093080,144,45,5,194
"93081",1093081,168,45,4,217
"93082",1093082,44,154,7,205
"93083",1093083,106,167,12,285
"93084",1093084,148,66,9,223
"93085",1093085,6,119,2,127
"93086",1093086,204,33,9,246
"93087",1093087,179,18,6,203
"93088",1093088,85,124,5,214
"93089",1093089,86,63,9,158
"93090",1093090,10,7,1,18
"93091",1093091,50,212,3,265
"93092",1093092,35,73,1,109
"93093",1093093,183,59,12,254
"93094",1093094,20,0,2,22
"93095",1093095,168,58,12,238
"93096",1093096,255,23,4,282
"93097",1093097,196,93,17,306
"93098",1093098,201,28,11,240
"93099",1093099,169,22,5,196
"93100",1093100,278,59,11,348
"93101",1093101,34,19,3,56
"93102",1093102,90,42,9,141
"93103",1093103,63,157,6,226
"93104",1093104,102,160,16,278
"93105",1093105,132,104,3,239
"93106",1093106,44,187,16,247
"93107",1093107,46,226,4,276
"93108",1093108,122,61,7,190
"93109",1093109,68,206,3,277
"93110",1093110,51,6,8,65
"93111",1093111,159,63,5,227
"93112",1093112,198,51,7,256
"93113",1093113,202,26,7,235
"93114",1093114,71,140,18,229
"93115",1093115,43,22,1,66
"93116",1093116,127,105,8,240
"93117",1093117,72,9,1,82
"93118",1093118,29,145,5,179
"93119",1093119,73,201,2,276
"93120",1093120,36,170,1,207
"93121",1093121,47,70,7,124
"93122",1093122,182,121,16,319
"93123",1093123,179,33,7,219
"93124",1093124,94,152,16,262
"93125",1093125,123,207,12,342
"93126",1093126,85,43,6,134
"93127",1093127,203,73,7,283
"93128",1093128,76,160,8,244
"93129",1093129,6,2,1,9
"93130",1093130,34,195,11,240
"93131",1093131,187,47,8,242
"93132",1093132,163,29,28,220
"93133",1093133,14,101,3,118
"93134",1093134,46,235,3,284
"93135",1093135,46,231,2,279
"93136",1093136,121,60,5,186
"93137",1093137,54,147,8,209
"93138",1093138,177,15,4,196
"93139",1093139,53,48,2,103
"93140",1093140,107,53,4,164
"93141",1093141,59,174,24,257
"93142",1093142,145,91,9,245
"93143",1093143,148,66,8,222
"93144",1093144,241,21,10,272
"93145",1093145,17,1,0,18
"93146",1093146,92,121,11,224
"93147",1093147,91,94,13,198
"93148",1093148,46,20,1,67
"93149",1093149,74,69,7,150
"93150",1093150,93,85,9,187
"93151",1093151,135,103,10,248
"93152",1093152,211,25,4,240
"93153",1093153,115,157,7,279
"93154",1093154,144,157,3,304
"93155",1093155,84,43,5,132
"93156",1093156,98,167,11,276
"93157",1093157,167,61,3,231
"93158",1093158,171,98,9,278
"93159",1093159,50,192,4,246
"93160",1093160,202,62,6,270
"93161",1093161,95,140,21,256
"93162",1093162,125,97,11,233
"93163",1093163,98,146,25,269
"93164",1093164,69,111,6,186
"93165",1093165,137,60,10,207
"93166",1093166,129,85,12,226
"93167",1093167,123,76,9,208
"93168",1093168,157,127,9,293
"93169",1093169,97,94,9,200
"93170",1093170,25,175,0,200
"93171",1093171,197,23,9,229
"93172",1093172,61,232,12,305
"93173",1093173,67,22,2,91
"93174",1093174,130,14,1,145
"93175",1093175,146,83,7,236
"93176",1093176,98,67,6,171
"93177",1093177,204,43,16,263
"93178",1093178,247,15,5,267
"93179",1093179,170,97,21,288
"93180",1093180,28,173,1,202
"93181",1093181,20,0,1,21
"93182",1093182,101,182,5,288
"93183",1093183,141,75,13,229
"93184",1093184,90,95,15,200
"93185",1093185,11,264,0,275
"93186",1093186,70,17,1,88
"93187",1093187,183,16,5,204
"93188",1093188,39,248,8,295
"93189",1093189,64,279,6,349
"93190",1093190,74,100,2,176
"93191",1093191,142,56,8,206
"93192",1093192,68,194,29,291
"93193",1093193,86,114,6,206
"93194",1093194,37,71,2,110
"93195",1093195,139,157,8,304
"93196",1093196,81,257,9,347
"93197",1093197,9,2,0,11
"93198",1093198,81,94,9,184
"93199",1093199,60,119,6,185
"93200",1093200,52,173,8,233
"93201",1093201,22,231,3,256
"93202",1093202,184,62,2,248
"93203",1093203,86,95,6,187
"93204",1093204,139,148,5,292
"93205",1093205,140,79,4,223
"93206",1093206,130,66,8,204
"93207",1093207,165,13,6,184
"93208",1093208,150,52,13,215
"93209",1093209,82,200,8,290
"93210",1093210,87,57,2,146
"93211",1093211,40,25,1,66
"93212",1093212,197,112,11,320
"93213",1093213,143,107,6,256
"93214",1093214,146,19,7,172
"93215",1093215,30,237,3,270
"93216",1093216,7,6,0,13
"93217",1093217,166,153,6,325
"93218",1093218,119,105,10,234
"93219",1093219,47,27,3,77
"93220",1093220,196,29,13,238
"93221",1093221,145,73,4,222
"93222",1093222,154,141,19,314
"93223",1093223,133,162,7,302
"93224",1093224,194,48,13,255
"93225",1093225,180,69,15,264
"93226",1093226,117,71,14,202
"93227",1093227,91,96,7,194
"93228",1093228,53,215,18,286
"93229",1093229,58,236,5,299
"93230",1093230,63,150,9,222
"93231",1093231,21,4,3,28
"93232",1093232,129,137,11,277
"93233",1093233,111,132,14,257
"93234",1093234,87,92,22,201
"93235",1093235,36,218,7,261
"93236",1093236,118,61,1,180
"93237",1093237,148,60,6,214
"93238",1093238,32,249,5,286
"93239",1093239,58,239,8,305
"93240",1093240,166,80,6,252
"93241",1093241,56,38,5,99
"93242",1093242,117,153,17,287
"93243",1093243,212,30,8,250
"93244",1093244,168,97,10,275
"93245",1093245,158,100,4,262
"93246",1093246,260,2,9,271
"93247",1093247,44,173,4,221
"93248",1093248,162,100,16,278
"93249",1093249,53,251,3,307
"93250",1093250,137,125,13,275
"93251",1093251,67,192,3,262
"93252",1093252,120,108,16,244
"93253",1093253,155,53,13,221
"93254",1093254,209,54,14,277
"93255",1093255,82,82,5,169
"93256",1093256,121,80,5,206
"93257",1093257,236,16,9,261
"93258",1093258,201,97,15,313
"93259",1093259,172,69,12,253
"93260",1093260,170,150,5,325
"93261",1093261,17,55,3,75
"93262",1093262,147,31,4,182
"93263",1093263,192,107,20,319
"93264",1093264,133,56,7,196
"93265",1093265,15,4,0,19
"93266",1093266,130,41,2,173
"93267",1093267,256,63,10,329
"93268",1093268,63,183,11,257
"93269",1093269,161,136,11,308
"93270",1093270,25,212,2,239
"93271",1093271,233,106,17,356
"93272",1093272,124,47,5,176
"93273",1093273,89,127,14,230
"93274",1093274,155,57,3,215
"93275",1093275,150,7,7,164
"93276",1093276,130,79,10,219
"93277",1093277,150,107,7,264
"93278",1093278,197,14,9,220
"93279",1093279,150,120,5,275
"93280",1093280,126,125,12,263
"93281",1093281,175,46,7,228
"93282",1093282,144,189,13,346
"93283",1093283,98,32,5,135
"93284",1093284,121,41,7,169
"93285",1093285,62,123,14,199
"93286",1093286,71,69,3,143
"93287",1093287,90,116,14,220
"93288",1093288,132,122,14,268
"93289",1093289,138,63,8,209
"93290",1093290,49,85,4,138
"93291",1093291,155,22,7,184
"93292",1093292,13,11,0,24
"93293",1093293,135,126,13,274
"93294",1093294,87,106,11,204
"93295",1093295,97,51,6,154
"93296",1093296,15,34,1,50
"93297",1093297,143,93,10,246
"93298",1093298,171,17,8,196
"93299",1093299,110,116,6,232
"93300",1093300,138,77,14,229
"93301",1093301,180,88,22,290
"93302",1093302,184,130,9,323
"93303",1093303,112,57,6,175
"93304",1093304,82,25,4,111
"93305",1093305,143,108,15,266
"93306",1093306,38,72,7,117
"93307",1093307,138,34,5,177
"93308",1093308,111,88,10,209
"93309",1093309,57,28,5,90
"93310",1093310,52,232,6,290
"93311",1093311,57,145,6,208
"93312",1093312,173,39,3,215
"93313",1093313,142,33,12,187
"93314",1093314,45,211,7,263
"93315",1093315,4,31,1,36
"93316",1093316,96,183,12,291
"93317",1093317,12,7,0,19
"93318",1093318,27,39,1,67
"93319",1093319,195,75,17,287
"93320",1093320,13,64,0,77
"93321",1093321,6,0,1,7
"93322",1093322,26,181,5,212
"93323",1093323,22,6,4,32
"93324",1093324,54,150,8,212
"93325",1093325,108,8,2,118
"93326",1093326,130,33,10,173
"93327",1093327,191,32,12,235
"93328",1093328,149,129,7,285
"93329",1093329,52,230,2,284
"93330",1093330,130,41,4,175
"93331",1093331,117,115,9,241
"93332",1093332,167,104,18,289
"93333",1093333,138,97,7,242
"93334",1093334,46,237,4,287
"93335",1093335,161,130,7,298
"93336",1093336,222,47,14,283
"93337",1093337,86,121,11,218
"93338",1093338,227,19,6,252
"93339",1093339,110,101,5,216
"93340",1093340,170,85,5,260
"93341",1093341,206,28,4,238
"93342",1093342,12,9,0,21
"93343",1093343,104,159,13,276
"93344",1093344,145,17,6,168
"93345",1093345,39,142,10,191
"93346",1093346,22,0,0,22
"93347",1093347,16,8,0,24
"93348",1093348,121,56,9,186
"93349",1093349,86,132,16,234
"93350",1093350,142,43,5,190
"93351",1093351,130,24,2,156
"93352",1093352,145,108,5,258
"93353",1093353,103,132,5,240
"93354",1093354,168,28,6,202
"93355",1093355,167,84,12,263
"93356",1093356,55,105,6,166
"93357",1093357,217,67,19,303
"93358",1093358,62,54,1,117
"93359",1093359,20,40,0,60
"93360",1093360,180,85,10,275
"93361",1093361,42,136,4,182
"93362",1093362,226,39,7,272
"93363",1093363,83,153,21,257
"93364",1093364,78,232,12,322
"93365",1093365,237,25,2,264
"93366",1093366,108,98,7,213
"93367",1093367,76,250,9,335
"93368",1093368,56,181,5,242
"93369",1093369,104,8,4,116
"93370",1093370,103,180,14,297
"93371",1093371,202,13,8,223
"93372",1093372,215,18,1,234
"93373",1093373,92,207,8,307
"93374",1093374,97,130,14,241
"93375",1093375,117,59,7,183
"93376",1093376,123,142,4,269
"93377",1093377,51,42,2,95
"93378",1093378,42,203,4,249
"93379",1093379,126,141,7,274
"93380",1093380,70,183,16,269
"93381",1093381,111,110,15,236
"93382",1093382,47,200,9,256
"93383",1093383,78,51,6,135
"93384",1093384,85,142,5,232
"93385",1093385,93,115,7,215
"93386",1093386,84,145,8,237
"93387",1093387,41,138,3,182
"93388",1093388,51,250,1,302
"93389",1093389,111,178,9,298
"93390",1093390,157,107,20,284
"93391",1093391,31,15,1,47
"93392",1093392,176,99,21,296
"93393",1093393,121,114,3,238
"93394",1093394,70,8,1,79
"93395",1093395,53,331,5,389
"93396",1093396,65,174,8,247
"93397",1093397,74,109,10,193
"93398",1093398,107,50,5,162
"93399",1093399,168,81,9,258
"93400",1093400,161,37,6,204
"93401",1093401,37,214,1,252
"93402",1093402,58,103,8,169
"93403",1093403,195,56,6,257
"93404",1093404,219,36,3,258
"93405",1093405,67,172,3,242
"93406",1093406,139,52,11,202
"93407",1093407,90,128,4,222
"93408",1093408,66,113,6,185
"93409",1093409,206,73,15,294
"93410",1093410,63,138,15,216
"93411",1093411,8,0,1,9
"93412",1093412,92,59,2,153
"93413",1093413,198,46,11,255
"93414",1093414,51,56,1,108
"93415",1093415,101,174,6,281
"93416",1093416,151,68,3,222
"93417",1093417,115,68,26,209
"93418",1093418,106,45,3,154
"93419",1093419,65,141,16,222
"93420",1093420,5,1,0,6
"93421",1093421,165,67,18,250
"93422",1093422,129,122,3,254
"93423",1093423,74,206,18,298
"93424",1093424,156,105,4,265
"93425",1093425,123,67,3,193
"93426",1093426,61,202,3,266
"93427",1093427,79,181,10,270
"93428",1093428,117,57,6,180
"93429",1093429,204,84,11,299
"93430",1093430,99,168,3,270
"93431",1093431,91,205,6,302
"93432",1093432,135,90,11,236
"93433",1093433,198,64,4,266
"93434",1093434,17,240,3,260
"93435",1093435,95,24,1,120
"93436",1093436,177,148,13,338
"93437",1093437,4,21,0,25
"93438",1093438,77,124,15,216
"93439",1093439,74,10,2,86
"93440",1093440,89,93,3,185
"93441",1093441,5,6,0,11
"93442",1093442,23,22,2,47
"93443",1093443,94,118,12,224
"93444",1093444,192,149,12,353
"93445",1093445,250,21,8,279
"93446",1093446,41,208,4,253
"93447",1093447,141,130,10,281
"93448",1093448,95,97,0,192
"93449",1093449,132,107,9,248
"93450",1093450,40,235,1,276
"93451",1093451,19,174,2,195
"93452",1093452,225,40,5,270
"93453",1093453,19,10,1,30
"93454",1093454,175,89,5,269
"93455",1093455,67,184,10,261
"93456",1093456,72,177,4,253
"93457",1093457,80,256,15,351
"93458",1093458,126,111,14,251
"93459",1093459,134,123,8,265
"93460",1093460,14,18,0,32
"93461",1093461,130,82,5,217
"93462",1093462,201,93,12,306
"93463",1093463,177,57,14,248
"93464",1093464,149,116,18,283
"93465",1093465,135,174,23,332
"93466",1093466,52,21,3,76
"93467",1093467,32,18,1,51
"93468",1093468,69,109,5,183
"93469",1093469,49,250,2,301
"93470",1093470,134,106,6,246
"93471",1093471,177,115,5,297
"93472",1093472,134,144,6,284
"93473",1093473,67,39,4,110
"93474",1093474,123,155,10,288
"93475",1093475,79,150,5,234
"93476",1093476,123,160,13,296
"93477",1093477,72,111,8,191
"93478",1093478,16,276,1,293
"93479",1093479,203,15,7,225
"93480",1093480,56,190,8,254
"93481",1093481,49,226,2,277
"93482",1093482,69,60,6,135
"93483",1093483,62,27,5,94
"93484",1093484,131,99,7,237
"93485",1093485,43,135,3,181
"93486",1093486,109,177,18,304
"93487",1093487,163,136,2,301
"93488",1093488,233,39,7,279
"93489",1093489,121,46,17,184
"93490",1093490,32,149,15,196
"93491",1093491,100,131,10,241
"93492",1093492,185,72,12,269
"93493",1093493,20,15,0,35
"93494",1093494,83,216,27,326
"93495",1093495,138,12,9,159
"93496",1093496,155,69,23,247
"93497",1093497,116,113,9,238
"93498",1093498,249,41,11,301
"93499",1093499,125,36,9,170
"93500",1093500,93,63,6,162
"93501",1093501,85,2,1,88
"93502",1093502,124,132,11,267
"93503",1093503,168,80,6,254
"93504",1093504,138,57,13,208
"93505",1093505,192,66,11,269
"93506",1093506,188,76,14,278
"93507",1093507,62,212,4,278
"93508",1093508,2,8,0,10
"93509",1093509,29,66,0,95
"93510",1093510,156,93,9,258
"93511",1093511,150,34,4,188
"93512",1093512,87,168,10,265
"93513",1093513,115,17,4,136
"93514",1093514,73,189,9,271
"93515",1093515,157,116,4,277
"93516",1093516,43,197,7,247
"93517",1093517,142,28,10,180
"93518",1093518,61,215,10,286
"93519",1093519,69,174,5,248
"93520",1093520,60,188,12,260
"93521",1093521,125,82,4,211
"93522",1093522,161,67,4,232
"93523",1093523,73,58,4,135
"93524",1093524,20,236,5,261
"93525",1093525,4,3,0,7
"93526",1093526,96,55,6,157
"93527",1093527,296,0,4,300
"93528",1093528,125,38,9,172
"93529",1093529,58,169,2,229
"93530",1093530,259,27,9,295
"93531",1093531,34,400,2,436
"93532",1093532,50,72,3,125
"93533",1093533,35,240,4,279
"93534",1093534,113,68,3,184
"93535",1093535,89,115,4,208
"93536",1093536,38,230,7,275
"93537",1093537,224,16,9,249
"93538",1093538,122,111,17,250
"93539",1093539,234,20,8,262
"93540",1093540,134,44,6,184
"93541",1093541,57,25,6,88
"93542",1093542,112,160,21,293
"93543",1093543,125,156,14,295
"93544",1093544,47,185,8,240
"93545",1093545,86,168,8,262
"93546",1093546,20,3,0,23
"93547",1093547,155,109,21,285
"93548",1093548,54,18,1,73
"93549",1093549,43,23,2,68
"93550",1093550,256,28,3,287
"93551",1093551,55,203,5,263
"93552",1093552,104,48,4,156
"93553",1093553,72,167,2,241
"93554",1093554,64,91,15,170
"93555",1093555,142,4,3,149
"93556",1093556,168,75,6,249
"93557",1093557,72,206,8,286
"93558",1093558,91,90,11,192
"93559",1093559,193,69,11,273
"93560",1093560,182,70,16,268
"93561",1093561,85,106,18,209
"93562",1093562,176,47,8,231
"93563",1093563,40,246,6,292
"93564",1093564,240,57,7,304
"93565",1093565,72,127,15,214
"93566",1093566,151,69,20,240
"93567",1093567,187,60,6,253
"93568",1093568,219,97,20,336
"93569",1093569,107,55,3,165
"93570",1093570,37,209,2,248
"93571",1093571,104,136,16,256
"93572",1093572,70,145,7,222
"93573",1093573,55,55,3,113
"93574",1093574,37,204,14,255
"93575",1093575,41,53,0,94
"93576",1093576,147,109,18,274
"93577",1093577,94,80,10,184
"93578",1093578,240,19,8,267
"93579",1093579,119,96,3,218
"93580",1093580,159,51,7,217
"93581",1093581,144,97,14,255
"93582",1093582,136,102,2,240
"93583",1093583,146,69,4,219
"93584",1093584,92,104,2,198
"93585",1093585,88,70,6,164
"93586",1093586,136,41,9,186
"93587",1093587,96,133,13,242
"93588",1093588,150,122,2,274
"93589",1093589,101,31,3,135
"93590",1093590,78,147,4,229
"93591",1093591,42,142,4,188
"93592",1093592,172,64,4,240
"93593",1093593,110,75,9,194
"93594",1093594,124,43,3,170
"93595",1093595,109,80,5,194
"93596",1093596,163,100,5,268
"93597",1093597,73,213,4,290
"93598",1093598,33,36,3,72
"93599",1093599,86,184,10,280
"93600",1093600,158,108,16,282
"93601",1093601,116,93,16,225
"93602",1093602,97,35,6,138
"93603",1093603,256,15,10,281
"93604",1093604,216,36,3,255
"93605",1093605,118,47,9,174
"93606",1093606,207,17,10,234
"93607",1093607,148,75,17,240
"93608",1093608,79,170,15,264
"93609",1093609,177,22,7,206
"93610",1093610,128,130,15,273
"93611",1093611,97,47,4,148
"93612",1093612,32,243,6,281
"93613",1093613,85,169,10,264
"93614",1093614,83,22,5,110
"93615",1093615,107,98,10,215
"93616",1093616,139,31,3,173
"93617",1093617,53,217,15,285
"93618",1093618,218,41,4,263
"93619",1093619,115,70,9,194
"93620",1093620,46,243,0,289
"93621",1093621,123,49,2,174
"93622",1093622,55,135,10,200
"93623",1093623,24,34,1,59
"93624",1093624,174,70,10,254
"93625",1093625,190,10,2,202
"93626",1093626,39,91,1,131
"93627",1093627,125,55,7,187
"93628",1093628,185,51,10,246
"93629",1093629,211,109,17,337
"93630",1093630,63,246,9,318
"93631",1093631,172,48,14,234
"93632",1093632,148,122,10,280
"93633",1093633,55,152,2,209
"93634",1093634,145,18,3,166
"93635",1093635,10,19,0,29
"93636",1093636,135,38,7,180
"93637",1093637,5,12,1,18
"93638",1093638,104,185,8,297
"93639",1093639,49,62,7,118
"93640",1093640,122,154,6,282
"93641",1093641,154,78,20,252
"93642",1093642,68,181,11,260
"93643",1093643,142,39,6,187
"93644",1093644,85,105,4,194
"93645",1093645,179,9,7,195
"93646",1093646,53,253,9,315
"93647",1093647,98,120,16,234
"93648",1093648,135,27,8,170
"93649",1093649,160,73,8,241
"93650",1093650,64,28,1,93
"93651",1093651,44,231,4,279
"93652",1093652,60,97,10,167
"93653",1093653,124,144,7,275
"93654",1093654,57,235,2,294
"93655",1093655,74,254,2,330
"93656",1093656,205,95,17,317
"93657",1093657,94,100,9,203
"93658",1093658,122,176,16,314
"93659",1093659,92,128,12,232
"93660",1093660,116,139,16,271
"93661",1093661,78,164,17,259
"93662",1093662,89,167,11,267
"93663",1093663,115,1,1,117
"93664",1093664,227,47,10,284
"93665",1093665,34,180,3,217
"93666",1093666,177,23,9,209
"93667",1093667,10,13,2,25
"93668",1093668,111,147,10,268
"93669",1093669,99,154,5,258
"93670",1093670,127,28,7,162
"93671",1093671,121,149,21,291
"93672",1093672,114,57,5,176
"93673",1093673,125,54,14,193
"93674",1093674,65,133,7,205
"93675",1093675,92,125,3,220
"93676",1093676,31,146,1,178
"93677",1093677,167,88,3,258
"93678",1093678,106,62,10,178
"93679",1093679,184,46,5,235
"93680",1093680,82,88,5,175
"93681",1093681,141,186,22,349
"93682",1093682,61,193,8,262
"93683",1093683,74,222,13,309
"93684",1093684,221,47,5,273
"93685",1093685,48,219,5,272
"93686",1093686,69,109,11,189
"93687",1093687,47,209,9,265
"93688",1093688,76,197,5,278
"93689",1093689,112,49,8,169
"93690",1093690,32,28,1,61
"93691",1093691,55,285,9,349
"93692",1093692,44,71,3,118
"93693",1093693,156,28,6,190
"93694",1093694,118,170,15,303
"93695",1093695,204,26,5,235
"93696",1093696,176,77,6,259
"93697",1093697,69,116,0,185
"93698",1093698,161,21,4,186
"93699",1093699,211,104,17,332
"93700",1093700,36,251,5,292
"93701",1093701,125,190,5,320
"93702",1093702,295,45,12,352
"93703",1093703,18,197,2,217
"93704",1093704,55,33,5,93
"93705",1093705,156,77,5,238
"93706",1093706,133,66,9,208
"93707",1093707,98,131,7,236
"93708",1093708,125,59,9,193
"93709",1093709,36,248,8,292
"93710",1093710,121,74,3,198
"93711",1093711,144,115,16,275
"93712",1093712,19,166,1,186
"93713",1093713,53,183,12,248
"93714",1093714,85,175,9,269
"93715",1093715,87,59,4,150
"93716",1093716,143,46,5,194
"93717",1093717,114,76,7,197
"93718",1093718,154,32,8,194
"93719",1093719,129,142,14,285
"93720",1093720,165,25,8,198
"93721",1093721,86,112,2,200
"93722",1093722,162,110,2,274
"93723",1093723,32,177,3,212
"93724",1093724,132,110,13,255
"93725",1093725,323,1,1,325
"93726",1093726,93,153,10,256
"93727",1093727,150,128,4,282
"93728",1093728,141,94,8,243
"93729",1093729,176,18,2,196
"93730",1093730,66,63,8,137
"93731",1093731,90,99,11,200
"93732",1093732,26,19,2,47
"93733",1093733,47,0,1,48
"93734",1093734,109,136,18,263
"93735",1093735,112,206,8,326
"93736",1093736,24,224,2,250
"93737",1093737,133,70,7,210
"93738",1093738,169,18,3,190
"93739",1093739,197,26,5,228
"93740",1093740,194,120,8,322
"93741",1093741,68,124,12,204
"93742",1093742,117,116,6,239
"93743",1093743,106,106,4,216
"93744",1093744,267,17,3,287
"93745",1093745,152,92,9,253
"93746",1093746,79,82,4,165
"93747",1093747,29,48,2,79
"93748",1093748,38,132,7,177
"93749",1093749,142,106,16,264
"93750",1093750,204,26,6,236
"93751",1093751,102,170,25,297
"93752",1093752,140,128,6,274
"93753",1093753,88,133,6,227
"93754",1093754,110,130,10,250
"93755",1093755,163,67,3,233
"93756",1093756,24,171,5,200
"93757",1093757,50,224,17,291
"93758",1093758,115,165,18,298
"93759",1093759,36,72,5,113
"93760",1093760,178,64,26,268
"93761",1093761,208,32,12,252
"93762",1093762,123,187,7,317
"93763",1093763,7,169,2,178
"93764",1093764,103,144,8,255
"93765",1093765,33,156,6,195
"93766",1093766,16,5,0,21
"93767",1093767,32,180,4,216
"93768",1093768,188,20,2,210
"93769",1093769,196,109,22,327
"93770",1093770,55,208,12,275
"93771",1093771,283,73,12,368
"93772",1093772,116,102,7,225
"93773",1093773,86,221,11,318
"93774",1093774,166,53,5,224
"93775",1093775,171,33,10,214
"93776",1093776,72,90,3,165
"93777",1093777,33,39,5,77
"93778",1093778,64,189,15,268
"93779",1093779,51,107,1,159
"93780",1093780,26,95,3,124
"93781",1093781,136,94,6,236
"93782",1093782,37,171,6,214
"93783",1093783,41,161,11,213
"93784",1093784,147,112,12,271
"93785",1093785,59,168,6,233
"93786",1093786,22,99,0,121
"93787",1093787,174,44,10,228
"93788",1093788,157,78,15,250
"93789",1093789,62,245,6,313
"93790",1093790,69,261,3,333
"93791",1093791,168,100,25,293
"93792",1093792,78,17,7,102
"93793",1093793,66,112,6,184
"93794",1093794,41,179,3,223
"93795",1093795,157,74,9,240
"93796",1093796,72,197,7,276
"93797",1093797,201,91,12,304
"93798",1093798,146,55,7,208
"93799",1093799,233,23,10,266
"93800",1093800,139,53,12,204
"93801",1093801,83,173,24,280
"93802",1093802,127,155,12,294
"93803",1093803,112,94,10,216
"93804",1093804,25,95,0,120
"93805",1093805,51,145,4,200
"93806",1093806,154,224,7,385
"93807",1093807,60,146,8,214
"93808",1093808,145,81,12,238
"93809",1093809,161,67,6,234
"93810",1093810,136,149,15,300
"93811",1093811,123,12,2,137
"93812",1093812,150,69,5,224
"93813",1093813,24,208,7,239
"93814",1093814,127,124,17,268
"93815",1093815,143,61,13,217
"93816",1093816,142,73,11,226
"93817",1093817,73,149,8,230
"93818",1093818,107,128,14,249
"93819",1093819,101,70,5,176
"93820",1093820,118,98,21,237
"93821",1093821,82,175,8,265
"93822",1093822,156,99,8,263
"93823",1093823,120,103,4,227
"93824",1093824,47,38,2,87
"93825",1093825,83,92,6,181
"93826",1093826,66,103,4,173
"93827",1093827,122,130,10,262
"93828",1093828,100,164,11,275
"93829",1093829,166,96,16,278
"93830",1093830,81,165,7,253
"93831",1093831,90,86,3,179
"93832",1093832,52,200,4,256
"93833",1093833,107,108,11,226
"93834",1093834,137,90,7,234
"93835",1093835,139,102,8,249
"93836",1093836,152,45,6,203
"93837",1093837,126,143,5,274
"93838",1093838,38,177,5,220
"93839",1093839,209,26,3,238
"93840",1093840,43,240,5,288
"93841",1093841,86,100,2,188
"93842",1093842,209,39,14,262
"93843",1093843,126,89,18,233
"93844",1093844,96,69,14,179
"93845",1093845,65,181,12,258
"93846",1093846,113,114,13,240
"93847",1093847,262,16,9,287
"93848",1093848,95,207,6,308
"93849",1093849,90,160,12,262
"93850",1093850,27,2,0,29
"93851",1093851,180,121,12,313
"93852",1093852,152,110,5,267
"93853",1093853,130,86,34,250
"93854",1093854,26,236,10,272
"93855",1093855,91,39,5,135
"93856",1093856,127,15,0,142
"93857",1093857,129,38,2,169
"93858",1093858,126,93,9,228
"93859",1093859,65,188,14,267
"93860",1093860,90,28,4,122
"93861",1093861,104,167,15,286
"93862",1093862,124,97,7,228
"93863",1093863,78,189,9,276
"93864",1093864,92,128,2,222
"93865",1093865,114,176,9,299
"93866",1093866,78,143,13,234
"93867",1093867,55,200,11,266
"93868",1093868,110,86,6,202
"93869",1093869,26,264,0,290
"93870",1093870,69,160,27,256
"93871",1093871,107,41,5,153
"93872",1093872,114,127,11,252
"93873",1093873,243,56,14,313
"93874",1093874,30,166,4,200
"93875",1093875,114,167,21,302
"93876",1093876,78,135,21,234
"93877",1093877,31,185,3,219
"93878",1093878,183,107,26,316
"93879",1093879,125,21,3,149
"93880",1093880,154,94,7,255
"93881",1093881,158,108,20,286
"93882",1093882,192,34,7,233
"93883",1093883,104,130,13,247
"93884",1093884,134,69,9,212
"93885",1093885,67,170,6,243
"93886",1093886,13,7,0,20
"93887",1093887,45,71,1,117
"93888",1093888,32,21,2,55
"93889",1093889,143,69,7,219
"93890",1093890,179,16,6,201
"93891",1093891,118,57,2,177
"93892",1093892,6,22,1,29
"93893",1093893,101,81,3,185
"93894",1093894,102,37,3,142
"93895",1093895,146,34,19,199
"93896",1093896,191,69,11,271
"93897",1093897,124,91,12,227
"93898",1093898,97,87,15,199
"93899",1093899,85,170,5,260
"93900",1093900,138,79,4,221
"93901",1093901,40,288,5,333
"93902",1093902,196,29,7,232
"93903",1093903,75,116,14,205
"93904",1093904,12,188,3,203
"93905",1093905,72,173,20,265
"93906",1093906,49,140,17,206
"93907",1093907,212,32,3,247
"93908",1093908,38,302,7,347
"93909",1093909,127,177,13,317
"93910",1093910,103,30,1,134
"93911",1093911,102,189,10,301
"93912",1093912,73,19,3,95
"93913",1093913,195,52,6,253
"93914",1093914,59,152,4,215
"93915",1093915,212,33,7,252
"93916",1093916,109,121,15,245
"93917",1093917,41,218,7,266
"93918",1093918,122,138,1,261
"93919",1093919,45,116,4,165
"93920",1093920,38,144,1,183
"93921",1093921,58,254,3,315
"93922",1093922,45,233,1,279
"93923",1093923,181,61,8,250
"93924",1093924,61,5,2,68
"93925",1093925,170,121,17,308
"93926",1093926,221,16,3,240
"93927",1093927,130,118,10,258
"93928",1093928,153,20,5,178
"93929",1093929,77,161,5,243
"93930",1093930,179,20,6,205
"93931",1093931,102,117,3,222
"93932",1093932,55,91,4,150
"93933",1093933,99,90,17,206
"93934",1093934,189,90,10,289
"93935",1093935,47,247,15,309
"93936",1093936,167,19,1,187
"93937",1093937,99,159,16,274
"93938",1093938,108,132,20,260
"93939",1093939,185,68,18,271
"93940",1093940,78,161,5,244
"93941",1093941,61,143,19,223
"93942",1093942,76,165,6,247
"93943",1093943,5,9,0,14
"93944",1093944,152,52,6,210
"93945",1093945,90,99,14,203
"93946",1093946,63,95,8,166
"93947",1093947,132,52,7,191
"93948",1093948,223,25,5,253
"93949",1093949,198,14,8,220
"93950",1093950,125,72,4,201
"93951",1093951,47,175,5,227
"93952",1093952,140,51,11,202
"93953",1093953,116,27,6,149
"93954",1093954,197,93,14,304
"93955",1093955,67,128,8,203
"93956",1093956,56,168,6,230
"93957",1093957,56,5,1,62
"93958",1093958,109,7,3,119
"93959",1093959,153,69,7,229
"93960",1093960,96,60,4,160
"93961",1093961,54,196,2,252
"93962",1093962,187,67,3,257
"93963",1093963,169,90,8,267
"93964",1093964,115,38,3,156
"93965",1093965,59,220,6,285
"93966",1093966,31,218,7,256
"93967",1093967,38,20,1,59
"93968",1093968,2,45,1,48
"93969",1093969,3,5,0,8
"93970",1093970,107,18,6,131
"93971",1093971,133,131,8,272
"93972",1093972,87,153,8,248
"93973",1093973,173,13,7,193
"93974",1093974,27,234,3,264
"93975",1093975,0,1,0,1
"93976",1093976,62,195,5,262
"93977",1093977,77,190,12,279
"93978",1093978,248,76,11,335
"93979",1093979,51,171,20,242
"93980",1093980,88,141,5,234
"93981",1093981,164,142,12,318
"93982",1093982,135,43,2,180
"93983",1093983,8,3,0,11
"93984",1093984,168,127,5,300
"93985",1093985,95,45,4,144
"93986",1093986,113,174,12,299
"93987",1093987,204,56,12,272
"93988",1093988,53,89,10,152
"93989",1093989,78,231,7,316
"93990",1093990,19,5,0,24
"93991",1093991,105,137,6,248
"93992",1093992,175,78,13,266
"93993",1093993,166,51,8,225
"93994",1093994,77,45,2,124
"93995",1093995,173,62,9,244
"93996",1093996,169,83,6,258
"93997",1093997,175,109,4,288
"93998",1093998,52,91,4,147
"93999",1093999,153,122,24,299
"94000",1094000,167,22,7,196
"94001",1094001,209,76,13,298
"94002",1094002,86,122,3,211
"94003",1094003,68,140,8,216
"94004",1094004,80,217,10,307
"94005",1094005,210,109,12,331
"94006",1094006,88,165,11,264
"94007",1094007,69,139,6,214
"94008",1094008,48,120,2,170
"94009",1094009,81,83,2,166
"94010",1094010,196,109,10,315
"94011",1094011,42,174,9,225
"94012",1094012,110,47,2,159
"94013",1094013,20,17,4,41
"94014",1094014,68,190,11,269
"94015",1094015,40,218,5,263
"94016",1094016,54,214,5,273
"94017",1094017,207,30,9,246
"94018",1094018,161,28,5,194
"94019",1094019,27,254,5,286
"94020",1094020,87,187,12,286
"94021",1094021,196,81,21,298
"94022",1094022,137,144,27,308
"94023",1094023,89,46,8,143
"94024",1094024,59,134,13,206
"94025",1094025,14,291,2,307
"94026",1094026,172,64,7,243
"94027",1094027,206,54,11,271
"94028",1094028,43,175,6,224
"94029",1094029,89,25,4,118
"94030",1094030,199,68,19,286
"94031",1094031,116,190,15,321
"94032",1094032,51,21,4,76
"94033",1094033,129,35,6,170
"94034",1094034,130,198,21,349
"94035",1094035,50,179,5,234
"94036",1094036,88,146,10,244
"94037",1094037,60,182,21,263
"94038",1094038,77,84,5,166
"94039",1094039,33,10,4,47
"94040",1094040,42,192,19,253
"94041",1094041,17,27,2,46
"94042",1094042,207,18,2,227
"94043",1094043,162,112,27,301
"94044",1094044,185,60,11,256
"94045",1094045,21,216,0,237
"94046",1094046,127,86,11,224
"94047",1094047,128,50,18,196
"94048",1094048,211,29,8,248
"94049",1094049,143,184,15,342
"94050",1094050,32,84,4,120
"94051",1094051,192,40,4,236
"94052",1094052,142,101,10,253
"94053",1094053,146,89,6,241
"94054",1094054,216,76,14,306
"94055",1094055,197,62,14,273
"94056",1094056,76,164,9,249
"94057",1094057,193,24,5,222
"94058",1094058,134,69,8,211
"94059",1094059,140,58,7,205
"94060",1094060,57,116,9,182
"94061",1094061,57,218,11,286
"94062",1094062,241,11,6,258
"94063",1094063,116,115,17,248
"94064",1094064,103,114,3,220
"94065",1094065,69,106,8,183
"94066",1094066,152,43,10,205
"94067",1094067,104,146,15,265
"94068",1094068,88,45,3,136
"94069",1094069,41,241,6,288
"94070",1094070,155,103,14,272
"94071",1094071,61,155,11,227
"94072",1094072,50,102,6,158
"94073",1094073,72,182,27,281
"94074",1094074,205,32,5,242
"94075",1094075,222,4,28,254
"94076",1094076,33,234,6,273
"94077",1094077,38,199,3,240
"94078",1094078,122,36,7,165
"94079",1094079,176,72,8,256
"94080",1094080,108,70,3,181
"94081",1094081,53,185,5,243
"94082",1094082,96,56,3,155
"94083",1094083,232,54,15,301
"94084",1094084,59,13,6,78
"94085",1094085,125,98,17,240
"94086",1094086,81,69,3,153
"94087",1094087,146,123,14,283
"94088",1094088,42,193,9,244
"94089",1094089,116,155,10,281
"94090",1094090,31,39,2,72
"94091",1094091,16,214,1,231
"94092",1094092,125,127,11,263
"94093",1094093,97,74,6,177
"94094",1094094,131,128,8,267
"94095",1094095,140,137,4,281
"94096",1094096,49,71,7,127
"94097",1094097,204,7,5,216
"94098",1094098,109,11,9,129
"94099",1094099,124,92,11,227
"94100",1094100,69,195,6,270
"94101",1094101,166,21,1,188
"94102",1094102,24,224,11,259
"94103",1094103,33,70,5,108
"94104",1094104,200,37,7,244
"94105",1094105,15,208,4,227
"94106",1094106,168,130,18,316
"94107",1094107,119,168,13,300
"94108",1094108,34,41,5,80
"94109",1094109,198,33,5,236
"94110",1094110,64,142,4,210
"94111",1094111,19,58,6,83
"94112",1094112,72,79,5,156
"94113",1094113,87,26,12,125
"94114",1094114,67,41,2,110
"94115",1094115,202,39,4,245
"94116",1094116,239,43,7,289
"94117",1094117,116,33,12,161
"94118",1094118,152,48,10,210
"94119",1094119,115,109,20,244
"94120",1094120,198,46,5,249
"94121",1094121,64,204,9,277
"94122",1094122,49,254,6,309
"94123",1094123,197,20,8,225
"94124",1094124,157,102,7,266
"94125",1094125,312,65,9,386
"94126",1094126,24,110,9,143
"94127",1094127,67,105,3,175
"94128",1094128,183,41,6,230
"94129",1094129,195,71,9,275
"94130",1094130,39,106,5,150
"94131",1094131,95,34,5,134
"94132",1094132,79,173,13,265
"94133",1094133,108,139,21,268
"94134",1094134,75,204,10,289
"94135",1094135,103,121,3,227
"94136",1094136,123,107,12,242
"94137",1094137,227,65,7,299
"94138",1094138,148,89,9,246
"94139",1094139,63,50,5,118
"94140",1094140,167,53,6,226
"94141",1094141,161,73,10,244
"94142",1094142,139,36,5,180
"94143",1094143,80,154,18,252
"94144",1094144,131,90,6,227
"94145",1094145,84,109,4,197
"94146",1094146,46,228,7,281
"94147",1094147,158,61,6,225
"94148",1094148,80,76,3,159
"94149",1094149,83,184,11,278
"94150",1094150,69,47,6,122
"94151",1094151,121,119,10,250
"94152",1094152,97,163,9,269
"94153",1094153,174,64,7,245
"94154",1094154,105,60,7,172
"94155",1094155,192,29,5,226
"94156",1094156,17,54,1,72
"94157",1094157,134,15,6,155
"94158",1094158,80,71,2,153
"94159",1094159,181,66,11,258
"94160",1094160,36,7,3,46
"94161",1094161,289,6,1,296
"94162",1094162,50,97,1,148
"94163",1094163,234,50,8,292
"94164",1094164,109,109,15,233
"94165",1094165,47,140,4,191
"94166",1094166,55,86,2,143
"94167",1094167,281,8,11,300
"94168",1094168,92,62,8,162
"94169",1094169,75,50,11,136
"94170",1094170,186,10,0,196
"94171",1094171,47,51,3,101
"94172",1094172,137,88,10,235
"94173",1094173,30,239,7,276
"94174",1094174,81,178,3,262
"94175",1094175,175,47,3,225
"94176",1094176,15,16,1,32
"94177",1094177,22,17,1,40
"94178",1094178,108,141,7,256
"94179",1094179,42,150,15,207
"94180",1094180,134,1,0,135
"94181",1094181,30,172,1,203
"94182",1094182,259,43,13,315
"94183",1094183,39,3,1,43
"94184",1094184,87,213,3,303
"94185",1094185,161,54,14,229
"94186",1094186,100,223,15,338
"94187",1094187,108,189,9,306
"94188",1094188,171,63,5,239
"94189",1094189,160,130,9,299
"94190",1094190,64,124,2,190
"94191",1094191,74,25,3,102
"94192",1094192,5,14,1,20
"94193",1094193,140,134,9,283
"94194",1094194,4,3,1,8
"94195",1094195,147,149,15,311
"94196",1094196,70,150,17,237
"94197",1094197,76,134,10,220
"94198",1094198,83,143,10,236
"94199",1094199,38,11,2,51
"94200",1094200,31,122,5,158
"94201",1094201,99,120,1,220
"94202",1094202,140,150,14,304
"94203",1094203,180,22,11,213
"94204",1094204,156,72,5,233
"94205",1094205,143,118,18,279
"94206",1094206,153,115,16,284
"94207",1094207,141,12,5,158
"94208",1094208,134,181,5,320
"94209",1094209,154,20,7,181
"94210",1094210,152,17,0,169
"94211",1094211,20,4,0,24
"94212",1094212,75,223,7,305
"94213",1094213,104,80,3,187
"94214",1094214,35,201,15,251
"94215",1094215,42,243,6,291
"94216",1094216,75,143,6,224
"94217",1094217,77,42,3,122
"94218",1094218,102,167,8,277
"94219",1094219,182,51,11,244
"94220",1094220,198,23,6,227
"94221",1094221,24,112,4,140
"94222",1094222,108,125,6,239
"94223",1094223,8,6,2,16
"94224",1094224,171,90,8,269
"94225",1094225,147,54,6,207
"94226",1094226,104,82,6,192
"94227",1094227,150,99,14,263
"94228",1094228,129,52,8,189
"94229",1094229,119,38,8,165
"94230",1094230,150,136,9,295
"94231",1094231,143,64,12,219
"94232",1094232,204,16,7,227
"94233",1094233,189,81,14,284
"94234",1094234,127,120,18,265
"94235",1094235,97,52,3,152
"94236",1094236,186,30,0,216
"94237",1094237,100,99,6,205
"94238",1094238,77,167,7,251
"94239",1094239,36,242,3,281
"94240",1094240,223,38,4,265
"94241",1094241,92,77,18,187
"94242",1094242,127,159,17,303
"94243",1094243,180,67,18,265
"94244",1094244,45,152,0,197
"94245",1094245,164,101,12,277
"94246",1094246,39,264,6,309
"94247",1094247,194,56,12,262
"94248",1094248,5,76,3,84
"94249",1094249,178,20,9,207
"94250",1094250,140,65,13,218
"94251",1094251,118,119,8,245
"94252",1094252,175,7,2,184
"94253",1094253,60,29,7,96
"94254",1094254,231,75,11,317
"94255",1094255,177,105,12,294
"94256",1094256,156,73,1,230
"94257",1094257,205,65,24,294
"94258",1094258,143,60,8,211
"94259",1094259,34,95,8,137
"94260",1094260,143,29,8,180
"94261",1094261,114,58,15,187
"94262",1094262,146,81,5,232
"94263",1094263,277,86,22,385
"94264",1094264,138,49,13,200
"94265",1094265,163,59,9,231
"94266",1094266,123,6,2,131
"94267",1094267,70,211,7,288
"94268",1094268,222,53,9,284
"94269",1094269,36,122,2,160
"94270",1094270,113,184,3,300
"94271",1094271,213,15,7,235
"94272",1094272,9,156,1,166
"94273",1094273,44,13,2,59
"94274",1094274,11,61,0,72
"94275",1094275,77,13,2,92
"94276",1094276,25,256,2,283
"94277",1094277,191,13,14,218
"94278",1094278,90,41,9,140
"94279",1094279,100,107,4,211
"94280",1094280,89,76,4,169
"94281",1094281,120,128,9,257
"94282",1094282,123,2,2,127
"94283",1094283,19,221,3,243
"94284",1094284,55,253,5,313
"94285",1094285,169,36,14,219
"94286",1094286,192,52,8,252
"94287",1094287,129,45,1,175
"94288",1094288,107,26,8,141
"94289",1094289,193,160,3,356
"94290",1094290,118,114,4,236
"94291",1094291,56,185,15,256
"94292",1094292,67,120,1,188
"94293",1094293,45,142,2,189
"94294",1094294,129,160,16,305
"94295",1094295,54,234,4,292
"94296",1094296,35,7,1,43
"94297",1094297,177,36,7,220
"94298",1094298,175,106,11,292
"94299",1094299,66,153,14,233
"94300",1094300,71,39,1,111
"94301",1094301,81,92,10,183
"94302",1094302,75,53,2,130
"94303",1094303,139,67,11,217
"94304",1094304,106,108,20,234
"94305",1094305,205,79,16,300
"94306",1094306,148,137,7,292
"94307",1094307,110,67,7,184
"94308",1094308,137,90,4,231
"94309",1094309,52,208,9,269
"94310",1094310,83,126,20,229
"94311",1094311,87,82,5,174
"94312",1094312,135,74,13,222
"94313",1094313,73,124,1,198
"94314",1094314,54,173,1,228
"94315",1094315,180,108,19,307
"94316",1094316,152,14,4,170
"94317",1094317,28,3,0,31
"94318",1094318,180,15,3,198
"94319",1094319,60,35,3,98
"94320",1094320,130,89,15,234
"94321",1094321,64,199,13,276
"94322",1094322,71,209,6,286
"94323",1094323,195,34,3,232
"94324",1094324,134,112,8,254
"94325",1094325,119,61,5,185
"94326",1094326,18,254,6,278
"94327",1094327,165,75,7,247
"94328",1094328,153,75,19,247
"94329",1094329,132,136,9,277
"94330",1094330,57,243,8,308
"94331",1094331,147,75,13,235
"94332",1094332,63,101,2,166
"94333",1094333,28,52,5,85
"94334",1094334,74,189,5,268
"94335",1094335,0,0,0,0
"94336",1094336,49,134,2,185
"94337",1094337,145,92,4,241
"94338",1094338,98,135,15,248
"94339",1094339,147,109,8,264
"94340",1094340,33,233,3,269
"94341",1094341,125,73,4,202
"94342",1094342,32,100,8,140
"94343",1094343,31,17,0,48
"94344",1094344,138,27,4,169
"94345",1094345,20,2,1,23
"94346",1094346,40,234,5,279
"94347",1094347,140,71,11,222
"94348",1094348,53,155,5,213
"94349",1094349,107,141,6,254
"94350",1094350,128,91,13,232
"94351",1094351,246,56,8,310
"94352",1094352,97,105,11,213
"94353",1094353,121,191,13,325
"94354",1094354,37,7,2,46
"94355",1094355,55,167,23,245
"94356",1094356,29,13,3,45
"94357",1094357,60,35,7,102
"94358",1094358,16,202,4,222
"94359",1094359,28,34,9,71
"94360",1094360,35,186,3,224
"94361",1094361,69,159,7,235
"94362",1094362,108,331,7,446
"94363",1094363,123,143,13,279
"94364",1094364,69,224,5,298
"94365",1094365,62,172,6,240
"94366",1094366,138,61,5,204
"94367",1094367,12,22,3,37
"94368",1094368,176,131,15,322
"94369",1094369,69,78,15,162
"94370",1094370,23,164,16,203
"94371",1094371,23,19,3,45
"94372",1094372,139,111,6,256
"94373",1094373,114,49,2,165
"94374",1094374,125,53,4,182
"94375",1094375,170,69,13,252
"94376",1094376,167,103,10,280
"94377",1094377,95,142,8,245
"94378",1094378,126,18,6,150
"94379",1094379,108,195,7,310
"94380",1094380,28,113,4,145
"94381",1094381,73,18,6,97
"94382",1094382,76,39,1,116
"94383",1094383,34,27,5,66
"94384",1094384,58,143,9,210
"94385",1094385,20,133,9,162
"94386",1094386,30,123,4,157
"94387",1094387,140,112,10,262
"94388",1094388,40,213,9,262
"94389",1094389,213,13,4,230
"94390",1094390,133,23,2,158
"94391",1094391,142,95,18,255
"94392",1094392,164,112,14,290
"94393",1094393,89,44,7,140
"94394",1094394,236,36,8,280
"94395",1094395,57,216,10,283
"94396",1094396,29,109,10,148
"94397",1094397,177,71,7,255
"94398",1094398,35,65,0,100
"94399",1094399,201,63,15,279
"94400",1094400,47,168,19,234
"94401",1094401,66,1,4,71
"94402",1094402,112,102,10,224
"94403",1094403,110,39,5,154
"94404",1094404,199,94,14,307
"94405",1094405,45,124,4,173
"94406",1094406,43,21,2,66
"94407",1094407,134,31,5,170
"94408",1094408,23,234,5,262
"94409",1094409,157,93,9,259
"94410",1094410,127,82,7,216
"94411",1094411,60,223,15,298
"94412",1094412,121,108,9,238
"94413",1094413,57,172,9,238
"94414",1094414,140,37,8,185
"94415",1094415,160,145,10,315
"94416",1094416,118,163,9,290
"94417",1094417,24,223,1,248
"94418",1094418,89,145,6,240
"94419",1094419,70,97,5,172
"94420",1094420,188,92,4,284
"94421",1094421,278,24,15,317
"94422",1094422,102,104,3,209
"94423",1094423,47,3,3,53
"94424",1094424,152,113,4,269
"94425",1094425,205,36,7,248
"94426",1094426,99,76,2,177
"94427",1094427,43,185,2,230
"94428",1094428,148,67,4,219
"94429",1094429,52,236,0,288
"94430",1094430,45,165,6,216
"94431",1094431,131,12,8,151
"94432",1094432,30,118,4,152
"94433",1094433,94,212,9,315
"94434",1094434,52,73,3,128
"94435",1094435,177,97,8,282
"94436",1094436,48,126,5,179
"94437",1094437,103,215,5,323
"94438",1094438,153,30,7,190
"94439",1094439,251,24,27,302
"94440",1094440,34,28,2,64
"94441",1094441,34,262,11,307
"94442",1094442,93,141,12,246
"94443",1094443,166,29,11,206
"94444",1094444,56,180,8,244
"94445",1094445,98,52,5,155
"94446",1094446,106,118,5,229
"94447",1094447,59,238,3,300
"94448",1094448,161,68,14,243
"94449",1094449,194,17,6,217
"94450",1094450,126,50,12,188
"94451",1094451,26,174,2,202
"94452",1094452,15,115,2,132
"94453",1094453,138,108,10,256
"94454",1094454,110,94,9,213
"94455",1094455,35,214,6,255
"94456",1094456,82,201,13,296
"94457",1094457,24,246,6,276
"94458",1094458,98,118,7,223
"94459",1094459,92,28,7,127
"94460",1094460,107,196,8,311
"94461",1094461,111,170,10,291
"94462",1094462,111,19,5,135
"94463",1094463,60,200,15,275
"94464",1094464,198,18,1,217
"94465",1094465,7,3,1,11
"94466",1094466,202,37,10,249
"94467",1094467,135,81,5,221
"94468",1094468,97,50,2,149
"94469",1094469,145,96,4,245
"94470",1094470,133,54,5,192
"94471",1094471,122,61,10,193
"94472",1094472,61,48,4,113
"94473",1094473,106,183,12,301
"94474",1094474,209,25,7,241
"94475",1094475,28,107,2,137
"94476",1094476,143,88,4,235
"94477",1094477,66,156,8,230
"94478",1094478,80,219,5,304
"94479",1094479,139,146,19,304
"94480",1094480,108,144,14,266
"94481",1094481,52,182,13,247
"94482",1094482,44,224,10,278
"94483",1094483,218,40,11,269
"94484",1094484,82,56,3,141
"94485",1094485,195,72,14,281
"94486",1094486,141,118,12,271
"94487",1094487,62,185,4,251
"94488",1094488,70,139,4,213
"94489",1094489,80,97,16,193
"94490",1094490,53,174,4,231
"94491",1094491,96,159,16,271
"94492",1094492,61,223,9,293
"94493",1094493,131,49,22,202
"94494",1094494,135,331,22,488
"94495",1094495,151,61,6,218
"94496",1094496,57,210,11,278
"94497",1094497,123,0,1,124
"94498",1094498,50,241,9,300
"94499",1094499,111,194,13,318
"94500",1094500,34,49,2,85
"94501",1094501,52,124,4,180
"94502",1094502,59,98,10,167
"94503",1094503,21,3,1,25
"94504",1094504,136,53,9,198
"94505",1094505,112,155,8,275
"94506",1094506,108,101,3,212
"94507",1094507,69,136,5,210
"94508",1094508,95,183,4,282
"94509",1094509,173,43,4,220
"94510",1094510,17,132,9,158
"94511",1094511,38,252,5,295
"94512",1094512,81,178,8,267
"94513",1094513,165,64,12,241
"94514",1094514,178,27,7,212
"94515",1094515,36,199,6,241
"94516",1094516,73,174,18,265
"94517",1094517,172,47,12,231
"94518",1094518,87,170,2,259
"94519",1094519,6,4,1,11
"94520",1094520,165,76,12,253
"94521",1094521,50,35,5,90
"94522",1094522,79,214,22,315
"94523",1094523,37,6,2,45
"94524",1094524,233,53,10,296
"94525",1094525,103,141,9,253
"94526",1094526,111,59,6,176
"94527",1094527,112,176,13,301
"94528",1094528,18,5,1,24
"94529",1094529,49,249,10,308
"94530",1094530,38,206,8,252
"94531",1094531,118,148,13,279
"94532",1094532,59,156,11,226
"94533",1094533,36,254,10,300
"94534",1094534,85,127,12,224
"94535",1094535,62,234,5,301
"94536",1094536,86,113,9,208
"94537",1094537,57,245,26,328
"94538",1094538,199,58,7,264
"94539",1094539,155,20,7,182
"94540",1094540,147,60,10,217
"94541",1094541,171,81,4,256
"94542",1094542,78,24,2,104
"94543",1094543,124,109,8,241
"94544",1094544,208,62,19,289
"94545",1094545,52,29,3,84
"94546",1094546,71,149,14,234
"94547",1094547,38,266,16,320
"94548",1094548,34,166,3,203
"94549",1094549,81,43,6,130
"94550",1094550,44,166,4,214
"94551",1094551,146,102,11,259
"94552",1094552,4,14,0,18
"94553",1094553,106,39,3,148
"94554",1094554,192,53,19,264
"94555",1094555,121,82,12,215
"94556",1094556,165,98,9,272
"94557",1094557,70,126,8,204
"94558",1094558,99,130,10,239
"94559",1094559,35,5,3,43
"94560",1094560,73,263,1,337
"94561",1094561,88,8,2,98
"94562",1094562,63,104,21,188
"94563",1094563,7,2,0,9
"94564",1094564,59,132,13,204
"94565",1094565,124,55,9,188
"94566",1094566,173,62,5,240
"94567",1094567,135,127,5,267
"94568",1094568,113,205,9,327
"94569",1094569,107,106,10,223
"94570",1094570,116,138,7,261
"94571",1094571,128,92,3,223
"94572",1094572,219,74,16,309
"94573",1094573,34,49,2,85
"94574",1094574,173,50,8,231
"94575",1094575,120,3,2,125
"94576",1094576,82,65,4,151
"94577",1094577,115,112,6,233
"94578",1094578,168,56,4,228
"94579",1094579,174,57,12,243
"94580",1094580,25,152,12,189
"94581",1094581,40,90,13,143
"94582",1094582,74,245,8,327
"94583",1094583,44,200,5,249
"94584",1094584,132,49,3,184
"94585",1094585,153,96,16,265
"94586",1094586,128,118,20,266
"94587",1094587,75,88,13,176
"94588",1094588,54,14,1,69
"94589",1094589,37,93,5,135
"94590",1094590,190,31,14,235
"94591",1094591,56,237,14,307
"94592",1094592,225,72,13,310
"94593",1094593,149,52,16,217
"94594",1094594,88,204,8,300
"94595",1094595,80,79,1,160
"94596",1094596,206,0,0,206
"94597",1094597,119,12,6,137
"94598",1094598,227,43,4,274
"94599",1094599,106,143,15,264
"94600",1094600,102,209,11,322
"94601",1094601,146,38,15,199
"94602",1094602,74,76,4,154
"94603",1094603,61,67,10,138
"94604",1094604,154,34,7,195
"94605",1094605,238,85,9,332
"94606",1094606,9,40,0,49
"94607",1094607,91,52,7,150
"94608",1094608,108,122,8,238
"94609",1094609,72,16,4,92
"94610",1094610,153,143,14,310
"94611",1094611,113,20,6,139
"94612",1094612,64,133,2,199
"94613",1094613,91,114,16,221
"94614",1094614,209,51,6,266
"94615",1094615,107,13,16,136
"94616",1094616,71,66,9,146
"94617",1094617,187,74,7,268
"94618",1094618,166,78,6,250
"94619",1094619,260,42,6,308
"94620",1094620,59,216,5,280
"94621",1094621,32,205,11,248
"94622",1094622,41,37,1,79
"94623",1094623,211,50,14,275
"94624",1094624,31,125,0,156
"94625",1094625,182,106,17,305
"94626",1094626,42,252,2,296
"94627",1094627,45,227,6,278
"94628",1094628,87,21,2,110
"94629",1094629,270,258,35,563
"94630",1094630,121,173,6,300
"94631",1094631,161,126,8,295
"94632",1094632,154,1,2,157
"94633",1094633,321,2,4,327
"94634",1094634,93,13,2,108
"94635",1094635,29,174,5,208
"94636",1094636,164,38,3,205
"94637",1094637,99,169,26,294
"94638",1094638,113,11,2,126
"94639",1094639,121,69,2,192
"94640",1094640,147,61,5,213
"94641",1094641,144,127,22,293
"94642",1094642,153,97,12,262
"94643",1094643,201,43,5,249
"94644",1094644,191,113,12,316
"94645",1094645,183,24,9,216
"94646",1094646,118,170,7,295
"94647",1094647,156,25,4,185
"94648",1094648,110,141,10,261
"94649",1094649,92,194,10,296
"94650",1094650,161,46,5,212
"94651",1094651,87,98,5,190
"94652",1094652,180,32,4,216
"94653",1094653,208,24,8,240
"94654",1094654,38,144,11,193
"94655",1094655,126,84,5,215
"94656",1094656,121,142,11,274
"94657",1094657,147,49,1,197
"94658",1094658,177,29,10,216
"94659",1094659,164,94,11,269
"94660",1094660,190,96,12,298
"94661",1094661,199,10,0,209
"94662",1094662,220,75,18,313
"94663",1094663,170,91,17,278
"94664",1094664,62,175,3,240
"94665",1094665,40,226,4,270
"94666",1094666,125,76,12,213
"94667",1094667,19,16,1,36
"94668",1094668,16,118,5,139
"94669",1094669,27,131,6,164
"94670",1094670,142,61,11,214
"94671",1094671,69,153,22,244
"94672",1094672,91,153,7,251
"94673",1094673,169,126,5,300
"94674",1094674,217,6,2,225
"94675",1094675,38,229,2,269
"94676",1094676,30,251,5,286
"94677",1094677,169,39,13,221
"94678",1094678,109,171,7,287
"94679",1094679,175,63,10,248
"94680",1094680,16,168,2,186
"94681",1094681,81,169,8,258
"94682",1094682,141,118,6,265
"94683",1094683,90,158,30,278
"94684",1094684,81,195,15,291
"94685",1094685,18,195,23,236
"94686",1094686,55,89,3,147
"94687",1094687,64,177,21,262
"94688",1094688,136,43,7,186
"94689",1094689,43,234,5,282
"94690",1094690,211,5,5,221
"94691",1094691,6,21,0,27
"94692",1094692,154,79,18,251
"94693",1094693,171,106,6,283
"94694",1094694,84,75,7,166
"94695",1094695,154,50,2,206
"94696",1094696,226,60,13,299
"94697",1094697,234,61,10,305
"94698",1094698,158,34,4,196
"94699",1094699,128,20,4,152
"94700",1094700,182,27,6,215
"94701",1094701,156,83,15,254
"94702",1094702,151,127,3,281
"94703",1094703,20,327,2,349
"94704",1094704,144,99,15,258
"94705",1094705,148,115,11,274
"94706",1094706,17,147,4,168
"94707",1094707,47,238,7,292
"94708",1094708,139,14,5,158
"94709",1094709,72,20,3,95
"94710",1094710,50,140,9,199
"94711",1094711,160,181,13,354
"94712",1094712,58,242,11,311
"94713",1094713,192,70,13,275
"94714",1094714,152,73,7,232
"94715",1094715,105,129,5,239
"94716",1094716,82,19,0,101
"94717",1094717,74,223,13,310
"94718",1094718,67,179,30,276
"94719",1094719,83,210,13,306
"94720",1094720,156,107,12,275
"94721",1094721,53,15,1,69
"94722",1094722,68,159,4,231
"94723",1094723,182,83,12,277
"94724",1094724,155,73,1,229
"94725",1094725,121,47,8,176
"94726",1094726,123,19,2,144
"94727",1094727,189,82,14,285
"94728",1094728,139,129,6,274
"94729",1094729,125,117,5,247
"94730",1094730,55,195,8,258
"94731",1094731,46,122,4,172
"94732",1094732,99,142,15,256
"94733",1094733,25,7,1,33
"94734",1094734,170,79,8,257
"94735",1094735,221,44,1,266
"94736",1094736,187,33,7,227
"94737",1094737,7,0,1,8
"94738",1094738,100,111,6,217
"94739",1094739,70,7,1,78
"94740",1094740,181,20,5,206
"94741",1094741,130,41,8,179
"94742",1094742,282,59,10,351
"94743",1094743,49,239,3,291
"94744",1094744,185,38,8,231
"94745",1094745,178,66,14,258
"94746",1094746,92,94,17,203
"94747",1094747,88,167,11,266
"94748",1094748,154,62,10,226
"94749",1094749,106,77,2,185
"94750",1094750,242,29,19,290
"94751",1094751,21,23,5,49
"94752",1094752,116,116,5,237
"94753",1094753,46,135,8,189
"94754",1094754,137,128,12,277
"94755",1094755,164,131,19,314
"94756",1094756,47,169,16,232
"94757",1094757,211,95,19,325
"94758",1094758,111,67,14,192
"94759",1094759,205,69,10,284
"94760",1094760,110,159,8,277
"94761",1094761,127,116,11,254
"94762",1094762,68,200,10,278
"94763",1094763,135,121,21,277
"94764",1094764,149,121,7,277
"94765",1094765,45,206,5,256
"94766",1094766,75,30,4,109
"94767",1094767,165,38,4,207
"94768",1094768,23,106,2,131
"94769",1094769,102,56,5,163
"94770",1094770,185,71,7,263
"94771",1094771,120,124,7,251
"94772",1094772,124,50,7,181
"94773",1094773,75,129,8,212
"94774",1094774,119,95,11,225
"94775",1094775,77,13,5,95
"94776",1094776,97,48,2,147
"94777",1094777,118,119,9,246
"94778",1094778,68,138,19,225
"94779",1094779,154,157,23,334
"94780",1094780,200,97,17,314
"94781",1094781,114,189,8,311
"94782",1094782,175,98,10,283
"94783",1094783,63,13,3,79
"94784",1094784,137,67,7,211
"94785",1094785,120,104,19,243
"94786",1094786,231,34,7,272
"94787",1094787,86,175,4,265
"94788",1094788,144,90,13,247
"94789",1094789,142,75,15,232
"94790",1094790,44,235,3,282
"94791",1094791,129,179,18,326
"94792",1094792,142,80,9,231
"94793",1094793,12,227,3,242
"94794",1094794,172,127,9,308
"94795",1094795,60,188,8,256
"94796",1094796,88,8,1,97
"94797",1094797,37,171,6,214
"94798",1094798,141,155,20,316
"94799",1094799,65,197,15,277
"94800",1094800,172,26,5,203
"94801",1094801,62,28,7,97
"94802",1094802,180,55,3,238
"94803",1094803,58,135,10,203
"94804",1094804,206,123,16,345
"94805",1094805,143,138,9,290
"94806",1094806,62,89,12,163
"94807",1094807,169,50,3,222
"94808",1094808,101,115,15,231
"94809",1094809,88,117,7,212
"94810",1094810,147,141,7,295
"94811",1094811,36,248,4,288
"94812",1094812,148,82,8,238
"94813",1094813,138,105,5,248
"94814",1094814,11,9,1,21
"94815",1094815,47,119,8,174
"94816",1094816,175,30,3,208
"94817",1094817,39,119,2,160
"94818",1094818,83,203,2,288
"94819",1094819,25,185,3,213
"94820",1094820,85,90,7,182
"94821",1094821,101,79,8,188
"94822",1094822,185,96,15,296
"94823",1094823,111,12,2,125
"94824",1094824,98,133,11,242
"94825",1094825,59,180,14,253
"94826",1094826,17,66,3,86
"94827",1094827,67,177,8,252
"94828",1094828,136,153,10,299
"94829",1094829,180,66,11,257
"94830",1094830,182,81,9,272
"94831",1094831,2,3,2,7
"94832",1094832,21,58,3,82
"94833",1094833,89,24,11,124
"94834",1094834,14,1,0,15
"94835",1094835,12,15,1,28
"94836",1094836,191,45,9,245
"94837",1094837,28,166,12,206
"94838",1094838,34,19,2,55
"94839",1094839,74,145,22,241
"94840",1094840,163,51,7,221
"94841",1094841,24,94,5,123
"94842",1094842,67,196,8,271
"94843",1094843,115,148,4,267
"94844",1094844,98,76,5,179
"94845",1094845,6,10,2,18
"94846",1094846,93,108,6,207
"94847",1094847,141,102,5,248
"94848",1094848,44,233,6,283
"94849",1094849,115,60,3,178
"94850",1094850,158,14,7,179
"94851",1094851,253,4,7,264
"94852",1094852,167,22,5,194
"94853",1094853,86,102,10,198
"94854",1094854,158,42,10,210
"94855",1094855,115,130,1,246
"94856",1094856,92,159,7,258
"94857",1094857,86,184,12,282
"94858",1094858,93,104,4,201
"94859",1094859,152,144,21,317
"94860",1094860,119,49,7,175
"94861",1094861,20,189,5,214
"94862",1094862,109,141,2,252
"94863",1094863,69,6,4,79
"94864",1094864,85,51,14,150
"94865",1094865,105,43,7,155
"94866",1094866,13,251,3,267
"94867",1094867,74,87,7,168
"94868",1094868,50,221,10,281
"94869",1094869,103,84,9,196
"94870",1094870,76,182,11,269
"94871",1094871,100,122,4,226
"94872",1094872,151,26,8,185
"94873",1094873,75,117,11,203
"94874",1094874,44,255,10,309
"94875",1094875,136,70,11,217
"94876",1094876,127,51,11,189
"94877",1094877,105,130,11,246
"94878",1094878,170,89,5,264
"94879",1094879,107,123,9,239
"94880",1094880,177,9,3,189
"94881",1094881,72,23,3,98
"94882",1094882,85,81,12,178
"94883",1094883,112,80,9,201
"94884",1094884,59,196,5,260
"94885",1094885,254,36,13,303
"94886",1094886,185,104,11,300
"94887",1094887,127,153,12,292
"94888",1094888,168,30,9,207
"94889",1094889,107,106,15,228
"94890",1094890,101,17,5,123
"94891",1094891,163,41,7,211
"94892",1094892,185,88,2,275
"94893",1094893,168,44,6,218
"94894",1094894,145,81,11,237
"94895",1094895,186,106,10,302
"94896",1094896,142,99,5,246
"94897",1094897,134,17,2,153
"94898",1094898,172,48,8,228
"94899",1094899,150,75,7,232
"94900",1094900,69,184,4,257
"94901",1094901,149,127,18,294
"94902",1094902,228,18,3,249
"94903",1094903,67,176,7,250
"94904",1094904,118,15,2,135
"94905",1094905,201,38,8,247
"94906",1094906,72,92,2,166
"94907",1094907,39,208,3,250
"94908",1094908,46,85,2,133
"94909",1094909,89,23,4,116
"94910",1094910,97,116,6,219
"94911",1094911,174,92,19,285
"94912",1094912,189,32,2,223
"94913",1094913,110,40,5,155
"94914",1094914,37,277,6,320
"94915",1094915,33,63,4,100
"94916",1094916,167,52,13,232
"94917",1094917,49,45,3,97
"94918",1094918,104,91,15,210
"94919",1094919,16,14,1,31
"94920",1094920,52,70,2,124
"94921",1094921,101,105,13,219
"94922",1094922,214,70,15,299
"94923",1094923,77,118,8,203
"94924",1094924,131,119,14,264
"94925",1094925,123,104,3,230
"94926",1094926,35,140,5,180
"94927",1094927,163,117,16,296
"94928",1094928,21,13,3,37
"94929",1094929,190,37,2,229
"94930",1094930,48,9,0,57
"94931",1094931,102,35,7,144
"94932",1094932,57,168,2,227
"94933",1094933,176,65,6,247
"94934",1094934,10,6,1,17
"94935",1094935,87,102,4,193
"94936",1094936,135,16,3,154
"94937",1094937,31,170,10,211
"94938",1094938,206,23,6,235
"94939",1094939,125,46,11,182
"94940",1094940,74,134,24,232
"94941",1094941,208,51,11,270
"94942",1094942,163,50,7,220
"94943",1094943,66,23,6,95
"94944",1094944,66,132,9,207
"94945",1094945,47,170,14,231
"94946",1094946,48,230,4,282
"94947",1094947,149,34,3,186
"94948",1094948,171,42,4,217
"94949",1094949,40,29,3,72
"94950",1094950,159,120,9,288
"94951",1094951,166,32,3,201
"94952",1094952,121,21,3,145
"94953",1094953,147,66,13,226
"94954",1094954,80,63,6,149
"94955",1094955,154,26,6,186
"94956",1094956,60,52,4,116
"94957",1094957,163,49,7,219
"94958",1094958,84,102,10,196
"94959",1094959,55,102,4,161
"94960",1094960,52,79,8,139
"94961",1094961,108,125,7,240
"94962",1094962,188,44,4,236
"94963",1094963,33,156,4,193
"94964",1094964,73,185,3,261
"94965",1094965,139,146,11,296
"94966",1094966,5,15,1,21
"94967",1094967,154,132,10,296
"94968",1094968,60,130,9,199
"94969",1094969,190,83,9,282
"94970",1094970,8,1,1,10
"94971",1094971,40,6,0,46
"94972",1094972,134,23,9,166
"94973",1094973,141,46,10,197
"94974",1094974,138,133,2,273
"94975",1094975,183,23,6,212
"94976",1094976,67,44,2,113
"94977",1094977,97,122,5,224
"94978",1094978,152,116,12,280
"94979",1094979,66,227,14,307
"94980",1094980,45,145,20,210
"94981",1094981,163,70,7,240
"94982",1094982,69,242,1,312
"94983",1094983,14,198,8,220
"94984",1094984,89,164,17,270
"94985",1094985,109,184,17,310
"94986",1094986,209,43,7,259
"94987",1094987,72,198,9,279
"94988",1094988,157,101,12,270
"94989",1094989,152,139,8,299
"94990",1094990,174,79,4,257
"94991",1094991,61,69,0,130
"94992",1094992,53,259,3,315
"94993",1094993,152,111,9,272
"94994",1094994,107,187,10,304
"94995",1094995,132,26,9,167
"94996",1094996,252,24,4,280
"94997",1094997,251,69,4,324
"94998",1094998,71,50,3,124
"94999",1094999,39,239,3,281
"95000",1095000,142,60,4,206
"95001",1095001,130,62,6,198
"95002",1095002,150,58,6,214
"95003",1095003,114,126,3,243
"95004",1095004,21,77,3,101
"95005",1095005,9,290,3,302
"95006",1095006,70,99,10,179
"95007",1095007,263,33,1,297
"95008",1095008,265,26,8,299
"95009",1095009,132,34,2,168
"95010",1095010,89,167,18,274
"95011",1095011,161,116,15,292
"95012",1095012,162,111,9,282
"95013",1095013,48,125,6,179
"95014",1095014,51,167,6,224
"95015",1095015,140,89,5,234
"95016",1095016,111,147,5,263
"95017",1095017,61,178,4,243
"95018",1095018,90,92,3,185
"95019",1095019,49,148,4,201
"95020",1095020,82,152,9,243
"95021",1095021,161,96,11,268
"95022",1095022,42,212,3,257
"95023",1095023,138,77,9,224
"95024",1095024,133,47,5,185
"95025",1095025,173,122,21,316
"95026",1095026,188,30,5,223
"95027",1095027,6,55,4,65
"95028",1095028,38,250,6,294
"95029",1095029,79,132,11,222
"95030",1095030,153,98,14,265
"95031",1095031,68,182,9,259
"95032",1095032,73,190,6,269
"95033",1095033,34,274,2,310
"95034",1095034,209,27,4,240
"95035",1095035,158,114,9,281
"95036",1095036,141,52,11,204
"95037",1095037,87,58,1,146
"95038",1095038,111,62,4,177
"95039",1095039,145,63,13,221
"95040",1095040,8,2,0,10
"95041",1095041,264,19,0,283
"95042",1095042,57,195,3,255
"95043",1095043,154,92,18,264
"95044",1095044,130,181,15,326
"95045",1095045,7,102,2,111
"95046",1095046,67,142,5,214
"95047",1095047,191,86,22,299
"95048",1095048,237,47,6,290
"95049",1095049,89,72,11,172
"95050",1095050,111,148,8,267
"95051",1095051,7,48,4,59
"95052",1095052,94,224,6,324
"95053",1095053,23,55,2,80
"95054",1095054,169,74,7,250
"95055",1095055,157,118,10,285
"95056",1095056,159,138,22,319
"95057",1095057,103,11,14,128
"95058",1095058,113,65,7,185
"95059",1095059,131,76,7,214
"95060",1095060,151,57,7,215
"95061",1095061,30,47,4,81
"95062",1095062,127,137,34,298
"95063",1095063,145,135,30,310
"95064",1095064,171,103,12,286
"95065",1095065,15,318,7,340
"95066",1095066,159,44,6,209
"95067",1095067,108,132,7,247
"95068",1095068,41,131,5,177
"95069",1095069,52,181,10,243
"95070",1095070,146,73,10,229
"95071",1095071,44,171,1,216
"95072",1095072,4,23,0,27
"95073",1095073,188,126,12,326
"95074",1095074,132,79,5,216
"95075",1095075,186,45,9,240
"95076",1095076,86,33,7,126
"95077",1095077,104,129,7,240
"95078",1095078,98,184,21,303
"95079",1095079,110,122,9,241
"95080",1095080,132,101,13,246
"95081",1095081,75,133,9,217
"95082",1095082,174,75,4,253
"95083",1095083,134,97,9,240
"95084",1095084,185,10,6,201
"95085",1095085,119,90,3,212
"95086",1095086,94,121,6,221
"95087",1095087,105,176,12,293
"95088",1095088,76,97,8,181
"95089",1095089,197,27,9,233
"95090",1095090,56,180,12,248
"95091",1095091,61,257,9,327
"95092",1095092,80,207,9,296
"95093",1095093,103,185,13,301
"95094",1095094,216,18,13,247
"95095",1095095,86,81,1,168
"95096",1095096,124,167,8,299
"95097",1095097,181,41,7,229
"95098",1095098,126,77,10,213
"95099",1095099,100,172,14,286
"95100",1095100,134,1,1,136
"95101",1095101,57,236,13,306
"95102",1095102,182,59,10,251
"95103",1095103,133,54,7,194
"95104",1095104,32,202,4,238
"95105",1095105,63,96,1,160
"95106",1095106,13,43,0,56
"95107",1095107,267,96,13,376
"95108",1095108,151,13,4,168
"95109",1095109,185,25,11,221
"95110",1095110,68,195,19,282
"95111",1095111,113,63,10,186
"95112",1095112,119,91,7,217
"95113",1095113,93,10,2,105
"95114",1095114,176,0,0,176
"95115",1095115,82,217,5,304
"95116",1095116,164,1,6,171
"95117",1095117,31,211,3,245
"95118",1095118,103,43,3,149
"95119",1095119,145,45,6,196
"95120",1095120,80,39,9,128
"95121",1095121,188,132,17,337
"95122",1095122,64,172,7,243
"95123",1095123,131,98,11,240
"95124",1095124,182,101,13,296
"95125",1095125,94,105,9,208
"95126",1095126,81,201,14,296
"95127",1095127,55,275,6,336
"95128",1095128,133,61,6,200
"95129",1095129,123,77,6,206
"95130",1095130,121,171,7,299
"95131",1095131,115,117,12,244
"95132",1095132,91,151,10,252
"95133",1095133,104,123,15,242
"95134",1095134,165,23,7,195
"95135",1095135,195,34,7,236
"95136",1095136,72,198,30,300
"95137",1095137,145,76,8,229
"95138",1095138,165,47,6,218
"95139",1095139,25,7,2,34
"95140",1095140,69,246,3,318
"95141",1095141,136,33,5,174
"95142",1095142,6,55,1,62
"95143",1095143,67,147,8,222
"95144",1095144,43,93,5,141
"95145",1095145,45,86,14,145
"95146",1095146,68,170,10,248
"95147",1095147,183,62,11,256
"95148",1095148,7,8,1,16
"95149",1095149,277,45,9,331
"95150",1095150,126,199,14,339
"95151",1095151,83,147,10,240
"95152",1095152,86,139,8,233
"95153",1095153,266,42,2,310
"95154",1095154,53,31,4,88
"95155",1095155,75,59,3,137
"95156",1095156,76,200,8,284
"95157",1095157,75,76,7,158
"95158",1095158,140,9,6,155
"95159",1095159,138,58,9,205
"95160",1095160,12,31,2,45
"95161",1095161,63,127,5,195
"95162",1095162,3,145,1,149
"95163",1095163,67,71,5,143
"95164",1095164,39,244,5,288
"95165",1095165,119,30,5,154
"95166",1095166,30,224,16,270
"95167",1095167,125,91,30,246
"95168",1095168,2,16,3,21
"95169",1095169,101,40,7,148
"95170",1095170,154,94,6,254
"95171",1095171,155,115,15,285
"95172",1095172,137,118,8,263
"95173",1095173,12,192,1,205
"95174",1095174,139,156,8,303
"95175",1095175,28,66,2,96
"95176",1095176,85,72,3,160
"95177",1095177,24,51,1,76
"95178",1095178,122,16,9,147
"95179",1095179,106,131,25,262
"95180",1095180,91,149,4,244
"95181",1095181,89,202,5,296
"95182",1095182,96,56,6,158
"95183",1095183,115,98,10,223
"95184",1095184,19,255,3,277
"95185",1095185,115,122,4,241
"95186",1095186,262,30,7,299
"95187",1095187,145,135,32,312
"95188",1095188,148,67,22,237
"95189",1095189,108,51,19,178
"95190",1095190,105,61,2,168
"95191",1095191,12,56,1,69
"95192",1095192,4,2,1,7
"95193",1095193,76,206,7,289
"95194",1095194,183,88,8,279
"95195",1095195,35,152,10,197
"95196",1095196,98,105,6,209
"95197",1095197,31,225,3,259
"95198",1095198,18,59,5,82
"95199",1095199,86,179,4,269
"95200",1095200,82,205,16,303
"95201",1095201,162,104,13,279
"95202",1095202,142,136,13,291
"95203",1095203,135,37,3,175
"95204",1095204,59,97,9,165
"95205",1095205,145,124,20,289
"95206",1095206,137,44,7,188
"95207",1095207,109,106,8,223
"95208",1095208,116,78,11,205
"95209",1095209,113,55,9,177
"95210",1095210,91,38,2,131
"95211",1095211,61,202,3,266
"95212",1095212,134,139,13,286
"95213",1095213,87,127,16,230
"95214",1095214,22,112,2,136
"95215",1095215,139,86,2,227
"95216",1095216,53,207,6,266
"95217",1095217,154,18,4,176
"95218",1095218,144,68,5,217
"95219",1095219,17,8,1,26
"95220",1095220,205,51,13,269
"95221",1095221,182,90,11,283
"95222",1095222,175,82,20,277
"95223",1095223,186,64,11,261
"95224",1095224,8,79,3,90
"95225",1095225,223,77,10,310
"95226",1095226,77,23,6,106
"95227",1095227,213,79,5,297
"95228",1095228,203,27,7,237
"95229",1095229,100,60,7,167
"95230",1095230,95,155,19,269
"95231",1095231,58,183,19,260
"95232",1095232,182,35,5,222
"95233",1095233,77,30,5,112
"95234",1095234,67,112,5,184
"95235",1095235,82,246,3,331
"95236",1095236,146,103,22,271
"95237",1095237,108,57,8,173
"95238",1095238,86,229,11,326
"95239",1095239,31,211,4,246
"95240",1095240,123,181,9,313
"95241",1095241,213,90,3,306
"95242",1095242,87,215,12,314
"95243",1095243,56,152,1,209
"95244",1095244,60,236,8,304
"95245",1095245,133,95,5,233
"95246",1095246,114,99,13,226
"95247",1095247,211,46,8,265
"95248",1095248,219,62,9,290
"95249",1095249,292,48,8,348
"95250",1095250,52,185,8,245
"95251",1095251,95,50,5,150
"95252",1095252,11,32,3,46
"95253",1095253,82,51,3,136
"95254",1095254,260,24,16,300
"95255",1095255,253,78,12,343
"95256",1095256,191,65,13,269
"95257",1095257,76,90,1,167
"95258",1095258,189,26,5,220
"95259",1095259,190,26,5,221
"95260",1095260,95,94,17,206
"95261",1095261,50,151,6,207
"95262",1095262,129,160,4,293
"95263",1095263,66,141,3,210
"95264",1095264,89,71,3,163
"95265",1095265,8,44,1,53
"95266",1095266,61,161,16,238
"95267",1095267,189,48,8,245
"95268",1095268,54,166,4,224
"95269",1095269,11,90,2,103
"95270",1095270,174,80,8,262
"95271",1095271,179,24,4,207
"95272",1095272,48,100,6,154
"95273",1095273,145,54,10,209
"95274",1095274,39,242,4,285
"95275",1095275,158,89,8,255
"95276",1095276,129,70,11,210
"95277",1095277,54,30,4,88
"95278",1095278,98,9,1,108
"95279",1095279,129,125,10,264
"95280",1095280,196,42,5,243
"95281",1095281,69,44,6,119
"95282",1095282,169,89,13,271
"95283",1095283,77,64,4,145
"95284",1095284,212,60,12,284
"95285",1095285,108,175,5,288
"95286",1095286,169,147,18,334
"95287",1095287,127,104,10,241
"95288",1095288,136,53,6,195
"95289",1095289,67,213,0,280
"95290",1095290,91,102,16,209
"95291",1095291,45,171,14,230
"95292",1095292,28,48,1,77
"95293",1095293,129,78,7,214
"95294",1095294,88,19,3,110
"95295",1095295,39,190,4,233
"95296",1095296,152,28,5,185
"95297",1095297,122,145,8,275
"95298",1095298,119,94,13,226
"95299",1095299,152,125,20,297
"95300",1095300,148,75,10,233
"95301",1095301,183,95,10,288
"95302",1095302,37,10,2,49
"95303",1095303,161,87,7,255
"95304",1095304,114,122,6,242
"95305",1095305,87,160,6,253
"95306",1095306,188,84,16,288
"95307",1095307,216,73,9,298
"95308",1095308,135,39,4,178
"95309",1095309,219,29,5,253
"95310",1095310,76,192,14,282
"95311",1095311,98,51,2,151
"95312",1095312,95,117,8,220
"95313",1095313,73,140,4,217
"95314",1095314,85,173,2,260
"95315",1095315,53,175,14,242
"95316",1095316,104,20,3,127
"95317",1095317,46,105,3,154
"95318",1095318,77,85,9,171
"95319",1095319,78,49,0,127
"95320",1095320,80,163,4,247
"95321",1095321,40,195,3,238
"95322",1095322,126,91,4,221
"95323",1095323,188,143,8,339
"95324",1095324,7,4,0,11
"95325",1095325,91,67,14,172
"95326",1095326,166,69,8,243
"95327",1095327,62,266,21,349
"95328",1095328,37,50,4,91
"95329",1095329,183,99,18,300
"95330",1095330,156,69,7,232
"95331",1095331,63,60,1,124
"95332",1095332,12,0,0,12
"95333",1095333,103,106,8,217
"95334",1095334,103,61,4,168
"95335",1095335,81,181,10,272
"95336",1095336,232,35,11,278
"95337",1095337,203,51,14,268
"95338",1095338,34,196,12,242
"95339",1095339,120,80,2,202
"95340",1095340,180,53,9,242
"95341",1095341,167,71,5,243
"95342",1095342,236,90,15,341
"95343",1095343,94,134,7,235
"95344",1095344,139,88,10,237
"95345",1095345,53,210,14,277
"95346",1095346,75,79,15,169
"95347",1095347,33,224,0,257
"95348",1095348,74,124,8,206
"95349",1095349,71,119,0,190
"95350",1095350,210,32,14,256
"95351",1095351,52,229,13,294
"95352",1095352,130,49,5,184
"95353",1095353,66,31,5,102
"95354",1095354,112,106,14,232
"95355",1095355,144,71,5,220
"95356",1095356,57,180,3,240
"95357",1095357,73,172,14,259
"95358",1095358,144,94,9,247
"95359",1095359,92,69,10,171
"95360",1095360,24,271,3,298
"95361",1095361,165,114,8,287
"95362",1095362,60,61,6,127
"95363",1095363,126,64,13,203
"95364",1095364,122,120,4,246
"95365",1095365,181,58,3,242
"95366",1095366,110,66,10,186
"95367",1095367,268,45,6,319
"95368",1095368,6,7,0,13
"95369",1095369,193,97,17,307
"95370",1095370,31,11,0,42
"95371",1095371,128,222,12,362
"95372",1095372,99,146,2,247
"95373",1095373,32,266,8,306
"95374",1095374,103,178,7,288
"95375",1095375,72,196,13,281
"95376",1095376,147,91,13,251
"95377",1095377,113,169,9,291
"95378",1095378,125,8,2,135
"95379",1095379,56,37,5,98
"95380",1095380,147,38,6,191
"95381",1095381,136,144,5,285
"95382",1095382,213,35,5,253
"95383",1095383,46,71,0,117
"95384",1095384,123,99,6,228
"95385",1095385,64,119,13,196
"95386",1095386,7,46,1,54
"95387",1095387,29,81,8,118
"95388",1095388,179,85,6,270
"95389",1095389,103,27,2,132
"95390",1095390,177,11,6,194
"95391",1095391,26,123,1,150
"95392",1095392,85,32,2,119
"95393",1095393,4,101,3,108
"95394",1095394,118,59,8,185
"95395",1095395,132,133,11,276
"95396",1095396,29,164,3,196
"95397",1095397,151,107,8,266
"95398",1095398,22,80,2,104
"95399",1095399,22,291,3,316
"95400",1095400,128,178,5,311
"95401",1095401,120,175,23,318
"95402",1095402,224,35,9,268
"95403",1095403,12,3,0,15
"95404",1095404,23,279,7,309
"95405",1095405,80,104,11,195
"95406",1095406,105,39,9,153
"95407",1095407,131,56,4,191
"95408",1095408,137,66,8,211
"95409",1095409,27,59,1,87
"95410",1095410,156,40,7,203
"95411",1095411,49,36,1,86
"95412",1095412,39,209,0,248
"95413",1095413,183,142,14,339
"95414",1095414,56,156,3,215
"95415",1095415,90,97,16,203
"95416",1095416,33,131,7,171
"95417",1095417,172,28,6,206
"95418",1095418,58,140,7,205
"95419",1095419,12,20,1,33
"95420",1095420,29,77,1,107
"95421",1095421,84,130,12,226
"95422",1095422,84,32,3,119
"95423",1095423,22,108,1,131
"95424",1095424,175,61,18,254
"95425",1095425,94,188,1,283
"95426",1095426,173,63,12,248
"95427",1095427,205,46,5,256
"95428",1095428,75,198,4,277
"95429",1095429,112,102,12,226
"95430",1095430,51,159,4,214
"95431",1095431,167,96,14,277
"95432",1095432,77,128,5,210
"95433",1095433,36,193,6,235
"95434",1095434,116,140,9,265
"95435",1095435,104,254,8,366
"95436",1095436,32,74,2,108
"95437",1095437,189,96,16,301
"95438",1095438,33,8,3,44
"95439",1095439,59,173,14,246
"95440",1095440,53,148,2,203
"95441",1095441,138,108,4,250
"95442",1095442,7,27,1,35
"95443",1095443,74,140,14,228
"95444",1095444,141,129,7,277
"95445",1095445,58,115,10,183
"95446",1095446,21,250,4,275
"95447",1095447,120,167,8,295
"95448",1095448,13,9,0,22
"95449",1095449,96,89,5,190
"95450",1095450,119,112,9,240
"95451",1095451,14,59,1,74
"95452",1095452,137,138,3,278
"95453",1095453,53,68,4,125
"95454",1095454,211,17,6,234
"95455",1095455,157,95,6,258
"95456",1095456,95,45,7,147
"95457",1095457,143,96,7,246
"95458",1095458,61,184,9,254
"95459",1095459,157,102,9,268
"95460",1095460,179,8,5,192
"95461",1095461,62,169,5,236
"95462",1095462,220,75,10,305
"95463",1095463,42,232,1,275
"95464",1095464,107,56,2,165
"95465",1095465,42,145,14,201
"95466",1095466,2,6,0,8
"95467",1095467,118,32,6,156
"95468",1095468,111,145,11,267
"95469",1095469,108,35,5,148
"95470",1095470,152,126,23,301
"95471",1095471,28,195,2,225
"95472",1095472,116,133,3,252
"95473",1095473,90,114,19,223
"95474",1095474,87,88,13,188
"95475",1095475,90,162,18,270
"95476",1095476,46,6,2,54
"95477",1095477,56,11,1,68
"95478",1095478,3,15,0,18
"95479",1095479,95,240,2,337
"95480",1095480,155,23,6,184
"95481",1095481,51,206,7,264
"95482",1095482,129,58,15,202
"95483",1095483,103,185,8,296
"95484",1095484,36,280,2,318
"95485",1095485,116,71,6,193
"95486",1095486,119,160,8,287
"95487",1095487,226,115,12,353
"95488",1095488,220,45,7,272
"95489",1095489,106,111,5,222
"95490",1095490,173,32,6,211
"95491",1095491,12,104,3,119
"95492",1095492,197,15,9,221
"95493",1095493,137,25,5,167
"95494",1095494,149,59,5,213
"95495",1095495,30,95,4,129
"95496",1095496,207,65,24,296
"95497",1095497,57,165,2,224
"95498",1095498,197,43,4,244
"95499",1095499,36,35,12,83
"95500",1095500,177,86,7,270
"95501",1095501,49,69,8,126
"95502",1095502,115,167,11,293
"95503",1095503,150,97,22,269
"95504",1095504,84,174,6,264
"95505",1095505,31,148,3,182
"95506",1095506,18,17,1,36
"95507",1095507,57,30,7,94
"95508",1095508,183,54,6,243
"95509",1095509,201,20,8,229
"95510",1095510,87,94,2,183
"95511",1095511,39,10,2,51
"95512",1095512,90,86,2,178
"95513",1095513,44,229,3,276
"95514",1095514,28,42,2,72
"95515",1095515,164,85,13,262
"95516",1095516,74,50,3,127
"95517",1095517,118,11,5,134
"95518",1095518,38,3,0,41
"95519",1095519,47,235,6,288
"95520",1095520,54,79,5,138
"95521",1095521,182,68,8,258
"95522",1095522,52,152,4,208
"95523",1095523,88,90,5,183
"95524",1095524,134,123,11,268
"95525",1095525,184,89,15,288
"95526",1095526,73,241,10,324
"95527",1095527,210,23,5,238
"95528",1095528,1,30,2,33
"95529",1095529,123,156,8,287
"95530",1095530,76,174,13,263
"95531",1095531,74,20,2,96
"95532",1095532,152,32,4,188
"95533",1095533,189,0,0,189
"95534",1095534,67,134,10,211
"95535",1095535,87,83,13,183
"95536",1095536,47,78,5,130
"95537",1095537,82,208,13,303
"95538",1095538,62,116,6,184
"95539",1095539,81,152,11,244
"95540",1095540,194,53,14,261
"95541",1095541,152,71,13,236
"95542",1095542,41,148,0,189
"95543",1095543,130,74,8,212
"95544",1095544,104,52,9,165
"95545",1095545,42,228,3,273
"95546",1095546,142,102,5,249
"95547",1095547,77,200,6,283
"95548",1095548,196,41,9,246
"95549",1095549,152,34,8,194
"95550",1095550,138,62,11,211
"95551",1095551,59,97,4,160
"95552",1095552,33,20,1,54
"95553",1095553,178,58,7,243
"95554",1095554,156,45,12,213
"95555",1095555,135,68,3,206
"95556",1095556,137,65,6,208
"95557",1095557,49,233,6,288
"95558",1095558,179,50,13,242
"95559",1095559,10,113,3,126
"95560",1095560,182,91,9,282
"95561",1095561,106,163,7,276
"95562",1095562,76,181,11,268
"95563",1095563,232,34,11,277
"95564",1095564,89,14,5,108
"95565",1095565,70,45,3,118
"95566",1095566,151,44,4,199
"95567",1095567,66,188,7,261
"95568",1095568,58,117,3,178
"95569",1095569,118,202,9,329
"95570",1095570,178,54,18,250
"95571",1095571,132,162,19,313
"95572",1095572,39,111,11,161
"95573",1095573,150,97,1,248
"95574",1095574,124,80,2,206
"95575",1095575,26,251,1,278
"95576",1095576,117,73,11,201
"95577",1095577,64,143,8,215
"95578",1095578,132,83,6,221
"95579",1095579,104,176,13,293
"95580",1095580,86,189,14,289
"95581",1095581,137,47,4,188
"95582",1095582,16,249,1,266
"95583",1095583,10,120,2,132
"95584",1095584,124,75,7,206
"95585",1095585,102,96,8,206
"95586",1095586,142,120,11,273
"95587",1095587,74,189,20,283
"95588",1095588,122,115,4,241
"95589",1095589,24,7,2,33
"95590",1095590,32,249,6,287
"95591",1095591,51,244,6,301
"95592",1095592,143,55,1,199
"95593",1095593,41,84,8,133
"95594",1095594,66,225,9,300
"95595",1095595,129,79,10,218
"95596",1095596,44,304,6,354
"95597",1095597,110,93,3,206
"95598",1095598,29,134,5,168
"95599",1095599,121,100,13,234
"95600",1095600,118,24,3,145
"95601",1095601,150,11,1,162
"95602",1095602,149,53,4,206
"95603",1095603,180,34,12,226
"95604",1095604,111,55,9,175
"95605",1095605,105,185,3,293
"95606",1095606,30,102,4,136
"95607",1095607,29,12,3,44
"95608",1095608,198,106,14,318
"95609",1095609,34,172,6,212
"95610",1095610,55,117,12,184
"95611",1095611,164,16,7,187
"95612",1095612,22,28,2,52
"95613",1095613,62,201,17,280
"95614",1095614,111,94,9,214
"95615",1095615,120,16,2,138
"95616",1095616,101,59,3,163
"95617",1095617,95,58,5,158
"95618",1095618,145,93,9,247
"95619",1095619,158,43,6,207
"95620",1095620,55,94,10,159
"95621",1095621,116,176,11,303
"95622",1095622,170,29,11,210
"95623",1095623,58,40,2,100
"95624",1095624,32,185,8,225
"95625",1095625,158,48,11,217
"95626",1095626,175,39,9,223
"95627",1095627,221,75,9,305
"95628",1095628,205,99,24,328
"95629",1095629,172,58,6,236
"95630",1095630,163,41,3,207
"95631",1095631,182,83,6,271
"95632",1095632,164,78,11,253
"95633",1095633,26,2,0,28
"95634",1095634,48,203,7,258
"95635",1095635,190,6,3,199
"95636",1095636,144,88,5,237
"95637",1095637,24,208,5,237
"95638",1095638,191,74,7,272
"95639",1095639,169,61,23,253
"95640",1095640,84,184,19,287
"95641",1095641,69,219,7,295
"95642",1095642,135,89,11,235
"95643",1095643,76,19,3,98
"95644",1095644,120,33,9,162
"95645",1095645,102,109,22,233
"95646",1095646,162,132,11,305
"95647",1095647,87,114,3,204
"95648",1095648,154,113,17,284
"95649",1095649,193,33,10,236
"95650",1095650,116,178,28,322
"95651",1095651,159,30,10,199
"95652",1095652,22,90,2,114
"95653",1095653,151,45,11,207
"95654",1095654,118,127,6,251
"95655",1095655,157,109,18,284
"95656",1095656,131,110,5,246
"95657",1095657,107,44,3,154
"95658",1095658,100,129,10,239
"95659",1095659,151,26,4,181
"95660",1095660,170,12,7,189
"95661",1095661,154,56,2,212
"95662",1095662,194,87,12,293
"95663",1095663,145,137,5,287
"95664",1095664,133,22,1,156
"95665",1095665,70,59,4,133
"95666",1095666,86,225,8,319
"95667",1095667,111,166,19,296
"95668",1095668,154,90,4,248
"95669",1095669,59,118,2,179
"95670",1095670,33,115,3,151
"95671",1095671,153,41,5,199
"95672",1095672,91,141,6,238
"95673",1095673,13,11,1,25
"95674",1095674,74,54,3,131
"95675",1095675,109,6,3,118
"95676",1095676,89,187,7,283
"95677",1095677,44,183,3,230
"95678",1095678,72,188,17,277
"95679",1095679,118,162,10,290
"95680",1095680,35,14,1,50
"95681",1095681,172,44,6,222
"95682",1095682,58,170,7,235
"95683",1095683,159,83,8,250
"95684",1095684,185,91,11,287
"95685",1095685,133,35,2,170
"95686",1095686,47,48,2,97
"95687",1095687,85,51,9,145
"95688",1095688,138,111,12,261
"95689",1095689,21,184,2,207
"95690",1095690,127,46,4,177
"95691",1095691,149,74,5,228
"95692",1095692,180,72,9,261
"95693",1095693,146,73,12,231
"95694",1095694,114,75,12,201
"95695",1095695,141,138,10,289
"95696",1095696,154,40,12,206
"95697",1095697,166,22,5,193
"95698",1095698,160,8,6,174
"95699",1095699,86,195,21,302
"95700",1095700,138,26,3,167
"95701",1095701,254,17,4,275
"95702",1095702,155,92,17,264
"95703",1095703,34,32,1,67
"95704",1095704,79,186,9,274
"95705",1095705,46,101,6,153
"95706",1095706,121,123,13,257
"95707",1095707,261,40,7,308
"95708",1095708,118,20,6,144
"95709",1095709,33,258,3,294
"95710",1095710,30,269,0,299
"95711",1095711,150,20,3,173
"95712",1095712,71,245,13,329
"95713",1095713,306,35,14,355
"95714",1095714,77,246,6,329
"95715",1095715,257,29,9,295
"95716",1095716,148,114,9,271
"95717",1095717,179,30,6,215
"95718",1095718,37,152,6,195
"95719",1095719,59,211,13,283
"95720",1095720,88,99,1,188
"95721",1095721,143,95,11,249
"95722",1095722,189,48,15,252
"95723",1095723,131,57,11,199
"95724",1095724,82,44,1,127
"95725",1095725,154,91,6,251
"95726",1095726,37,143,3,183
"95727",1095727,30,301,5,336
"95728",1095728,193,56,15,264
"95729",1095729,154,184,14,352
"95730",1095730,48,217,4,269
"95731",1095731,7,65,13,85
"95732",1095732,59,22,1,82
"95733",1095733,36,74,7,117
"95734",1095734,68,174,19,261
"95735",1095735,70,189,5,264
"95736",1095736,18,220,2,240
"95737",1095737,36,141,18,195
"95738",1095738,112,76,9,197
"95739",1095739,81,227,7,315
"95740",1095740,21,211,7,239
"95741",1095741,118,22,3,143
"95742",1095742,147,89,12,248
"95743",1095743,208,48,6,262
"95744",1095744,112,50,10,172
"95745",1095745,196,80,8,284
"95746",1095746,2,4,0,6
"95747",1095747,188,72,27,287
"95748",1095748,45,95,7,147
"95749",1095749,131,147,3,281
"95750",1095750,218,67,9,294
"95751",1095751,165,117,15,297
"95752",1095752,135,55,7,197
"95753",1095753,100,135,13,248
"95754",1095754,163,11,4,178
"95755",1095755,136,121,10,267
"95756",1095756,48,63,5,116
"95757",1095757,113,204,4,321
"95758",1095758,120,93,3,216
"95759",1095759,105,42,2,149
"95760",1095760,82,189,22,293
"95761",1095761,87,46,7,140
"95762",1095762,65,237,6,308
"95763",1095763,55,201,15,271
"95764",1095764,161,25,16,202
"95765",1095765,235,32,8,275
"95766",1095766,104,68,11,183
"95767",1095767,143,97,9,249
"95768",1095768,42,91,13,146
"95769",1095769,79,38,2,119
"95770",1095770,17,0,0,17
"95771",1095771,13,3,0,16
"95772",1095772,73,22,3,98
"95773",1095773,75,18,0,93
"95774",1095774,18,11,1,30
"95775",1095775,90,30,8,128
"95776",1095776,3,21,0,24
"95777",1095777,144,51,0,195
"95778",1095778,130,85,5,220
"95779",1095779,117,68,8,193
"95780",1095780,108,183,5,296
"95781",1095781,172,116,11,299
"95782",1095782,139,51,46,236
"95783",1095783,52,198,19,269
"95784",1095784,31,23,1,55
"95785",1095785,120,73,4,197
"95786",1095786,144,59,3,206
"95787",1095787,183,6,2,191
"95788",1095788,203,42,10,255
"95789",1095789,60,209,6,275
"95790",1095790,112,121,4,237
"95791",1095791,207,97,18,322
"95792",1095792,66,165,6,237
"95793",1095793,151,34,5,190
"95794",1095794,112,129,5,246
"95795",1095795,182,15,5,202
"95796",1095796,55,141,7,203
"95797",1095797,178,102,16,296
"95798",1095798,64,199,7,270
"95799",1095799,157,48,16,221
"95800",1095800,130,58,4,192
"95801",1095801,56,154,7,217
"95802",1095802,23,3,2,28
"95803",1095803,82,164,12,258
"95804",1095804,45,71,9,125
"95805",1095805,214,50,8,272
"95806",1095806,175,22,4,201
"95807",1095807,50,121,4,175
"95808",1095808,146,24,6,176
"95809",1095809,98,9,3,110
"95810",1095810,126,120,5,251
"95811",1095811,110,191,10,311
"95812",1095812,133,18,5,156
"95813",1095813,102,52,6,160
"95814",1095814,47,127,5,179
"95815",1095815,176,18,2,196
"95816",1095816,35,155,2,192
"95817",1095817,46,58,6,110
"95818",1095818,156,147,23,326
"95819",1095819,59,75,2,136
"95820",1095820,106,180,11,297
"95821",1095821,20,253,3,276
"95822",1095822,39,196,4,239
"95823",1095823,119,75,6,200
"95824",1095824,18,54,1,73
"95825",1095825,186,63,7,256
"95826",1095826,62,235,17,314
"95827",1095827,218,76,11,305
"95828",1095828,71,216,2,289
"95829",1095829,156,30,5,191
"95830",1095830,65,230,13,308
"95831",1095831,216,23,8,247
"95832",1095832,90,50,4,144
"95833",1095833,106,37,3,146
"95834",1095834,194,135,13,342
"95835",1095835,45,243,13,301
"95836",1095836,125,41,4,170
"95837",1095837,105,133,16,254
"95838",1095838,180,49,11,240
"95839",1095839,152,137,11,300
"95840",1095840,111,29,6,146
"95841",1095841,28,216,0,244
"95842",1095842,57,9,1,67
"95843",1095843,52,176,5,233
"95844",1095844,160,26,9,195
"95845",1095845,156,128,20,304
"95846",1095846,154,106,6,266
"95847",1095847,53,182,5,240
"95848",1095848,94,83,4,181
"95849",1095849,43,208,5,256
"95850",1095850,173,89,16,278
"95851",1095851,135,62,1,198
"95852",1095852,20,196,6,222
"95853",1095853,61,175,13,249
"95854",1095854,60,113,13,186
"95855",1095855,219,21,5,245
"95856",1095856,94,125,8,227
"95857",1095857,34,266,1,301
"95858",1095858,122,13,5,140
"95859",1095859,28,149,5,182
"95860",1095860,177,102,12,291
"95861",1095861,71,243,13,327
"95862",1095862,67,31,0,98
"95863",1095863,94,186,15,295
"95864",1095864,116,120,7,243
"95865",1095865,66,39,2,107
"95866",1095866,216,18,5,239
"95867",1095867,108,87,11,206
"95868",1095868,180,89,9,278
"95869",1095869,108,23,10,141
"95870",1095870,13,1,0,14
"95871",1095871,164,130,19,313
"95872",1095872,180,35,5,220
"95873",1095873,135,88,4,227
"95874",1095874,27,1,0,28
"95875",1095875,159,87,3,249
"95876",1095876,82,175,12,269
"95877",1095877,98,60,5,163
"95878",1095878,49,36,4,89
"95879",1095879,125,40,4,169
"95880",1095880,193,42,3,238
"95881",1095881,69,166,7,242
"95882",1095882,199,45,2,246
"95883",1095883,116,66,18,200
"95884",1095884,144,54,11,209
"95885",1095885,102,70,5,177
"95886",1095886,162,93,6,261
"95887",1095887,52,49,7,108
"95888",1095888,194,15,11,220
"95889",1095889,5,6,0,11
"95890",1095890,59,191,3,253
"95891",1095891,24,210,5,239
"95892",1095892,157,57,10,224
"95893",1095893,184,97,18,299
"95894",1095894,133,71,12,216
"95895",1095895,55,223,10,288
"95896",1095896,102,4,5,111
"95897",1095897,69,110,1,180
"95898",1095898,202,54,6,262
"95899",1095899,51,146,10,207
"95900",1095900,35,255,1,291
"95901",1095901,61,79,3,143
"95902",1095902,141,124,15,280
"95903",1095903,180,136,18,334
"95904",1095904,213,32,5,250
"95905",1095905,103,55,6,164
"95906",1095906,157,21,8,186
"95907",1095907,180,100,17,297
"95908",1095908,88,2,4,94
"95909",1095909,166,19,4,189
"95910",1095910,119,16,6,141
"95911",1095911,30,50,5,85
"95912",1095912,86,100,3,189
"95913",1095913,129,126,2,257
"95914",1095914,52,133,9,194
"95915",1095915,112,36,3,151
"95916",1095916,125,69,1,195
"95917",1095917,15,79,1,95
"95918",1095918,39,196,0,235
"95919",1095919,107,62,10,179
"95920",1095920,22,105,8,135
"95921",1095921,80,50,0,130
"95922",1095922,183,43,13,239
"95923",1095923,218,101,7,326
"95924",1095924,60,97,10,167
"95925",1095925,86,203,4,293
"95926",1095926,133,85,19,237
"95927",1095927,118,158,11,287
"95928",1095928,113,2,4,119
"95929",1095929,135,108,9,252
"95930",1095930,58,135,7,200
"95931",1095931,88,181,12,281
"95932",1095932,154,42,22,218
"95933",1095933,47,15,1,63
"95934",1095934,64,179,13,256
"95935",1095935,112,65,9,186
"95936",1095936,72,221,3,296
"95937",1095937,114,100,5,219
"95938",1095938,100,101,17,218
"95939",1095939,170,55,2,227
"95940",1095940,74,124,8,206
"95941",1095941,198,19,6,223
"95942",1095942,192,45,8,245
"95943",1095943,60,173,1,234
"95944",1095944,49,103,2,154
"95945",1095945,115,30,8,153
"95946",1095946,47,132,7,186
"95947",1095947,238,14,9,261
"95948",1095948,44,235,16,295
"95949",1095949,84,118,16,218
"95950",1095950,136,46,16,198
"95951",1095951,88,139,15,242
"95952",1095952,117,187,18,322
"95953",1095953,23,267,1,291
"95954",1095954,37,220,4,261
"95955",1095955,73,159,8,240
"95956",1095956,68,134,0,202
"95957",1095957,6,5,0,11
"95958",1095958,82,198,4,284
"95959",1095959,146,114,11,271
"95960",1095960,193,71,14,278
"95961",1095961,183,64,15,262
"95962",1095962,77,124,12,213
"95963",1095963,82,191,4,277
"95964",1095964,166,54,5,225
"95965",1095965,176,60,13,249
"95966",1095966,53,270,6,329
"95967",1095967,189,203,19,411
"95968",1095968,194,68,8,270
"95969",1095969,158,57,12,227
"95970",1095970,160,65,12,237
"95971",1095971,4,23,0,27
"95972",1095972,95,110,11,216
"95973",1095973,57,175,4,236
"95974",1095974,46,271,3,320
"95975",1095975,148,107,6,261
"95976",1095976,139,24,9,172
"95977",1095977,162,53,8,223
"95978",1095978,203,85,11,299
"95979",1095979,76,96,0,172
"95980",1095980,142,87,4,233
"95981",1095981,102,192,8,302
"95982",1095982,54,174,5,233
"95983",1095983,35,220,8,263
"95984",1095984,79,81,9,169
"95985",1095985,42,231,6,279
"95986",1095986,11,11,0,22
"95987",1095987,81,176,6,263
"95988",1095988,13,24,1,38
"95989",1095989,121,32,7,160
"95990",1095990,94,56,2,152
"95991",1095991,91,145,3,239
"95992",1095992,22,37,0,59
"95993",1095993,251,7,26,284
"95994",1095994,147,72,5,224
"95995",1095995,136,107,16,259
"95996",1095996,174,60,6,240
"95997",1095997,36,23,2,61
"95998",1095998,63,145,8,216
"95999",1095999,1,174,1,176
"96000",1096000,66,55,4,125
"96001",1096001,51,194,9,254
"96002",1096002,25,186,8,219
"96003",1096003,44,232,6,282
"96004",1096004,251,27,7,285
"96005",1096005,29,215,8,252
"96006",1096006,105,87,7,199
"96007",1096007,150,40,5,195
"96008",1096008,29,152,3,184
"96009",1096009,146,110,9,265
"96010",1096010,191,103,15,309
"96011",1096011,129,34,7,170
"96012",1096012,93,138,8,239
"96013",1096013,160,76,3,239
"96014",1096014,174,55,12,241
"96015",1096015,86,195,12,293
"96016",1096016,107,52,3,162
"96017",1096017,168,32,4,204
"96018",1096018,80,216,8,304
"96019",1096019,103,134,7,244
"96020",1096020,124,98,8,230
"96021",1096021,190,66,6,262
"96022",1096022,151,33,7,191
"96023",1096023,219,23,7,249
"96024",1096024,82,186,15,283
"96025",1096025,75,98,11,184
"96026",1096026,235,26,0,261
"96027",1096027,66,119,8,193
"96028",1096028,28,155,5,188
"96029",1096029,96,167,5,268
"96030",1096030,59,199,15,273
"96031",1096031,53,1,0,54
"96032",1096032,169,116,8,293
"96033",1096033,147,54,10,211
"96034",1096034,64,27,7,98
"96035",1096035,112,78,18,208
"96036",1096036,79,217,4,300
"96037",1096037,155,71,18,244
"96038",1096038,31,186,2,219
"96039",1096039,233,19,10,262
"96040",1096040,31,25,0,56
"96041",1096041,201,21,8,230
"96042",1096042,170,71,2,243
"96043",1096043,2,8,0,10
"96044",1096044,59,149,11,219
"96045",1096045,64,119,1,184
"96046",1096046,83,181,9,273
"96047",1096047,43,118,1,162
"96048",1096048,36,168,8,212
"96049",1096049,115,72,13,200
"96050",1096050,176,43,2,221
"96051",1096051,201,98,11,310
"96052",1096052,141,144,2,287
"96053",1096053,5,152,2,159
"96054",1096054,63,138,5,206
"96055",1096055,94,125,10,229
"96056",1096056,51,132,10,193
"96057",1096057,26,150,8,184
"96058",1096058,122,27,9,158
"96059",1096059,215,26,6,247
"96060",1096060,104,16,5,125
"96061",1096061,59,167,6,232
"96062",1096062,58,124,6,188
"96063",1096063,47,195,13,255
"96064",1096064,69,117,11,197
"96065",1096065,35,195,4,234
"96066",1096066,8,34,4,46
"96067",1096067,142,114,4,260
"96068",1096068,47,94,9,150
"96069",1096069,76,45,5,126
"96070",1096070,34,161,7,202
"96071",1096071,9,19,2,30
"96072",1096072,208,24,8,240
"96073",1096073,99,167,19,285
"96074",1096074,91,104,18,213
"96075",1096075,157,127,10,294
"96076",1096076,23,49,2,74
"96077",1096077,132,8,7,147
"96078",1096078,47,22,0,69
"96079",1096079,35,181,9,225
"96080",1096080,109,150,3,262
"96081",1096081,128,30,12,170
"96082",1096082,160,66,11,237
"96083",1096083,204,29,6,239
"96084",1096084,43,173,2,218
"96085",1096085,163,58,7,228
"96086",1096086,52,273,8,333
"96087",1096087,108,94,7,209
"96088",1096088,109,16,0,125
"96089",1096089,44,60,6,110
"96090",1096090,137,61,5,203
"96091",1096091,139,47,8,194
"96092",1096092,123,2,8,133
"96093",1096093,111,137,7,255
"96094",1096094,95,110,6,211
"96095",1096095,164,15,2,181
"96096",1096096,90,235,3,328
"96097",1096097,43,169,11,223
"96098",1096098,203,102,4,309
"96099",1096099,222,93,5,320
"96100",1096100,129,43,6,178
"96101",1096101,87,127,2,216
"96102",1096102,98,89,4,191
"96103",1096103,104,106,4,214
"96104",1096104,73,107,2,182
"96105",1096105,234,65,7,306
"96106",1096106,155,129,18,302
"96107",1096107,233,25,7,265
"96108",1096108,142,44,6,192
"96109",1096109,52,151,4,207
"96110",1096110,99,178,12,289
"96111",1096111,168,53,6,227
"96112",1096112,117,102,12,231
"96113",1096113,44,93,5,142
"96114",1096114,266,23,19,308
"96115",1096115,108,128,7,243
"96116",1096116,125,103,8,236
"96117",1096117,87,217,7,311
"96118",1096118,101,221,17,339
"96119",1096119,104,50,6,160
"96120",1096120,129,41,2,172
"96121",1096121,65,195,22,282
"96122",1096122,156,102,12,270
"96123",1096123,101,161,8,270
"96124",1096124,51,73,9,133
"96125",1096125,137,27,11,175
"96126",1096126,53,229,12,294
"96127",1096127,131,108,8,247
"96128",1096128,135,4,0,139
"96129",1096129,100,70,8,178
"96130",1096130,38,145,4,187
"96131",1096131,88,129,9,226
"96132",1096132,47,77,2,126
"96133",1096133,75,195,10,280
"96134",1096134,143,107,7,257
"96135",1096135,17,176,1,194
"96136",1096136,116,18,0,134
"96137",1096137,146,175,15,336
"96138",1096138,48,233,9,290
"96139",1096139,43,62,6,111
"96140",1096140,59,168,14,241
"96141",1096141,170,126,8,304
"96142",1096142,214,48,4,266
"96143",1096143,186,131,5,322
"96144",1096144,32,88,5,125
"96145",1096145,148,107,10,265
"96146",1096146,37,227,9,273
"96147",1096147,65,259,7,331
"96148",1096148,218,36,7,261
"96149",1096149,152,112,14,278
"96150",1096150,43,276,3,322
"96151",1096151,175,137,8,320
"96152",1096152,194,40,5,239
"96153",1096153,183,32,3,218
"96154",1096154,163,51,12,226
"96155",1096155,100,44,15,159
"96156",1096156,85,182,10,277
"96157",1096157,230,50,16,296
"96158",1096158,101,175,16,292
"96159",1096159,203,78,10,291
"96160",1096160,261,7,20,288
"96161",1096161,54,166,15,235
"96162",1096162,122,68,16,206
"96163",1096163,181,52,13,246
"96164",1096164,103,36,5,144
"96165",1096165,137,114,9,260
"96166",1096166,188,60,6,254
"96167",1096167,117,69,8,194
"96168",1096168,94,30,9,133
"96169",1096169,90,54,8,152
"96170",1096170,165,51,5,221
"96171",1096171,36,45,6,87
"96172",1096172,170,50,25,245
"96173",1096173,36,192,5,233
"96174",1096174,81,209,16,306
"96175",1096175,151,49,4,204
"96176",1096176,45,243,2,290
"96177",1096177,130,140,13,283
"96178",1096178,81,235,8,324
"96179",1096179,79,163,3,245
"96180",1096180,151,59,11,221
"96181",1096181,106,71,14,191
"96182",1096182,133,55,3,191
"96183",1096183,207,152,5,364
"96184",1096184,40,107,5,152
"96185",1096185,85,55,9,149
"96186",1096186,113,43,3,159
"96187",1096187,187,74,7,268
"96188",1096188,54,205,11,270
"96189",1096189,23,101,9,133
"96190",1096190,129,59,6,194
"96191",1096191,145,18,11,174
"96192",1096192,57,111,12,180
"96193",1096193,123,176,14,313
"96194",1096194,102,86,20,208
"96195",1096195,127,55,7,189
"96196",1096196,77,78,13,168
"96197",1096197,103,79,8,190
"96198",1096198,76,202,8,286
"96199",1096199,7,270,1,278
"96200",1096200,56,136,8,200
"96201",1096201,198,82,21,301
"96202",1096202,70,153,24,247
"96203",1096203,115,70,11,196
"96204",1096204,38,212,5,255
"96205",1096205,40,110,5,155
"96206",1096206,35,226,2,263
"96207",1096207,141,95,4,240
"96208",1096208,85,94,17,196
"96209",1096209,58,187,1,246
"96210",1096210,149,77,8,234
"96211",1096211,39,235,22,296
"96212",1096212,106,116,17,239
"96213",1096213,232,41,17,290
"96214",1096214,89,78,1,168
"96215",1096215,50,206,14,270
"96216",1096216,153,55,3,211
"96217",1096217,128,95,13,236
"96218",1096218,160,54,5,219
"96219",1096219,48,153,5,206
"96220",1096220,105,187,14,306
"96221",1096221,165,90,7,262
"96222",1096222,72,75,8,155
"96223",1096223,3,35,7,45
"96224",1096224,98,140,28,266
"96225",1096225,80,170,9,259
"96226",1096226,107,63,12,182
"96227",1096227,101,133,7,241
"96228",1096228,1,10,2,13
"96229",1096229,19,75,0,94
"96230",1096230,27,257,1,285
"96231",1096231,44,46,7,97
"96232",1096232,140,32,8,180
"96233",1096233,105,145,3,253
"96234",1096234,212,36,10,258
"96235",1096235,101,86,2,189
"96236",1096236,132,192,9,333
"96237",1096237,116,40,3,159
"96238",1096238,1,29,0,30
"96239",1096239,170,80,14,264
"96240",1096240,131,21,3,155
"96241",1096241,75,81,6,162
"96242",1096242,114,146,11,271
"96243",1096243,106,116,7,229
"96244",1096244,100,180,10,290
"96245",1096245,16,14,1,31
"96246",1096246,145,80,9,234
"96247",1096247,82,30,4,116
"96248",1096248,101,146,12,259
"96249",1096249,31,8,1,40
"96250",1096250,110,158,10,278
"96251",1096251,216,58,20,294
"96252",1096252,52,195,9,256
"96253",1096253,120,28,13,161
"96254",1096254,131,88,3,222
"96255",1096255,21,153,6,180
"96256",1096256,123,193,11,327
"96257",1096257,199,17,3,219
"96258",1096258,172,105,21,298
"96259",1096259,187,59,3,249
"96260",1096260,37,291,3,331
"96261",1096261,162,29,1,192
"96262",1096262,127,24,5,156
"96263",1096263,68,121,6,195
"96264",1096264,166,113,10,289
"96265",1096265,69,145,14,228
"96266",1096266,102,144,7,253
"96267",1096267,75,139,13,227
"96268",1096268,93,194,8,295
"96269",1096269,64,213,6,283
"96270",1096270,172,48,8,228
"96271",1096271,256,21,2,279
"96272",1096272,38,23,9,70
"96273",1096273,121,75,7,203
"96274",1096274,5,4,1,10
"96275",1096275,111,35,1,147
"96276",1096276,29,120,7,156
"96277",1096277,72,202,11,285
"96278",1096278,151,112,11,274
"96279",1096279,91,153,12,256
"96280",1096280,41,117,3,161
"96281",1096281,61,231,10,302
"96282",1096282,3,7,0,10
"96283",1096283,34,20,0,54
"96284",1096284,116,131,14,261
"96285",1096285,135,129,23,287
"96286",1096286,162,70,13,245
"96287",1096287,77,230,8,315
"96288",1096288,191,42,11,244
"96289",1096289,4,3,1,8
"96290",1096290,60,31,7,98
"96291",1096291,226,66,7,299
"96292",1096292,150,72,15,237
"96293",1096293,204,68,17,289
"96294",1096294,217,38,3,258
"96295",1096295,125,34,9,168
"96296",1096296,94,161,8,263
"96297",1096297,169,48,6,223
"96298",1096298,210,56,15,281
"96299",1096299,30,237,3,270
"96300",1096300,119,96,7,222
"96301",1096301,130,139,25,294
"96302",1096302,186,46,6,238
"96303",1096303,40,2,3,45
"96304",1096304,63,165,3,231
"96305",1096305,127,26,5,158
"96306",1096306,209,40,4,253
"96307",1096307,143,66,2,211
"96308",1096308,212,14,12,238
"96309",1096309,290,94,22,406
"96310",1096310,56,192,9,257
"96311",1096311,61,83,3,147
"96312",1096312,53,180,9,242
"96313",1096313,150,77,14,241
"96314",1096314,191,114,12,317
"96315",1096315,114,80,9,203
"96316",1096316,59,134,6,199
"96317",1096317,92,46,1,139
"96318",1096318,218,57,10,285
"96319",1096319,194,89,14,297
"96320",1096320,33,121,3,157
"96321",1096321,94,285,15,394
"96322",1096322,184,58,17,259
"96323",1096323,115,74,2,191
"96324",1096324,171,84,8,263
"96325",1096325,77,44,3,124
"96326",1096326,184,66,5,255
"96327",1096327,98,50,5,153
"96328",1096328,125,72,5,202
"96329",1096329,168,20,9,197
"96330",1096330,183,79,8,270
"96331",1096331,92,125,9,226
"96332",1096332,191,62,5,258
"96333",1096333,123,56,3,182
"96334",1096334,84,182,7,273
"96335",1096335,45,203,0,248
"96336",1096336,219,116,18,353
"96337",1096337,165,110,20,295
"96338",1096338,114,87,4,205
"96339",1096339,92,125,18,235
"96340",1096340,210,36,11,257
"96341",1096341,116,113,8,237
"96342",1096342,153,58,6,217
"96343",1096343,121,83,2,206
"96344",1096344,120,178,17,315
"96345",1096345,78,149,6,233
"96346",1096346,70,101,10,181
"96347",1096347,66,165,3,234
"96348",1096348,52,197,7,256
"96349",1096349,134,50,10,194
"96350",1096350,53,210,9,272
"96351",1096351,214,45,7,266
"96352",1096352,181,31,8,220
"96353",1096353,226,70,10,306
"96354",1096354,122,116,5,243
"96355",1096355,155,60,12,227
"96356",1096356,34,261,3,298
"96357",1096357,294,70,14,378
"96358",1096358,17,44,0,61
"96359",1096359,138,56,13,207
"96360",1096360,198,77,24,299
"96361",1096361,189,62,16,267
"96362",1096362,88,42,6,136
"96363",1096363,35,220,10,265
"96364",1096364,188,64,2,254
"96365",1096365,176,39,3,218
"96366",1096366,117,91,10,218
"96367",1096367,157,162,19,338
"96368",1096368,42,186,14,242
"96369",1096369,201,24,6,231
"96370",1096370,140,1,1,142
"96371",1096371,138,27,1,166
"96372",1096372,168,4,3,175
"96373",1096373,139,86,8,233
"96374",1096374,176,41,11,228
"96375",1096375,91,185,9,285
"96376",1096376,197,36,8,241
"96377",1096377,169,38,6,213
"96378",1096378,82,43,1,126
"96379",1096379,191,27,3,221
"96380",1096380,12,75,5,92
"96381",1096381,95,118,13,226
"96382",1096382,76,207,1,284
"96383",1096383,98,172,7,277
"96384",1096384,137,70,8,215
"96385",1096385,194,63,12,269
"96386",1096386,37,8,1,46
"96387",1096387,168,85,15,268
"96388",1096388,26,29,5,60
"96389",1096389,138,157,7,302
"96390",1096390,39,222,4,265
"96391",1096391,173,8,4,185
"96392",1096392,191,65,6,262
"96393",1096393,139,128,4,271
"96394",1096394,32,213,13,258
"96395",1096395,87,100,12,199
"96396",1096396,146,54,3,203
"96397",1096397,130,68,9,207
"96398",1096398,176,59,6,241
"96399",1096399,115,174,13,302
"96400",1096400,116,86,8,210
"96401",1096401,24,28,0,52
"96402",1096402,113,150,10,273
"96403",1096403,153,75,9,237
"96404",1096404,67,138,2,207
"96405",1096405,63,139,5,207
"96406",1096406,232,40,6,278
"96407",1096407,25,268,3,296
"96408",1096408,148,39,17,204
"96409",1096409,211,42,8,261
"96410",1096410,61,208,5,274
"96411",1096411,122,41,2,165
"96412",1096412,137,5,8,150
"96413",1096413,128,59,4,191
"96414",1096414,21,213,6,240
"96415",1096415,104,7,2,113
"96416",1096416,39,215,4,258
"96417",1096417,165,31,11,207
"96418",1096418,155,161,3,319
"96419",1096419,196,76,8,280
"96420",1096420,50,177,3,230
"96421",1096421,170,99,17,286
"96422",1096422,95,138,1,234
"96423",1096423,26,22,0,48
"96424",1096424,272,23,4,299
"96425",1096425,169,85,5,259
"96426",1096426,197,99,11,307
"96427",1096427,249,7,1,257
"96428",1096428,77,128,27,232
"96429",1096429,85,89,1,175
"96430",1096430,106,14,3,123
"96431",1096431,109,40,3,152
"96432",1096432,94,82,4,180
"96433",1096433,212,69,20,301
"96434",1096434,107,178,11,296
"96435",1096435,65,141,2,208
"96436",1096436,122,112,7,241
"96437",1096437,74,89,7,170
"96438",1096438,66,208,5,279
"96439",1096439,44,226,8,278
"96440",1096440,129,64,7,200
"96441",1096441,143,119,10,272
"96442",1096442,108,75,6,189
"96443",1096443,150,1,1,152
"96444",1096444,72,208,15,295
"96445",1096445,53,120,3,176
"96446",1096446,123,99,2,224
"96447",1096447,60,293,8,361
"96448",1096448,193,15,2,210
"96449",1096449,152,103,16,271
"96450",1096450,270,34,4,308
"96451",1096451,91,11,4,106
"96452",1096452,118,48,9,175
"96453",1096453,61,232,7,300
"96454",1096454,13,0,0,13
"96455",1096455,164,19,6,189
"96456",1096456,198,74,2,274
"96457",1096457,164,122,17,303
"96458",1096458,206,88,18,312
"96459",1096459,123,77,3,203
"96460",1096460,185,40,21,246
"96461",1096461,12,16,3,31
"96462",1096462,72,201,21,294
"96463",1096463,80,26,0,106
"96464",1096464,149,69,3,221
"96465",1096465,176,66,11,253
"96466",1096466,18,5,3,26
"96467",1096467,54,205,3,262
"96468",1096468,171,135,15,321
"96469",1096469,81,21,3,105
"96470",1096470,81,137,7,225
"96471",1096471,208,44,10,262
"96472",1096472,66,108,2,176
"96473",1096473,82,21,3,106
"96474",1096474,193,64,5,262
"96475",1096475,55,182,4,241
"96476",1096476,74,129,10,213
"96477",1096477,94,173,15,282
"96478",1096478,99,69,9,177
"96479",1096479,193,94,4,291
"96480",1096480,59,136,6,201
"96481",1096481,148,84,9,241
"96482",1096482,255,53,6,314
"96483",1096483,7,30,0,37
"96484",1096484,42,185,1,228
"96485",1096485,50,188,11,249
"96486",1096486,56,43,1,100
"96487",1096487,97,132,13,242
"96488",1096488,72,54,7,133
"96489",1096489,12,41,1,54
"96490",1096490,156,120,6,282
"96491",1096491,182,39,7,228
"96492",1096492,63,29,6,98
"96493",1096493,39,230,9,278
"96494",1096494,173,18,3,194
"96495",1096495,112,43,5,160
"96496",1096496,93,140,13,246
"96497",1096497,102,176,10,288
"96498",1096498,25,119,2,146
"96499",1096499,41,10,0,51
"96500",1096500,249,18,4,271
"96501",1096501,196,35,6,237
"96502",1096502,227,0,0,227
"96503",1096503,25,17,2,44
"96504",1096504,332,3,4,339
"96505",1096505,61,277,6,344
"96506",1096506,13,0,0,13
"96507",1096507,154,96,9,259
"96508",1096508,38,162,13,213
"96509",1096509,83,37,4,124
"96510",1096510,84,201,6,291
"96511",1096511,120,172,15,307
"96512",1096512,166,38,8,212
"96513",1096513,97,65,6,168
"96514",1096514,170,36,2,208
"96515",1096515,197,33,10,240
"96516",1096516,194,74,3,271
"96517",1096517,156,81,7,244
"96518",1096518,71,168,2,241
"96519",1096519,130,161,13,304
"96520",1096520,32,152,15,199
"96521",1096521,236,90,12,338
"96522",1096522,68,93,8,169
"96523",1096523,187,89,7,283
"96524",1096524,105,119,7,231
"96525",1096525,110,126,9,245
"96526",1096526,51,197,13,261
"96527",1096527,179,124,13,316
"96528",1096528,14,13,0,27
"96529",1096529,43,59,3,105
"96530",1096530,75,175,8,258
"96531",1096531,129,72,17,218
"96532",1096532,12,267,8,287
"96533",1096533,127,68,20,215
"96534",1096534,87,135,8,230
"96535",1096535,76,142,3,221
"96536",1096536,203,14,2,219
"96537",1096537,2,4,2,8
"96538",1096538,44,12,1,57
"96539",1096539,193,95,23,311
"96540",1096540,177,75,15,267
"96541",1096541,81,36,8,125
"96542",1096542,130,75,1,206
"96543",1096543,86,81,6,173
"96544",1096544,190,58,9,257
"96545",1096545,153,88,15,256
"96546",1096546,77,211,8,296
"96547",1096547,106,125,13,244
"96548",1096548,102,175,6,283
"96549",1096549,134,40,6,180
"96550",1096550,85,148,12,245
"96551",1096551,175,30,8,213
"96552",1096552,49,235,3,287
"96553",1096553,182,60,11,253
"96554",1096554,137,148,11,296
"96555",1096555,119,132,11,262
"96556",1096556,13,264,2,279
"96557",1096557,131,97,10,238
"96558",1096558,57,74,9,140
"96559",1096559,157,74,6,237
"96560",1096560,197,29,3,229
"96561",1096561,108,104,6,218
"96562",1096562,73,173,18,264
"96563",1096563,158,109,12,279
"96564",1096564,67,58,5,130
"96565",1096565,106,163,17,286
"96566",1096566,82,97,3,182
"96567",1096567,79,96,5,180
"96568",1096568,33,17,0,50
"96569",1096569,32,85,12,129
"96570",1096570,47,182,5,234
"96571",1096571,132,18,5,155
"96572",1096572,25,170,20,215
"96573",1096573,42,220,8,270
"96574",1096574,128,140,11,279
"96575",1096575,146,84,11,241
"96576",1096576,75,236,10,321
"96577",1096577,111,173,16,300
"96578",1096578,196,57,13,266
"96579",1096579,42,177,3,222
"96580",1096580,18,69,6,93
"96581",1096581,87,183,8,278
"96582",1096582,117,156,14,287
"96583",1096583,93,255,5,353
"96584",1096584,128,54,16,198
"96585",1096585,29,118,10,157
"96586",1096586,170,31,7,208
"96587",1096587,185,39,6,230
"96588",1096588,57,131,11,199
"96589",1096589,54,157,8,219
"96590",1096590,167,12,9,188
"96591",1096591,155,102,22,279
"96592",1096592,133,54,2,189
"96593",1096593,30,139,3,172
"96594",1096594,149,65,15,229
"96595",1096595,233,51,11,295
"96596",1096596,171,72,5,248
"96597",1096597,220,26,6,252
"96598",1096598,99,142,7,248
"96599",1096599,135,18,8,161
"96600",1096600,169,79,15,263
"96601",1096601,146,107,7,260
"96602",1096602,195,100,9,304
"96603",1096603,197,48,4,249
"96604",1096604,48,130,6,184
"96605",1096605,50,141,11,202
"96606",1096606,45,173,12,230
"96607",1096607,110,149,17,276
"96608",1096608,82,13,6,101
"96609",1096609,63,242,5,310
"96610",1096610,18,11,1,30
"96611",1096611,220,19,11,250
"96612",1096612,126,91,7,224
"96613",1096613,57,127,9,193
"96614",1096614,65,154,3,222
"96615",1096615,96,128,9,233
"96616",1096616,192,63,23,278
"96617",1096617,86,119,4,209
"96618",1096618,55,185,6,246
"96619",1096619,117,30,4,151
"96620",1096620,4,31,1,36
"96621",1096621,47,34,4,85
"96622",1096622,31,205,2,238
"96623",1096623,133,55,7,195
"96624",1096624,74,167,24,265
"96625",1096625,125,81,11,217
"96626",1096626,130,104,8,242
"96627",1096627,8,22,0,30
"96628",1096628,161,41,6,208
"96629",1096629,84,53,6,143
"96630",1096630,0,0,0,0
"96631",1096631,32,233,2,267
"96632",1096632,67,68,4,139
"96633",1096633,143,69,8,220
"96634",1096634,112,70,5,187
"96635",1096635,74,167,11,252
"96636",1096636,60,211,22,293
"96637",1096637,133,112,5,250
"96638",1096638,172,42,21,235
"96639",1096639,263,45,10,318
"96640",1096640,139,162,1,302
"96641",1096641,143,167,13,323
"96642",1096642,8,246,11,265
"96643",1096643,91,119,11,221
"96644",1096644,164,37,8,209
"96645",1096645,120,172,9,301
"96646",1096646,124,163,15,302
"96647",1096647,160,47,11,218
"96648",1096648,132,52,6,190
"96649",1096649,187,86,14,287
"96650",1096650,96,63,6,165
"96651",1096651,162,154,17,333
"96652",1096652,87,211,8,306
"96653",1096653,55,155,11,221
"96654",1096654,106,112,11,229
"96655",1096655,57,60,4,121
"96656",1096656,132,192,8,332
"96657",1096657,104,172,9,285
"96658",1096658,141,146,15,302
"96659",1096659,115,172,15,302
"96660",1096660,63,157,23,243
"96661",1096661,176,92,3,271
"96662",1096662,78,121,12,211
"96663",1096663,154,87,11,252
"96664",1096664,100,34,1,135
"96665",1096665,115,130,3,248
"96666",1096666,167,26,4,197
"96667",1096667,214,12,2,228
"96668",1096668,23,143,10,176
"96669",1096669,91,168,12,271
"96670",1096670,77,226,8,311
"96671",1096671,100,165,3,268
"96672",1096672,204,14,6,224
"96673",1096673,148,172,14,334
"96674",1096674,93,133,9,235
"96675",1096675,87,127,16,230
"96676",1096676,143,24,1,168
"96677",1096677,82,49,0,131
"96678",1096678,129,76,8,213
"96679",1096679,79,61,4,144
"96680",1096680,135,159,13,307
"96681",1096681,136,164,15,315
"96682",1096682,53,29,4,86
"96683",1096683,35,81,0,116
"96684",1096684,93,215,11,319
"96685",1096685,54,241,16,311
"96686",1096686,128,144,10,282
"96687",1096687,161,18,3,182
"96688",1096688,55,63,4,122
"96689",1096689,85,35,4,124
"96690",1096690,34,25,2,61
"96691",1096691,52,160,5,217
"96692",1096692,228,98,7,333
"96693",1096693,172,92,12,276
"96694",1096694,112,114,12,238
"96695",1096695,96,127,9,232
"96696",1096696,129,108,9,246
"96697",1096697,188,44,9,241
"96698",1096698,142,56,8,206
"96699",1096699,102,245,7,354
"96700",1096700,223,86,5,314
"96701",1096701,50,189,5,244
"96702",1096702,86,50,1,137
"96703",1096703,67,132,10,209
"96704",1096704,429,49,17,495
"96705",1096705,131,129,13,273
"96706",1096706,169,88,20,277
"96707",1096707,186,112,5,303
"96708",1096708,194,50,5,249
"96709",1096709,83,147,8,238
"96710",1096710,129,53,8,190
"96711",1096711,104,99,9,212
"96712",1096712,217,28,9,254
"96713",1096713,224,79,16,319
"96714",1096714,81,75,7,163
"96715",1096715,83,74,18,175
"96716",1096716,112,70,7,189
"96717",1096717,137,13,3,153
"96718",1096718,71,83,5,159
"96719",1096719,79,117,18,214
"96720",1096720,64,111,5,180
"96721",1096721,13,17,2,32
"96722",1096722,20,200,2,222
"96723",1096723,5,12,0,17
"96724",1096724,119,189,9,317
"96725",1096725,168,86,3,257
"96726",1096726,171,74,10,255
"96727",1096727,50,30,2,82
"96728",1096728,105,207,6,318
"96729",1096729,74,208,5,287
"96730",1096730,131,77,7,215
"96731",1096731,47,148,6,201
"96732",1096732,191,15,8,214
"96733",1096733,67,67,3,137
"96734",1096734,139,147,9,295
"96735",1096735,138,148,9,295
"96736",1096736,94,190,3,287
"96737",1096737,28,195,5,228
"96738",1096738,203,87,12,302
"96739",1096739,143,61,1,205
"96740",1096740,190,91,16,297
"96741",1096741,200,97,10,307
"96742",1096742,108,111,16,235
"96743",1096743,164,28,3,195
"96744",1096744,170,95,8,273
"96745",1096745,95,70,6,171
"96746",1096746,171,66,13,250
"96747",1096747,244,45,3,292
"96748",1096748,69,229,2,300
"96749",1096749,43,140,1,184
"96750",1096750,190,36,23,249
"96751",1096751,46,185,3,234
"96752",1096752,117,114,7,238
"96753",1096753,178,76,9,263
"96754",1096754,39,179,5,223
"96755",1096755,183,23,2,208
"96756",1096756,55,245,5,305
"96757",1096757,67,23,2,92
"96758",1096758,2,5,3,10
"96759",1096759,158,105,13,276
"96760",1096760,97,84,1,182
"96761",1096761,76,187,4,267
"96762",1096762,125,107,7,239
"96763",1096763,82,227,11,320
"96764",1096764,73,133,16,222
"96765",1096765,119,76,19,214
"96766",1096766,34,41,2,77
"96767",1096767,35,10,3,48
"96768",1096768,150,96,5,251
"96769",1096769,100,150,2,252
"96770",1096770,224,43,8,275
"96771",1096771,239,57,10,306
"96772",1096772,147,72,6,225
"96773",1096773,57,84,6,147
"96774",1096774,143,68,8,219
"96775",1096775,225,58,10,293
"96776",1096776,90,231,3,324
"96777",1096777,198,42,8,248
"96778",1096778,97,98,7,202
"96779",1096779,103,93,7,203
"96780",1096780,119,68,2,189
"96781",1096781,123,147,23,293
"96782",1096782,114,130,2,246
"96783",1096783,55,210,14,279
"96784",1096784,68,9,4,81
"96785",1096785,159,85,12,256
"96786",1096786,90,133,12,235
"96787",1096787,136,32,3,171
"96788",1096788,204,40,12,256
"96789",1096789,94,86,9,189
"96790",1096790,111,139,13,263
"96791",1096791,147,16,4,167
"96792",1096792,140,34,5,179
"96793",1096793,132,59,9,200
"96794",1096794,68,171,19,258
"96795",1096795,145,72,7,224
"96796",1096796,75,190,20,285
"96797",1096797,51,204,5,260
"96798",1096798,231,61,11,303
"96799",1096799,196,80,7,283
"96800",1096800,51,99,1,151
"96801",1096801,173,98,5,276
"96802",1096802,0,22,0,22
"96803",1096803,31,184,4,219
"96804",1096804,20,28,0,48
"96805",1096805,52,232,10,294
"96806",1096806,164,136,10,310
"96807",1096807,27,207,0,234
"96808",1096808,84,66,4,154
"96809",1096809,40,66,1,107
"96810",1096810,115,85,11,211
"96811",1096811,140,59,1,200
"96812",1096812,146,32,7,185
"96813",1096813,48,43,10,101
"96814",1096814,96,189,5,290
"96815",1096815,108,58,4,170
"96816",1096816,104,47,5,156
"96817",1096817,85,33,2,120
"96818",1096818,104,176,9,289
"96819",1096819,214,57,6,277
"96820",1096820,88,80,1,169
"96821",1096821,130,104,5,239
"96822",1096822,41,117,1,159
"96823",1096823,118,35,12,165
"96824",1096824,63,138,7,208
"96825",1096825,124,106,14,244
"96826",1096826,101,173,7,281
"96827",1096827,152,98,8,258
"96828",1096828,129,133,22,284
"96829",1096829,220,30,8,258
"96830",1096830,157,25,9,191
"96831",1096831,173,40,2,215
"96832",1096832,130,13,4,147
"96833",1096833,78,81,4,163
"96834",1096834,177,29,4,210
"96835",1096835,9,60,3,72
"96836",1096836,168,49,10,227
"96837",1096837,97,38,4,139
"96838",1096838,163,139,9,311
"96839",1096839,143,52,9,204
"96840",1096840,122,61,13,196
"96841",1096841,167,98,14,279
"96842",1096842,100,184,8,292
"96843",1096843,82,85,11,178
"96844",1096844,130,84,3,217
"96845",1096845,67,58,9,134
"96846",1096846,143,10,1,154
"96847",1096847,32,173,5,210
"96848",1096848,87,114,11,212
"96849",1096849,105,18,4,127
"96850",1096850,125,66,12,203
"96851",1096851,240,17,8,265
"96852",1096852,51,113,17,181
"96853",1096853,208,102,3,313
"96854",1096854,111,110,1,222
"96855",1096855,96,42,5,143
"96856",1096856,146,25,2,173
"96857",1096857,222,60,12,294
"96858",1096858,66,106,6,178
"96859",1096859,193,100,15,308
"96860",1096860,175,26,7,208
"96861",1096861,63,173,5,241
"96862",1096862,137,31,3,171
"96863",1096863,52,227,1,280
"96864",1096864,82,160,24,266
"96865",1096865,80,35,10,125
"96866",1096866,14,186,2,202
"96867",1096867,32,284,3,319
"96868",1096868,201,59,12,272
"96869",1096869,39,226,4,269
"96870",1096870,114,42,10,166
"96871",1096871,82,106,6,194
"96872",1096872,160,72,15,247
"96873",1096873,97,175,7,279
"96874",1096874,157,111,12,280
"96875",1096875,155,144,21,320
"96876",1096876,132,0,0,132
"96877",1096877,217,17,9,243
"96878",1096878,146,59,2,207
"96879",1096879,166,105,10,281
"96880",1096880,85,146,14,245
"96881",1096881,182,15,6,203
"96882",1096882,30,203,3,236
"96883",1096883,166,32,9,207
"96884",1096884,144,41,1,186
"96885",1096885,122,38,12,172
"96886",1096886,180,74,9,263
"96887",1096887,52,162,5,219
"96888",1096888,213,12,5,230
"96889",1096889,118,148,15,281
"96890",1096890,232,2,1,235
"96891",1096891,153,106,4,263
"96892",1096892,55,26,0,81
"96893",1096893,85,67,2,154
"96894",1096894,20,168,1,189
"96895",1096895,156,108,9,273
"96896",1096896,206,82,8,296
"96897",1096897,77,170,14,261
"96898",1096898,200,67,12,279
"96899",1096899,128,110,4,242
"96900",1096900,145,133,3,281
"96901",1096901,202,55,6,263
"96902",1096902,42,37,3,82
"96903",1096903,160,106,12,278
"96904",1096904,108,163,9,280
"96905",1096905,26,81,2,109
"96906",1096906,137,16,1,154
"96907",1096907,139,71,10,220
"96908",1096908,61,105,6,172
"96909",1096909,96,66,5,167
"96910",1096910,73,240,9,322
"96911",1096911,87,66,11,164
"96912",1096912,179,27,16,222
"96913",1096913,43,243,9,295
"96914",1096914,90,64,13,167
"96915",1096915,119,34,2,155
"96916",1096916,99,185,11,295
"96917",1096917,194,91,5,290
"96918",1096918,179,18,7,204
"96919",1096919,107,123,11,241
"96920",1096920,35,100,2,137
"96921",1096921,123,73,3,199
"96922",1096922,29,293,3,325
"96923",1096923,68,37,5,110
"96924",1096924,118,123,8,249
"96925",1096925,181,58,4,243
"96926",1096926,130,2,2,134
"96927",1096927,14,82,7,103
"96928",1096928,79,140,3,222
"96929",1096929,33,201,7,241
"96930",1096930,165,138,19,322
"96931",1096931,130,92,8,230
"96932",1096932,104,123,9,236
"96933",1096933,194,56,19,269
"96934",1096934,84,111,13,208
"96935",1096935,73,197,11,281
"96936",1096936,80,142,8,230
"96937",1096937,122,156,14,292
"96938",1096938,121,85,9,215
"96939",1096939,65,174,10,249
"96940",1096940,40,161,7,208
"96941",1096941,173,88,7,268
"96942",1096942,178,136,2,316
"96943",1096943,103,133,16,252
"96944",1096944,64,151,1,216
"96945",1096945,40,69,3,112
"96946",1096946,227,12,5,244
"96947",1096947,81,162,18,261
"96948",1096948,216,42,9,267
"96949",1096949,84,62,12,158
"96950",1096950,106,42,10,158
"96951",1096951,93,157,15,265
"96952",1096952,245,56,14,315
"96953",1096953,201,42,7,250
"96954",1096954,30,31,2,63
"96955",1096955,63,154,5,222
"96956",1096956,127,92,9,228
"96957",1096957,38,210,9,257
"96958",1096958,131,87,7,225
"96959",1096959,100,156,10,266
"96960",1096960,171,69,4,244
"96961",1096961,108,85,12,205
"96962",1096962,146,111,10,267
"96963",1096963,27,256,3,286
"96964",1096964,134,72,3,209
"96965",1096965,88,67,7,162
"96966",1096966,37,34,3,74
"96967",1096967,102,80,7,189
"96968",1096968,90,100,13,203
"96969",1096969,239,32,7,278
"96970",1096970,121,174,13,308
"96971",1096971,152,36,4,192
"96972",1096972,97,149,16,262
"96973",1096973,56,138,11,205
"96974",1096974,73,58,5,136
"96975",1096975,39,192,4,235
"96976",1096976,128,85,7,220
"96977",1096977,63,121,3,187
"96978",1096978,109,54,14,177
"96979",1096979,223,73,6,302
"96980",1096980,124,85,6,215
"96981",1096981,156,66,7,229
"96982",1096982,54,166,9,229
"96983",1096983,264,21,9,294
"96984",1096984,65,218,12,295
"96985",1096985,132,164,12,308
"96986",1096986,166,70,13,249
"96987",1096987,158,54,7,219
"96988",1096988,24,215,3,242
"96989",1096989,136,105,7,248
"96990",1096990,160,48,10,218
"96991",1096991,84,72,19,175
"96992",1096992,77,95,20,192
"96993",1096993,73,171,24,268
"96994",1096994,84,82,7,173
"96995",1096995,128,58,2,188
"96996",1096996,94,168,8,270
"96997",1096997,53,73,13,139
"96998",1096998,128,140,18,286
"96999",1096999,32,43,3,78
"97000",1097000,177,42,8,227
"97001",1097001,12,82,1,95
"97002",1097002,186,96,11,293
"97003",1097003,4,6,0,10
"97004",1097004,242,11,7,260
"97005",1097005,58,201,9,268
"97006",1097006,235,37,8,280
"97007",1097007,31,195,2,228
"97008",1097008,193,67,17,277
"97009",1097009,181,18,9,208
"97010",1097010,190,75,10,275
"97011",1097011,58,221,3,282
"97012",1097012,126,99,7,232
"97013",1097013,144,90,6,240
"97014",1097014,139,83,13,235
"97015",1097015,52,185,18,255
"97016",1097016,42,239,1,282
"97017",1097017,62,125,10,197
"97018",1097018,120,104,10,234
"97019",1097019,50,91,11,152
"97020",1097020,106,160,15,281
"97021",1097021,119,76,18,213
"97022",1097022,238,36,13,287
"97023",1097023,148,114,15,277
"97024",1097024,175,134,17,326
"97025",1097025,128,71,9,208
"97026",1097026,96,111,16,223
"97027",1097027,152,83,3,238
"97028",1097028,84,83,25,192
"97029",1097029,221,18,2,241
"97030",1097030,116,85,4,205
"97031",1097031,154,52,4,210
"97032",1097032,198,37,6,241
"97033",1097033,81,41,6,128
"97034",1097034,45,215,1,261
"97035",1097035,25,6,0,31
"97036",1097036,149,150,7,306
"97037",1097037,60,92,6,158
"97038",1097038,131,65,1,197
"97039",1097039,154,38,5,197
"97040",1097040,153,268,25,446
"97041",1097041,42,204,3,249
"97042",1097042,145,89,5,239
"97043",1097043,37,211,0,248
"97044",1097044,29,131,8,168
"97045",1097045,131,121,4,256
"97046",1097046,65,37,6,108
"97047",1097047,158,90,4,252
"97048",1097048,78,185,20,283
"97049",1097049,122,47,2,171
"97050",1097050,122,174,14,310
"97051",1097051,202,53,11,266
"97052",1097052,185,24,8,217
"97053",1097053,176,84,6,266
"97054",1097054,159,82,8,249
"97055",1097055,197,59,2,258
"97056",1097056,105,102,25,232
"97057",1097057,187,98,8,293
"97058",1097058,79,118,9,206
"97059",1097059,104,120,4,228
"97060",1097060,152,73,12,237
"97061",1097061,66,226,5,297
"97062",1097062,93,27,11,131
"97063",1097063,87,121,9,217
"97064",1097064,260,4,0,264
"97065",1097065,155,129,14,298
"97066",1097066,130,55,10,195
"97067",1097067,100,200,4,304
"97068",1097068,136,58,5,199
"97069",1097069,285,9,9,303
"97070",1097070,23,242,2,267
"97071",1097071,207,31,6,244
"97072",1097072,30,96,12,138
"97073",1097073,220,35,6,261
"97074",1097074,80,82,12,174
"97075",1097075,188,22,4,214
"97076",1097076,96,119,11,226
"97077",1097077,56,75,5,136
"97078",1097078,106,30,3,139
"97079",1097079,69,10,3,82
"97080",1097080,4,7,0,11
"97081",1097081,34,218,11,263
"97082",1097082,121,127,13,261
"97083",1097083,29,42,4,75
"97084",1097084,41,55,5,101
"97085",1097085,158,48,7,213
"97086",1097086,158,132,10,300
"97087",1097087,88,240,6,334
"97088",1097088,47,229,6,282
"97089",1097089,155,46,1,202
"97090",1097090,169,99,15,283
"97091",1097091,313,11,5,329
"97092",1097092,91,63,7,161
"97093",1097093,107,104,7,218
"97094",1097094,99,141,10,250
"97095",1097095,3,43,1,47
"97096",1097096,151,19,6,176
"97097",1097097,81,160,10,251
"97098",1097098,184,85,24,293
"97099",1097099,37,41,3,81
"97100",1097100,104,155,12,271
"97101",1097101,62,179,9,250
"97102",1097102,5,40,0,45
"97103",1097103,24,231,3,258
"97104",1097104,72,261,6,339
"97105",1097105,100,119,7,226
"97106",1097106,71,89,8,168
"97107",1097107,22,4,1,27
"97108",1097108,118,56,4,178
"97109",1097109,197,20,10,227
"97110",1097110,120,159,14,293
"97111",1097111,76,171,12,259
"97112",1097112,74,98,14,186
"97113",1097113,101,42,5,148
"97114",1097114,58,241,2,301
"97115",1097115,53,204,2,259
"97116",1097116,167,90,11,268
"97117",1097117,174,106,5,285
"97118",1097118,15,211,2,228
"97119",1097119,45,121,7,173
"97120",1097120,46,323,13,382
"97121",1097121,163,102,13,278
"97122",1097122,138,120,13,271
"97123",1097123,168,144,6,318
"97124",1097124,133,106,5,244
"97125",1097125,74,70,1,145
"97126",1097126,110,29,13,152
"97127",1097127,110,151,16,277
"97128",1097128,140,24,5,169
"97129",1097129,77,25,3,105
"97130",1097130,192,52,8,252
"97131",1097131,37,249,6,292
"97132",1097132,109,181,11,301
"97133",1097133,111,56,14,181
"97134",1097134,61,199,7,267
"97135",1097135,150,28,6,184
"97136",1097136,149,60,24,233
"97137",1097137,55,18,2,75
"97138",1097138,167,119,10,296
"97139",1097139,135,17,6,158
"97140",1097140,3,7,2,12
"97141",1097141,40,171,0,211
"97142",1097142,133,158,10,301
"97143",1097143,12,8,0,20
"97144",1097144,42,17,0,59
"97145",1097145,43,159,8,210
"97146",1097146,83,173,10,266
"97147",1097147,75,197,10,282
"97148",1097148,86,225,5,316
"97149",1097149,12,15,1,28
"97150",1097150,138,133,7,278
"97151",1097151,38,242,7,287
"97152",1097152,43,179,5,227
"97153",1097153,209,31,9,249
"97154",1097154,66,20,0,86
"97155",1097155,112,59,4,175
"97156",1097156,60,220,5,285
"97157",1097157,192,41,11,244
"97158",1097158,106,99,11,216
"97159",1097159,184,45,4,233
"97160",1097160,31,75,10,116
"97161",1097161,141,77,15,233
"97162",1097162,22,273,1,296
"97163",1097163,202,63,6,271
"97164",1097164,60,147,7,214
"97165",1097165,149,149,15,313
"97166",1097166,287,81,14,382
"97167",1097167,184,123,14,321
"97168",1097168,148,46,12,206
"97169",1097169,187,79,7,273
"97170",1097170,124,54,6,184
"97171",1097171,162,113,8,283
"97172",1097172,131,96,6,233
"97173",1097173,246,13,5,264
"97174",1097174,83,158,5,246
"97175",1097175,207,63,8,278
"97176",1097176,154,54,9,217
"97177",1097177,6,21,1,28
"97178",1097178,195,20,2,217
"97179",1097179,244,32,14,290
"97180",1097180,109,151,11,271
"97181",1097181,29,96,7,132
"97182",1097182,110,126,7,243
"97183",1097183,114,74,0,188
"97184",1097184,141,37,5,183
"97185",1097185,124,72,4,200
"97186",1097186,80,81,2,163
"97187",1097187,58,199,18,275
"97188",1097188,34,10,3,47
"97189",1097189,105,175,10,290
"97190",1097190,128,80,12,220
"97191",1097191,134,127,9,270
"97192",1097192,126,126,16,268
"97193",1097193,206,74,8,288
"97194",1097194,117,127,13,257
"97195",1097195,282,6,5,293
"97196",1097196,106,185,13,304
"97197",1097197,120,178,13,311
"97198",1097198,142,87,10,239
"97199",1097199,77,61,9,147
"97200",1097200,252,40,5,297
"97201",1097201,237,23,8,268
"97202",1097202,73,202,11,286
"97203",1097203,117,3,0,120
"97204",1097204,38,176,6,220
"97205",1097205,59,218,12,289
"97206",1097206,151,68,10,229
"97207",1097207,34,250,3,287
"97208",1097208,108,214,18,340
"97209",1097209,96,170,6,272
"97210",1097210,180,73,10,263
"97211",1097211,40,70,4,114
"97212",1097212,213,16,8,237
"97213",1097213,136,50,6,192
"97214",1097214,167,94,8,269
"97215",1097215,176,98,1,275
"97216",1097216,10,5,0,15
"97217",1097217,80,46,5,131
"97218",1097218,132,14,8,154
"97219",1097219,63,207,20,290
"97220",1097220,140,171,8,319
"97221",1097221,67,195,8,270
"97222",1097222,119,62,11,192
"97223",1097223,80,186,16,282
"97224",1097224,37,207,3,247
"97225",1097225,118,114,10,242
"97226",1097226,69,116,8,193
"97227",1097227,46,274,5,325
"97228",1097228,28,47,0,75
"97229",1097229,138,126,9,273
"97230",1097230,80,191,7,278
"97231",1097231,120,9,5,134
"97232",1097232,235,47,13,295
"97233",1097233,72,168,20,260
"97234",1097234,19,53,1,73
"97235",1097235,33,26,4,63
"97236",1097236,15,135,4,154
"97237",1097237,232,40,8,280
"97238",1097238,152,44,6,202
"97239",1097239,22,205,3,230
"97240",1097240,36,157,9,202
"97241",1097241,81,29,0,110
"97242",1097242,152,76,2,230
"97243",1097243,118,166,13,297
"97244",1097244,112,122,20,254
"97245",1097245,97,120,4,221
"97246",1097246,31,224,9,264
"97247",1097247,90,92,24,206
"97248",1097248,97,206,23,326
"97249",1097249,41,99,2,142
"97250",1097250,152,75,13,240
"97251",1097251,129,58,1,188
"97252",1097252,141,50,13,204
"97253",1097253,168,135,6,309
"97254",1097254,59,175,18,252
"97255",1097255,141,53,4,198
"97256",1097256,61,192,4,257
"97257",1097257,129,65,7,201
"97258",1097258,166,120,11,297
"97259",1097259,74,200,6,280
"97260",1097260,110,65,15,190
"97261",1097261,150,77,17,244
"97262",1097262,28,164,4,196
"97263",1097263,54,124,7,185
"97264",1097264,89,42,11,142
"97265",1097265,270,43,12,325
"97266",1097266,144,68,8,220
"97267",1097267,33,21,0,54
"97268",1097268,113,114,5,232
"97269",1097269,125,98,12,235
"97270",1097270,88,124,16,228
"97271",1097271,58,145,15,218
"97272",1097272,185,53,7,245
"97273",1097273,100,97,11,208
"97274",1097274,107,158,6,271
"97275",1097275,158,91,13,262
"97276",1097276,168,17,2,187
"97277",1097277,196,44,9,249
"97278",1097278,56,234,12,302
"97279",1097279,224,55,13,292
"97280",1097280,178,82,2,262
"97281",1097281,128,134,14,276
"97282",1097282,113,0,0,113
"97283",1097283,52,218,15,285
"97284",1097284,70,87,5,162
"97285",1097285,77,170,3,250
"97286",1097286,5,5,0,10
"97287",1097287,61,235,8,304
"97288",1097288,15,0,0,15
"97289",1097289,184,60,10,254
"97290",1097290,83,116,18,217
"97291",1097291,118,30,3,151
"97292",1097292,127,52,12,191
"97293",1097293,28,202,5,235
"97294",1097294,120,93,4,217
"97295",1097295,132,37,5,174
"97296",1097296,205,14,3,222
"97297",1097297,112,97,7,216
"97298",1097298,46,176,6,228
"97299",1097299,80,22,0,102
"97300",1097300,75,97,8,180
"97301",1097301,75,121,2,198
"97302",1097302,155,60,7,222
"97303",1097303,28,85,2,115
"97304",1097304,162,77,4,243
"97305",1097305,41,10,1,52
"97306",1097306,123,127,6,256
"97307",1097307,186,38,6,230
"97308",1097308,109,59,6,174
"97309",1097309,85,101,13,199
"97310",1097310,97,37,5,139
"97311",1097311,23,172,6,201
"97312",1097312,161,98,18,277
"97313",1097313,60,145,12,217
"97314",1097314,138,58,10,206
"97315",1097315,60,47,3,110
"97316",1097316,193,69,1,263
"97317",1097317,36,165,6,207
"97318",1097318,219,65,4,288
"97319",1097319,140,171,11,322
"97320",1097320,147,48,11,206
"97321",1097321,130,105,15,250
"97322",1097322,111,31,10,152
"97323",1097323,165,59,7,231
"97324",1097324,160,58,5,223
"97325",1097325,121,93,7,221
"97326",1097326,129,98,13,240
"97327",1097327,138,76,11,225
"97328",1097328,29,0,2,31
"97329",1097329,120,121,14,255
"97330",1097330,23,26,2,51
"97331",1097331,125,104,5,234
"97332",1097332,142,110,8,260
"97333",1097333,238,28,10,276
"97334",1097334,170,81,13,264
"97335",1097335,147,43,3,193
"97336",1097336,94,127,7,228
"97337",1097337,34,25,3,62
"97338",1097338,74,143,16,233
"97339",1097339,116,117,0,233
"97340",1097340,37,190,7,234
"97341",1097341,144,94,10,248
"97342",1097342,97,3,2,102
"97343",1097343,120,196,18,334
"97344",1097344,140,102,6,248
"97345",1097345,119,43,12,174
"97346",1097346,173,81,16,270
"97347",1097347,27,238,0,265
"97348",1097348,200,50,9,259
"97349",1097349,200,39,26,265
"97350",1097350,212,58,13,283
"97351",1097351,142,155,14,311
"97352",1097352,148,26,5,179
"97353",1097353,144,92,13,249
"97354",1097354,129,49,12,190
"97355",1097355,170,88,9,267
"97356",1097356,167,48,7,222
"97357",1097357,131,98,5,234
"97358",1097358,118,125,10,253
"97359",1097359,54,265,0,319
"97360",1097360,28,3,3,34
"97361",1097361,10,0,0,10
"97362",1097362,146,75,17,238
"97363",1097363,125,76,5,206
"97364",1097364,181,96,18,295
"97365",1097365,94,34,3,131
"97366",1097366,121,53,7,181
"97367",1097367,237,44,9,290
"97368",1097368,114,92,8,214
"97369",1097369,23,0,0,23
"97370",1097370,149,43,6,198
"97371",1097371,30,51,1,82
"97372",1097372,121,149,9,279
"97373",1097373,100,68,7,175
"97374",1097374,161,34,4,199
"97375",1097375,30,45,1,76
"97376",1097376,27,149,2,178
"97377",1097377,15,101,2,118
"97378",1097378,47,18,4,69
"97379",1097379,176,47,6,229
"97380",1097380,291,68,25,384
"97381",1097381,56,197,8,261
"97382",1097382,70,85,1,156
"97383",1097383,182,66,8,256
"97384",1097384,76,182,9,267
"97385",1097385,97,6,2,105
"97386",1097386,209,17,6,232
"97387",1097387,140,33,2,175
"97388",1097388,79,168,1,248
"97389",1097389,97,21,4,122
"97390",1097390,189,19,12,220
"97391",1097391,129,162,10,301
"97392",1097392,12,37,4,53
"97393",1097393,60,89,4,153
"97394",1097394,110,95,4,209
"97395",1097395,133,126,11,270
"97396",1097396,116,129,5,250
"97397",1097397,75,190,14,279
"97398",1097398,190,38,12,240
"97399",1097399,80,218,8,306
"97400",1097400,180,21,4,205
"97401",1097401,150,100,21,271
"97402",1097402,227,83,12,322
"97403",1097403,154,97,16,267
"97404",1097404,115,96,8,219
"97405",1097405,101,194,16,311
"97406",1097406,71,181,13,265
"97407",1097407,110,118,25,253
"97408",1097408,35,228,4,267
"97409",1097409,16,259,2,277
"97410",1097410,116,79,16,211
"97411",1097411,126,13,2,141
"97412",1097412,127,72,6,205
"97413",1097413,183,81,8,272
"97414",1097414,72,135,7,214
"97415",1097415,283,29,9,321
"97416",1097416,28,38,1,67
"97417",1097417,58,9,0,67
"97418",1097418,182,81,10,273
"97419",1097419,139,42,6,187
"97420",1097420,69,192,3,264
"97421",1097421,90,186,7,283
"97422",1097422,159,146,7,312
"97423",1097423,136,96,16,248
"97424",1097424,250,24,10,284
"97425",1097425,92,34,4,130
"97426",1097426,84,169,11,264
"97427",1097427,171,58,6,235
"97428",1097428,216,34,5,255
"97429",1097429,162,68,9,239
"97430",1097430,117,160,11,288
"97431",1097431,102,126,9,237
"97432",1097432,12,10,5,27
"97433",1097433,108,88,5,201
"97434",1097434,57,166,12,235
"97435",1097435,73,124,3,200
"97436",1097436,188,43,2,233
"97437",1097437,56,222,2,280
"97438",1097438,49,28,1,78
"97439",1097439,84,196,7,287
"97440",1097440,121,180,11,312
"97441",1097441,21,66,3,90
"97442",1097442,160,74,3,237
"97443",1097443,168,16,5,189
"97444",1097444,6,3,1,10
"97445",1097445,71,130,15,216
"97446",1097446,80,214,10,304
"97447",1097447,254,38,10,302
"97448",1097448,119,33,8,160
"97449",1097449,12,17,1,30
"97450",1097450,163,24,12,199
"97451",1097451,78,53,5,136
"97452",1097452,159,124,8,291
"97453",1097453,142,53,15,210
"97454",1097454,115,121,18,254
"97455",1097455,124,85,22,231
"97456",1097456,50,12,1,63
"97457",1097457,31,272,2,305
"97458",1097458,69,148,4,221
"97459",1097459,150,41,4,195
"97460",1097460,148,120,12,280
"97461",1097461,140,23,3,166
"97462",1097462,99,136,6,241
"97463",1097463,103,129,5,237
"97464",1097464,49,134,17,200
"97465",1097465,67,188,12,267
"97466",1097466,147,92,17,256
"97467",1097467,55,217,8,280
"97468",1097468,161,70,17,248
"97469",1097469,35,269,3,307
"97470",1097470,185,27,3,215
"97471",1097471,144,83,8,235
"97472",1097472,195,64,13,272
"97473",1097473,156,58,10,224
"97474",1097474,102,59,12,173
"97475",1097475,207,74,15,296
"97476",1097476,132,52,10,194
"97477",1097477,85,22,5,112
"97478",1097478,104,221,9,334
"97479",1097479,144,117,14,275
"97480",1097480,40,4,0,44
"97481",1097481,140,96,9,245
"97482",1097482,50,151,11,212
"97483",1097483,89,117,14,220
"97484",1097484,139,176,10,325
"97485",1097485,105,66,5,176
"97486",1097486,43,129,5,177
"97487",1097487,41,141,3,185
"97488",1097488,107,127,13,247
"97489",1097489,87,129,6,222
"97490",1097490,30,120,5,155
"97491",1097491,65,112,12,189
"97492",1097492,235,16,5,256
"97493",1097493,102,189,5,296
"97494",1097494,26,187,4,217
"97495",1097495,194,33,7,234
"97496",1097496,141,42,4,187
"97497",1097497,180,55,13,248
"97498",1097498,172,95,14,281
"97499",1097499,96,237,14,347
"97500",1097500,200,41,5,246
"97501",1097501,21,198,4,223
"97502",1097502,5,1,0,6
"97503",1097503,127,96,7,230
"97504",1097504,106,68,13,187
"97505",1097505,105,121,7,233
"97506",1097506,21,4,0,25
"97507",1097507,138,119,17,274
"97508",1097508,112,65,7,184
"97509",1097509,170,93,10,273
"97510",1097510,107,186,22,315
"97511",1097511,186,7,5,198
"97512",1097512,132,63,23,218
"97513",1097513,166,104,10,280
"97514",1097514,135,109,7,251
"97515",1097515,34,252,3,289
"97516",1097516,70,96,3,169
"97517",1097517,118,118,13,249
"97518",1097518,160,66,8,234
"97519",1097519,55,157,3,215
"97520",1097520,109,102,5,216
"97521",1097521,14,121,1,136
"97522",1097522,234,7,5,246
"97523",1097523,27,164,8,199
"97524",1097524,53,131,8,192
"97525",1097525,241,24,12,277
"97526",1097526,112,174,10,296
"97527",1097527,35,133,12,180
"97528",1097528,72,203,7,282
"97529",1097529,81,236,8,325
"97530",1097530,26,56,4,86
"97531",1097531,100,66,8,174
"97532",1097532,17,10,0,27
"97533",1097533,57,267,8,332
"97534",1097534,100,196,2,298
"97535",1097535,280,3,4,287
"97536",1097536,45,203,11,259
"97537",1097537,59,77,1,137
"97538",1097538,112,100,9,221
"97539",1097539,68,70,3,141
"97540",1097540,83,93,10,186
"97541",1097541,187,34,5,226
"97542",1097542,34,254,0,288
"97543",1097543,16,9,0,25
"97544",1097544,75,97,5,177
"97545",1097545,68,181,3,252
"97546",1097546,111,38,14,163
"97547",1097547,111,28,3,142
"97548",1097548,71,58,7,136
"97549",1097549,179,30,6,215
"97550",1097550,60,63,6,129
"97551",1097551,116,82,17,215
"97552",1097552,182,110,12,304
"97553",1097553,146,54,9,209
"97554",1097554,116,53,6,175
"97555",1097555,99,60,8,167
"97556",1097556,113,30,1,144
"97557",1097557,98,56,2,156
"97558",1097558,174,11,7,192
"97559",1097559,178,79,7,264
"97560",1097560,38,17,3,58
"97561",1097561,165,86,13,264
"97562",1097562,212,69,13,294
"97563",1097563,82,109,5,196
"97564",1097564,131,22,6,159
"97565",1097565,185,48,7,240
"97566",1097566,128,133,9,270
"97567",1097567,201,44,9,254
"97568",1097568,97,222,5,324
"97569",1097569,101,168,5,274
"97570",1097570,119,112,15,246
"97571",1097571,80,54,7,141
"97572",1097572,218,47,15,280
"97573",1097573,104,163,6,273
"97574",1097574,92,150,16,258
"97575",1097575,106,161,6,273
"97576",1097576,46,23,2,71
"97577",1097577,77,91,14,182
"97578",1097578,149,38,4,191
"97579",1097579,38,104,13,155
"97580",1097580,90,70,17,177
"97581",1097581,199,36,1,236
"97582",1097582,49,234,7,290
"97583",1097583,120,84,5,209
"97584",1097584,73,223,10,306
"97585",1097585,66,228,3,297
"97586",1097586,155,151,12,318
"97587",1097587,171,68,7,246
"97588",1097588,114,93,13,220
"97589",1097589,101,173,17,291
"97590",1097590,95,91,12,198
"97591",1097591,51,172,4,227
"97592",1097592,112,162,15,289
"97593",1097593,201,75,5,281
"97594",1097594,178,57,7,242
"97595",1097595,69,107,6,182
"97596",1097596,52,188,17,257
"97597",1097597,229,7,1,237
"97598",1097598,136,33,8,177
"97599",1097599,173,77,17,267
"97600",1097600,128,141,20,289
"97601",1097601,191,30,5,226
"97602",1097602,108,61,5,174
"97603",1097603,52,265,6,323
"97604",1097604,111,144,12,267
"97605",1097605,234,23,6,263
"97606",1097606,100,99,11,210
"97607",1097607,17,15,1,33
"97608",1097608,159,158,13,330
"97609",1097609,31,183,2,216
"97610",1097610,33,250,9,292
"97611",1097611,144,166,5,315
"97612",1097612,77,71,11,159
"97613",1097613,116,20,5,141
"97614",1097614,251,24,0,275
"97615",1097615,17,146,1,164
"97616",1097616,133,42,4,179
"97617",1097617,31,0,1,32
"97618",1097618,110,104,8,222
"97619",1097619,69,23,0,92
"97620",1097620,64,104,6,174
"97621",1097621,235,34,14,283
"97622",1097622,70,187,4,261
"97623",1097623,3,36,0,39
"97624",1097624,110,14,3,127
"97625",1097625,116,64,8,188
"97626",1097626,192,110,8,310
"97627",1097627,91,79,8,178
"97628",1097628,66,217,0,283
"97629",1097629,158,38,1,197
"97630",1097630,131,11,2,144
"97631",1097631,100,114,8,222
"97632",1097632,109,113,5,227
"97633",1097633,101,123,4,228
"97634",1097634,243,8,4,255
"97635",1097635,79,220,15,314
"97636",1097636,226,41,4,271
"97637",1097637,219,57,1,277
"97638",1097638,111,156,4,271
"97639",1097639,13,228,3,244
"97640",1097640,220,22,6,248
"97641",1097641,41,37,1,79
"97642",1097642,35,183,0,218
"97643",1097643,32,254,7,293
"97644",1097644,75,133,7,215
"97645",1097645,119,65,9,193
"97646",1097646,127,137,8,272
"97647",1097647,136,70,6,212
"97648",1097648,143,61,5,209
"97649",1097649,194,97,17,308
"97650",1097650,199,50,10,259
"97651",1097651,127,23,5,155
"97652",1097652,146,153,15,314
"97653",1097653,218,30,13,261
"97654",1097654,58,241,6,305
"97655",1097655,105,81,19,205
"97656",1097656,108,168,6,282
"97657",1097657,123,114,4,241
"97658",1097658,92,127,14,233
"97659",1097659,239,42,16,297
"97660",1097660,86,205,9,300
"97661",1097661,48,184,3,235
"97662",1097662,40,70,1,111
"97663",1097663,49,273,3,325
"97664",1097664,36,207,3,246
"97665",1097665,258,12,5,275
"97666",1097666,123,38,7,168
"97667",1097667,76,5,2,83
"97668",1097668,74,212,16,302
"97669",1097669,206,105,26,337
"97670",1097670,137,44,8,189
"97671",1097671,196,73,15,284
"97672",1097672,2,11,0,13
"97673",1097673,99,43,5,147
"97674",1097674,37,252,4,293
"97675",1097675,28,52,0,80
"97676",1097676,133,167,8,308
"97677",1097677,161,104,4,269
"97678",1097678,14,22,2,38
"97679",1097679,22,18,4,44
"97680",1097680,172,35,6,213
"97681",1097681,40,229,2,271
"97682",1097682,196,85,25,306
"97683",1097683,23,59,2,84
"97684",1097684,8,74,0,82
"97685",1097685,89,161,19,269
"97686",1097686,95,161,28,284
"97687",1097687,64,173,3,240
"97688",1097688,56,20,3,79
"97689",1097689,169,37,6,212
"97690",1097690,70,95,1,166
"97691",1097691,31,25,0,56
"97692",1097692,56,199,8,263
"97693",1097693,159,96,5,260
"97694",1097694,182,119,14,315
"97695",1097695,54,234,4,292
"97696",1097696,248,49,10,307
"97697",1097697,190,63,10,263
"97698",1097698,122,78,9,209
"97699",1097699,88,186,13,287
"97700",1097700,80,102,2,184
"97701",1097701,145,113,3,261
"97702",1097702,172,46,5,223
"97703",1097703,40,238,4,282
"97704",1097704,91,149,5,245
"97705",1097705,33,110,2,145
"97706",1097706,165,53,16,234
"97707",1097707,257,24,11,292
"97708",1097708,8,72,3,83
"97709",1097709,218,25,4,247
"97710",1097710,60,156,3,219
"97711",1097711,174,95,10,279
"97712",1097712,118,152,4,274
"97713",1097713,233,45,5,283
"97714",1097714,132,39,9,180
"97715",1097715,91,189,13,293
"97716",1097716,30,85,5,120
"97717",1097717,20,142,5,167
"97718",1097718,73,16,6,95
"97719",1097719,108,58,6,172
"97720",1097720,145,129,5,279
"97721",1097721,62,39,6,107
"97722",1097722,94,132,2,228
"97723",1097723,96,149,18,263
"97724",1097724,29,242,2,273
"97725",1097725,155,56,17,228
"97726",1097726,182,20,5,207
"97727",1097727,45,243,8,296
"97728",1097728,232,56,10,298
"97729",1097729,186,82,18,286
"97730",1097730,152,59,4,215
"97731",1097731,131,110,15,256
"97732",1097732,112,25,7,144
"97733",1097733,221,63,13,297
"97734",1097734,95,104,19,218
"97735",1097735,23,209,2,234
"97736",1097736,260,18,6,284
"97737",1097737,131,122,5,258
"97738",1097738,20,45,4,69
"97739",1097739,90,87,3,180
"97740",1097740,174,84,6,264
"97741",1097741,54,49,9,112
"97742",1097742,50,158,10,218
"97743",1097743,98,121,13,232
"97744",1097744,41,266,1,308
"97745",1097745,84,109,6,199
"97746",1097746,7,48,2,57
"97747",1097747,167,75,17,259
"97748",1097748,46,88,10,144
"97749",1097749,110,119,13,242
"97750",1097750,154,151,19,324
"97751",1097751,83,148,10,241
"97752",1097752,16,159,11,186
"97753",1097753,200,80,17,297
"97754",1097754,122,134,14,270
"97755",1097755,139,156,13,308
"97756",1097756,181,131,6,318
"97757",1097757,60,178,11,249
"97758",1097758,198,39,9,246
"97759",1097759,128,156,21,305
"97760",1097760,16,28,0,44
"97761",1097761,75,64,12,151
"97762",1097762,37,187,5,229
"97763",1097763,166,87,6,259
"97764",1097764,2,14,0,16
"97765",1097765,150,61,4,215
"97766",1097766,105,121,0,226
"97767",1097767,86,127,3,216
"97768",1097768,127,107,5,239
"97769",1097769,25,9,1,35
"97770",1097770,122,128,2,252
"97771",1097771,160,70,7,237
"97772",1097772,70,73,7,150
"97773",1097773,137,56,6,199
"97774",1097774,67,144,7,218
"97775",1097775,40,47,7,94
"97776",1097776,147,26,7,180
"97777",1097777,74,0,0,74
"97778",1097778,128,95,3,226
"97779",1097779,110,110,3,223
"97780",1097780,151,103,10,264
"97781",1097781,246,16,9,271
"97782",1097782,169,125,19,313
"97783",1097783,46,62,3,111
"97784",1097784,98,39,3,140
"97785",1097785,153,117,5,275
"97786",1097786,114,42,6,162
"97787",1097787,117,67,6,190
"97788",1097788,83,132,10,225
"97789",1097789,186,103,8,297
"97790",1097790,216,80,14,310
"97791",1097791,197,24,9,230
"97792",1097792,46,280,2,328
"97793",1097793,91,20,0,111
"97794",1097794,158,76,6,240
"97795",1097795,174,18,3,195
"97796",1097796,85,98,0,183
"97797",1097797,37,215,11,263
"97798",1097798,99,143,4,246
"97799",1097799,189,70,9,268
"97800",1097800,100,52,8,160
"97801",1097801,87,133,7,227
"97802",1097802,164,70,10,244
"97803",1097803,62,181,5,248
"97804",1097804,73,60,4,137
"97805",1097805,52,159,4,215
"97806",1097806,7,65,1,73
"97807",1097807,148,84,16,248
"97808",1097808,80,35,1,116
"97809",1097809,28,157,6,191
"97810",1097810,41,114,6,161
"97811",1097811,36,138,5,179
"97812",1097812,92,93,7,192
"97813",1097813,124,156,6,286
"97814",1097814,114,182,6,302
"97815",1097815,18,46,2,66
"97816",1097816,54,108,13,175
"97817",1097817,111,47,3,161
"97818",1097818,13,153,1,167
"97819",1097819,132,73,7,212
"97820",1097820,132,142,10,284
"97821",1097821,230,64,7,301
"97822",1097822,73,241,8,322
"97823",1097823,56,133,4,193
"97824",1097824,29,25,0,54
"97825",1097825,158,41,3,202
"97826",1097826,94,72,7,173
"97827",1097827,184,35,3,222
"97828",1097828,114,1,6,121
"97829",1097829,158,27,1,186
"97830",1097830,66,33,0,99
"97831",1097831,178,137,18,333
"97832",1097832,35,74,0,109
"97833",1097833,62,126,16,204
"97834",1097834,149,20,1,170
"97835",1097835,100,211,6,317
"97836",1097836,129,93,14,236
"97837",1097837,133,117,3,253
"97838",1097838,75,109,8,192
"97839",1097839,69,177,22,268
"97840",1097840,131,95,3,229
"97841",1097841,92,64,13,169
"97842",1097842,96,14,2,112
"97843",1097843,189,85,4,278
"97844",1097844,105,41,11,157
"97845",1097845,11,227,1,239
"97846",1097846,19,11,2,32
"97847",1097847,153,182,19,354
"97848",1097848,176,65,10,251
"97849",1097849,98,70,19,187
"97850",1097850,133,160,25,318
"97851",1097851,231,58,16,305
"97852",1097852,149,93,7,249
"97853",1097853,195,99,4,298
"97854",1097854,172,52,14,238
"97855",1097855,43,41,6,90
"97856",1097856,133,101,5,239
"97857",1097857,149,45,7,201
"97858",1097858,145,90,9,244
"97859",1097859,170,78,24,272
"97860",1097860,16,19,3,38
"97861",1097861,15,15,2,32
"97862",1097862,229,240,9,478
"97863",1097863,209,35,5,249
"97864",1097864,95,124,1,220
"97865",1097865,122,167,14,303
"97866",1097866,22,200,3,225
"97867",1097867,36,167,3,206
"97868",1097868,111,155,4,270
"97869",1097869,136,35,4,175
"97870",1097870,110,153,10,273
"97871",1097871,27,94,2,123
"97872",1097872,45,202,11,258
"97873",1097873,5,3,1,9
"97874",1097874,125,77,2,204
"97875",1097875,99,141,15,255
"97876",1097876,197,43,13,253
"97877",1097877,168,59,4,231
"97878",1097878,109,423,18,550
"97879",1097879,100,230,6,336
"97880",1097880,146,87,4,237
"97881",1097881,77,219,11,307
"97882",1097882,83,179,10,272
"97883",1097883,85,157,21,263
"97884",1097884,139,104,3,246
"97885",1097885,63,262,5,330
"97886",1097886,140,72,7,219
"97887",1097887,145,96,10,251
"97888",1097888,4,65,1,70
"97889",1097889,143,98,11,252
"97890",1097890,131,56,9,196
"97891",1097891,96,27,6,129
"97892",1097892,7,5,2,14
"97893",1097893,11,93,3,107
"97894",1097894,160,109,21,290
"97895",1097895,43,185,5,233
"97896",1097896,145,68,5,218
"97897",1097897,102,123,1,226
"97898",1097898,169,73,7,249
"97899",1097899,5,3,1,9
"97900",1097900,69,245,10,324
"97901",1097901,80,80,18,178
"97902",1097902,71,90,13,174
"97903",1097903,220,19,3,242
"97904",1097904,55,5,2,62
"97905",1097905,65,205,0,270
"97906",1097906,131,102,5,238
"97907",1097907,102,25,3,130
"97908",1097908,29,28,6,63
"97909",1097909,56,273,9,338
"97910",1097910,154,90,2,246
"97911",1097911,72,240,5,317
"97912",1097912,87,110,9,206
"97913",1097913,168,142,17,327
"97914",1097914,163,2,0,165
"97915",1097915,87,159,10,256
"97916",1097916,106,194,11,311
"97917",1097917,103,150,10,263
"97918",1097918,30,144,8,182
"97919",1097919,91,7,3,101
"97920",1097920,210,62,10,282
"97921",1097921,138,58,3,199
"97922",1097922,7,135,3,145
"97923",1097923,44,252,5,301
"97924",1097924,139,53,12,204
"97925",1097925,146,51,5,202
"97926",1097926,155,36,4,195
"97927",1097927,45,130,5,180
"97928",1097928,97,179,21,297
"97929",1097929,177,34,7,218
"97930",1097930,3,3,1,7
"97931",1097931,42,71,5,118
"97932",1097932,276,49,7,332
"97933",1097933,80,200,10,290
"97934",1097934,210,36,16,262
"97935",1097935,109,111,8,228
"97936",1097936,115,94,11,220
"97937",1097937,67,180,9,256
"97938",1097938,141,34,5,180
"97939",1097939,170,11,3,184
"97940",1097940,49,222,7,278
"97941",1097941,79,59,6,144
"97942",1097942,90,19,3,112
"97943",1097943,126,31,5,162
"97944",1097944,14,223,1,238
"97945",1097945,64,118,8,190
"97946",1097946,128,42,13,183
"97947",1097947,164,93,9,266
"97948",1097948,30,62,2,94
"97949",1097949,180,53,7,240
"97950",1097950,27,154,1,182
"97951",1097951,38,137,2,177
"97952",1097952,102,175,11,288
"97953",1097953,177,25,7,209
"97954",1097954,249,16,10,275
"97955",1097955,138,28,4,170
"97956",1097956,87,214,9,310
"97957",1097957,165,29,6,200
"97958",1097958,153,48,6,207
"97959",1097959,118,162,20,300
"97960",1097960,106,189,10,305
"97961",1097961,111,173,14,298
"97962",1097962,56,85,1,142
"97963",1097963,82,135,7,224
"97964",1097964,90,126,23,239
"97965",1097965,182,29,5,216
"97966",1097966,54,158,13,225
"97967",1097967,75,121,6,202
"97968",1097968,36,156,8,200
"97969",1097969,75,75,12,162
"97970",1097970,211,105,27,343
"97971",1097971,84,100,2,186
"97972",1097972,155,57,3,215
"97973",1097973,95,80,5,180
"97974",1097974,116,112,5,233
"97975",1097975,77,179,8,264
"97976",1097976,31,135,3,169
"97977",1097977,210,19,5,234
"97978",1097978,183,65,10,258
"97979",1097979,124,15,2,141
"97980",1097980,84,97,9,190
"97981",1097981,121,136,8,265
"97982",1097982,92,93,11,196
"97983",1097983,47,230,21,298
"97984",1097984,187,54,6,247
"97985",1097985,153,21,6,180
"97986",1097986,52,216,9,277
"97987",1097987,75,209,16,300
"97988",1097988,115,21,14,150
"97989",1097989,44,97,6,147
"97990",1097990,69,208,14,291
"97991",1097991,96,127,4,227
"97992",1097992,116,113,6,235
"97993",1097993,51,187,8,246
"97994",1097994,58,215,9,282
"97995",1097995,140,5,4,149
"97996",1097996,30,133,8,171
"97997",1097997,36,151,0,187
"97998",1097998,97,127,25,249
"97999",1097999,52,137,2,191
"98000",1098000,125,37,2,164
"98001",1098001,154,155,12,321
"98002",1098002,32,138,4,174
"98003",1098003,115,62,6,183
"98004",1098004,124,155,11,290
"98005",1098005,44,125,2,171
"98006",1098006,164,92,7,263
"98007",1098007,73,220,8,301
"98008",1098008,76,29,6,111
"98009",1098009,31,204,5,240
"98010",1098010,132,22,5,159
"98011",1098011,103,45,12,160
"98012",1098012,170,88,15,273
"98013",1098013,153,100,1,254
"98014",1098014,237,30,10,277
"98015",1098015,203,49,7,259
"98016",1098016,213,62,8,283
"98017",1098017,161,26,9,196
"98018",1098018,68,68,12,148
"98019",1098019,245,28,4,277
"98020",1098020,120,105,15,240
"98021",1098021,123,133,15,271
"98022",1098022,35,277,3,315
"98023",1098023,61,164,8,233
"98024",1098024,92,134,3,229
"98025",1098025,137,85,9,231
"98026",1098026,107,70,2,179
"98027",1098027,94,144,5,243
"98028",1098028,168,86,8,262
"98029",1098029,11,34,2,47
"98030",1098030,31,144,5,180
"98031",1098031,81,77,13,171
"98032",1098032,75,88,3,166
"98033",1098033,214,18,6,238
"98034",1098034,47,238,8,293
"98035",1098035,22,291,7,320
"98036",1098036,161,98,19,278
"98037",1098037,203,145,8,356
"98038",1098038,147,120,9,276
"98039",1098039,78,252,12,342
"98040",1098040,85,53,5,143
"98041",1098041,100,28,6,134
"98042",1098042,26,147,6,179
"98043",1098043,7,13,0,20
"98044",1098044,121,100,2,223
"98045",1098045,174,34,10,218
"98046",1098046,180,129,18,327
"98047",1098047,46,220,6,272
"98048",1098048,7,4,0,11
"98049",1098049,157,60,6,223
"98050",1098050,45,185,5,235
"98051",1098051,41,203,6,250
"98052",1098052,192,81,11,284
"98053",1098053,209,84,18,311
"98054",1098054,72,11,1,84
"98055",1098055,139,118,25,282
"98056",1098056,114,21,5,140
"98057",1098057,109,217,9,335
"98058",1098058,138,81,12,231
"98059",1098059,193,50,11,254
"98060",1098060,92,121,6,219
"98061",1098061,64,106,4,174
"98062",1098062,9,36,1,46
"98063",1098063,15,213,4,232
"98064",1098064,129,96,6,231
"98065",1098065,199,47,6,252
"98066",1098066,85,65,5,155
"98067",1098067,107,89,5,201
"98068",1098068,265,196,13,474
"98069",1098069,20,126,2,148
"98070",1098070,68,117,16,201
"98071",1098071,78,152,10,240
"98072",1098072,51,97,6,154
"98073",1098073,103,183,6,292
"98074",1098074,112,122,4,238
"98075",1098075,16,1,0,17
"98076",1098076,85,182,6,273
"98077",1098077,71,102,0,173
"98078",1098078,114,142,2,258
"98079",1098079,98,52,11,161
"98080",1098080,136,24,0,160
"98081",1098081,95,44,9,148
"98082",1098082,129,82,14,225
"98083",1098083,154,11,2,167
"98084",1098084,115,3,0,118
"98085",1098085,153,72,6,231
"98086",1098086,221,44,12,277
"98087",1098087,30,251,8,289
"98088",1098088,205,93,8,306
"98089",1098089,59,180,10,249
"98090",1098090,168,33,10,211
"98091",1098091,24,165,2,191
"98092",1098092,105,48,11,164
"98093",1098093,41,208,4,253
"98094",1098094,207,62,12,281
"98095",1098095,160,63,5,228
"98096",1098096,119,20,1,140
"98097",1098097,110,181,10,301
"98098",1098098,92,189,9,290
"98099",1098099,50,128,5,183
"98100",1098100,95,120,9,224
"98101",1098101,105,98,3,206
"98102",1098102,131,40,10,181
"98103",1098103,58,28,2,88
"98104",1098104,90,134,19,243
"98105",1098105,147,87,7,241
"98106",1098106,46,192,8,246
"98107",1098107,10,17,0,27
"98108",1098108,49,232,4,285
"98109",1098109,211,34,19,264
"98110",1098110,190,59,21,270
"98111",1098111,56,217,12,285
"98112",1098112,181,56,22,259
"98113",1098113,142,25,9,176
"98114",1098114,31,37,1,69
"98115",1098115,61,85,9,155
"98116",1098116,151,87,14,252
"98117",1098117,175,53,7,235
"98118",1098118,168,98,14,280
"98119",1098119,25,248,2,275
"98120",1098120,25,243,10,278
"98121",1098121,93,71,3,167
"98122",1098122,171,63,2,236
"98123",1098123,161,45,5,211
"98124",1098124,74,182,3,259
"98125",1098125,62,2,1,65
"98126",1098126,174,73,9,256
"98127",1098127,13,150,2,165
"98128",1098128,150,96,12,258
"98129",1098129,186,29,9,224
"98130",1098130,119,26,7,152
"98131",1098131,20,164,7,191
"98132",1098132,87,113,11,211
"98133",1098133,214,50,8,272
"98134",1098134,37,245,5,287
"98135",1098135,67,14,3,84
"98136",1098136,75,80,6,161
"98137",1098137,156,86,19,261
"98138",1098138,147,30,3,180
"98139",1098139,189,22,1,212
"98140",1098140,1,4,0,5
"98141",1098141,114,150,9,273
"98142",1098142,124,136,5,265
"98143",1098143,127,3,1,131
"98144",1098144,99,99,3,201
"98145",1098145,95,73,3,171
"98146",1098146,25,20,3,48
"98147",1098147,108,74,9,191
"98148",1098148,32,166,12,210
"98149",1098149,34,241,5,280
"98150",1098150,94,19,6,119
"98151",1098151,66,106,3,175
"98152",1098152,62,122,12,196
"98153",1098153,56,129,2,187
"98154",1098154,100,123,6,229
"98155",1098155,152,72,4,228
"98156",1098156,147,93,10,250
"98157",1098157,37,108,11,156
"98158",1098158,7,109,0,116
"98159",1098159,15,4,0,19
"98160",1098160,121,46,13,180
"98161",1098161,115,17,3,135
"98162",1098162,81,189,15,285
"98163",1098163,203,13,4,220
"98164",1098164,60,67,11,138
"98165",1098165,52,163,7,222
"98166",1098166,58,121,10,189
"98167",1098167,122,34,12,168
"98168",1098168,38,221,23,282
"98169",1098169,52,168,6,226
"98170",1098170,48,236,7,291
"98171",1098171,169,99,3,271
"98172",1098172,199,51,13,263
"98173",1098173,228,32,10,270
"98174",1098174,95,109,6,210
"98175",1098175,79,180,6,265
"98176",1098176,144,15,1,160
"98177",1098177,139,51,9,199
"98178",1098178,252,28,10,290
"98179",1098179,24,66,1,91
"98180",1098180,195,285,28,508
"98181",1098181,22,33,2,57
"98182",1098182,18,6,1,25
"98183",1098183,55,225,9,289
"98184",1098184,190,63,0,253
"98185",1098185,64,14,3,81
"98186",1098186,50,56,8,114
"98187",1098187,136,71,11,218
"98188",1098188,192,37,11,240
"98189",1098189,135,69,7,211
"98190",1098190,54,105,7,166
"98191",1098191,145,32,6,183
"98192",1098192,88,17,2,107
"98193",1098193,116,161,8,285
"98194",1098194,214,38,5,257
"98195",1098195,16,173,4,193
"98196",1098196,29,12,10,51
"98197",1098197,184,34,3,221
"98198",1098198,178,125,15,318
"98199",1098199,72,93,5,170
"98200",1098200,91,180,6,277
"98201",1098201,261,17,7,285
"98202",1098202,117,67,9,193
"98203",1098203,62,204,12,278
"98204",1098204,66,125,5,196
"98205",1098205,183,15,1,199
"98206",1098206,205,55,15,275
"98207",1098207,91,165,8,264
"98208",1098208,129,141,9,279
"98209",1098209,133,79,0,212
"98210",1098210,50,296,7,353
"98211",1098211,165,62,7,234
"98212",1098212,214,39,6,259
"98213",1098213,88,175,4,267
"98214",1098214,89,89,7,185
"98215",1098215,118,197,23,338
"98216",1098216,148,45,7,200
"98217",1098217,40,173,3,216
"98218",1098218,149,83,6,238
"98219",1098219,169,95,12,276
"98220",1098220,179,44,4,227
"98221",1098221,52,117,5,174
"98222",1098222,185,19,14,218
"98223",1098223,140,130,23,293
"98224",1098224,150,42,3,195
"98225",1098225,112,38,9,159
"98226",1098226,174,67,11,252
"98227",1098227,70,200,4,274
"98228",1098228,138,104,22,264
"98229",1098229,84,111,3,198
"98230",1098230,197,54,2,253
"98231",1098231,114,161,9,284
"98232",1098232,107,111,14,232
"98233",1098233,78,177,3,258
"98234",1098234,92,92,8,192
"98235",1098235,55,205,3,263
"98236",1098236,45,188,7,240
"98237",1098237,45,347,3,395
"98238",1098238,49,2,1,52
"98239",1098239,78,215,11,304
"98240",1098240,153,55,9,217
"98241",1098241,140,28,6,174
"98242",1098242,142,34,7,183
"98243",1098243,41,139,6,186
"98244",1098244,188,66,7,261
"98245",1098245,67,163,21,251
"98246",1098246,119,49,9,177
"98247",1098247,158,109,3,270
"98248",1098248,23,182,10,215
"98249",1098249,250,27,11,288
"98250",1098250,62,16,6,84
"98251",1098251,155,68,3,226
"98252",1098252,43,150,13,206
"98253",1098253,24,91,4,119
"98254",1098254,125,109,9,243
"98255",1098255,187,40,7,234
"98256",1098256,20,146,1,167
"98257",1098257,98,29,2,129
"98258",1098258,203,60,14,277
"98259",1098259,144,126,7,277
"98260",1098260,112,85,17,214
"98261",1098261,78,201,15,294
"98262",1098262,140,59,5,204
"98263",1098263,84,181,12,277
"98264",1098264,158,50,7,215
"98265",1098265,54,199,10,263
"98266",1098266,160,52,16,228
"98267",1098267,166,25,10,201
"98268",1098268,126,122,11,259
"98269",1098269,199,27,5,231
"98270",1098270,135,57,11,203
"98271",1098271,24,235,4,263
"98272",1098272,168,139,12,319
"98273",1098273,91,136,12,239
"98274",1098274,8,1,0,9
"98275",1098275,124,142,5,271
"98276",1098276,200,51,5,256
"98277",1098277,22,135,5,162
"98278",1098278,121,135,1,257
"98279",1098279,152,67,14,233
"98280",1098280,56,77,5,138
"98281",1098281,74,150,6,230
"98282",1098282,48,151,1,200
"98283",1098283,28,155,14,197
"98284",1098284,87,127,14,228
"98285",1098285,213,78,23,314
"98286",1098286,153,62,12,227
"98287",1098287,205,85,16,306
"98288",1098288,54,221,9,284
"98289",1098289,43,63,5,111
"98290",1098290,93,138,11,242
"98291",1098291,195,94,24,313
"98292",1098292,22,4,2,28
"98293",1098293,108,54,3,165
"98294",1098294,96,58,8,162
"98295",1098295,162,18,2,182
"98296",1098296,22,10,2,34
"98297",1098297,157,76,10,243
"98298",1098298,120,79,5,204
"98299",1098299,37,23,3,63
"98300",1098300,109,168,10,287
"98301",1098301,43,237,7,287
"98302",1098302,132,52,2,186
"98303",1098303,271,39,7,317
"98304",1098304,111,118,12,241
"98305",1098305,113,38,9,160
"98306",1098306,108,110,17,235
"98307",1098307,158,51,14,223
"98308",1098308,46,164,15,225
"98309",1098309,50,185,6,241
"98310",1098310,118,36,6,160
"98311",1098311,172,132,11,315
"98312",1098312,95,75,8,178
"98313",1098313,104,45,4,153
"98314",1098314,164,57,7,228
"98315",1098315,60,224,1,285
"98316",1098316,55,186,2,243
"98317",1098317,246,0,7,253
"98318",1098318,24,245,3,272
"98319",1098319,49,215,6,270
"98320",1098320,125,146,21,292
"98321",1098321,169,137,8,314
"98322",1098322,92,131,5,228
"98323",1098323,104,106,7,217
"98324",1098324,56,167,7,230
"98325",1098325,170,77,8,255
"98326",1098326,126,95,18,239
"98327",1098327,111,38,4,153
"98328",1098328,79,46,10,135
"98329",1098329,41,100,7,148
"98330",1098330,143,64,6,213
"98331",1098331,158,62,1,221
"98332",1098332,14,67,0,81
"98333",1098333,144,60,7,211
"98334",1098334,219,53,8,280
"98335",1098335,176,66,13,255
"98336",1098336,128,114,14,256
"98337",1098337,3,11,0,14
"98338",1098338,80,132,1,213
"98339",1098339,52,186,15,253
"98340",1098340,43,268,5,316
"98341",1098341,100,122,23,245
"98342",1098342,48,76,9,133
"98343",1098343,166,114,12,292
"98344",1098344,148,166,11,325
"98345",1098345,38,4,2,44
"98346",1098346,53,181,5,239
"98347",1098347,106,34,5,145
"98348",1098348,127,90,6,223
"98349",1098349,132,160,5,297
"98350",1098350,173,66,2,241
"98351",1098351,81,123,2,206
"98352",1098352,29,158,2,189
"98353",1098353,178,90,17,285
"98354",1098354,101,166,2,269
"98355",1098355,16,3,0,19
"98356",1098356,128,67,4,199
"98357",1098357,127,122,4,253
"98358",1098358,98,123,14,235
"98359",1098359,237,34,9,280
"98360",1098360,66,112,3,181
"98361",1098361,25,182,3,210
"98362",1098362,56,60,5,121
"98363",1098363,85,185,9,279
"98364",1098364,126,86,9,221
"98365",1098365,34,19,2,55
"98366",1098366,163,73,4,240
"98367",1098367,47,249,7,303
"98368",1098368,50,203,3,256
"98369",1098369,179,15,3,197
"98370",1098370,102,43,4,149
"98371",1098371,67,216,7,290
"98372",1098372,324,6,8,338
"98373",1098373,80,64,5,149
"98374",1098374,140,22,1,163
"98375",1098375,25,4,1,30
"98376",1098376,182,79,10,271
"98377",1098377,15,17,1,33
"98378",1098378,71,152,1,224
"98379",1098379,121,160,7,288
"98380",1098380,23,10,2,35
"98381",1098381,87,230,8,325
"98382",1098382,52,206,11,269
"98383",1098383,187,56,8,251
"98384",1098384,82,79,17,178
"98385",1098385,82,15,6,103
"98386",1098386,102,202,11,315
"98387",1098387,171,94,13,278
"98388",1098388,178,66,6,250
"98389",1098389,129,24,3,156
"98390",1098390,147,71,10,228
"98391",1098391,83,184,15,282
"98392",1098392,76,165,19,260
"98393",1098393,226,12,1,239
"98394",1098394,108,139,9,256
"98395",1098395,41,237,13,291
"98396",1098396,65,4,0,69
"98397",1098397,191,43,9,243
"98398",1098398,20,22,0,42
"98399",1098399,43,111,0,154
"98400",1098400,146,19,8,173
"98401",1098401,25,13,3,41
"98402",1098402,264,37,8,309
"98403",1098403,111,78,8,197
"98404",1098404,59,234,2,295
"98405",1098405,88,5,4,97
"98406",1098406,45,74,5,124
"98407",1098407,112,162,10,284
"98408",1098408,1,10,0,11
"98409",1098409,169,46,12,227
"98410",1098410,43,107,3,153
"98411",1098411,39,22,1,62
"98412",1098412,100,8,1,109
"98413",1098413,123,159,18,300
"98414",1098414,68,218,15,301
"98415",1098415,29,232,5,266
"98416",1098416,50,41,0,91
"98417",1098417,190,55,10,255
"98418",1098418,16,153,3,172
"98419",1098419,44,205,7,256
"98420",1098420,49,101,6,156
"98421",1098421,146,68,8,222
"98422",1098422,129,139,6,274
"98423",1098423,59,244,5,308
"98424",1098424,95,26,1,122
"98425",1098425,160,2,0,162
"98426",1098426,41,35,1,77
"98427",1098427,183,69,12,264
"98428",1098428,60,188,10,258
"98429",1098429,154,30,11,195
"98430",1098430,161,87,6,254
"98431",1098431,51,68,5,124
"98432",1098432,171,10,3,184
"98433",1098433,134,152,10,296
"98434",1098434,66,157,2,225
"98435",1098435,149,79,8,236
"98436",1098436,95,147,9,251
"98437",1098437,121,149,28,298
"98438",1098438,169,26,9,204
"98439",1098439,7,4,0,11
"98440",1098440,73,189,3,265
"98441",1098441,156,72,3,231
"98442",1098442,127,59,1,187
"98443",1098443,46,24,3,73
"98444",1098444,214,90,28,332
"98445",1098445,119,48,4,171
"98446",1098446,102,157,9,268
"98447",1098447,103,110,4,217
"98448",1098448,134,138,12,284
"98449",1098449,153,47,3,203
"98450",1098450,75,183,20,278
"98451",1098451,70,69,8,147
"98452",1098452,147,103,9,259
"98453",1098453,84,32,4,120
"98454",1098454,48,137,4,189
"98455",1098455,34,57,6,97
"98456",1098456,69,86,4,159
"98457",1098457,89,255,4,348
"98458",1098458,180,62,7,249
"98459",1098459,105,153,16,274
"98460",1098460,166,89,7,262
"98461",1098461,76,228,7,311
"98462",1098462,127,152,20,299
"98463",1098463,62,134,13,209
"98464",1098464,108,140,13,261
"98465",1098465,143,133,9,285
"98466",1098466,76,105,10,191
"98467",1098467,114,129,2,245
"98468",1098468,69,191,9,269
"98469",1098469,68,97,18,183
"98470",1098470,44,127,12,183
"98471",1098471,103,174,10,287
"98472",1098472,110,153,11,274
"98473",1098473,214,85,17,316
"98474",1098474,108,124,35,267
"98475",1098475,208,63,7,278
"98476",1098476,39,73,5,117
"98477",1098477,165,80,5,250
"98478",1098478,39,219,10,268
"98479",1098479,96,182,8,286
"98480",1098480,159,110,18,287
"98481",1098481,74,72,4,150
"98482",1098482,139,142,14,295
"98483",1098483,128,131,2,261
"98484",1098484,93,35,6,134
"98485",1098485,54,189,8,251
"98486",1098486,190,54,11,255
"98487",1098487,191,34,8,233
"98488",1098488,103,151,10,264
"98489",1098489,104,196,7,307
"98490",1098490,22,216,2,240
"98491",1098491,37,248,11,296
"98492",1098492,74,128,12,214
"98493",1098493,132,61,14,207
"98494",1098494,114,83,6,203
"98495",1098495,96,133,3,232
"98496",1098496,36,253,3,292
"98497",1098497,122,155,8,285
"98498",1098498,76,207,1,284
"98499",1098499,133,125,23,281
"98500",1098500,96,150,10,256
"98501",1098501,60,210,10,280
"98502",1098502,15,17,2,34
"98503",1098503,54,136,16,206
"98504",1098504,207,96,9,312
"98505",1098505,144,90,3,237
"98506",1098506,115,175,7,297
"98507",1098507,133,45,4,182
"98508",1098508,99,3,2,104
"98509",1098509,212,60,7,279
"98510",1098510,70,95,9,174
"98511",1098511,161,24,4,189
"98512",1098512,133,38,4,175
"98513",1098513,49,170,14,233
"98514",1098514,217,86,3,306
"98515",1098515,127,134,11,272
"98516",1098516,50,175,1,226
"98517",1098517,12,42,0,54
"98518",1098518,22,9,0,31
"98519",1098519,145,59,6,210
"98520",1098520,137,39,10,186
"98521",1098521,73,104,12,189
"98522",1098522,189,77,3,269
"98523",1098523,71,203,3,277
"98524",1098524,132,87,7,226
"98525",1098525,87,130,10,227
"98526",1098526,73,187,30,290
"98527",1098527,66,197,1,264
"98528",1098528,118,62,10,190
"98529",1098529,160,90,3,253
"98530",1098530,35,49,5,89
"98531",1098531,84,188,6,278
"98532",1098532,12,21,0,33
"98533",1098533,83,97,9,189
"98534",1098534,223,31,7,261
"98535",1098535,36,38,6,80
"98536",1098536,46,185,18,249
"98537",1098537,130,65,11,206
"98538",1098538,51,166,10,227
"98539",1098539,127,0,0,127
"98540",1098540,87,179,5,271
"98541",1098541,35,256,6,297
"98542",1098542,132,336,8,476
"98543",1098543,23,18,1,42
"98544",1098544,58,187,18,263
"98545",1098545,88,219,6,313
"98546",1098546,57,162,8,227
"98547",1098547,196,71,8,275
"98548",1098548,64,213,5,282
"98549",1098549,56,165,4,225
"98550",1098550,78,33,7,118
"98551",1098551,202,47,18,267
"98552",1098552,152,25,6,183
"98553",1098553,18,164,5,187
"98554",1098554,82,183,28,293
"98555",1098555,134,76,3,213
"98556",1098556,183,4,7,194
"98557",1098557,121,169,25,315
"98558",1098558,107,63,9,179
"98559",1098559,135,146,13,294
"98560",1098560,183,32,7,222
"98561",1098561,43,39,3,85
"98562",1098562,164,100,5,269
"98563",1098563,302,89,10,401
"98564",1098564,167,138,11,316
"98565",1098565,95,45,9,149
"98566",1098566,82,129,6,217
"98567",1098567,158,49,3,210
"98568",1098568,221,52,11,284
"98569",1098569,135,120,24,279
"98570",1098570,91,101,14,206
"98571",1098571,154,53,9,216
"98572",1098572,36,206,3,245
"98573",1098573,138,45,10,193
"98574",1098574,84,204,15,303
"98575",1098575,187,71,5,263
"98576",1098576,158,8,2,168
"98577",1098577,59,215,8,282
"98578",1098578,49,219,11,279
"98579",1098579,24,9,2,35
"98580",1098580,131,147,12,290
"98581",1098581,151,69,14,234
"98582",1098582,172,6,5,183
"98583",1098583,90,48,5,143
"98584",1098584,147,94,3,244
"98585",1098585,67,125,8,200
"98586",1098586,20,50,3,73
"98587",1098587,161,23,1,185
"98588",1098588,207,111,11,329
"98589",1098589,51,129,11,191
"98590",1098590,63,151,4,218
"98591",1098591,89,158,19,266
"98592",1098592,183,30,10,223
"98593",1098593,175,112,3,290
"98594",1098594,173,18,7,198
"98595",1098595,203,30,9,242
"98596",1098596,195,25,6,226
"98597",1098597,205,41,11,257
"98598",1098598,45,190,3,238
"98599",1098599,29,222,5,256
"98600",1098600,177,48,4,229
"98601",1098601,143,127,6,276
"98602",1098602,137,26,3,166
"98603",1098603,112,39,6,157
"98604",1098604,81,93,15,189
"98605",1098605,71,52,1,124
"98606",1098606,41,152,10,203
"98607",1098607,47,202,3,252
"98608",1098608,34,128,2,164
"98609",1098609,39,222,4,265
"98610",1098610,215,68,12,295
"98611",1098611,145,73,14,232
"98612",1098612,7,5,1,13
"98613",1098613,171,78,12,261
"98614",1098614,138,128,5,271
"98615",1098615,101,54,15,170
"98616",1098616,110,148,14,272
"98617",1098617,174,11,2,187
"98618",1098618,49,218,10,277
"98619",1098619,10,32,1,43
"98620",1098620,156,134,7,297
"98621",1098621,153,108,13,274
"98622",1098622,290,7,10,307
"98623",1098623,35,232,15,282
"98624",1098624,163,105,10,278
"98625",1098625,137,111,9,257
"98626",1098626,25,234,8,267
"98627",1098627,108,164,8,280
"98628",1098628,152,120,8,280
"98629",1098629,168,100,7,275
"98630",1098630,175,23,6,204
"98631",1098631,190,88,8,286
"98632",1098632,70,108,3,181
"98633",1098633,29,99,3,131
"98634",1098634,102,129,11,242
"98635",1098635,52,137,6,195
"98636",1098636,178,53,6,237
"98637",1098637,72,105,10,187
"98638",1098638,21,38,0,59
"98639",1098639,21,3,2,26
"98640",1098640,148,93,12,253
"98641",1098641,100,15,2,117
"98642",1098642,139,44,5,188
"98643",1098643,126,30,5,161
"98644",1098644,36,216,6,258
"98645",1098645,111,111,21,243
"98646",1098646,8,236,5,249
"98647",1098647,131,124,11,266
"98648",1098648,20,3,1,24
"98649",1098649,87,45,3,135
"98650",1098650,36,224,5,265
"98651",1098651,116,75,11,202
"98652",1098652,158,85,2,245
"98653",1098653,109,23,4,136
"98654",1098654,102,150,11,263
"98655",1098655,154,43,4,201
"98656",1098656,78,61,3,142
"98657",1098657,86,198,7,291
"98658",1098658,114,120,2,236
"98659",1098659,195,55,8,258
"98660",1098660,183,88,12,283
"98661",1098661,6,7,1,14
"98662",1098662,113,154,11,278
"98663",1098663,27,295,8,330
"98664",1098664,152,13,6,171
"98665",1098665,138,181,9,328
"98666",1098666,86,26,3,115
"98667",1098667,92,58,4,154
"98668",1098668,202,56,12,270
"98669",1098669,33,166,5,204
"98670",1098670,156,108,9,273
"98671",1098671,112,164,14,290
"98672",1098672,231,19,4,254
"98673",1098673,19,142,3,164
"98674",1098674,208,45,8,261
"98675",1098675,194,84,24,302
"98676",1098676,211,23,5,239
"98677",1098677,98,89,2,189
"98678",1098678,129,114,18,261
"98679",1098679,61,122,2,185
"98680",1098680,64,55,4,123
"98681",1098681,87,116,3,206
"98682",1098682,28,125,1,154
"98683",1098683,242,107,14,363
"98684",1098684,191,62,6,259
"98685",1098685,72,175,19,266
"98686",1098686,26,4,2,32
"98687",1098687,79,12,4,95
"98688",1098688,112,62,7,181
"98689",1098689,64,164,9,237
"98690",1098690,177,44,6,227
"98691",1098691,74,186,11,271
"98692",1098692,31,8,2,41
"98693",1098693,22,128,5,155
"98694",1098694,63,38,7,108
"98695",1098695,119,70,7,196
"98696",1098696,61,203,0,264
"98697",1098697,100,141,8,249
"98698",1098698,174,74,15,263
"98699",1098699,117,53,6,176
"98700",1098700,18,11,2,31
"98701",1098701,129,80,7,216
"98702",1098702,177,61,2,240
"98703",1098703,240,32,9,281
"98704",1098704,172,42,9,223
"98705",1098705,146,99,11,256
"98706",1098706,93,186,17,296
"98707",1098707,99,105,6,210
"98708",1098708,61,179,6,246
"98709",1098709,86,131,2,219
"98710",1098710,123,23,7,153
"98711",1098711,113,113,4,230
"98712",1098712,132,27,10,169
"98713",1098713,41,212,2,255
"98714",1098714,149,55,13,217
"98715",1098715,97,93,4,194
"98716",1098716,50,197,15,262
"98717",1098717,29,149,6,184
"98718",1098718,125,103,12,240
"98719",1098719,193,6,5,204
"98720",1098720,61,84,5,150
"98721",1098721,52,238,8,298
"98722",1098722,19,31,3,53
"98723",1098723,137,137,9,283
"98724",1098724,130,149,8,287
"98725",1098725,116,41,3,160
"98726",1098726,70,184,5,259
"98727",1098727,172,87,3,262
"98728",1098728,116,90,15,221
"98729",1098729,169,28,4,201
"98730",1098730,143,32,5,180
"98731",1098731,100,206,9,315
"98732",1098732,135,54,7,196
"98733",1098733,94,185,10,289
"98734",1098734,4,25,0,29
"98735",1098735,160,56,2,218
"98736",1098736,71,159,2,232
"98737",1098737,98,144,6,248
"98738",1098738,85,86,4,175
"98739",1098739,134,101,12,247
"98740",1098740,61,200,3,264
"98741",1098741,145,105,15,265
"98742",1098742,105,27,7,139
"98743",1098743,204,14,10,228
"98744",1098744,53,242,2,297
"98745",1098745,116,132,7,255
"98746",1098746,164,96,16,276
"98747",1098747,68,224,7,299
"98748",1098748,57,190,17,264
"98749",1098749,72,117,9,198
"98750",1098750,65,188,13,266
"98751",1098751,167,104,9,280
"98752",1098752,179,68,10,257
"98753",1098753,234,65,11,310
"98754",1098754,123,98,1,222
"98755",1098755,69,21,0,90
"98756",1098756,34,232,8,274
"98757",1098757,199,34,11,244
"98758",1098758,16,73,2,91
"98759",1098759,100,91,6,197
"98760",1098760,54,175,6,235
"98761",1098761,98,133,5,236
"98762",1098762,86,37,3,126
"98763",1098763,136,31,10,177
"98764",1098764,40,96,4,140
"98765",1098765,88,165,12,265
"98766",1098766,58,259,2,319
"98767",1098767,10,3,0,13
"98768",1098768,41,125,3,169
"98769",1098769,31,5,3,39
"98770",1098770,158,153,14,325
"98771",1098771,129,57,8,194
"98772",1098772,144,116,5,265
"98773",1098773,125,181,9,315
"98774",1098774,20,142,9,171
"98775",1098775,221,17,4,242
"98776",1098776,29,277,7,313
"98777",1098777,33,251,4,288
"98778",1098778,186,30,11,227
"98779",1098779,102,105,2,209
"98780",1098780,205,69,10,284
"98781",1098781,109,102,12,223
"98782",1098782,3,20,1,24
"98783",1098783,9,294,2,305
"98784",1098784,135,21,3,159
"98785",1098785,103,70,0,173
"98786",1098786,32,202,6,240
"98787",1098787,188,50,6,244
"98788",1098788,144,47,5,196
"98789",1098789,198,24,1,223
"98790",1098790,86,183,2,271
"98791",1098791,136,34,6,176
"98792",1098792,62,43,4,109
"98793",1098793,107,134,17,258
"98794",1098794,201,110,18,329
"98795",1098795,135,74,16,225
"98796",1098796,193,66,8,267
"98797",1098797,51,128,10,189
"98798",1098798,113,104,11,228
"98799",1098799,43,184,3,230
"98800",1098800,58,239,9,306
"98801",1098801,93,88,10,191
"98802",1098802,163,78,6,247
"98803",1098803,120,152,14,286
"98804",1098804,106,118,4,228
"98805",1098805,90,25,7,122
"98806",1098806,72,76,11,159
"98807",1098807,261,0,0,261
"98808",1098808,46,221,6,273
"98809",1098809,188,72,3,263
"98810",1098810,123,155,10,288
"98811",1098811,104,187,14,305
"98812",1098812,64,147,6,217
"98813",1098813,97,100,4,201
"98814",1098814,18,12,1,31
"98815",1098815,148,2,0,150
"98816",1098816,42,114,5,161
"98817",1098817,90,152,6,248
"98818",1098818,152,64,3,219
"98819",1098819,191,87,24,302
"98820",1098820,107,68,10,185
"98821",1098821,131,74,3,208
"98822",1098822,169,144,10,323
"98823",1098823,215,35,8,258
"98824",1098824,208,53,13,274
"98825",1098825,98,164,13,275
"98826",1098826,60,47,7,114
"98827",1098827,97,41,5,143
"98828",1098828,93,183,10,286
"98829",1098829,92,122,0,214
"98830",1098830,96,123,8,227
"98831",1098831,92,81,5,178
"98832",1098832,85,184,20,289
"98833",1098833,85,173,10,268
"98834",1098834,143,113,14,270
"98835",1098835,64,158,12,234
"98836",1098836,80,36,6,122
"98837",1098837,129,184,17,330
"98838",1098838,115,58,7,180
"98839",1098839,90,15,0,105
"98840",1098840,55,122,5,182
"98841",1098841,70,44,5,119
"98842",1098842,131,129,4,264
"98843",1098843,142,11,5,158
"98844",1098844,143,79,12,234
"98845",1098845,139,122,7,268
"98846",1098846,84,194,19,297
"98847",1098847,115,89,4,208
"98848",1098848,20,75,5,100
"98849",1098849,26,26,1,53
"98850",1098850,100,170,6,276
"98851",1098851,115,167,12,294
"98852",1098852,29,18,1,48
"98853",1098853,139,56,10,205
"98854",1098854,48,233,4,285
"98855",1098855,54,202,5,261
"98856",1098856,196,90,2,288
"98857",1098857,94,86,5,185
"98858",1098858,66,51,5,122
"98859",1098859,146,57,11,214
"98860",1098860,128,125,14,267
"98861",1098861,133,60,17,210
"98862",1098862,11,177,2,190
"98863",1098863,109,64,5,178
"98864",1098864,133,152,13,298
"98865",1098865,59,130,7,196
"98866",1098866,93,212,4,309
"98867",1098867,107,44,12,163
"98868",1098868,185,90,12,287
"98869",1098869,39,159,5,203
"98870",1098870,111,102,8,221
"98871",1098871,70,140,2,212
"98872",1098872,150,67,22,239
"98873",1098873,49,191,7,247
"98874",1098874,77,213,1,291
"98875",1098875,141,71,18,230
"98876",1098876,197,84,28,309
"98877",1098877,88,54,2,144
"98878",1098878,44,254,10,308
"98879",1098879,143,109,9,261
"98880",1098880,161,52,6,219
"98881",1098881,194,74,21,289
"98882",1098882,119,64,0,183
"98883",1098883,217,40,10,267
"98884",1098884,158,45,16,219
"98885",1098885,145,78,17,240
"98886",1098886,62,78,6,146
"98887",1098887,114,99,13,226
"98888",1098888,72,241,19,332
"98889",1098889,93,193,10,296
"98890",1098890,139,37,3,179
"98891",1098891,45,256,18,319
"98892",1098892,47,188,8,243
"98893",1098893,204,115,7,326
"98894",1098894,229,44,14,287
"98895",1098895,153,114,10,277
"98896",1098896,51,223,10,284
"98897",1098897,43,178,10,231
"98898",1098898,179,82,7,268
"98899",1098899,90,31,1,122
"98900",1098900,262,11,3,276
"98901",1098901,34,163,2,199
"98902",1098902,175,49,6,230
"98903",1098903,173,79,9,261
"98904",1098904,44,61,1,106
"98905",1098905,121,25,14,160
"98906",1098906,151,70,9,230
"98907",1098907,56,145,3,204
"98908",1098908,24,191,2,217
"98909",1098909,79,2,0,81
"98910",1098910,48,211,10,269
"98911",1098911,10,133,5,148
"98912",1098912,134,96,11,241
"98913",1098913,14,288,4,306
"98914",1098914,23,318,5,346
"98915",1098915,4,4,0,8
"98916",1098916,111,139,8,258
"98917",1098917,94,81,3,178
"98918",1098918,46,69,4,119
"98919",1098919,115,67,10,192
"98920",1098920,55,266,5,326
"98921",1098921,183,87,4,274
"98922",1098922,198,22,4,224
"98923",1098923,90,138,9,237
"98924",1098924,34,260,4,298
"98925",1098925,50,172,10,232
"98926",1098926,126,63,8,197
"98927",1098927,99,85,6,190
"98928",1098928,47,159,11,217
"98929",1098929,160,43,12,215
"98930",1098930,226,58,14,298
"98931",1098931,162,21,4,187
"98932",1098932,87,145,16,248
"98933",1098933,188,57,11,256
"98934",1098934,97,130,13,240
"98935",1098935,159,72,21,252
"98936",1098936,159,71,6,236
"98937",1098937,146,29,9,184
"98938",1098938,119,131,1,251
"98939",1098939,44,146,4,194
"98940",1098940,35,163,8,206
"98941",1098941,143,41,4,188
"98942",1098942,32,232,5,269
"98943",1098943,151,51,5,207
"98944",1098944,111,53,1,165
"98945",1098945,64,211,2,277
"98946",1098946,210,49,10,269
"98947",1098947,127,172,13,312
"98948",1098948,66,185,7,258
"98949",1098949,72,196,14,282
"98950",1098950,162,87,5,254
"98951",1098951,197,16,2,215
"98952",1098952,159,86,10,255
"98953",1098953,120,125,16,261
"98954",1098954,33,246,2,281
"98955",1098955,111,3,0,114
"98956",1098956,172,12,7,191
"98957",1098957,181,86,10,277
"98958",1098958,81,145,3,229
"98959",1098959,0,23,0,23
"98960",1098960,264,10,6,280
"98961",1098961,3,0,0,3
"98962",1098962,54,218,8,280
"98963",1098963,157,77,7,241
"98964",1098964,15,3,0,18
"98965",1098965,116,91,4,211
"98966",1098966,147,67,2,216
"98967",1098967,146,162,4,312
"98968",1098968,102,99,2,203
"98969",1098969,7,5,3,15
"98970",1098970,39,234,5,278
"98971",1098971,9,191,3,203
"98972",1098972,219,78,13,310
"98973",1098973,0,1,0,1
"98974",1098974,156,124,11,291
"98975",1098975,162,6,8,176
"98976",1098976,23,64,1,88
"98977",1098977,89,68,6,163
"98978",1098978,101,99,7,207
"98979",1098979,164,92,5,261
"98980",1098980,52,130,7,189
"98981",1098981,117,139,11,267
"98982",1098982,119,15,4,138
"98983",1098983,141,106,5,252
"98984",1098984,131,30,3,164
"98985",1098985,115,83,8,206
"98986",1098986,152,77,15,244
"98987",1098987,29,86,2,117
"98988",1098988,140,174,8,322
"98989",1098989,200,39,4,243
"98990",1098990,167,56,4,227
"98991",1098991,11,4,0,15
"98992",1098992,108,40,6,154
"98993",1098993,83,189,8,280
"98994",1098994,163,82,11,256
"98995",1098995,69,206,8,283
"98996",1098996,144,63,15,222
"98997",1098997,59,74,6,139
"98998",1098998,101,149,12,262
"98999",1098999,80,232,8,320
"99000",1099000,129,49,6,184
"99001",1099001,76,165,4,245
"99002",1099002,190,26,8,224
"99003",1099003,44,41,0,85
"99004",1099004,50,115,22,187
"99005",1099005,45,285,6,336
"99006",1099006,143,171,9,323
"99007",1099007,7,9,0,16
"99008",1099008,141,114,10,265
"99009",1099009,110,36,12,158
"99010",1099010,75,85,9,169
"99011",1099011,119,90,8,217
"99012",1099012,170,91,7,268
"99013",1099013,122,102,6,230
"99014",1099014,69,234,12,315
"99015",1099015,188,28,6,222
"99016",1099016,80,6,4,90
"99017",1099017,8,13,1,22
"99018",1099018,58,238,8,304
"99019",1099019,179,32,12,223
"99020",1099020,111,31,8,150
"99021",1099021,243,40,15,298
"99022",1099022,38,256,8,302
"99023",1099023,92,159,13,264
"99024",1099024,41,22,2,65
"99025",1099025,14,18,2,34
"99026",1099026,165,54,6,225
"99027",1099027,177,87,7,271
"99028",1099028,101,120,7,228
"99029",1099029,45,408,2,455
"99030",1099030,171,69,10,250
"99031",1099031,103,30,4,137
"99032",1099032,30,18,2,50
"99033",1099033,120,33,8,161
"99034",1099034,82,186,9,277
"99035",1099035,199,48,9,256
"99036",1099036,32,252,5,289
"99037",1099037,114,68,15,197
"99038",1099038,84,21,2,107
"99039",1099039,112,100,12,224
"99040",1099040,130,43,4,177
"99041",1099041,61,159,10,230
"99042",1099042,90,50,9,149
"99043",1099043,48,161,6,215
"99044",1099044,73,103,7,183
"99045",1099045,76,224,13,313
"99046",1099046,56,0,2,58
"99047",1099047,93,197,12,302
"99048",1099048,134,101,18,253
"99049",1099049,187,83,10,280
"99050",1099050,67,49,6,122
"99051",1099051,178,101,8,287
"99052",1099052,48,5,2,55
"99053",1099053,166,38,3,207
"99054",1099054,59,246,5,310
"99055",1099055,112,71,18,201
"99056",1099056,52,234,1,287
"99057",1099057,112,54,7,173
"99058",1099058,26,259,2,287
"99059",1099059,65,53,7,125
"99060",1099060,116,114,2,232
"99061",1099061,50,247,13,310
"99062",1099062,153,101,9,263
"99063",1099063,164,116,9,289
"99064",1099064,82,203,5,290
"99065",1099065,100,204,8,312
"99066",1099066,48,166,3,217
"99067",1099067,7,29,0,36
"99068",1099068,140,51,16,207
"99069",1099069,134,49,2,185
"99070",1099070,74,116,3,193
"99071",1099071,80,136,13,229
"99072",1099072,219,36,11,266
"99073",1099073,85,194,12,291
"99074",1099074,103,142,18,263
"99075",1099075,171,23,6,200
"99076",1099076,134,36,4,174
"99077",1099077,29,209,3,241
"99078",1099078,102,215,6,323
"99079",1099079,67,195,11,273
"99080",1099080,148,98,10,256
"99081",1099081,227,60,15,302
"99082",1099082,124,177,6,307
"99083",1099083,66,183,4,253
"99084",1099084,101,59,5,165
"99085",1099085,156,140,11,307
"99086",1099086,181,74,15,270
"99087",1099087,95,68,6,169
"99088",1099088,116,136,7,259
"99089",1099089,179,109,14,302
"99090",1099090,156,56,12,224
"99091",1099091,219,44,4,267
"99092",1099092,20,34,3,57
"99093",1099093,128,89,11,228
"99094",1099094,163,108,2,273
"99095",1099095,137,15,0,152
"99096",1099096,152,105,3,260
"99097",1099097,150,80,4,234
"99098",1099098,95,151,11,257
"99099",1099099,64,63,7,134
"99100",1099100,146,47,3,196
"99101",1099101,3,18,0,21
"99102",1099102,19,2,1,22
"99103",1099103,26,134,5,165
"99104",1099104,141,19,5,165
"99105",1099105,63,54,7,124
"99106",1099106,124,106,7,237
"99107",1099107,35,230,1,266
"99108",1099108,75,185,6,266
"99109",1099109,191,29,10,230
"99110",1099110,182,64,5,251
"99111",1099111,116,82,8,206
"99112",1099112,125,46,6,177
"99113",1099113,141,126,11,278
"99114",1099114,120,91,4,215
"99115",1099115,52,195,11,258
"99116",1099116,140,82,11,233
"99117",1099117,49,132,15,196
"99118",1099118,168,114,5,287
"99119",1099119,25,193,6,224
"99120",1099120,94,116,11,221
"99121",1099121,133,102,10,245
"99122",1099122,51,79,5,135
"99123",1099123,139,63,2,204
"99124",1099124,143,65,9,217
"99125",1099125,175,39,9,223
"99126",1099126,82,146,3,231
"99127",1099127,18,240,5,263
"99128",1099128,25,153,0,178
"99129",1099129,142,135,22,299
"99130",1099130,102,62,5,169
"99131",1099131,6,2,0,8
"99132",1099132,47,220,4,271
"99133",1099133,199,60,16,275
"99134",1099134,81,188,29,298
"99135",1099135,174,58,5,237
"99136",1099136,96,190,15,301
"99137",1099137,100,159,7,266
"99138",1099138,156,23,4,183
"99139",1099139,55,40,4,99
"99140",1099140,185,10,5,200
"99141",1099141,109,166,10,285
"99142",1099142,165,13,4,182
"99143",1099143,91,94,19,204
"99144",1099144,113,58,7,178
"99145",1099145,19,42,2,63
"99146",1099146,143,148,7,298
"99147",1099147,213,15,3,231
"99148",1099148,156,82,7,245
"99149",1099149,115,48,0,163
"99150",1099150,283,19,4,306
"99151",1099151,68,239,4,311
"99152",1099152,116,141,12,269
"99153",1099153,184,61,5,250
"99154",1099154,107,114,10,231
"99155",1099155,140,78,9,227
"99156",1099156,66,108,2,176
"99157",1099157,159,86,6,251
"99158",1099158,91,142,9,242
"99159",1099159,164,72,8,244
"99160",1099160,120,20,7,147
"99161",1099161,238,40,3,281
"99162",1099162,88,63,5,156
"99163",1099163,159,134,4,297
"99164",1099164,89,37,4,130
"99165",1099165,238,34,8,280
"99166",1099166,43,235,3,281
"99167",1099167,17,17,2,36
"99168",1099168,26,184,3,213
"99169",1099169,177,113,5,295
"99170",1099170,29,234,5,268
"99171",1099171,193,61,9,263
"99172",1099172,88,27,7,122
"99173",1099173,176,29,7,212
"99174",1099174,68,63,2,133
"99175",1099175,128,97,4,229
"99176",1099176,53,208,12,273
"99177",1099177,38,0,1,39
"99178",1099178,124,50,4,178
"99179",1099179,203,40,8,251
"99180",1099180,117,216,9,342
"99181",1099181,105,55,12,172
"99182",1099182,165,143,3,311
"99183",1099183,37,281,7,325
"99184",1099184,114,212,5,331
"99185",1099185,107,61,3,171
"99186",1099186,84,166,14,264
"99187",1099187,167,66,10,243
"99188",1099188,162,100,6,268
"99189",1099189,172,87,12,271
"99190",1099190,88,59,5,152
"99191",1099191,162,34,6,202
"99192",1099192,27,206,2,235
"99193",1099193,176,114,10,300
"99194",1099194,126,35,7,168
"99195",1099195,119,56,2,177
"99196",1099196,189,83,8,280
"99197",1099197,98,32,6,136
"99198",1099198,98,159,7,264
"99199",1099199,124,49,7,180
"99200",1099200,60,141,11,212
"99201",1099201,137,34,2,173
"99202",1099202,28,52,1,81
"99203",1099203,84,189,8,281
"99204",1099204,206,22,7,235
"99205",1099205,208,82,6,296
"99206",1099206,39,213,14,266
"99207",1099207,44,29,4,77
"99208",1099208,178,111,5,294
"99209",1099209,170,133,18,321
"99210",1099210,104,112,8,224
"99211",1099211,136,144,2,282
"99212",1099212,139,29,3,171
"99213",1099213,246,26,4,276
"99214",1099214,100,116,9,225
"99215",1099215,142,129,6,277
"99216",1099216,74,77,8,159
"99217",1099217,142,41,6,189
"99218",1099218,109,67,2,178
"99219",1099219,119,14,0,133
"99220",1099220,56,127,18,201
"99221",1099221,169,34,3,206
"99222",1099222,148,85,14,247
"99223",1099223,105,121,18,244
"99224",1099224,112,116,6,234
"99225",1099225,27,255,2,284
"99226",1099226,71,103,9,183
"99227",1099227,66,223,3,292
"99228",1099228,68,213,5,286
"99229",1099229,94,227,1,322
"99230",1099230,92,33,8,133
"99231",1099231,207,91,12,310
"99232",1099232,115,101,7,223
"99233",1099233,66,237,22,325
"99234",1099234,63,188,13,264
"99235",1099235,87,52,6,145
"99236",1099236,121,97,15,233
"99237",1099237,55,144,4,203
"99238",1099238,88,77,5,170
"99239",1099239,162,81,6,249
"99240",1099240,235,52,14,301
"99241",1099241,196,73,15,284
"99242",1099242,166,119,8,293
"99243",1099243,127,137,15,279
"99244",1099244,54,14,3,71
"99245",1099245,86,272,3,361
"99246",1099246,137,62,2,201
"99247",1099247,139,26,4,169
"99248",1099248,89,136,9,234
"99249",1099249,99,185,8,292
"99250",1099250,65,191,9,265
"99251",1099251,191,95,14,300
"99252",1099252,58,38,5,101
"99253",1099253,223,11,8,242
"99254",1099254,26,97,1,124
"99255",1099255,177,62,10,249
"99256",1099256,246,65,13,324
"99257",1099257,129,13,3,145
"99258",1099258,102,61,12,175
"99259",1099259,114,9,7,130
"99260",1099260,150,82,11,243
"99261",1099261,26,191,3,220
"99262",1099262,77,208,8,293
"99263",1099263,248,25,9,282
"99264",1099264,67,0,0,67
"99265",1099265,14,9,0,23
"99266",1099266,181,59,9,249
"99267",1099267,22,2,1,25
"99268",1099268,118,124,12,254
"99269",1099269,151,22,3,176
"99270",1099270,54,248,2,304
"99271",1099271,63,18,5,86
"99272",1099272,130,32,5,167
"99273",1099273,40,191,7,238
"99274",1099274,45,57,6,108
"99275",1099275,107,72,8,187
"99276",1099276,153,57,8,218
"99277",1099277,136,5,1,142
"99278",1099278,62,184,11,257
"99279",1099279,43,256,13,312
"99280",1099280,146,109,7,262
"99281",1099281,122,148,3,273
"99282",1099282,88,180,13,281
"99283",1099283,193,93,7,293
"99284",1099284,104,128,10,242
"99285",1099285,183,95,9,287
"99286",1099286,82,230,12,324
"99287",1099287,85,162,16,263
"99288",1099288,24,15,1,40
"99289",1099289,119,81,7,207
"99290",1099290,85,180,4,269
"99291",1099291,69,167,5,241
"99292",1099292,100,192,3,295
"99293",1099293,141,80,18,239
"99294",1099294,35,115,9,159
"99295",1099295,26,155,4,185
"99296",1099296,173,33,6,212
"99297",1099297,64,192,7,263
"99298",1099298,212,77,28,317
"99299",1099299,60,74,14,148
"99300",1099300,160,140,6,306
"99301",1099301,52,142,1,195
"99302",1099302,127,54,5,186
"99303",1099303,2,14,0,16
"99304",1099304,128,102,7,237
"99305",1099305,122,58,10,190
"99306",1099306,147,88,23,258
"99307",1099307,146,98,8,252
"99308",1099308,0,2,0,2
"99309",1099309,92,65,15,172
"99310",1099310,110,188,5,303
"99311",1099311,98,91,3,192
"99312",1099312,59,176,4,239
"99313",1099313,71,51,3,125
"99314",1099314,34,122,10,166
"99315",1099315,99,99,3,201
"99316",1099316,115,54,6,175
"99317",1099317,122,56,6,184
"99318",1099318,219,38,4,261
"99319",1099319,78,169,15,262
"99320",1099320,309,21,4,334
"99321",1099321,150,100,3,253
"99322",1099322,147,85,7,239
"99323",1099323,109,64,5,178
"99324",1099324,177,40,11,228
"99325",1099325,81,11,4,96
"99326",1099326,91,161,4,256
"99327",1099327,54,35,2,91
"99328",1099328,17,84,0,101
"99329",1099329,220,7,7,234
"99330",1099330,128,158,5,291
"99331",1099331,103,146,7,256
"99332",1099332,131,177,10,318
"99333",1099333,47,66,0,113
"99334",1099334,96,194,13,303
"99335",1099335,48,90,7,145
"99336",1099336,122,88,6,216
"99337",1099337,108,176,4,288
"99338",1099338,173,92,6,271
"99339",1099339,17,6,1,24
"99340",1099340,147,132,7,286
"99341",1099341,149,35,8,192
"99342",1099342,4,12,0,16
"99343",1099343,83,140,6,229
"99344",1099344,198,21,5,224
"99345",1099345,160,58,2,220
"99346",1099346,37,20,0,57
"99347",1099347,155,111,12,278
"99348",1099348,161,77,9,247
"99349",1099349,72,118,11,201
"99350",1099350,34,22,2,58
"99351",1099351,41,91,14,146
"99352",1099352,22,35,1,58
"99353",1099353,82,131,7,220
"99354",1099354,74,210,8,292
"99355",1099355,109,81,11,201
"99356",1099356,97,119,11,227
"99357",1099357,181,76,3,260
"99358",1099358,139,84,8,231
"99359",1099359,153,116,7,276
"99360",1099360,81,51,5,137
"99361",1099361,125,138,3,266
"99362",1099362,130,145,9,284
"99363",1099363,62,164,2,228
"99364",1099364,115,34,3,152
"99365",1099365,179,70,14,263
"99366",1099366,109,84,6,199
"99367",1099367,249,65,13,327
"99368",1099368,68,63,7,138
"99369",1099369,70,187,7,264
"99370",1099370,134,115,9,258
"99371",1099371,198,81,8,287
"99372",1099372,139,83,7,229
"99373",1099373,45,245,5,295
"99374",1099374,85,123,4,212
"99375",1099375,29,152,1,182
"99376",1099376,117,40,9,166
"99377",1099377,74,129,29,232
"99378",1099378,90,155,7,252
"99379",1099379,165,30,4,199
"99380",1099380,1,12,2,15
"99381",1099381,87,91,14,192
"99382",1099382,120,102,5,227
"99383",1099383,26,58,2,86
"99384",1099384,128,62,9,199
"99385",1099385,50,281,4,335
"99386",1099386,173,59,12,244
"99387",1099387,52,123,6,181
"99388",1099388,59,171,6,236
"99389",1099389,197,39,10,246
"99390",1099390,234,10,4,248
"99391",1099391,159,47,10,216
"99392",1099392,53,163,5,221
"99393",1099393,24,103,7,134
"99394",1099394,55,220,6,281
"99395",1099395,145,62,12,219
"99396",1099396,99,179,14,292
"99397",1099397,67,99,1,167
"99398",1099398,187,66,14,267
"99399",1099399,152,131,7,290
"99400",1099400,50,218,16,284
"99401",1099401,162,98,13,273
"99402",1099402,80,211,9,300
"99403",1099403,42,169,2,213
"99404",1099404,228,67,4,299
"99405",1099405,212,54,9,275
"99406",1099406,145,87,8,240
"99407",1099407,106,150,22,278
"99408",1099408,126,21,1,148
"99409",1099409,164,57,10,231
"99410",1099410,100,172,9,281
"99411",1099411,62,195,11,268
"99412",1099412,128,44,20,192
"99413",1099413,39,55,9,103
"99414",1099414,81,110,11,202
"99415",1099415,44,68,3,115
"99416",1099416,77,210,18,305
"99417",1099417,127,97,13,237
"99418",1099418,122,62,2,186
"99419",1099419,128,96,16,240
"99420",1099420,107,128,3,238
"99421",1099421,35,234,4,273
"99422",1099422,264,8,1,273
"99423",1099423,123,62,23,208
"99424",1099424,226,17,10,253
"99425",1099425,21,18,1,40
"99426",1099426,31,198,4,233
"99427",1099427,131,26,4,161
"99428",1099428,133,20,7,160
"99429",1099429,110,54,4,168
"99430",1099430,196,61,1,258
"99431",1099431,31,232,3,266
"99432",1099432,55,180,2,237
"99433",1099433,69,185,7,261
"99434",1099434,11,165,21,197
"99435",1099435,99,129,14,242
"99436",1099436,186,86,4,276
"99437",1099437,161,55,7,223
"99438",1099438,50,29,4,83
"99439",1099439,13,54,4,71
"99440",1099440,0,9,0,9
"99441",1099441,21,208,6,235
"99442",1099442,193,105,10,308
"99443",1099443,180,51,10,241
"99444",1099444,250,28,11,289
"99445",1099445,60,231,19,310
"99446",1099446,86,176,22,284
"99447",1099447,129,138,23,290
"99448",1099448,89,102,3,194
"99449",1099449,10,14,0,24
"99450",1099450,274,35,10,319
"99451",1099451,153,101,23,277
"99452",1099452,73,168,10,251
"99453",1099453,89,95,7,191
"99454",1099454,67,120,11,198
"99455",1099455,166,82,8,256
"99456",1099456,72,33,1,106
"99457",1099457,118,91,12,221
"99458",1099458,33,158,2,193
"99459",1099459,125,67,7,199
"99460",1099460,108,83,13,204
"99461",1099461,118,67,6,191
"99462",1099462,107,1,1,109
"99463",1099463,213,72,24,309
"99464",1099464,275,5,6,286
"99465",1099465,114,70,10,194
"99466",1099466,135,30,11,176
"99467",1099467,166,14,7,187
"99468",1099468,35,218,4,257
"99469",1099469,244,51,10,305
"99470",1099470,113,188,19,320
"99471",1099471,176,109,6,291
"99472",1099472,155,20,2,177
"99473",1099473,28,138,5,171
"99474",1099474,94,194,3,291
"99475",1099475,114,117,10,241
"99476",1099476,49,180,7,236
"99477",1099477,156,55,11,222
"99478",1099478,157,62,9,228
"99479",1099479,73,128,5,206
"99480",1099480,153,61,12,226
"99481",1099481,7,29,0,36
"99482",1099482,132,119,6,257
"99483",1099483,176,68,9,253
"99484",1099484,76,256,10,342
"99485",1099485,46,152,15,213
"99486",1099486,91,182,5,278
"99487",1099487,125,74,4,203
"99488",1099488,166,61,13,240
"99489",1099489,42,275,4,321
"99490",1099490,80,60,6,146
"99491",1099491,78,103,16,197
"99492",1099492,87,140,6,233
"99493",1099493,64,3,0,67
"99494",1099494,36,113,5,154
"99495",1099495,98,107,15,220
"99496",1099496,117,136,12,265
"99497",1099497,4,32,0,36
"99498",1099498,153,42,5,200
"99499",1099499,46,181,9,236
"99500",1099500,97,49,2,148
"99501",1099501,74,152,4,230
"99502",1099502,154,134,12,300
"99503",1099503,37,131,3,171
"99504",1099504,47,238,13,298
"99505",1099505,131,138,2,271
"99506",1099506,56,113,7,176
"99507",1099507,20,189,2,211
"99508",1099508,139,105,5,249
"99509",1099509,100,65,8,173
"99510",1099510,72,213,16,301
"99511",1099511,148,88,6,242
"99512",1099512,54,80,6,140
"99513",1099513,97,86,6,189
"99514",1099514,76,176,19,271
"99515",1099515,144,100,14,258
"99516",1099516,117,76,2,195
"99517",1099517,36,41,1,78
"99518",1099518,78,9,3,90
"99519",1099519,40,237,0,277
"99520",1099520,89,61,1,151
"99521",1099521,157,45,6,208
"99522",1099522,248,63,7,318
"99523",1099523,178,27,3,208
"99524",1099524,196,22,9,227
"99525",1099525,32,10,0,42
"99526",1099526,45,41,3,89
"99527",1099527,66,140,6,212
"99528",1099528,165,66,11,242
"99529",1099529,31,264,10,305
"99530",1099530,98,64,8,170
"99531",1099531,122,180,10,312
"99532",1099532,236,11,1,248
"99533",1099533,200,34,5,239
"99534",1099534,313,0,8,321
"99535",1099535,132,142,19,293
"99536",1099536,56,129,5,190
"99537",1099537,1,5,0,6
"99538",1099538,60,67,6,133
"99539",1099539,175,62,6,243
"99540",1099540,197,30,10,237
"99541",1099541,167,30,1,198
"99542",1099542,82,176,22,280
"99543",1099543,85,123,7,215
"99544",1099544,158,132,11,301
"99545",1099545,13,5,1,19
"99546",1099546,120,203,14,337
"99547",1099547,82,141,9,232
"99548",1099548,126,47,6,179
"99549",1099549,45,74,18,137
"99550",1099550,95,245,16,356
"99551",1099551,16,3,1,20
"99552",1099552,69,148,5,222
"99553",1099553,121,102,13,236
"99554",1099554,187,60,4,251
"99555",1099555,134,101,15,250
"99556",1099556,171,45,2,218
"99557",1099557,87,178,16,281
"99558",1099558,129,20,3,152
"99559",1099559,119,36,5,160
"99560",1099560,163,102,9,274
"99561",1099561,170,84,14,268
"99562",1099562,127,95,3,225
"99563",1099563,115,53,5,173
"99564",1099564,42,80,7,129
"99565",1099565,142,12,8,162
"99566",1099566,194,41,8,243
"99567",1099567,143,110,19,272
"99568",1099568,225,19,5,249
"99569",1099569,88,81,2,171
"99570",1099570,62,219,8,289
"99571",1099571,162,58,4,224
"99572",1099572,119,118,2,239
"99573",1099573,172,108,18,298
"99574",1099574,51,79,4,134
"99575",1099575,83,17,3,103
"99576",1099576,28,90,0,118
"99577",1099577,123,282,14,419
"99578",1099578,121,155,16,292
"99579",1099579,119,138,10,267
"99580",1099580,143,87,9,239
"99581",1099581,93,26,3,122
"99582",1099582,205,75,4,284
"99583",1099583,39,181,17,237
"99584",1099584,162,53,8,223
"99585",1099585,103,97,11,211
"99586",1099586,105,114,3,222
"99587",1099587,95,46,3,144
"99588",1099588,244,43,13,300
"99589",1099589,67,204,12,283
"99590",1099590,189,47,11,247
"99591",1099591,118,129,3,250
"99592",1099592,31,145,3,179
"99593",1099593,55,180,19,254
"99594",1099594,228,20,8,256
"99595",1099595,48,72,6,126
"99596",1099596,92,51,10,153
"99597",1099597,96,35,17,148
"99598",1099598,205,33,3,241
"99599",1099599,153,94,3,250
"99600",1099600,47,176,18,241
"99601",1099601,69,175,4,248
"99602",1099602,118,83,3,204
"99603",1099603,135,73,6,214
"99604",1099604,141,70,5,216
"99605",1099605,155,49,1,205
"99606",1099606,101,92,15,208
"99607",1099607,140,39,10,189
"99608",1099608,167,46,15,228
"99609",1099609,71,60,8,139
"99610",1099610,166,25,6,197
"99611",1099611,10,76,0,86
"99612",1099612,222,31,9,262
"99613",1099613,144,39,6,189
"99614",1099614,189,73,7,269
"99615",1099615,155,64,9,228
"99616",1099616,178,97,17,292
"99617",1099617,212,40,5,257
"99618",1099618,247,84,9,340
"99619",1099619,99,24,2,125
"99620",1099620,136,144,18,298
"99621",1099621,129,61,5,195
"99622",1099622,161,113,6,280
"99623",1099623,102,104,8,214
"99624",1099624,42,201,13,256
"99625",1099625,170,41,4,215
"99626",1099626,110,65,12,187
"99627",1099627,118,117,15,250
"99628",1099628,68,222,7,297
"99629",1099629,202,9,8,219
"99630",1099630,166,94,16,276
"99631",1099631,60,155,4,219
"99632",1099632,4,4,0,8
"99633",1099633,151,142,6,299
"99634",1099634,72,79,4,155
"99635",1099635,76,85,9,170
"99636",1099636,113,10,2,125
"99637",1099637,210,27,8,245
"99638",1099638,219,106,16,341
"99639",1099639,142,75,4,221
"99640",1099640,70,22,6,98
"99641",1099641,93,122,9,224
"99642",1099642,58,231,1,290
"99643",1099643,159,14,6,179
"99644",1099644,87,196,11,294
"99645",1099645,39,113,7,159
"99646",1099646,114,170,19,303
"99647",1099647,169,106,12,287
"99648",1099648,140,71,14,225
"99649",1099649,95,39,6,140
"99650",1099650,198,39,6,243
"99651",1099651,255,8,3,266
"99652",1099652,77,215,18,310
"99653",1099653,48,181,7,236
"99654",1099654,42,238,17,297
"99655",1099655,114,8,3,125
"99656",1099656,30,81,2,113
"99657",1099657,224,41,6,271
"99658",1099658,144,36,3,183
"99659",1099659,50,178,10,238
"99660",1099660,79,236,10,325
"99661",1099661,2,5,1,8
"99662",1099662,56,23,1,80
"99663",1099663,164,142,21,327
"99664",1099664,160,69,1,230
"99665",1099665,85,35,3,123
"99666",1099666,157,52,4,213
"99667",1099667,88,122,11,221
"99668",1099668,112,58,7,177
"99669",1099669,87,34,1,122
"99670",1099670,27,88,6,121
"99671",1099671,150,55,4,209
"99672",1099672,130,91,6,227
"99673",1099673,68,67,9,144
"99674",1099674,43,215,6,264
"99675",1099675,124,45,11,180
"99676",1099676,47,227,3,277
"99677",1099677,116,175,10,301
"99678",1099678,165,62,7,234
"99679",1099679,118,64,6,188
"99680",1099680,46,133,2,181
"99681",1099681,216,70,9,295
"99682",1099682,52,173,14,239
"99683",1099683,55,133,6,194
"99684",1099684,100,176,8,284
"99685",1099685,46,23,7,76
"99686",1099686,81,62,5,148
"99687",1099687,24,172,3,199
"99688",1099688,130,132,7,269
"99689",1099689,152,104,12,268
"99690",1099690,179,48,9,236
"99691",1099691,40,82,9,131
"99692",1099692,195,26,8,229
"99693",1099693,78,80,1,159
"99694",1099694,47,212,1,260
"99695",1099695,176,40,5,221
"99696",1099696,167,144,2,313
"99697",1099697,134,115,7,256
"99698",1099698,79,182,12,273
"99699",1099699,216,25,10,251
"99700",1099700,127,140,18,285
"99701",1099701,162,37,5,204
"99702",1099702,41,205,7,253
"99703",1099703,123,159,4,286
"99704",1099704,207,15,11,233
"99705",1099705,76,152,7,235
"99706",1099706,155,93,9,257
"99707",1099707,42,7,3,52
"99708",1099708,38,178,8,224
"99709",1099709,87,172,10,269
"99710",1099710,92,99,7,198
"99711",1099711,73,203,2,278
"99712",1099712,70,181,9,260
"99713",1099713,118,196,11,325
"99714",1099714,153,4,2,159
"99715",1099715,162,24,0,186
"99716",1099716,96,138,5,239
"99717",1099717,173,29,5,207
"99718",1099718,182,66,9,257
"99719",1099719,80,176,3,259
"99720",1099720,223,98,8,329
"99721",1099721,89,59,2,150
"99722",1099722,125,79,5,209
"99723",1099723,11,0,1,12
"99724",1099724,11,155,3,169
"99725",1099725,183,59,5,247
"99726",1099726,91,166,9,266
"99727",1099727,149,128,18,295
"99728",1099728,153,53,5,211
"99729",1099729,187,76,1,264
"99730",1099730,115,110,3,228
"99731",1099731,28,257,2,287
"99732",1099732,6,90,2,98
"99733",1099733,130,128,5,263
"99734",1099734,185,62,16,263
"99735",1099735,86,194,5,285
"99736",1099736,224,67,9,300
"99737",1099737,86,67,7,160
"99738",1099738,73,59,4,136
"99739",1099739,11,119,0,130
"99740",1099740,264,15,13,292
"99741",1099741,231,60,22,313
"99742",1099742,71,2,0,73
"99743",1099743,134,130,10,274
"99744",1099744,108,26,6,140
"99745",1099745,110,89,3,202
"99746",1099746,116,191,17,324
"99747",1099747,0,5,0,5
"99748",1099748,38,210,11,259
"99749",1099749,176,113,15,304
"99750",1099750,30,35,2,67
"99751",1099751,101,196,15,312
"99752",1099752,71,119,8,198
"99753",1099753,71,205,14,290
"99754",1099754,37,267,13,317
"99755",1099755,109,84,12,205
"99756",1099756,105,148,7,260
"99757",1099757,57,71,12,140
"99758",1099758,136,91,22,249
"99759",1099759,147,16,3,166
"99760",1099760,96,219,7,322
"99761",1099761,80,32,3,115
"99762",1099762,123,103,12,238
"99763",1099763,34,104,3,141
"99764",1099764,48,4,1,53
"99765",1099765,83,80,12,175
"99766",1099766,100,107,10,217
"99767",1099767,81,185,20,286
"99768",1099768,15,2,2,19
"99769",1099769,118,60,11,189
"99770",1099770,22,154,5,181
"99771",1099771,193,45,11,249
"99772",1099772,163,130,18,311
"99773",1099773,78,71,6,155
"99774",1099774,16,206,8,230
"99775",1099775,2,3,0,5
"99776",1099776,51,206,10,267
"99777",1099777,53,52,3,108
"99778",1099778,43,74,6,123
"99779",1099779,128,62,4,194
"99780",1099780,123,128,10,261
"99781",1099781,24,146,15,185
"99782",1099782,109,216,3,328
"99783",1099783,172,30,12,214
"99784",1099784,109,106,14,229
"99785",1099785,25,95,5,125
"99786",1099786,122,52,3,177
"99787",1099787,112,165,14,291
"99788",1099788,75,171,16,262
"99789",1099789,37,189,2,228
"99790",1099790,122,35,5,162
"99791",1099791,99,145,9,253
"99792",1099792,72,107,13,192
"99793",1099793,12,16,0,28
"99794",1099794,204,37,2,243
"99795",1099795,199,30,6,235
"99796",1099796,185,25,4,214
"99797",1099797,116,137,8,261
"99798",1099798,70,82,6,158
"99799",1099799,43,183,9,235
"99800",1099800,73,44,4,121
"99801",1099801,188,65,14,267
"99802",1099802,85,88,10,183
"99803",1099803,16,4,1,21
"99804",1099804,44,7,5,56
"99805",1099805,186,48,5,239
"99806",1099806,74,154,12,240
"99807",1099807,96,242,11,349
"99808",1099808,122,54,6,182
"99809",1099809,238,30,5,273
"99810",1099810,106,91,6,203
"99811",1099811,63,18,2,83
"99812",1099812,197,84,7,288
"99813",1099813,51,136,11,198
"99814",1099814,202,80,16,298
"99815",1099815,228,36,13,277
"99816",1099816,253,30,6,289
"99817",1099817,183,17,6,206
"99818",1099818,121,87,19,227
"99819",1099819,5,11,0,16
"99820",1099820,101,104,8,213
"99821",1099821,189,45,4,238
"99822",1099822,212,53,10,275
"99823",1099823,66,163,2,231
"99824",1099824,88,185,3,276
"99825",1099825,99,30,4,133
"99826",1099826,191,13,0,204
"99827",1099827,34,225,2,261
"99828",1099828,48,201,8,257
"99829",1099829,92,44,3,139
"99830",1099830,51,216,6,273
"99831",1099831,264,3,9,276
"99832",1099832,53,165,7,225
"99833",1099833,115,67,8,190
"99834",1099834,97,48,5,150
"99835",1099835,229,50,14,293
"99836",1099836,284,5,2,291
"99837",1099837,239,64,12,315
"99838",1099838,51,61,3,115
"99839",1099839,128,66,10,204
"99840",1099840,123,92,8,223
"99841",1099841,115,71,18,204
"99842",1099842,103,211,4,318
"99843",1099843,29,108,3,140
"99844",1099844,183,94,16,293
"99845",1099845,52,201,12,265
"99846",1099846,161,123,7,291
"99847",1099847,100,47,6,153
"99848",1099848,168,69,7,244
"99849",1099849,82,98,0,180
"99850",1099850,118,52,5,175
"99851",1099851,188,63,13,264
"99852",1099852,18,14,4,36
"99853",1099853,28,60,5,93
"99854",1099854,158,74,3,235
"99855",1099855,73,102,4,179
"99856",1099856,93,172,6,271
"99857",1099857,40,95,5,140
"99858",1099858,28,29,4,61
"99859",1099859,11,17,1,29
"99860",1099860,135,128,10,273
"99861",1099861,13,155,2,170
"99862",1099862,166,126,22,314
"99863",1099863,69,144,25,238
"99864",1099864,138,65,9,212
"99865",1099865,164,44,10,218
"99866",1099866,104,82,10,196
"99867",1099867,54,240,4,298
"99868",1099868,117,148,8,273
"99869",1099869,168,45,4,217
"99870",1099870,150,40,20,210
"99871",1099871,200,49,9,258
"99872",1099872,122,94,11,227
"99873",1099873,115,14,3,132
"99874",1099874,164,59,8,231
"99875",1099875,29,175,0,204
"99876",1099876,198,25,3,226
"99877",1099877,41,32,5,78
"99878",1099878,106,1,0,107
"99879",1099879,24,81,2,107
"99880",1099880,57,283,3,343
"99881",1099881,148,98,5,251
"99882",1099882,134,102,5,241
"99883",1099883,329,4,6,339
"99884",1099884,113,148,12,273
"99885",1099885,20,258,2,280
"99886",1099886,60,141,5,206
"99887",1099887,2,7,0,9
"99888",1099888,238,64,12,314
"99889",1099889,103,116,11,230
"99890",1099890,140,28,3,171
"99891",1099891,71,160,3,234
"99892",1099892,65,109,4,178
"99893",1099893,196,39,6,241
"99894",1099894,55,201,9,265
"99895",1099895,61,168,15,244
"99896",1099896,203,78,13,294
"99897",1099897,139,60,5,204
"99898",1099898,130,176,6,312
"99899",1099899,118,105,9,232
"99900",1099900,192,95,8,295
"99901",1099901,146,81,15,242
"99902",1099902,3,9,0,12
"99903",1099903,96,146,16,258
"99904",1099904,174,47,0,221
"99905",1099905,108,177,9,294
"99906",1099906,68,51,19,138
"99907",1099907,106,176,11,293
"99908",1099908,23,208,1,232
"99909",1099909,57,147,3,207
"99910",1099910,68,171,14,253
"99911",1099911,165,112,6,283
"99912",1099912,1,2,1,4
"99913",1099913,142,81,11,234
"99914",1099914,41,214,11,266
"99915",1099915,159,119,15,293
"99916",1099916,186,25,4,215
"99917",1099917,43,203,10,256
"99918",1099918,84,48,9,141
"99919",1099919,68,205,6,279
"99920",1099920,160,66,7,233
"99921",1099921,73,186,10,269
"99922",1099922,102,89,8,199
"99923",1099923,104,33,13,150
"99924",1099924,220,45,11,276
"99925",1099925,94,138,23,255
"99926",1099926,49,79,8,136
"99927",1099927,280,17,7,304
"99928",1099928,71,5,0,76
"99929",1099929,95,159,12,266
"99930",1099930,75,32,2,109
"99931",1099931,32,3,2,37
"99932",1099932,52,6,1,59
"99933",1099933,128,110,14,252
"99934",1099934,183,66,13,262
"99935",1099935,164,110,5,279
"99936",1099936,31,60,2,93
"99937",1099937,32,273,6,311
"99938",1099938,117,97,12,226
"99939",1099939,213,37,6,256
"99940",1099940,72,281,10,363
"99941",1099941,5,4,0,9
"99942",1099942,191,17,9,217
"99943",1099943,132,175,12,319
"99944",1099944,7,0,0,7
"99945",1099945,3,217,3,223
"99946",1099946,75,99,6,180
"99947",1099947,83,133,6,222
"99948",1099948,189,71,7,267
"99949",1099949,99,120,9,228
"99950",1099950,118,95,6,219
"99951",1099951,52,212,13,277
"99952",1099952,205,52,11,268
"99953",1099953,133,20,2,155
"99954",1099954,199,76,14,289
"99955",1099955,105,119,6,230
"99956",1099956,158,122,12,292
"99957",1099957,206,116,7,329
"99958",1099958,171,161,8,340
"99959",1099959,149,117,22,288
"99960",1099960,132,62,13,207
"99961",1099961,84,41,6,131
"99962",1099962,93,185,0,278
"99963",1099963,222,20,3,245
"99964",1099964,143,138,17,298
"99965",1099965,156,75,6,237
"99966",1099966,30,24,5,59
"99967",1099967,20,185,3,208
"99968",1099968,60,153,12,225
"99969",1099969,99,48,4,151
"99970",1099970,66,122,12,200
"99971",1099971,50,61,17,128
"99972",1099972,261,9,4,274
"99973",1099973,111,189,19,319
"99974",1099974,129,40,6,175
"99975",1099975,24,40,2,66
"99976",1099976,140,88,16,244
"99977",1099977,47,181,8,236
"99978",1099978,44,213,7,264
"99979",1099979,103,148,8,259
"99980",1099980,106,31,0,137
"99981",1099981,85,44,4,133
"99982",1099982,67,187,5,259
"99983",1099983,86,146,16,248
"99984",1099984,125,48,8,181
"99985",1099985,208,10,2,220
"99986",1099986,74,62,4,140
"99987",1099987,191,68,20,279
"99988",1099988,31,8,2,41
"99989",1099989,19,217,6,242
"99990",1099990,142,48,8,198
"99991",1099991,122,163,16,301
"99992",1099992,216,48,3,267
"99993",1099993,109,13,5,127
"99994",1099994,208,78,7,293
"99995",1099995,44,271,8,323
"99996",1099996,112,30,2,144
"99997",1099997,55,172,9,236
"99998",1099998,189,23,3,215
"99999",1099999,221,108,10,339
"100000",1100000,100,161,6,267
"100001",1100001,224,29,6,259
"100002",1100002,30,46,2,78
"100003",1100003,158,14,3,175
"100004",1100004,139,112,12,263
"100005",1100005,188,37,6,231
"100006",1100006,77,201,9,287
"100007",1100007,207,97,21,325
"100008",1100008,94,129,6,229
"100009",1100009,48,137,6,191
"100010",1100010,167,105,17,289
"100011",1100011,98,59,14,171
"100012",1100012,212,51,6,269
"100013",1100013,76,180,5,261
"100014",1100014,207,31,10,248
"100015",1100015,128,130,8,266
"100016",1100016,16,65,1,82
"100017",1100017,21,5,2,28
"100018",1100018,24,145,7,176
"100019",1100019,187,16,4,207
"100020",1100020,126,151,24,301
"100021",1100021,74,143,3,220
"100022",1100022,96,137,1,234
"100023",1100023,157,69,7,233
"100024",1100024,130,56,9,195
"100025",1100025,50,175,14,239
"100026",1100026,43,203,9,255
"100027",1100027,18,75,2,95
"100028",1100028,168,73,11,252
"100029",1100029,104,48,15,167
"100030",1100030,55,56,6,117
"100031",1100031,132,90,2,224
"100032",1100032,1,22,0,23
"100033",1100033,141,63,5,209
"100034",1100034,108,120,7,235
"100035",1100035,39,191,9,239
"100036",1100036,67,35,11,113
"100037",1100037,259,32,12,303
"100038",1100038,91,114,15,220
"100039",1100039,95,160,17,272
"100040",1100040,20,156,4,180
"100041",1100041,45,144,1,190
"100042",1100042,121,138,5,264
"100043",1100043,194,36,9,239
"100044",1100044,151,49,7,207
"100045",1100045,219,19,9,247
"100046",1100046,157,128,17,302
"100047",1100047,14,14,0,28
"100048",1100048,38,31,5,74
"100049",1100049,190,72,15,277
"100050",1100050,219,33,8,260
"100051",1100051,179,141,21,341
"100052",1100052,89,118,3,210
"100053",1100053,126,117,7,250
"100054",1100054,58,226,17,301
"100055",1100055,60,63,2,125
"100056",1100056,98,153,5,256
"100057",1100057,86,80,4,170
"100058",1100058,40,246,6,292
"100059",1100059,23,25,1,49
"100060",1100060,6,74,5,85
"100061",1100061,181,56,7,244
"100062",1100062,106,5,5,116
"100063",1100063,76,195,5,276
"100064",1100064,33,88,6,127
"100065",1100065,3,2,0,5
"100066",1100066,159,147,7,313
"100067",1100067,253,29,8,290
"100068",1100068,86,98,10,194
"100069",1100069,40,149,8,197
"100070",1100070,122,138,15,275
"100071",1100071,192,87,8,287
"100072",1100072,97,185,11,293
"100073",1100073,157,99,10,266
"100074",1100074,123,180,6,309
"100075",1100075,54,149,4,207
"100076",1100076,55,174,6,235
"100077",1100077,126,114,15,255
"100078",1100078,19,6,0,25
"100079",1100079,136,42,7,185
"100080",1100080,113,138,9,260
"100081",1100081,203,32,13,248
"100082",1100082,177,45,5,227
"100083",1100083,226,40,6,272
"100084",1100084,82,131,9,222
"100085",1100085,133,55,5,193
"100086",1100086,249,13,4,266
"100087",1100087,110,104,14,228
"100088",1100088,98,88,6,192
"100089",1100089,162,127,9,298
"100090",1100090,66,220,2,288
"100091",1100091,130,56,14,200
"100092",1100092,169,102,16,287
"100093",1100093,216,15,1,232
"100094",1100094,80,83,20,183
"100095",1100095,174,152,13,339
"100096",1100096,121,146,19,286
"100097",1100097,65,81,8,154
"100098",1100098,157,49,8,214
"100099",1100099,165,56,6,227
"100100",1100100,131,98,7,236
"100101",1100101,216,19,9,244
"100102",1100102,160,53,8,221
"100103",1100103,160,92,15,267
"100104",1100104,34,316,7,357
"100105",1100105,159,13,13,185
"100106",1100106,216,78,14,308
"100107",1100107,91,64,8,163
"100108",1100108,47,187,7,241
"100109",1100109,159,62,5,226
"100110",1100110,205,86,19,310
"100111",1100111,80,171,8,259
"100112",1100112,87,65,2,154
"100113",1100113,70,199,10,279
"100114",1100114,11,52,0,63
"100115",1100115,173,68,21,262
"100116",1100116,139,45,5,189
"100117",1100117,37,218,5,260
"100118",1100118,226,32,6,264
"100119",1100119,56,169,19,244
"100120",1100120,145,119,14,278
"100121",1100121,166,138,14,318
"100122",1100122,214,18,4,236
"100123",1100123,119,39,2,160
"100124",1100124,22,183,8,213
"100125",1100125,175,17,10,202
"100126",1100126,148,49,8,205
"100127",1100127,120,92,3,215
"100128",1100128,197,45,11,253
"100129",1100129,75,25,4,104
"100130",1100130,120,179,25,324
"100131",1100131,131,19,2,152
"100132",1100132,153,13,5,171
"100133",1100133,95,46,4,145
"100134",1100134,53,139,17,209
"100135",1100135,192,16,6,214
"100136",1100136,61,196,6,263
"100137",1100137,253,23,7,283
"100138",1100138,58,2,0,60
"100139",1100139,178,48,6,232
"100140",1100140,119,36,8,163
"100141",1100141,179,36,5,220
"100142",1100142,59,33,2,94
"100143",1100143,78,118,7,203
"100144",1100144,138,60,8,206
"100145",1100145,78,173,26,277
"100146",1100146,216,73,8,297
"100147",1100147,80,202,7,289
"100148",1100148,110,142,13,265
"100149",1100149,93,80,13,186
"100150",1100150,349,49,22,420
"100151",1100151,141,55,6,202
"100152",1100152,54,89,0,143
"100153",1100153,97,212,8,317
"100154",1100154,119,65,3,187
"100155",1100155,224,45,6,275
"100156",1100156,67,57,2,126
"100157",1100157,97,158,15,270
"100158",1100158,224,50,21,295
"100159",1100159,68,122,5,195
"100160",1100160,195,109,12,316
"100161",1100161,24,5,1,30
"100162",1100162,156,23,6,185
"100163",1100163,75,185,8,268
"100164",1100164,181,36,3,220
"100165",1100165,164,63,19,246
"100166",1100166,110,59,12,181
"100167",1100167,133,70,10,213
"100168",1100168,123,30,8,161
"100169",1100169,86,107,18,211
"100170",1100170,163,99,8,270
"100171",1100171,156,106,7,269
"100172",1100172,116,98,9,223
"100173",1100173,107,182,2,291
"100174",1100174,265,10,8,283
"100175",1100175,115,85,10,210
"100176",1100176,239,24,5,268
"100177",1100177,28,142,2,172
"100178",1100178,44,110,12,166
"100179",1100179,31,0,0,31
"100180",1100180,17,167,8,192
"100181",1100181,35,242,6,283
"100182",1100182,239,22,4,265
"100183",1100183,64,0,3,67
"100184",1100184,111,41,6,158
"100185",1100185,211,64,14,289
"100186",1100186,125,42,8,175
"100187",1100187,162,109,16,287
"100188",1100188,113,136,11,260
"100189",1100189,19,164,2,185
"100190",1100190,218,57,10,285
"100191",1100191,113,37,1,151
"100192",1100192,97,136,19,252
"100193",1100193,150,63,7,220
"100194",1100194,60,274,17,351
"100195",1100195,47,244,4,295
"100196",1100196,95,86,9,190
"100197",1100197,135,100,13,248
"100198",1100198,174,32,3,209
"100199",1100199,116,47,3,166
"100200",1100200,3,45,1,49
"100201",1100201,94,50,9,153
"100202",1100202,3,4,0,7
"100203",1100203,231,85,10,326
"100204",1100204,76,130,5,211
"100205",1100205,202,77,13,292
"100206",1100206,60,205,5,270
"100207",1100207,85,5,6,96
"100208",1100208,226,60,14,300
"100209",1100209,17,136,0,153
"100210",1100210,142,91,6,239
"100211",1100211,137,114,7,258
"100212",1100212,47,171,2,220
"100213",1100213,103,74,6,183
"100214",1100214,207,62,9,278
"100215",1100215,100,194,11,305
"100216",1100216,148,61,6,215
"100217",1100217,62,133,15,210
"100218",1100218,141,93,4,238
"100219",1100219,88,248,5,341
"100220",1100220,154,107,12,273
"100221",1100221,174,33,13,220
"100222",1100222,38,296,6,340
"100223",1100223,72,66,18,156
"100224",1100224,179,51,10,240
"100225",1100225,32,213,9,254
"100226",1100226,105,153,6,264
"100227",1100227,239,65,4,308
"100228",1100228,154,72,10,236
"100229",1100229,179,23,5,207
"100230",1100230,92,143,9,244
"100231",1100231,23,59,2,84
"100232",1100232,37,214,6,257
"100233",1100233,23,110,11,144
"100234",1100234,73,191,5,269
"100235",1100235,65,200,2,267
"100236",1100236,92,122,11,225
"100237",1100237,184,29,6,219
"100238",1100238,112,158,9,279
"100239",1100239,162,146,14,322
"100240",1100240,59,129,1,189
"100241",1100241,40,146,3,189
"100242",1100242,108,65,13,186
"100243",1100243,250,7,3,260
"100244",1100244,20,258,7,285
"100245",1100245,8,69,2,79
"100246",1100246,139,42,6,187
"100247",1100247,154,40,12,206
"100248",1100248,143,34,3,180
"100249",1100249,220,85,12,317
"100250",1100250,7,1,0,8
"100251",1100251,154,160,8,322
"100252",1100252,59,176,3,238
"100253",1100253,75,204,22,301
"100254",1100254,53,182,14,249
"100255",1100255,74,82,15,171
"100256",1100256,170,72,5,247
"100257",1100257,148,52,8,208
"100258",1100258,71,230,2,303
"100259",1100259,77,184,5,266
"100260",1100260,46,231,5,282
"100261",1100261,108,156,9,273
"100262",1100262,101,122,9,232
"100263",1100263,73,217,7,297
"100264",1100264,200,40,7,247
"100265",1100265,32,214,7,253
"100266",1100266,61,166,9,236
"100267",1100267,32,230,4,266
"100268",1100268,54,27,0,81
"100269",1100269,104,150,12,266
"100270",1100270,100,111,2,213
"100271",1100271,126,111,2,239
"100272",1100272,35,247,3,285
"100273",1100273,82,75,2,159
"100274",1100274,54,261,6,321
"100275",1100275,188,28,3,219
"100276",1100276,76,114,8,198
"100277",1100277,59,121,7,187
"100278",1100278,45,244,2,291
"100279",1100279,5,114,0,119
"100280",1100280,42,135,11,188
"100281",1100281,63,121,5,189
"100282",1100282,75,184,9,268
"100283",1100283,305,7,8,320
"100284",1100284,204,53,10,267
"100285",1100285,225,50,15,290
"100286",1100286,30,270,3,303
"100287",1100287,246,12,3,261
"100288",1100288,110,101,8,219
"100289",1100289,210,85,9,304
"100290",1100290,45,159,5,209
"100291",1100291,106,129,5,240
"100292",1100292,140,108,9,257
"100293",1100293,56,239,9,304
"100294",1100294,177,48,17,242
"100295",1100295,13,9,1,23
"100296",1100296,70,96,10,176
"100297",1100297,37,243,6,286
"100298",1100298,263,30,10,303
"100299",1100299,212,79,22,313
"100300",1100300,102,28,1,131
"100301",1100301,135,142,10,287
"100302",1100302,49,94,4,147
"100303",1100303,70,169,3,242
"100304",1100304,39,167,8,214
"100305",1100305,37,272,5,314
"100306",1100306,109,144,13,266
"100307",1100307,63,131,14,208
"100308",1100308,143,158,23,324
"100309",1100309,95,81,8,184
"100310",1100310,105,221,10,336
"100311",1100311,198,67,6,271
"100312",1100312,120,169,20,309
"100313",1100313,1,4,0,5
"100314",1100314,141,61,2,204
"100315",1100315,74,56,5,135
"100316",1100316,72,77,9,158
"100317",1100317,110,74,5,189
"100318",1100318,82,65,6,153
"100319",1100319,177,82,7,266
"100320",1100320,41,7,2,50
"100321",1100321,56,218,1,275
"100322",1100322,16,98,3,117
"100323",1100323,107,56,5,168
"100324",1100324,158,42,11,211
"100325",1100325,56,33,0,89
"100326",1100326,106,146,15,267
"100327",1100327,271,84,16,371
"100328",1100328,114,58,1,173
"100329",1100329,49,145,8,202
"100330",1100330,224,54,22,300
"100331",1100331,8,70,4,82
"100332",1100332,11,78,1,90
"100333",1100333,107,129,4,240
"100334",1100334,165,115,9,289
"100335",1100335,69,196,9,274
"100336",1100336,118,143,11,272
"100337",1100337,149,186,12,347
"100338",1100338,191,78,22,291
"100339",1100339,37,85,9,131
"100340",1100340,14,4,0,18
"100341",1100341,83,80,2,165
"100342",1100342,46,299,2,347
"100343",1100343,161,29,3,193
"100344",1100344,149,143,23,315
"100345",1100345,125,121,12,258
"100346",1100346,59,127,12,198
"100347",1100347,94,146,0,240
"100348",1100348,169,44,9,222
"100349",1100349,146,123,7,276
"100350",1100350,137,65,5,207
"100351",1100351,187,15,4,206
"100352",1100352,132,65,3,200
"100353",1100353,153,66,11,230
"100354",1100354,204,6,1,211
"100355",1100355,44,193,8,245
"100356",1100356,164,60,4,228
"100357",1100357,71,175,19,265
"100358",1100358,86,80,6,172
"100359",1100359,166,96,5,267
"100360",1100360,151,65,4,220
"100361",1100361,113,51,5,169
"100362",1100362,87,173,10,270
"100363",1100363,152,48,13,213
"100364",1100364,207,27,9,243
"100365",1100365,127,79,2,208
"100366",1100366,83,138,10,231
"100367",1100367,117,34,8,159
"100368",1100368,38,38,2,78
"100369",1100369,106,92,11,209
"100370",1100370,118,143,18,279
"100371",1100371,101,171,7,279
"100372",1100372,126,110,12,248
"100373",1100373,118,152,13,283
"100374",1100374,100,55,9,164
"100375",1100375,55,211,9,275
"100376",1100376,98,198,8,304
"100377",1100377,87,159,23,269
"100378",1100378,127,45,7,179
"100379",1100379,140,94,8,242
"100380",1100380,83,150,8,241
"100381",1100381,81,185,12,278
"100382",1100382,79,20,9,108
"100383",1100383,141,16,4,161
"100384",1100384,134,331,15,480
"100385",1100385,38,8,2,48
"100386",1100386,64,91,3,158
"100387",1100387,111,168,5,284
"100388",1100388,79,106,9,194
"100389",1100389,208,17,6,231
"100390",1100390,164,102,2,268
"100391",1100391,53,50,7,110
"100392",1100392,205,26,8,239
"100393",1100393,42,250,6,298
"100394",1100394,134,129,4,267
"100395",1100395,44,267,4,315
"100396",1100396,200,22,1,223
"100397",1100397,172,42,2,216
"100398",1100398,115,145,20,280
"100399",1100399,115,25,1,141
"100400",1100400,224,47,19,290
"100401",1100401,169,138,25,332
"100402",1100402,252,33,7,292
"100403",1100403,173,98,18,289
"100404",1100404,119,127,10,256
"100405",1100405,213,20,13,246
"100406",1100406,35,218,6,259
"100407",1100407,54,90,9,153
"100408",1100408,72,9,1,82
"100409",1100409,125,146,17,288
"100410",1100410,138,146,8,292
"100411",1100411,109,45,12,166
"100412",1100412,18,202,4,224
"100413",1100413,50,99,10,159
"100414",1100414,153,15,5,173
"100415",1100415,230,59,14,303
"100416",1100416,79,70,4,153
"100417",1100417,118,53,5,176
"100418",1100418,60,234,5,299
"100419",1100419,49,71,0,120
"100420",1100420,38,263,4,305
"100421",1100421,99,136,15,250
"100422",1100422,13,2,0,15
"100423",1100423,28,249,8,285
"100424",1100424,173,23,9,205
"100425",1100425,118,23,2,143
"100426",1100426,305,2,6,313
"100427",1100427,13,3,2,18
"100428",1100428,61,145,7,213
"100429",1100429,30,264,2,296
"100430",1100430,142,121,18,281
"100431",1100431,11,28,3,42
"100432",1100432,4,79,3,86
"100433",1100433,117,148,11,276
"100434",1100434,127,43,8,178
"100435",1100435,192,44,9,245
"100436",1100436,57,230,3,290
"100437",1100437,58,30,3,91
"100438",1100438,70,120,11,201
"100439",1100439,188,24,8,220
"100440",1100440,170,28,9,207
"100441",1100441,139,63,10,212
"100442",1100442,162,34,6,202
"100443",1100443,66,67,7,140
"100444",1100444,52,63,10,125
"100445",1100445,93,163,7,263
"100446",1100446,135,24,4,163
"100447",1100447,165,43,13,221
"100448",1100448,189,89,7,285
"100449",1100449,153,123,11,287
"100450",1100450,106,205,18,329
"100451",1100451,144,101,8,253
"100452",1100452,154,102,12,268
"100453",1100453,52,116,10,178
"100454",1100454,124,72,5,201
"100455",1100455,36,59,1,96
"100456",1100456,18,183,2,203
"100457",1100457,64,100,14,178
"100458",1100458,231,47,11,289
"100459",1100459,6,67,1,74
"100460",1100460,188,87,15,290
"100461",1100461,87,197,3,287
"100462",1100462,111,85,5,201
"100463",1100463,115,57,18,190
"100464",1100464,114,37,7,158
"100465",1100465,93,114,5,212
"100466",1100466,103,115,13,231
"100467",1100467,164,119,17,300
"100468",1100468,51,226,6,283
"100469",1100469,45,47,5,97
"100470",1100470,52,3,1,56
"100471",1100471,64,259,4,327
"100472",1100472,162,78,23,263
"100473",1100473,128,97,9,234
"100474",1100474,3,2,0,5
"100475",1100475,136,142,7,285
"100476",1100476,27,82,1,110
"100477",1100477,136,169,13,318
"100478",1100478,149,85,12,246
"100479",1100479,162,21,3,186
"100480",1100480,115,47,4,166
"100481",1100481,114,1,0,115
"100482",1100482,121,37,4,162
"100483",1100483,212,72,11,295
"100484",1100484,62,29,4,95
"100485",1100485,185,83,10,278
"100486",1100486,93,108,3,204
"100487",1100487,227,53,13,293
"100488",1100488,189,126,21,336
"100489",1100489,141,110,4,255
"100490",1100490,147,119,8,274
"100491",1100491,231,20,3,254
"100492",1100492,44,221,7,272
"100493",1100493,30,179,8,217
"100494",1100494,135,52,9,196
"100495",1100495,27,218,1,246
"100496",1100496,17,168,4,189
"100497",1100497,108,41,8,157
"100498",1100498,169,34,9,212
"100499",1100499,67,130,4,201
"100500",1100500,6,97,1,104
"100501",1100501,142,35,10,187
"100502",1100502,28,20,2,50
"100503",1100503,152,132,13,297
"100504",1100504,163,93,9,265
"100505",1100505,149,39,4,192
"100506",1100506,152,46,7,205
"100507",1100507,21,163,2,186
"100508",1100508,91,187,10,288
"100509",1100509,28,274,7,309
"100510",1100510,65,115,8,188
"100511",1100511,107,41,11,159
"100512",1100512,84,171,5,260
"100513",1100513,36,273,17,326
"100514",1100514,43,10,1,54
"100515",1100515,178,9,25,212
"100516",1100516,114,72,8,194
"100517",1100517,52,254,12,318
"100518",1100518,108,119,5,232
"100519",1100519,146,40,15,201
"100520",1100520,88,11,5,104
"100521",1100521,174,105,5,284
"100522",1100522,85,133,5,223
"100523",1100523,310,27,7,344
"100524",1100524,172,103,15,290
"100525",1100525,133,72,8,213
"100526",1100526,85,115,8,208
"100527",1100527,123,127,5,255
"100528",1100528,33,249,2,284
"100529",1100529,254,44,11,309
"100530",1100530,139,97,18,254
"100531",1100531,41,171,5,217
"100532",1100532,176,57,29,262
"100533",1100533,142,67,4,213
"100534",1100534,40,207,1,248
"100535",1100535,200,34,5,239
"100536",1100536,177,93,10,280
"100537",1100537,105,185,9,299
"100538",1100538,173,118,18,309
"100539",1100539,133,115,8,256
"100540",1100540,104,32,6,142
"100541",1100541,24,15,2,41
"100542",1100542,255,15,5,275
"100543",1100543,77,169,13,259
"100544",1100544,180,95,23,298
"100545",1100545,165,74,1,240
"100546",1100546,96,103,0,199
"100547",1100547,77,183,11,271
"100548",1100548,27,138,16,181
"100549",1100549,29,169,5,203
"100550",1100550,163,67,6,236
"100551",1100551,91,144,8,243
"100552",1100552,107,154,18,279
"100553",1100553,85,81,9,175
"100554",1100554,247,19,5,271
"100555",1100555,33,66,6,105
"100556",1100556,117,126,15,258
"100557",1100557,230,21,5,256
"100558",1100558,147,63,0,210
"100559",1100559,170,79,8,257
"100560",1100560,127,58,7,192
"100561",1100561,175,35,5,215
"100562",1100562,127,16,3,146
"100563",1100563,113,94,9,216
"100564",1100564,105,82,3,190
"100565",1100565,109,0,0,109
"100566",1100566,83,158,10,251
"100567",1100567,48,158,5,211
"100568",1100568,81,182,10,273
"100569",1100569,79,186,14,279
"100570",1100570,88,167,20,275
"100571",1100571,152,32,4,188
"100572",1100572,90,126,7,223
"100573",1100573,104,82,7,193
"100574",1100574,153,132,5,290
"100575",1100575,222,35,7,264
"100576",1100576,170,111,11,292
"100577",1100577,35,95,1,131
"100578",1100578,54,123,7,184
"100579",1100579,208,36,6,250
"100580",1100580,76,186,16,278
"100581",1100581,156,19,9,184
"100582",1100582,14,104,6,124
"100583",1100583,71,105,14,190
"100584",1100584,50,202,5,257
"100585",1100585,60,6,3,69
"100586",1100586,97,42,2,141
"100587",1100587,170,83,4,257
"100588",1100588,155,34,2,191
"100589",1100589,73,123,7,203
"100590",1100590,80,119,5,204
"100591",1100591,32,14,1,47
"100592",1100592,80,188,7,275
"100593",1100593,248,13,2,263
"100594",1100594,175,96,12,283
"100595",1100595,87,171,3,261
"100596",1100596,32,260,4,296
"100597",1100597,171,29,6,206
"100598",1100598,104,67,9,180
"100599",1100599,33,255,5,293
"100600",1100600,121,163,5,289
"100601",1100601,208,70,14,292
"100602",1100602,4,13,1,18
"100603",1100603,12,53,1,66
"100604",1100604,98,152,11,261
"100605",1100605,55,94,7,156
"100606",1100606,68,198,11,277
"100607",1100607,163,16,2,181
"100608",1100608,94,169,13,276
"100609",1100609,106,107,10,223
"100610",1100610,95,217,7,319
"100611",1100611,34,23,0,57
"100612",1100612,61,191,2,254
"100613",1100613,91,37,9,137
"100614",1100614,49,104,7,160
"100615",1100615,168,15,2,185
"100616",1100616,78,236,16,330
"100617",1100617,30,159,4,193
"100618",1100618,144,83,8,235
"100619",1100619,206,47,12,265
"100620",1100620,166,89,16,271
"100621",1100621,70,176,5,251
"100622",1100622,122,108,5,235
"100623",1100623,99,11,0,110
"100624",1100624,3,18,2,23
"100625",1100625,72,174,13,259
"100626",1100626,222,37,13,272
"100627",1100627,176,54,9,239
"100628",1100628,97,66,3,166
"100629",1100629,81,206,14,301
"100630",1100630,99,20,5,124
"100631",1100631,28,46,9,83
"100632",1100632,2,1,0,3
"100633",1100633,47,172,2,221
"100634",1100634,88,178,8,274
"100635",1100635,154,83,13,250
"100636",1100636,79,143,2,224
"100637",1100637,44,267,6,317
"100638",1100638,181,27,5,213
"100639",1100639,86,208,9,303
"100640",1100640,89,160,15,264
"100641",1100641,77,70,6,153
"100642",1100642,173,7,3,183
"100643",1100643,195,48,11,254
"100644",1100644,74,101,2,177
"100645",1100645,169,68,5,242
"100646",1100646,132,156,12,300
"100647",1100647,60,221,20,301
"100648",1100648,93,84,1,178
"100649",1100649,34,5,0,39
"100650",1100650,105,55,2,162
"100651",1100651,202,30,13,245
"100652",1100652,99,76,3,178
"100653",1100653,125,194,12,331
"100654",1100654,97,132,4,233
"100655",1100655,38,247,6,291
"100656",1100656,49,123,7,179
"100657",1100657,150,112,8,270
"100658",1100658,113,158,11,282
"100659",1100659,87,223,14,324
"100660",1100660,116,48,5,169
"100661",1100661,68,179,0,247
"100662",1100662,34,32,4,70
"100663",1100663,218,61,12,291
"100664",1100664,51,134,16,201
"100665",1100665,112,65,13,190
"100666",1100666,238,9,6,253
"100667",1100667,43,4,6,53
"100668",1100668,89,216,7,312
"100669",1100669,17,22,1,40
"100670",1100670,105,107,1,213
"100671",1100671,14,38,0,52
"100672",1100672,105,148,5,258
"100673",1100673,36,217,7,260
"100674",1100674,43,161,6,210
"100675",1100675,108,94,2,204
"100676",1100676,21,5,0,26
"100677",1100677,117,169,4,290
"100678",1100678,169,69,9,247
"100679",1100679,253,25,8,286
"100680",1100680,101,160,3,264
"100681",1100681,67,152,10,229
"100682",1100682,49,40,2,91
"100683",1100683,28,12,3,43
"100684",1100684,126,64,3,193
"100685",1100685,59,73,1,133
"100686",1100686,61,253,2,316
"100687",1100687,13,138,0,151
"100688",1100688,25,31,1,57
"100689",1100689,47,150,3,200
"100690",1100690,84,55,1,140
"100691",1100691,152,142,11,305
"100692",1100692,41,116,5,162
"100693",1100693,115,158,4,277
"100694",1100694,116,125,8,249
"100695",1100695,60,37,1,98
"100696",1100696,178,42,7,227
"100697",1100697,164,133,0,297
"100698",1100698,138,108,8,254
"100699",1100699,44,134,0,178
"100700",1100700,132,117,16,265
"100701",1100701,134,196,6,336
"100702",1100702,157,41,6,204
"100703",1100703,36,157,8,201
"100704",1100704,32,175,3,210
"100705",1100705,99,43,3,145
"100706",1100706,82,131,13,226
"100707",1100707,8,21,3,32
"100708",1100708,107,87,6,200
"100709",1100709,146,30,2,178
"100710",1100710,111,56,9,176
"100711",1100711,60,16,1,77
"100712",1100712,19,177,6,202
"100713",1100713,172,42,4,218
"100714",1100714,207,64,10,281
"100715",1100715,140,71,16,227
"100716",1100716,104,19,3,126
"100717",1100717,50,181,4,235
"100718",1100718,131,49,11,191
"100719",1100719,5,232,3,240
"100720",1100720,93,26,6,125
"100721",1100721,46,11,0,57
"100722",1100722,31,179,4,214
"100723",1100723,116,68,1,185
"100724",1100724,163,104,20,287
"100725",1100725,184,27,9,220
"100726",1100726,61,205,2,268
"100727",1100727,105,104,12,221
"100728",1100728,90,104,8,202
"100729",1100729,102,142,8,252
"100730",1100730,100,67,7,174
"100731",1100731,212,76,11,299
"100732",1100732,35,123,5,163
"100733",1100733,91,8,2,101
"100734",1100734,96,186,6,288
"100735",1100735,55,273,12,340
"100736",1100736,80,158,21,259
"100737",1100737,33,403,1,437
"100738",1100738,188,33,11,232
"100739",1100739,88,56,6,150
"100740",1100740,29,221,7,257
"100741",1100741,143,85,12,240
"100742",1100742,46,173,6,225
"100743",1100743,96,54,5,155
"100744",1100744,24,246,6,276
"100745",1100745,208,52,5,265
"100746",1100746,139,135,15,289
"100747",1100747,210,63,7,280
"100748",1100748,246,17,3,266
"100749",1100749,177,108,6,291
"100750",1100750,166,62,14,242
"100751",1100751,43,70,7,120
"100752",1100752,9,2,2,13
"100753",1100753,47,192,5,244
"100754",1100754,117,165,15,297
"100755",1100755,80,155,10,245
"100756",1100756,218,84,39,341
"100757",1100757,34,241,7,282
"100758",1100758,74,111,5,190
"100759",1100759,154,34,10,198
"100760",1100760,149,84,7,240
"100761",1100761,51,177,10,238
"100762",1100762,141,29,8,178
"100763",1100763,94,142,9,245
"100764",1100764,99,173,15,287
"100765",1100765,153,47,6,206
"100766",1100766,73,25,2,100
"100767",1100767,111,35,14,160
"100768",1100768,47,298,12,357
"100769",1100769,114,128,9,251
"100770",1100770,56,171,9,236
"100771",1100771,170,103,12,285
"100772",1100772,105,62,4,171
"100773",1100773,25,206,6,237
"100774",1100774,22,176,3,201
"100775",1100775,142,114,18,274
"100776",1100776,49,22,1,72
"100777",1100777,34,51,2,87
"100778",1100778,209,31,5,245
"100779",1100779,151,71,6,228
"100780",1100780,153,106,2,261
"100781",1100781,72,158,9,239
"100782",1100782,62,124,8,194
"100783",1100783,67,97,4,168
"100784",1100784,15,203,4,222
"100785",1100785,100,181,12,293
"100786",1100786,111,187,6,304
"100787",1100787,79,51,16,146
"100788",1100788,16,276,5,297
"100789",1100789,23,127,11,161
"100790",1100790,101,144,7,252
"100791",1100791,227,0,0,227
"100792",1100792,140,156,20,316
"100793",1100793,63,212,11,286
"100794",1100794,84,193,3,280
"100795",1100795,85,108,5,198
"100796",1100796,67,111,8,186
"100797",1100797,113,124,9,246
"100798",1100798,152,82,3,237
"100799",1100799,151,45,6,202
"100800",1100800,192,48,5,245
"100801",1100801,141,83,7,231
"100802",1100802,100,56,11,167
"100803",1100803,138,75,10,223
"100804",1100804,63,161,16,240
"100805",1100805,186,21,3,210
"100806",1100806,100,59,7,166
"100807",1100807,5,4,1,10
"100808",1100808,43,81,2,126
"100809",1100809,92,199,14,305
"100810",1100810,200,41,5,246
"100811",1100811,140,57,9,206
"100812",1100812,178,48,2,228
"100813",1100813,152,51,5,208
"100814",1100814,70,81,9,160
"100815",1100815,245,32,6,283
"100816",1100816,73,42,3,118
"100817",1100817,93,122,11,226
"100818",1100818,23,194,6,223
"100819",1100819,88,133,12,233
"100820",1100820,173,49,8,230
"100821",1100821,47,264,1,312
"100822",1100822,52,137,8,197
"100823",1100823,59,112,13,184
"100824",1100824,16,1,1,18
"100825",1100825,155,54,8,217
"100826",1100826,72,11,3,86
"100827",1100827,11,35,0,46
"100828",1100828,22,206,3,231
"100829",1100829,177,21,5,203
"100830",1100830,130,60,8,198
"100831",1100831,25,173,6,204
"100832",1100832,148,120,2,270
"100833",1100833,68,174,15,257
"100834",1100834,62,191,11,264
"100835",1100835,44,96,6,146
"100836",1100836,159,27,9,195
"100837",1100837,39,226,8,273
"100838",1100838,164,94,8,266
"100839",1100839,21,192,5,218
"100840",1100840,163,71,10,244
"100841",1100841,193,18,9,220
"100842",1100842,261,42,8,311
"100843",1100843,149,77,2,228
"100844",1100844,77,236,15,328
"100845",1100845,95,122,15,232
"100846",1100846,149,90,7,246
"100847",1100847,155,83,10,248
"100848",1100848,81,167,5,253
"100849",1100849,168,84,11,263
"100850",1100850,64,134,7,205
"100851",1100851,156,55,9,220
"100852",1100852,214,97,7,318
"100853",1100853,117,100,7,224
"100854",1100854,23,26,3,52
"100855",1100855,125,58,5,188
"100856",1100856,32,188,4,224
"100857",1100857,74,20,0,94
"100858",1100858,33,231,5,269
"100859",1100859,9,94,3,106
"100860",1100860,156,103,5,264
"100861",1100861,151,50,4,205
"100862",1100862,46,45,7,98
"100863",1100863,10,84,0,94
"100864",1100864,82,146,13,241
"100865",1100865,258,45,13,316
"100866",1100866,316,8,5,329
"100867",1100867,63,165,6,234
"100868",1100868,15,14,4,33
"100869",1100869,108,12,1,121
"100870",1100870,1,5,0,6
"100871",1100871,83,41,11,135
"100872",1100872,29,238,1,268
"100873",1100873,82,20,2,104
"100874",1100874,67,172,3,242
"100875",1100875,61,110,5,176
"100876",1100876,52,71,0,123
"100877",1100877,196,41,7,244
"100878",1100878,13,5,0,18
"100879",1100879,74,143,12,229
"100880",1100880,205,36,7,248
"100881",1100881,187,37,16,240
"100882",1100882,40,111,5,156
"100883",1100883,140,98,9,247
"100884",1100884,80,195,16,291
"100885",1100885,133,67,16,216
"100886",1100886,174,98,3,275
"100887",1100887,188,82,10,280
"100888",1100888,211,118,16,345
"100889",1100889,72,8,1,81
"100890",1100890,10,94,2,106
"100891",1100891,154,55,4,213
"100892",1100892,122,94,19,235
"100893",1100893,201,74,13,288
"100894",1100894,223,74,14,311
"100895",1100895,123,122,9,254
"100896",1100896,38,34,2,74
"100897",1100897,175,149,12,336
"100898",1100898,6,1,1,8
"100899",1100899,48,168,5,221
"100900",1100900,51,153,13,217
"100901",1100901,54,206,8,268
"100902",1100902,165,67,10,242
"100903",1100903,182,15,2,199
"100904",1100904,25,95,2,122
"100905",1100905,27,150,4,181
"100906",1100906,217,42,5,264
"100907",1100907,153,349,20,522
"100908",1100908,69,142,14,225
"100909",1100909,81,141,15,237
"100910",1100910,124,173,17,314
"100911",1100911,91,87,6,184
"100912",1100912,211,52,15,278
"100913",1100913,32,207,7,246
"100914",1100914,51,196,7,254
"100915",1100915,168,71,1,240
"100916",1100916,36,180,2,218
"100917",1100917,198,67,18,283
"100918",1100918,200,4,1,205
"100919",1100919,91,196,8,295
"100920",1100920,224,43,5,272
"100921",1100921,1,18,0,19
"100922",1100922,67,244,6,317
"100923",1100923,146,75,9,230
"100924",1100924,147,13,2,162
"100925",1100925,92,198,6,296
"100926",1100926,226,46,8,280
"100927",1100927,71,200,2,273
"100928",1100928,181,1,1,183
"100929",1100929,92,175,18,285
"100930",1100930,151,73,5,229
"100931",1100931,160,53,2,215
"100932",1100932,142,68,6,216
"100933",1100933,7,0,0,7
"100934",1100934,187,85,9,281
"100935",1100935,166,76,10,252
"100936",1100936,134,24,5,163
"100937",1100937,105,176,5,286
"100938",1100938,186,78,11,275
"100939",1100939,76,98,4,178
"100940",1100940,214,97,12,323
"100941",1100941,14,140,4,158
"100942",1100942,177,85,7,269
"100943",1100943,86,127,5,218
"100944",1100944,18,166,1,185
"100945",1100945,220,8,3,231
"100946",1100946,193,19,9,221
"100947",1100947,121,36,5,162
"100948",1100948,178,7,2,187
"100949",1100949,67,90,8,165
"100950",1100950,113,24,1,138
"100951",1100951,52,168,9,229
"100952",1100952,47,253,4,304
"100953",1100953,70,116,3,189
"100954",1100954,18,236,6,260
"100955",1100955,161,37,6,204
"100956",1100956,52,239,11,302
"100957",1100957,204,33,4,241
"100958",1100958,24,270,6,300
"100959",1100959,150,91,5,246
"100960",1100960,123,139,6,268
"100961",1100961,31,23,5,59
"100962",1100962,45,116,13,174
"100963",1100963,14,62,0,76
"100964",1100964,143,98,6,247
"100965",1100965,115,218,6,339
"100966",1100966,48,92,3,143
"100967",1100967,246,13,10,269
"100968",1100968,170,72,12,254
"100969",1100969,102,118,12,232
"100970",1100970,250,40,8,298
"100971",1100971,73,110,11,194
"100972",1100972,26,4,4,34
"100973",1100973,76,259,8,343
"100974",1100974,143,119,11,273
"100975",1100975,70,111,9,190
"100976",1100976,160,75,12,247
"100977",1100977,75,51,12,138
"100978",1100978,202,88,10,300
"100979",1100979,10,231,0,241
"100980",1100980,52,137,7,196
"100981",1100981,147,98,1,246
"100982",1100982,147,62,3,212
"100983",1100983,158,54,11,223
"100984",1100984,133,329,11,473
"100985",1100985,180,81,7,268
"100986",1100986,124,256,4,384
"100987",1100987,168,45,4,217
"100988",1100988,154,122,7,283
"100989",1100989,191,101,13,305
"100990",1100990,69,170,4,243
"100991",1100991,148,72,7,227
"100992",1100992,103,61,4,168
"100993",1100993,187,62,11,260
"100994",1100994,1,10,1,12
"100995",1100995,161,28,6,195
"100996",1100996,69,119,3,191
"100997",1100997,98,147,8,253
"100998",1100998,55,235,5,295
"100999",1100999,181,81,4,266
"101000",1101000,206,70,23,299
"101001",1101001,31,196,19,246
"101002",1101002,80,35,10,125
"101003",1101003,135,68,15,218
"101004",1101004,147,18,11,176
"101005",1101005,95,168,8,271
"101006",1101006,37,290,2,329
"101007",1101007,212,19,2,233
"101008",1101008,126,14,3,143
"101009",1101009,9,5,1,15
"101010",1101010,53,146,3,202
"101011",1101011,158,73,4,235
"101012",1101012,66,232,3,301
"101013",1101013,123,16,4,143
"101014",1101014,185,41,7,233
"101015",1101015,100,14,4,118
"101016",1101016,73,176,23,272
"101017",1101017,131,143,9,283
"101018",1101018,126,18,6,150
"101019",1101019,15,1,0,16
"101020",1101020,125,135,9,269
"101021",1101021,179,121,22,322
"101022",1101022,183,139,13,335
"101023",1101023,141,74,5,220
"101024",1101024,226,35,7,268
"101025",1101025,140,102,3,245
"101026",1101026,31,19,3,53
"101027",1101027,155,37,7,199
"101028",1101028,149,101,16,266
"101029",1101029,65,10,0,75
"101030",1101030,112,101,11,224
"101031",1101031,131,5,1,137
"101032",1101032,168,73,16,257
"101033",1101033,52,119,13,184
"101034",1101034,78,121,6,205
"101035",1101035,156,48,26,230
"101036",1101036,157,141,9,307
"101037",1101037,128,168,16,312
"101038",1101038,160,49,18,227
"101039",1101039,211,10,3,224
"101040",1101040,79,113,8,200
"101041",1101041,85,234,18,337
"101042",1101042,48,170,5,223
"101043",1101043,116,69,6,191
"101044",1101044,30,132,3,165
"101045",1101045,224,93,24,341
"101046",1101046,57,17,2,76
"101047",1101047,90,103,3,196
"101048",1101048,52,201,6,259
"101049",1101049,101,45,8,154
"101050",1101050,33,33,5,71
"101051",1101051,161,59,16,236
"101052",1101052,139,27,4,170
"101053",1101053,133,214,11,358
"101054",1101054,180,46,3,229
"101055",1101055,60,201,5,266
"101056",1101056,63,184,9,256
"101057",1101057,106,25,5,136
"101058",1101058,132,26,2,160
"101059",1101059,102,201,9,312
"101060",1101060,19,161,3,183
"101061",1101061,115,100,28,243
"101062",1101062,195,64,11,270
"101063",1101063,92,0,0,92
"101064",1101064,95,122,4,221
"101065",1101065,115,120,7,242
"101066",1101066,40,72,4,116
"101067",1101067,64,146,7,217
"101068",1101068,27,188,0,215
"101069",1101069,148,156,10,314
"101070",1101070,42,8,6,56
"101071",1101071,227,78,23,328
"101072",1101072,247,6,1,254
"101073",1101073,181,70,7,258
"101074",1101074,185,37,8,230
"101075",1101075,61,215,6,282
"101076",1101076,139,56,11,206
"101077",1101077,97,41,10,148
"101078",1101078,85,146,3,234
"101079",1101079,138,80,5,223
"101080",1101080,242,18,10,270
"101081",1101081,80,6,0,86
"101082",1101082,141,57,3,201
"101083",1101083,154,71,8,233
"101084",1101084,73,60,9,142
"101085",1101085,98,37,12,147
"101086",1101086,99,39,4,142
"101087",1101087,77,145,7,229
"101088",1101088,142,70,4,216
"101089",1101089,174,74,9,257
"101090",1101090,157,76,9,242
"101091",1101091,60,218,13,291
"101092",1101092,121,119,8,248
"101093",1101093,104,54,7,165
"101094",1101094,96,177,7,280
"101095",1101095,114,42,10,166
"101096",1101096,56,169,15,240
"101097",1101097,204,48,14,266
"101098",1101098,61,165,16,242
"101099",1101099,62,24,3,89
"101100",1101100,61,39,2,102
"101101",1101101,69,241,5,315
"101102",1101102,153,104,17,274
"101103",1101103,171,60,9,240
"101104",1101104,111,126,7,244
"101105",1101105,178,32,8,218
"101106",1101106,113,88,4,205
"101107",1101107,24,47,2,73
"101108",1101108,121,60,4,185
"101109",1101109,94,206,6,306
"101110",1101110,42,161,9,212
"101111",1101111,65,237,13,315
"101112",1101112,121,11,5,137
"101113",1101113,28,24,3,55
"101114",1101114,102,168,10,280
"101115",1101115,88,162,15,265
"101116",1101116,14,5,0,19
"101117",1101117,127,21,8,156
"101118",1101118,62,165,6,233
"101119",1101119,32,95,1,128
"101120",1101120,113,62,3,178
"101121",1101121,41,44,3,88
"101122",1101122,138,137,12,287
"101123",1101123,75,147,14,236
"101124",1101124,65,241,12,318
"101125",1101125,48,156,1,205
"101126",1101126,168,67,7,242
"101127",1101127,58,141,2,201
"101128",1101128,98,63,14,175
"101129",1101129,120,128,11,259
"101130",1101130,188,62,8,258
"101131",1101131,65,18,0,83
"101132",1101132,54,151,7,212
"101133",1101133,110,149,20,279
"101134",1101134,195,27,11,233
"101135",1101135,220,14,7,241
"101136",1101136,68,246,2,316
"101137",1101137,82,179,9,270
"101138",1101138,179,23,14,216
"101139",1101139,98,113,13,224
"101140",1101140,23,35,1,59
"101141",1101141,18,12,0,30
"101142",1101142,46,132,3,181
"101143",1101143,117,61,4,182
"101144",1101144,119,102,13,234
"101145",1101145,34,54,1,89
"101146",1101146,82,208,13,303
"101147",1101147,58,369,9,436
"101148",1101148,27,8,3,38
"101149",1101149,69,156,15,240
"101150",1101150,230,47,1,278
"101151",1101151,140,23,3,166
"101152",1101152,71,92,10,173
"101153",1101153,34,177,9,220
"101154",1101154,130,66,8,204
"101155",1101155,65,175,20,260
"101156",1101156,26,230,1,257
"101157",1101157,151,64,8,223
"101158",1101158,104,148,0,252
"101159",1101159,113,110,2,225
"101160",1101160,42,238,2,282
"101161",1101161,21,0,2,23
"101162",1101162,42,203,3,248
"101163",1101163,10,259,3,272
"101164",1101164,149,98,20,267
"101165",1101165,197,25,6,228
"101166",1101166,68,27,1,96
"101167",1101167,136,41,5,182
"101168",1101168,115,103,13,231
"101169",1101169,114,99,26,239
"101170",1101170,149,76,18,243
"101171",1101171,55,198,6,259
"101172",1101172,209,48,12,269
"101173",1101173,154,27,3,184
"101174",1101174,153,120,9,282
"101175",1101175,8,15,1,24
"101176",1101176,157,100,8,265
"101177",1101177,202,66,11,279
"101178",1101178,150,83,11,244
"101179",1101179,52,230,14,296
"101180",1101180,141,152,8,301
"101181",1101181,36,262,8,306
"101182",1101182,109,121,8,238
"101183",1101183,162,57,2,221
"101184",1101184,121,154,7,282
"101185",1101185,108,4,1,113
"101186",1101186,42,132,2,176
"101187",1101187,61,77,3,141
"101188",1101188,87,171,10,268
"101189",1101189,58,266,4,328
"101190",1101190,158,60,13,231
"101191",1101191,143,81,12,236
"101192",1101192,84,46,4,134
"101193",1101193,69,61,1,131
"101194",1101194,60,93,3,156
"101195",1101195,115,77,18,210
"101196",1101196,130,91,4,225
"101197",1101197,162,95,15,272
"101198",1101198,53,143,1,197
"101199",1101199,36,124,10,170
"101200",1101200,111,110,17,238
"101201",1101201,172,94,5,271
"101202",1101202,114,165,13,292
"101203",1101203,130,147,10,287
"101204",1101204,73,187,7,267
"101205",1101205,108,153,20,281
"101206",1101206,161,84,14,259
"101207",1101207,45,243,6,294
"101208",1101208,56,44,3,103
"101209",1101209,25,41,3,69
"101210",1101210,48,65,2,115
"101211",1101211,93,83,14,190
"101212",1101212,70,233,3,306
"101213",1101213,31,19,6,56
"101214",1101214,82,116,4,202
"101215",1101215,45,173,4,222
"101216",1101216,91,85,14,190
"101217",1101217,158,77,21,256
"101218",1101218,191,29,8,228
"101219",1101219,61,224,14,299
"101220",1101220,92,69,3,164
"101221",1101221,103,117,10,230
"101222",1101222,59,228,15,302
"101223",1101223,66,70,13,149
"101224",1101224,152,123,10,285
"101225",1101225,128,106,4,238
"101226",1101226,136,60,3,199
"101227",1101227,170,85,15,270
"101228",1101228,97,55,7,159
"101229",1101229,22,122,1,145
"101230",1101230,210,110,11,331
"101231",1101231,262,9,6,277
"101232",1101232,100,176,9,285
"101233",1101233,117,113,4,234
"101234",1101234,58,233,4,295
"101235",1101235,199,66,5,270
"101236",1101236,172,64,11,247
"101237",1101237,158,68,10,236
"101238",1101238,181,51,5,237
"101239",1101239,13,10,0,23
"101240",1101240,193,67,9,269
"101241",1101241,80,138,8,226
"101242",1101242,112,150,6,268
"101243",1101243,158,129,9,296
"101244",1101244,51,196,2,249
"101245",1101245,76,231,18,325
"101246",1101246,101,30,4,135
"101247",1101247,2,0,0,2
"101248",1101248,47,262,3,312
"101249",1101249,144,62,4,210
"101250",1101250,2,5,1,8
"101251",1101251,0,0,0,0
"101252",1101252,68,86,4,158
"101253",1101253,193,52,22,267
"101254",1101254,129,67,10,206
"101255",1101255,83,202,13,298
"101256",1101256,138,109,6,253
"101257",1101257,148,45,6,199
"101258",1101258,130,120,7,257
"101259",1101259,10,11,3,24
"101260",1101260,91,37,14,142
"101261",1101261,62,14,1,77
"101262",1101262,108,67,2,177
"101263",1101263,127,150,15,292
"101264",1101264,87,52,6,145
"101265",1101265,88,104,14,206
"101266",1101266,215,50,4,269
"101267",1101267,49,194,5,248
"101268",1101268,191,110,18,319
"101269",1101269,104,94,19,217
"101270",1101270,141,21,3,165
"101271",1101271,93,90,13,196
"101272",1101272,7,3,1,11
"101273",1101273,71,88,15,174
"101274",1101274,120,36,2,158
"101275",1101275,99,110,10,219
"101276",1101276,39,58,3,100
"101277",1101277,108,132,3,243
"101278",1101278,208,32,5,245
"101279",1101279,177,85,10,272
"101280",1101280,169,32,0,201
"101281",1101281,150,80,3,233
"101282",1101282,14,176,2,192
"101283",1101283,24,180,2,206
"101284",1101284,109,99,9,217
"101285",1101285,108,177,13,298
"101286",1101286,136,95,3,234
"101287",1101287,155,104,5,264
"101288",1101288,169,38,3,210
"101289",1101289,130,46,9,185
"101290",1101290,136,111,18,265
"101291",1101291,196,52,19,267
"101292",1101292,91,44,7,142
"101293",1101293,124,89,16,229
"101294",1101294,114,52,16,182
"101295",1101295,142,120,18,280
"101296",1101296,44,237,6,287
"101297",1101297,154,41,4,199
"101298",1101298,63,138,10,211
"101299",1101299,103,82,14,199
"101300",1101300,44,64,2,110
"101301",1101301,194,95,13,302
"101302",1101302,231,50,14,295
"101303",1101303,96,193,6,295
"101304",1101304,73,204,9,286
"101305",1101305,156,41,15,212
"101306",1101306,66,213,9,288
"101307",1101307,159,95,7,261
"101308",1101308,26,40,5,71
"101309",1101309,42,219,16,277
"101310",1101310,117,85,21,223
"101311",1101311,126,51,4,181
"101312",1101312,90,141,13,244
"101313",1101313,27,202,0,229
"101314",1101314,140,104,25,269
"101315",1101315,160,23,7,190
"101316",1101316,149,83,1,233
"101317",1101317,79,134,3,216
"101318",1101318,123,45,20,188
"101319",1101319,213,20,11,244
"101320",1101320,108,144,6,258
"101321",1101321,21,163,7,191
"101322",1101322,179,28,9,216
"101323",1101323,83,152,10,245
"101324",1101324,124,180,7,311
"101325",1101325,11,92,2,105
"101326",1101326,5,23,1,29
"101327",1101327,161,138,25,324
"101328",1101328,139,88,20,247
"101329",1101329,111,46,3,160
"101330",1101330,26,174,7,207
"101331",1101331,164,108,9,281
"101332",1101332,149,65,7,221
"101333",1101333,125,42,4,171
"101334",1101334,218,55,17,290
"101335",1101335,33,100,14,147
"101336",1101336,130,48,1,179
"101337",1101337,118,35,1,154
"101338",1101338,91,248,12,351
"101339",1101339,198,21,8,227
"101340",1101340,81,159,3,243
"101341",1101341,84,240,11,335
"101342",1101342,156,39,5,200
"101343",1101343,62,139,13,214
"101344",1101344,197,114,15,326
"101345",1101345,192,85,7,284
"101346",1101346,91,142,16,249
"101347",1101347,61,148,21,230
"101348",1101348,82,192,11,285
"101349",1101349,130,162,10,302
"101350",1101350,51,120,4,175
"101351",1101351,168,77,6,251
"101352",1101352,41,149,2,192
"101353",1101353,178,64,9,251
"101354",1101354,99,19,7,125
"101355",1101355,170,107,15,292
"101356",1101356,209,16,6,231
"101357",1101357,322,1,4,327
"101358",1101358,110,97,5,212
"101359",1101359,107,27,4,138
"101360",1101360,177,31,8,216
"101361",1101361,3,14,0,17
"101362",1101362,11,171,6,188
"101363",1101363,259,59,10,328
"101364",1101364,67,69,13,149
"101365",1101365,60,205,11,276
"101366",1101366,119,35,5,159
"101367",1101367,166,44,10,220
"101368",1101368,121,89,3,213
"101369",1101369,198,29,3,230
"101370",1101370,126,27,9,162
"101371",1101371,110,72,3,185
"101372",1101372,58,157,7,222
"101373",1101373,106,159,15,280
"101374",1101374,84,120,7,211
"101375",1101375,131,120,5,256
"101376",1101376,140,29,2,171
"101377",1101377,96,14,0,110
"101378",1101378,175,20,7,202
"101379",1101379,176,35,10,221
"101380",1101380,67,124,20,211
"101381",1101381,152,67,4,223
"101382",1101382,145,84,6,235
"101383",1101383,191,46,7,244
"101384",1101384,116,134,14,264
"101385",1101385,219,22,4,245
"101386",1101386,206,97,21,324
"101387",1101387,81,110,9,200
"101388",1101388,69,241,4,314
"101389",1101389,24,191,11,226
"101390",1101390,123,110,15,248
"101391",1101391,205,45,13,263
"101392",1101392,175,74,4,253
"101393",1101393,229,114,16,359
"101394",1101394,191,27,4,222
"101395",1101395,173,142,9,324
"101396",1101396,87,105,3,195
"101397",1101397,39,197,7,243
"101398",1101398,103,71,5,179
"101399",1101399,118,119,15,252
"101400",1101400,86,219,9,314
"101401",1101401,102,145,10,257
"101402",1101402,89,166,8,263
"101403",1101403,161,37,3,201
"101404",1101404,118,25,3,146
"101405",1101405,108,35,7,150
"101406",1101406,54,180,8,242
"101407",1101407,148,36,6,190
"101408",1101408,33,175,6,214
"101409",1101409,58,214,2,274
"101410",1101410,177,122,10,309
"101411",1101411,126,8,5,139
"101412",1101412,11,7,0,18
"101413",1101413,101,48,11,160
"101414",1101414,183,138,9,330
"101415",1101415,107,83,18,208
"101416",1101416,80,180,15,275
"101417",1101417,59,106,9,174
"101418",1101418,39,121,1,161
"101419",1101419,111,119,6,236
"101420",1101420,7,92,2,101
"101421",1101421,137,12,1,150
"101422",1101422,143,160,7,310
"101423",1101423,147,87,4,238
"101424",1101424,50,203,14,267
"101425",1101425,47,241,7,295
"101426",1101426,150,98,6,254
"101427",1101427,86,110,2,198
"101428",1101428,33,115,7,155
"101429",1101429,243,5,3,251
"101430",1101430,35,243,3,281
"101431",1101431,112,148,5,265
"101432",1101432,92,159,8,259
"101433",1101433,96,160,7,263
"101434",1101434,27,209,3,239
"101435",1101435,187,50,9,246
"101436",1101436,180,42,8,230
"101437",1101437,68,138,4,210
"101438",1101438,8,165,5,178
"101439",1101439,224,21,6,251
"101440",1101440,87,231,2,320
"101441",1101441,123,82,4,209
"101442",1101442,61,85,3,149
"101443",1101443,191,71,17,279
"101444",1101444,66,218,8,292
"101445",1101445,40,212,6,258
"101446",1101446,170,49,6,225
"101447",1101447,61,66,1,128
"101448",1101448,161,60,2,223
"101449",1101449,56,30,5,91
"101450",1101450,15,196,1,212
"101451",1101451,119,111,12,242
"101452",1101452,160,72,8,240
"101453",1101453,172,102,14,288
"101454",1101454,16,244,2,262
"101455",1101455,113,61,11,185
"101456",1101456,76,240,5,321
"101457",1101457,38,221,3,262
"101458",1101458,7,6,0,13
"101459",1101459,130,92,11,233
"101460",1101460,161,198,15,374
"101461",1101461,202,27,7,236
"101462",1101462,152,32,9,193
"101463",1101463,123,102,2,227
"101464",1101464,144,151,24,319
"101465",1101465,33,110,2,145
"101466",1101466,24,149,2,175
"101467",1101467,117,109,2,228
"101468",1101468,57,165,8,230
"101469",1101469,28,187,8,223
"101470",1101470,106,24,4,134
"101471",1101471,192,15,9,216
"101472",1101472,96,144,2,242
"101473",1101473,125,56,5,186
"101474",1101474,121,113,14,248
"101475",1101475,129,35,6,170
"101476",1101476,56,99,3,158
"101477",1101477,259,36,7,302
"101478",1101478,179,53,17,249
"101479",1101479,136,48,8,192
"101480",1101480,299,1,1,301
"101481",1101481,131,185,16,332
"101482",1101482,149,133,24,306
"101483",1101483,186,73,5,264
"101484",1101484,78,107,19,204
"101485",1101485,58,252,11,321
"101486",1101486,169,48,7,224
"101487",1101487,225,47,3,275
"101488",1101488,109,98,5,212
"101489",1101489,37,0,0,37
"101490",1101490,38,210,9,257
"101491",1101491,124,72,2,198
"101492",1101492,220,13,6,239
"101493",1101493,185,25,4,214
"101494",1101494,46,202,8,256
"101495",1101495,122,15,2,139
"101496",1101496,124,172,27,323
"101497",1101497,71,215,6,292
"101498",1101498,134,102,11,247
"101499",1101499,148,104,15,267
"101500",1101500,179,32,6,217
"101501",1101501,63,99,8,170
"101502",1101502,146,96,8,250
"101503",1101503,225,16,3,244
"101504",1101504,53,180,9,242
"101505",1101505,90,107,22,219
"101506",1101506,100,100,14,214
"101507",1101507,253,41,9,303
"101508",1101508,53,99,2,154
"101509",1101509,53,200,12,265
"101510",1101510,113,83,2,198
"101511",1101511,204,130,14,348
"101512",1101512,104,64,4,172
"101513",1101513,100,205,16,321
"101514",1101514,64,182,14,260
"101515",1101515,139,74,20,233
"101516",1101516,104,97,17,218
"101517",1101517,110,154,4,268
"101518",1101518,71,41,7,119
"101519",1101519,53,28,4,85
"101520",1101520,117,145,10,272
"101521",1101521,197,98,15,310
"101522",1101522,57,43,5,105
"101523",1101523,76,178,12,266
"101524",1101524,141,54,4,199
"101525",1101525,19,11,3,33
"101526",1101526,183,121,15,319
"101527",1101527,170,49,3,222
"101528",1101528,81,185,10,276
"101529",1101529,151,24,5,180
"101530",1101530,179,43,4,226
"101531",1101531,86,126,5,217
"101532",1101532,127,103,10,240
"101533",1101533,153,63,10,226
"101534",1101534,159,21,7,187
"101535",1101535,16,50,0,66
"101536",1101536,169,22,8,199
"101537",1101537,79,117,4,200
"101538",1101538,91,153,7,251
"101539",1101539,105,155,13,273
"101540",1101540,158,88,6,252
"101541",1101541,135,124,15,274
"101542",1101542,24,265,2,291
"101543",1101543,87,67,9,163
"101544",1101544,211,30,6,247
"101545",1101545,98,228,7,333
"101546",1101546,129,32,5,166
"101547",1101547,71,23,1,95
"101548",1101548,167,112,20,299
"101549",1101549,12,193,6,211
"101550",1101550,69,178,8,255
"101551",1101551,149,49,5,203
"101552",1101552,56,233,12,301
"101553",1101553,140,82,9,231
"101554",1101554,90,95,5,190
"101555",1101555,71,222,12,305
"101556",1101556,176,31,8,215
"101557",1101557,127,81,5,213
"101558",1101558,146,57,3,206
"101559",1101559,95,128,10,233
"101560",1101560,114,78,4,196
"101561",1101561,131,145,17,293
"101562",1101562,65,194,12,271
"101563",1101563,157,64,14,235
"101564",1101564,28,22,0,50
"101565",1101565,175,76,3,254
"101566",1101566,110,162,16,288
"101567",1101567,123,122,6,251
"101568",1101568,172,84,6,262
"101569",1101569,152,22,2,176
"101570",1101570,119,51,11,181
"101571",1101571,57,105,4,166
"101572",1101572,115,97,2,214
"101573",1101573,25,250,7,282
"101574",1101574,52,18,5,75
"101575",1101575,142,43,17,202
"101576",1101576,21,46,3,70
"101577",1101577,139,60,5,204
"101578",1101578,107,102,9,218
"101579",1101579,56,147,1,204
"101580",1101580,155,25,9,189
"101581",1101581,120,192,17,329
"101582",1101582,132,169,19,320
"101583",1101583,30,72,4,106
"101584",1101584,26,253,5,284
"101585",1101585,173,66,5,244
"101586",1101586,73,137,6,216
"101587",1101587,99,107,6,212
"101588",1101588,86,87,6,179
"101589",1101589,48,11,1,60
"101590",1101590,99,109,6,214
"101591",1101591,159,109,8,276
"101592",1101592,200,27,5,232
"101593",1101593,200,49,7,256
"101594",1101594,170,32,7,209
"101595",1101595,15,104,1,120
"101596",1101596,84,4,1,89
"101597",1101597,36,275,6,317
"101598",1101598,164,23,7,194
"101599",1101599,204,92,20,316
"101600",1101600,58,198,22,278
"101601",1101601,62,61,4,127
"101602",1101602,67,119,9,195
"101603",1101603,88,36,8,132
"101604",1101604,106,44,2,152
"101605",1101605,37,113,2,152
"101606",1101606,104,188,13,305
"101607",1101607,51,176,5,232
"101608",1101608,96,108,4,208
"101609",1101609,50,4,3,57
"101610",1101610,6,0,0,6
"101611",1101611,44,228,6,278
"101612",1101612,93,141,17,251
"101613",1101613,76,152,5,233
"101614",1101614,36,268,2,306
"101615",1101615,157,43,4,204
"101616",1101616,57,196,6,259
"101617",1101617,68,188,17,273
"101618",1101618,155,89,1,245
"101619",1101619,142,95,13,250
"101620",1101620,57,251,12,320
"101621",1101621,208,23,15,246
"101622",1101622,22,16,0,38
"101623",1101623,56,151,11,218
"101624",1101624,124,62,15,201
"101625",1101625,184,66,5,255
"101626",1101626,123,21,5,149
"101627",1101627,217,49,11,277
"101628",1101628,48,15,2,65
"101629",1101629,27,138,0,165
"101630",1101630,71,227,16,314
"101631",1101631,107,127,3,237
"101632",1101632,227,66,16,309
"101633",1101633,139,124,26,289
"101634",1101634,112,52,6,170
"101635",1101635,169,171,12,352
"101636",1101636,19,45,0,64
"101637",1101637,99,70,5,174
"101638",1101638,111,149,15,275
"101639",1101639,142,119,4,265
"101640",1101640,131,83,11,225
"101641",1101641,232,15,7,254
"101642",1101642,93,146,9,248
"101643",1101643,55,114,0,169
"101644",1101644,152,43,5,200
"101645",1101645,180,20,10,210
"101646",1101646,113,71,5,189
"101647",1101647,220,19,5,244
"101648",1101648,44,220,9,273
"101649",1101649,98,188,8,294
"101650",1101650,129,114,8,251
"101651",1101651,66,175,18,259
"101652",1101652,37,214,5,256
"101653",1101653,71,221,10,302
"101654",1101654,74,38,5,117
"101655",1101655,113,67,6,186
"101656",1101656,160,75,24,259
"101657",1101657,94,68,8,170
"101658",1101658,14,40,0,54
"101659",1101659,159,17,12,188
"101660",1101660,197,19,11,227
"101661",1101661,128,168,13,309
"101662",1101662,195,128,12,335
"101663",1101663,181,19,2,202
"101664",1101664,50,122,8,180
"101665",1101665,79,86,9,174
"101666",1101666,54,100,0,154
"101667",1101667,85,135,21,241
"101668",1101668,178,22,6,206
"101669",1101669,54,262,3,319
"101670",1101670,129,40,7,176
"101671",1101671,108,106,6,220
"101672",1101672,85,137,2,224
"101673",1101673,159,40,4,203
"101674",1101674,38,194,4,236
"101675",1101675,99,11,3,113
"101676",1101676,39,39,2,80
"101677",1101677,54,210,5,269
"101678",1101678,166,44,14,224
"101679",1101679,7,10,0,17
"101680",1101680,168,61,6,235
"101681",1101681,12,39,3,54
"101682",1101682,62,219,16,297
"101683",1101683,60,24,0,84
"101684",1101684,168,90,16,274
"101685",1101685,107,46,4,157
"101686",1101686,116,176,11,303
"101687",1101687,110,119,8,237
"101688",1101688,40,260,12,312
"101689",1101689,28,251,1,280
"101690",1101690,77,129,20,226
"101691",1101691,32,195,2,229
"101692",1101692,35,184,16,235
"101693",1101693,20,11,4,35
"101694",1101694,155,72,9,236
"101695",1101695,115,2,3,120
"101696",1101696,19,234,1,254
"101697",1101697,57,203,4,264
"101698",1101698,180,119,15,314
"101699",1101699,29,84,8,121
"101700",1101700,222,50,7,279
"101701",1101701,21,64,6,91
"101702",1101702,77,183,12,272
"101703",1101703,205,33,5,243
"101704",1101704,214,38,8,260
"101705",1101705,158,100,11,269
"101706",1101706,4,7,0,11
"101707",1101707,161,36,10,207
"101708",1101708,79,171,9,259
"101709",1101709,140,39,7,186
"101710",1101710,73,35,3,111
"101711",1101711,112,189,8,309
"101712",1101712,32,198,3,233
"101713",1101713,171,25,7,203
"101714",1101714,160,42,10,212
"101715",1101715,116,43,7,166
"101716",1101716,110,76,3,189
"101717",1101717,212,36,9,257
"101718",1101718,52,132,7,191
"101719",1101719,33,230,5,268
"101720",1101720,190,30,4,224
"101721",1101721,103,126,3,232
"101722",1101722,39,10,4,53
"101723",1101723,26,170,3,199
"101724",1101724,129,208,4,341
"101725",1101725,71,25,1,97
"101726",1101726,53,209,3,265
"101727",1101727,27,128,10,165
"101728",1101728,111,81,14,206
"101729",1101729,91,147,10,248
"101730",1101730,36,228,5,269
"101731",1101731,174,82,9,265
"101732",1101732,42,213,2,257
"101733",1101733,25,240,1,266
"101734",1101734,97,36,9,142
"101735",1101735,182,60,6,248
"101736",1101736,117,37,5,159
"101737",1101737,52,228,3,283
"101738",1101738,97,35,3,135
"101739",1101739,145,143,20,308
"101740",1101740,84,116,11,211
"101741",1101741,187,54,3,244
"101742",1101742,171,38,10,219
"101743",1101743,54,141,1,196
"101744",1101744,150,26,5,181
"101745",1101745,48,199,4,251
"101746",1101746,101,190,9,300
"101747",1101747,49,102,9,160
"101748",1101748,85,90,9,184
"101749",1101749,73,245,8,326
"101750",1101750,125,49,4,178
"101751",1101751,126,89,5,220
"101752",1101752,208,43,10,261
"101753",1101753,214,33,5,252
"101754",1101754,84,123,6,213
"101755",1101755,18,38,2,58
"101756",1101756,186,46,10,242
"101757",1101757,166,63,5,234
"101758",1101758,13,265,2,280
"101759",1101759,209,38,9,256
"101760",1101760,69,171,4,244
"101761",1101761,214,46,4,264
"101762",1101762,213,9,3,225
"101763",1101763,75,143,11,229
"101764",1101764,54,191,8,253
"101765",1101765,141,95,3,239
"101766",1101766,139,136,2,277
"101767",1101767,108,123,8,239
"101768",1101768,95,162,10,267
"101769",1101769,39,147,3,189
"101770",1101770,94,127,18,239
"101771",1101771,175,74,8,257
"101772",1101772,73,193,12,278
"101773",1101773,125,85,17,227
"101774",1101774,209,81,6,296
"101775",1101775,18,11,0,29
"101776",1101776,92,108,3,203
"101777",1101777,109,164,4,277
"101778",1101778,172,67,7,246
"101779",1101779,24,144,6,174
"101780",1101780,76,51,8,135
"101781",1101781,51,186,4,241
"101782",1101782,71,130,5,206
"101783",1101783,146,38,5,189
"101784",1101784,150,123,15,288
"101785",1101785,134,123,19,276
"101786",1101786,85,196,10,291
"101787",1101787,139,144,25,308
"101788",1101788,99,205,10,314
"101789",1101789,13,10,2,25
"101790",1101790,32,5,0,37
"101791",1101791,194,74,8,276
"101792",1101792,111,74,12,197
"101793",1101793,40,92,8,140
"101794",1101794,12,5,1,18
"101795",1101795,51,173,14,238
"101796",1101796,73,234,7,314
"101797",1101797,66,236,3,305
"101798",1101798,104,113,2,219
"101799",1101799,18,192,3,213
"101800",1101800,32,154,2,188
"101801",1101801,51,97,7,155
"101802",1101802,195,44,6,245
"101803",1101803,87,191,16,294
"101804",1101804,200,48,12,260
"101805",1101805,18,126,1,145
"101806",1101806,97,163,11,271
"101807",1101807,174,74,20,268
"101808",1101808,156,60,7,223
"101809",1101809,283,54,9,346
"101810",1101810,174,109,9,292
"101811",1101811,170,40,10,220
"101812",1101812,103,159,6,268
"101813",1101813,25,292,4,321
"101814",1101814,33,172,4,209
"101815",1101815,166,95,3,264
"101816",1101816,2,5,1,8
"101817",1101817,96,153,12,261
"101818",1101818,129,138,14,281
"101819",1101819,96,186,11,293
"101820",1101820,12,54,2,68
"101821",1101821,11,33,1,45
"101822",1101822,138,103,6,247
"101823",1101823,126,64,12,202
"101824",1101824,189,134,5,328
"101825",1101825,170,47,6,223
"101826",1101826,62,161,9,232
"101827",1101827,54,110,14,178
"101828",1101828,46,268,6,320
"101829",1101829,40,261,3,304
"101830",1101830,68,242,9,319
"101831",1101831,173,89,13,275
"101832",1101832,139,34,5,178
"101833",1101833,53,75,10,138
"101834",1101834,114,137,7,258
"101835",1101835,197,52,8,257
"101836",1101836,80,158,18,256
"101837",1101837,128,50,4,182
"101838",1101838,139,74,0,213
"101839",1101839,88,166,11,265
"101840",1101840,74,164,15,253
"101841",1101841,84,39,9,132
"101842",1101842,210,62,9,281
"101843",1101843,81,26,4,111
"101844",1101844,61,155,20,236
"101845",1101845,204,62,9,275
"101846",1101846,91,149,11,251
"101847",1101847,37,16,1,54
"101848",1101848,83,147,11,241
"101849",1101849,172,83,11,266
"101850",1101850,100,87,5,192
"101851",1101851,31,49,6,86
"101852",1101852,79,180,7,266
"101853",1101853,123,86,17,226
"101854",1101854,53,230,2,285
"101855",1101855,18,132,1,151
"101856",1101856,97,164,18,279
"101857",1101857,27,13,0,40
"101858",1101858,155,44,5,204
"101859",1101859,53,221,6,280
"101860",1101860,128,88,21,237
"101861",1101861,37,181,9,227
"101862",1101862,214,117,11,342
"101863",1101863,89,264,6,359
"101864",1101864,176,19,1,196
"101865",1101865,44,200,9,253
"101866",1101866,57,209,3,269
"101867",1101867,136,46,14,196
"101868",1101868,46,246,14,306
"101869",1101869,173,41,10,224
"101870",1101870,26,194,5,225
"101871",1101871,75,197,8,280
"101872",1101872,22,14,1,37
"101873",1101873,110,54,2,166
"101874",1101874,136,58,3,197
"101875",1101875,102,99,7,208
"101876",1101876,113,117,11,241
"101877",1101877,27,37,1,65
"101878",1101878,79,55,1,135
"101879",1101879,138,147,15,300
"101880",1101880,54,243,1,298
"101881",1101881,160,57,8,225
"101882",1101882,26,9,1,36
"101883",1101883,77,117,9,203
"101884",1101884,109,174,8,291
"101885",1101885,48,250,7,305
"101886",1101886,132,78,4,214
"101887",1101887,43,12,1,56
"101888",1101888,180,31,8,219
"101889",1101889,171,27,5,203
"101890",1101890,190,54,13,257
"101891",1101891,189,18,3,210
"101892",1101892,154,99,7,260
"101893",1101893,103,11,5,119
"101894",1101894,177,23,10,210
"101895",1101895,81,1,0,82
"101896",1101896,56,266,10,332
"101897",1101897,75,226,11,312
"101898",1101898,62,145,3,210
"101899",1101899,120,130,6,256
"101900",1101900,48,138,8,194
"101901",1101901,143,94,15,252
"101902",1101902,63,155,1,219
"101903",1101903,250,4,4,258
"101904",1101904,153,117,7,277
"101905",1101905,174,38,7,219
"101906",1101906,235,34,6,275
"101907",1101907,125,159,5,289
"101908",1101908,41,54,5,100
"101909",1101909,160,17,5,182
"101910",1101910,18,265,6,289
"101911",1101911,23,247,3,273
"101912",1101912,128,69,8,205
"101913",1101913,191,67,7,265
"101914",1101914,132,102,15,249
"101915",1101915,55,179,6,240
"101916",1101916,108,77,8,193
"101917",1101917,145,19,0,164
"101918",1101918,167,101,8,276
"101919",1101919,82,150,9,241
"101920",1101920,122,104,10,236
"101921",1101921,163,98,11,272
"101922",1101922,61,236,5,302
"101923",1101923,203,54,7,264
"101924",1101924,193,16,5,214
"101925",1101925,16,230,4,250
"101926",1101926,149,138,17,304
"101927",1101927,66,172,9,247
"101928",1101928,134,148,1,283
"101929",1101929,251,21,7,279
"101930",1101930,21,212,1,234
"101931",1101931,137,151,8,296
"101932",1101932,195,33,8,236
"101933",1101933,248,33,13,294
"101934",1101934,127,87,10,224
"101935",1101935,52,243,10,305
"101936",1101936,159,97,12,268
"101937",1101937,167,107,16,290
"101938",1101938,98,37,7,142
"101939",1101939,85,2,3,90
"101940",1101940,135,91,8,234
"101941",1101941,21,143,8,172
"101942",1101942,20,155,5,180
"101943",1101943,33,1,4,38
"101944",1101944,200,38,7,245
"101945",1101945,81,160,20,261
"101946",1101946,42,232,5,279
"101947",1101947,128,52,6,186
"101948",1101948,117,121,3,241
"101949",1101949,75,185,9,269
"101950",1101950,19,186,2,207
"101951",1101951,64,154,11,229
"101952",1101952,37,105,5,147
"101953",1101953,45,49,2,96
"101954",1101954,183,51,5,239
"101955",1101955,0,7,0,7
"101956",1101956,99,44,3,146
"101957",1101957,164,99,10,273
"101958",1101958,82,133,5,220
"101959",1101959,37,261,7,305
"101960",1101960,86,65,3,154
"101961",1101961,58,131,4,193
"101962",1101962,184,70,5,259
"101963",1101963,144,47,12,203
"101964",1101964,142,99,9,250
"101965",1101965,179,108,6,293
"101966",1101966,58,162,6,226
"101967",1101967,127,118,5,250
"101968",1101968,90,121,10,221
"101969",1101969,73,126,6,205
"101970",1101970,168,61,16,245
"101971",1101971,67,63,4,134
"101972",1101972,89,101,7,197
"101973",1101973,122,169,21,312
"101974",1101974,116,29,7,152
"101975",1101975,190,29,10,229
"101976",1101976,168,102,4,274
"101977",1101977,79,0,2,81
"101978",1101978,183,92,13,288
"101979",1101979,183,4,3,190
"101980",1101980,75,131,4,210
"101981",1101981,213,8,6,227
"101982",1101982,144,32,6,182
"101983",1101983,4,5,0,9
"101984",1101984,110,63,6,179
"101985",1101985,59,56,5,120
"101986",1101986,127,154,2,283
"101987",1101987,148,135,18,301
"101988",1101988,249,65,18,332
"101989",1101989,262,0,0,262
"101990",1101990,52,124,4,180
"101991",1101991,125,43,6,174
"101992",1101992,35,13,1,49
"101993",1101993,60,35,1,96
"101994",1101994,141,41,9,191
"101995",1101995,126,96,4,226
"101996",1101996,136,59,5,200
"101997",1101997,55,85,10,150
"101998",1101998,141,54,6,201
"101999",1101999,70,84,3,157
"102000",1102000,63,161,6,230
"102001",1102001,212,62,15,289
"102002",1102002,23,40,2,65
"102003",1102003,108,100,8,216
"102004",1102004,50,91,10,151
"102005",1102005,79,19,5,103
"102006",1102006,132,99,11,242
"102007",1102007,159,146,5,310
"102008",1102008,13,203,4,220
"102009",1102009,109,40,8,157
"102010",1102010,45,214,2,261
"102011",1102011,18,68,1,87
"102012",1102012,41,219,15,275
"102013",1102013,62,144,4,210
"102014",1102014,32,251,7,290
"102015",1102015,118,57,5,180
"102016",1102016,106,177,13,296
"102017",1102017,23,110,3,136
"102018",1102018,70,40,7,117
"102019",1102019,85,111,0,196
"102020",1102020,53,157,1,211
"102021",1102021,134,54,13,201
"102022",1102022,126,151,3,280
"102023",1102023,141,76,12,229
"102024",1102024,186,8,6,200
"102025",1102025,39,240,4,283
"102026",1102026,200,45,14,259
"102027",1102027,219,49,9,277
"102028",1102028,75,206,13,294
"102029",1102029,108,137,8,253
"102030",1102030,24,96,7,127
"102031",1102031,123,61,9,193
"102032",1102032,45,200,1,246
"102033",1102033,82,174,11,267
"102034",1102034,185,14,7,206
"102035",1102035,124,87,13,224
"102036",1102036,157,80,11,248
"102037",1102037,26,244,2,272
"102038",1102038,62,180,17,259
"102039",1102039,40,259,7,306
"102040",1102040,160,22,8,190
"102041",1102041,8,139,3,150
"102042",1102042,48,37,3,88
"102043",1102043,55,225,1,281
"102044",1102044,29,123,2,154
"102045",1102045,10,282,7,299
"102046",1102046,191,23,14,228
"102047",1102047,71,228,3,302
"102048",1102048,65,49,10,124
"102049",1102049,189,32,6,227
"102050",1102050,177,62,10,249
"102051",1102051,63,185,4,252
"102052",1102052,163,63,14,240
"102053",1102053,173,114,14,301
"102054",1102054,38,163,3,204
"102055",1102055,124,51,7,182
"102056",1102056,152,123,5,280
"102057",1102057,6,12,1,19
"102058",1102058,26,125,2,153
"102059",1102059,39,118,5,162
"102060",1102060,144,41,8,193
"102061",1102061,84,33,4,121
"102062",1102062,116,26,2,144
"102063",1102063,194,70,17,281
"102064",1102064,172,15,7,194
"102065",1102065,106,169,12,287
"102066",1102066,142,78,12,232
"102067",1102067,75,80,6,161
"102068",1102068,80,91,7,178
"102069",1102069,236,32,7,275
"102070",1102070,171,76,4,251
"102071",1102071,196,94,20,310
"102072",1102072,50,246,7,303
"102073",1102073,84,248,13,345
"102074",1102074,123,46,4,173
"102075",1102075,190,43,12,245
"102076",1102076,107,16,5,128
"102077",1102077,55,167,12,234
"102078",1102078,210,110,8,328
"102079",1102079,146,75,6,227
"102080",1102080,102,30,2,134
"102081",1102081,87,84,3,174
"102082",1102082,130,36,16,182
"102083",1102083,181,42,13,236
"102084",1102084,136,92,4,232
"102085",1102085,279,20,9,308
"102086",1102086,111,56,5,172
"102087",1102087,56,5,4,65
"102088",1102088,84,93,9,186
"102089",1102089,47,47,3,97
"102090",1102090,109,76,12,197
"102091",1102091,110,47,14,171
"102092",1102092,45,177,6,228
"102093",1102093,90,13,3,106
"102094",1102094,174,95,10,279
"102095",1102095,65,132,11,208
"102096",1102096,22,0,1,23
"102097",1102097,51,143,9,203
"102098",1102098,214,15,4,233
"102099",1102099,100,34,3,137
"102100",1102100,65,157,12,234
"102101",1102101,20,13,5,38
"102102",1102102,119,64,5,188
"102103",1102103,24,7,0,31
"102104",1102104,125,170,7,302
"102105",1102105,242,30,13,285
"102106",1102106,155,69,9,233
"102107",1102107,59,15,1,75
"102108",1102108,147,112,15,274
"102109",1102109,32,220,1,253
"102110",1102110,48,198,9,255
"102111",1102111,138,186,19,343
"102112",1102112,190,327,9,526
"102113",1102113,182,42,8,232
"102114",1102114,99,201,11,311
"102115",1102115,58,173,10,241
"102116",1102116,67,9,2,78
"102117",1102117,138,165,23,326
"102118",1102118,144,19,1,164
"102119",1102119,56,171,17,244
"102120",1102120,85,224,12,321
"102121",1102121,195,57,3,255
"102122",1102122,137,51,8,196
"102123",1102123,126,22,8,156
"102124",1102124,39,227,4,270
"102125",1102125,116,153,3,272
"102126",1102126,189,20,5,214
"102127",1102127,118,130,7,255
"102128",1102128,117,167,16,300
"102129",1102129,199,48,8,255
"102130",1102130,103,76,3,182
"102131",1102131,101,142,5,248
"102132",1102132,14,69,2,85
"102133",1102133,82,7,2,91
"102134",1102134,74,99,7,180
"102135",1102135,65,134,7,206
"102136",1102136,127,75,5,207
"102137",1102137,66,185,5,256
"102138",1102138,138,103,11,252
"102139",1102139,99,41,6,146
"102140",1102140,69,247,11,327
"102141",1102141,142,30,4,176
"102142",1102142,51,12,2,65
"102143",1102143,145,67,5,217
"102144",1102144,29,192,18,239
"102145",1102145,198,98,14,310
"102146",1102146,38,15,0,53
"102147",1102147,155,128,13,296
"102148",1102148,70,225,3,298
"102149",1102149,145,146,9,300
"102150",1102150,45,151,11,207
"102151",1102151,0,1,0,1
"102152",1102152,106,195,13,314
"102153",1102153,123,18,4,145
"102154",1102154,183,65,16,264
"102155",1102155,23,184,5,212
"102156",1102156,131,138,31,300
"102157",1102157,69,162,13,244
"102158",1102158,106,15,2,123
"102159",1102159,124,155,8,287
"102160",1102160,52,152,11,215
"102161",1102161,12,13,0,25
"102162",1102162,25,242,4,271
"102163",1102163,20,105,3,128
"102164",1102164,92,178,7,277
"102165",1102165,187,107,8,302
"102166",1102166,139,269,15,423
"102167",1102167,67,88,1,156
"102168",1102168,165,57,11,233
"102169",1102169,144,162,14,320
"102170",1102170,123,93,3,219
"102171",1102171,158,49,9,216
"102172",1102172,171,71,3,245
"102173",1102173,80,191,7,278
"102174",1102174,176,86,7,269
"102175",1102175,93,1,3,97
"102176",1102176,86,93,0,179
"102177",1102177,100,123,16,239
"102178",1102178,55,141,3,199
"102179",1102179,98,59,4,161
"102180",1102180,237,86,17,340
"102181",1102181,74,246,12,332
"102182",1102182,26,87,3,116
"102183",1102183,58,158,11,227
"102184",1102184,66,131,8,205
"102185",1102185,107,172,9,288
"102186",1102186,202,22,5,229
"102187",1102187,128,148,18,294
"102188",1102188,62,115,17,194
"102189",1102189,141,124,12,277
"102190",1102190,151,115,9,275
"102191",1102191,84,19,10,113
"102192",1102192,176,22,4,202
"102193",1102193,134,145,7,286
"102194",1102194,201,57,12,270
"102195",1102195,24,213,4,241
"102196",1102196,173,60,3,236
"102197",1102197,81,114,9,204
"102198",1102198,43,247,4,294
"102199",1102199,23,34,2,59
"102200",1102200,104,120,14,238
"102201",1102201,136,137,14,287
"102202",1102202,108,139,15,262
"102203",1102203,170,94,13,277
"102204",1102204,208,12,9,229
"102205",1102205,49,182,16,247
"102206",1102206,130,120,3,253
"102207",1102207,136,186,16,338
"102208",1102208,38,193,10,241
"102209",1102209,66,172,11,249
"102210",1102210,173,92,1,266
"102211",1102211,93,172,26,291
"102212",1102212,264,76,17,357
"102213",1102213,72,223,20,315
"102214",1102214,92,84,4,180
"102215",1102215,152,96,8,256
"102216",1102216,169,145,16,330
"102217",1102217,100,146,15,261
"102218",1102218,151,25,5,181
"102219",1102219,87,118,9,214
"102220",1102220,98,107,12,217
"102221",1102221,122,38,9,169
"102222",1102222,39,19,3,61
"102223",1102223,66,155,19,240
"102224",1102224,139,23,3,165
"102225",1102225,189,78,6,273
"102226",1102226,115,80,12,207
"102227",1102227,29,223,2,254
"102228",1102228,6,17,2,25
"102229",1102229,0,0,0,0
"102230",1102230,134,112,25,271
"102231",1102231,43,255,5,303
"102232",1102232,69,144,2,215
"102233",1102233,59,45,4,108
"102234",1102234,55,37,4,96
"102235",1102235,92,55,11,158
"102236",1102236,29,220,2,251
"102237",1102237,171,97,13,281
"102238",1102238,50,110,4,164
"102239",1102239,99,166,6,271
"102240",1102240,180,16,2,198
"102241",1102241,7,14,0,21
"102242",1102242,92,82,6,180
"102243",1102243,93,182,9,284
"102244",1102244,182,74,15,271
"102245",1102245,268,17,1,286
"102246",1102246,20,272,2,294
"102247",1102247,273,216,31,520
"102248",1102248,90,60,6,156
"102249",1102249,91,75,2,168
"102250",1102250,102,146,6,254
"102251",1102251,121,29,4,154
"102252",1102252,83,66,3,152
"102253",1102253,122,76,3,201
"102254",1102254,187,30,8,225
"102255",1102255,151,27,8,186
"102256",1102256,63,178,10,251
"102257",1102257,0,3,0,3
"102258",1102258,67,162,10,239
"102259",1102259,144,64,1,209
"102260",1102260,47,234,5,286
"102261",1102261,131,183,16,330
"102262",1102262,145,68,7,220
"102263",1102263,210,21,4,235
"102264",1102264,131,31,3,165
"102265",1102265,133,52,40,225
"102266",1102266,34,223,5,262
"102267",1102267,33,248,2,283
"102268",1102268,115,101,11,227
"102269",1102269,55,178,8,241
"102270",1102270,61,222,1,284
"102271",1102271,178,29,11,218
"102272",1102272,29,101,7,137
"102273",1102273,161,30,5,196
"102274",1102274,120,154,7,281
"102275",1102275,90,72,9,171
"102276",1102276,85,99,3,187
"102277",1102277,91,251,10,352
"102278",1102278,62,189,7,258
"102279",1102279,169,97,10,276
"102280",1102280,125,101,5,231
"102281",1102281,219,17,6,242
"102282",1102282,1,2,0,3
"102283",1102283,221,35,7,263
"102284",1102284,107,107,11,225
"102285",1102285,128,88,12,228
"102286",1102286,130,108,5,243
"102287",1102287,13,4,0,17
"102288",1102288,112,186,11,309
"102289",1102289,99,64,2,165
"102290",1102290,173,102,10,285
"102291",1102291,187,57,8,252
"102292",1102292,145,148,13,306
"102293",1102293,117,201,15,333
"102294",1102294,116,213,12,341
"102295",1102295,91,111,10,212
"102296",1102296,42,278,3,323
"102297",1102297,125,161,25,311
"102298",1102298,100,118,11,229
"102299",1102299,36,71,1,108
"102300",1102300,61,57,5,123
"102301",1102301,185,65,2,252
"102302",1102302,122,77,10,209
"102303",1102303,73,164,4,241
"102304",1102304,127,90,11,228
"102305",1102305,86,153,9,248
"102306",1102306,53,205,6,264
"102307",1102307,130,63,14,207
"102308",1102308,38,84,6,128
"102309",1102309,54,210,2,266
"102310",1102310,1,4,0,5
"102311",1102311,16,3,1,20
"102312",1102312,52,217,5,274
"102313",1102313,85,47,7,139
"102314",1102314,40,137,0,177
"102315",1102315,135,53,9,197
"102316",1102316,210,51,3,264
"102317",1102317,61,127,10,198
"102318",1102318,88,130,12,230
"102319",1102319,7,12,0,19
"102320",1102320,158,119,6,283
"102321",1102321,125,69,3,197
"102322",1102322,183,105,12,300
"102323",1102323,144,21,10,175
"102324",1102324,62,186,5,253
"102325",1102325,140,24,7,171
"102326",1102326,185,96,11,292
"102327",1102327,255,42,7,304
"102328",1102328,190,12,2,204
"102329",1102329,161,152,17,330
"102330",1102330,169,22,12,203
"102331",1102331,83,129,3,215
"102332",1102332,10,253,1,264
"102333",1102333,12,189,8,209
"102334",1102334,253,49,12,314
"102335",1102335,78,212,7,297
"102336",1102336,181,55,7,243
"102337",1102337,31,248,2,281
"102338",1102338,171,60,7,238
"102339",1102339,64,135,8,207
"102340",1102340,98,112,27,237
"102341",1102341,134,26,2,162
"102342",1102342,46,223,19,288
"102343",1102343,78,55,5,138
"102344",1102344,130,134,16,280
"102345",1102345,248,72,6,326
"102346",1102346,144,66,4,214
"102347",1102347,102,127,14,243
"102348",1102348,147,101,10,258
"102349",1102349,82,234,10,326
"102350",1102350,98,188,1,287
"102351",1102351,162,75,2,239
"102352",1102352,150,110,9,269
"102353",1102353,61,82,9,152
"102354",1102354,75,63,0,138
"102355",1102355,127,2,0,129
"102356",1102356,86,74,2,162
"102357",1102357,134,26,3,163
"102358",1102358,55,189,9,253
"102359",1102359,124,6,7,137
"102360",1102360,3,65,0,68
"102361",1102361,37,251,4,292
"102362",1102362,59,174,8,241
"102363",1102363,69,155,9,233
"102364",1102364,186,13,16,215
"102365",1102365,105,116,8,229
"102366",1102366,71,12,1,84
"102367",1102367,5,31,3,39
"102368",1102368,59,261,2,322
"102369",1102369,69,125,10,204
"102370",1102370,106,66,3,175
"102371",1102371,177,18,7,202
"102372",1102372,53,8,0,61
"102373",1102373,18,67,2,87
"102374",1102374,165,89,2,256
"102375",1102375,123,108,4,235
"102376",1102376,65,213,12,290
"102377",1102377,110,80,11,201
"102378",1102378,132,123,11,266
"102379",1102379,115,107,11,233
"102380",1102380,137,19,6,162
"102381",1102381,55,229,15,299
"102382",1102382,141,142,16,299
"102383",1102383,189,51,22,262
"102384",1102384,37,195,6,238
"102385",1102385,182,54,17,253
"102386",1102386,118,57,6,181
"102387",1102387,207,62,15,284
"102388",1102388,197,84,4,285
"102389",1102389,11,6,0,17
"102390",1102390,201,61,15,277
"102391",1102391,160,51,6,217
"102392",1102392,161,98,15,274
"102393",1102393,131,135,7,273
"102394",1102394,128,96,13,237
"102395",1102395,102,4,2,108
"102396",1102396,81,31,3,115
"102397",1102397,34,297,3,334
"102398",1102398,125,85,9,219
"102399",1102399,16,109,2,127
"102400",1102400,173,45,5,223
"102401",1102401,38,21,1,60
"102402",1102402,38,95,6,139
"102403",1102403,41,195,2,238
"102404",1102404,26,6,8,40
"102405",1102405,56,173,22,251
"102406",1102406,137,125,5,267
"102407",1102407,47,108,2,157
"102408",1102408,96,211,15,322
"102409",1102409,167,111,13,291
"102410",1102410,109,59,12,180
"102411",1102411,49,4,4,57
"102412",1102412,110,160,25,295
"102413",1102413,181,79,8,268
"102414",1102414,55,226,19,300
"102415",1102415,57,143,5,205
"102416",1102416,53,93,4,150
"102417",1102417,126,98,16,240
"102418",1102418,141,57,13,211
"102419",1102419,118,17,2,137
"102420",1102420,157,171,7,335
"102421",1102421,47,177,4,228
"102422",1102422,76,106,5,187
"102423",1102423,171,98,9,278
"102424",1102424,132,39,9,180
"102425",1102425,137,44,6,187
"102426",1102426,64,31,4,99
"102427",1102427,7,87,1,95
"102428",1102428,112,159,26,297
"102429",1102429,129,100,11,240
"102430",1102430,74,227,9,310
"102431",1102431,8,25,1,34
"102432",1102432,42,17,2,61
"102433",1102433,186,150,9,345
"102434",1102434,15,159,0,174
"102435",1102435,166,100,23,289
"102436",1102436,45,163,11,219
"102437",1102437,43,176,8,227
"102438",1102438,129,18,2,149
"102439",1102439,1,5,0,6
"102440",1102440,186,78,12,276
"102441",1102441,87,183,5,275
"102442",1102442,70,119,3,192
"102443",1102443,103,153,5,261
"102444",1102444,106,174,20,300
"102445",1102445,165,103,5,273
"102446",1102446,137,161,19,317
"102447",1102447,5,23,1,29
"102448",1102448,118,52,13,183
"102449",1102449,179,49,9,237
"102450",1102450,133,154,10,297
"102451",1102451,227,12,3,242
"102452",1102452,164,71,9,244
"102453",1102453,152,41,7,200
"102454",1102454,200,13,8,221
"102455",1102455,147,109,9,265
"102456",1102456,49,28,2,79
"102457",1102457,13,22,3,38
"102458",1102458,16,8,0,24
"102459",1102459,163,74,5,242
"102460",1102460,151,32,10,193
"102461",1102461,80,43,2,125
"102462",1102462,68,192,14,274
"102463",1102463,218,1,1,220
"102464",1102464,259,42,8,309
"102465",1102465,143,45,3,191
"102466",1102466,62,138,8,208
"102467",1102467,119,51,9,179
"102468",1102468,7,132,3,142
"102469",1102469,78,50,0,128
"102470",1102470,176,77,7,260
"102471",1102471,177,15,5,197
"102472",1102472,104,198,15,317
"102473",1102473,76,185,7,268
"102474",1102474,48,100,14,162
"102475",1102475,37,107,5,149
"102476",1102476,140,123,14,277
"102477",1102477,76,245,1,322
"102478",1102478,173,23,8,204
"102479",1102479,164,141,13,318
"102480",1102480,74,234,5,313
"102481",1102481,135,49,6,190
"102482",1102482,97,95,14,206
"102483",1102483,67,208,23,298
"102484",1102484,116,73,14,203
"102485",1102485,54,258,6,318
"102486",1102486,89,157,21,267
"102487",1102487,143,112,21,276
"102488",1102488,160,79,9,248
"102489",1102489,42,152,14,208
"102490",1102490,85,198,9,292
"102491",1102491,50,180,7,237
"102492",1102492,38,105,8,151
"102493",1102493,53,113,5,171
"102494",1102494,9,4,0,13
"102495",1102495,22,225,6,253
"102496",1102496,55,205,6,266
"102497",1102497,47,163,12,222
"102498",1102498,71,115,6,192
"102499",1102499,130,68,9,207
"102500",1102500,26,183,5,214
"102501",1102501,132,143,12,287
"102502",1102502,138,65,8,211
"102503",1102503,138,13,2,153
"102504",1102504,138,65,16,219
"102505",1102505,29,203,10,242
"102506",1102506,199,25,10,234
"102507",1102507,192,45,7,244
"102508",1102508,155,170,12,337
"102509",1102509,40,7,1,48
"102510",1102510,14,44,0,58
"102511",1102511,62,184,4,250
"102512",1102512,30,188,5,223
"102513",1102513,42,185,0,227
"102514",1102514,99,200,3,302
"102515",1102515,38,89,2,129
"102516",1102516,180,63,15,258
"102517",1102517,121,124,9,254
"102518",1102518,157,56,2,215
"102519",1102519,35,32,2,69
"102520",1102520,123,25,6,154
"102521",1102521,82,160,13,255
"102522",1102522,144,35,5,184
"102523",1102523,205,54,14,273
"102524",1102524,108,6,5,119
"102525",1102525,100,24,5,129
"102526",1102526,42,44,1,87
"102527",1102527,103,177,7,287
"102528",1102528,24,145,2,171
"102529",1102529,102,156,7,265
"102530",1102530,160,127,17,304
"102531",1102531,64,201,3,268
"102532",1102532,195,23,10,228
"102533",1102533,106,4,0,110
"102534",1102534,189,132,11,332
"102535",1102535,156,113,8,277
"102536",1102536,50,7,1,58
"102537",1102537,28,20,3,51
"102538",1102538,286,33,5,324
"102539",1102539,157,76,5,238
"102540",1102540,79,159,6,244
"102541",1102541,37,248,5,290
"102542",1102542,154,93,6,253
"102543",1102543,130,58,11,199
"102544",1102544,33,156,5,194
"102545",1102545,171,43,6,220
"102546",1102546,43,200,6,249
"102547",1102547,134,97,14,245
"102548",1102548,60,169,12,241
"102549",1102549,163,78,16,257
"102550",1102550,7,122,1,130
"102551",1102551,114,30,2,146
"102552",1102552,39,100,7,146
"102553",1102553,112,65,5,182
"102554",1102554,136,100,11,247
"102555",1102555,54,103,4,161
"102556",1102556,23,6,0,29
"102557",1102557,130,98,3,231
"102558",1102558,71,122,5,198
"102559",1102559,68,227,8,303
"102560",1102560,70,97,6,173
"102561",1102561,202,98,20,320
"102562",1102562,139,133,23,295
"102563",1102563,147,40,9,196
"102564",1102564,145,111,16,272
"102565",1102565,58,298,1,357
"102566",1102566,48,208,7,263
"102567",1102567,81,149,10,240
"102568",1102568,66,43,6,115
"102569",1102569,60,47,2,109
"102570",1102570,34,19,0,53
"102571",1102571,41,276,2,319
"102572",1102572,156,85,5,246
"102573",1102573,198,16,4,218
"102574",1102574,77,232,13,322
"102575",1102575,153,133,7,293
"102576",1102576,222,30,15,267
"102577",1102577,145,52,5,202
"102578",1102578,285,50,21,356
"102579",1102579,110,161,7,278
"102580",1102580,56,141,7,204
"102581",1102581,147,129,4,280
"102582",1102582,40,122,2,164
"102583",1102583,101,63,10,174
"102584",1102584,130,67,18,215
"102585",1102585,31,227,3,261
"102586",1102586,71,172,12,255
"102587",1102587,156,134,14,304
"102588",1102588,219,60,5,284
"102589",1102589,167,7,5,179
"102590",1102590,177,88,7,272
"102591",1102591,107,186,12,305
"102592",1102592,172,24,11,207
"102593",1102593,118,105,7,230
"102594",1102594,143,125,7,275
"102595",1102595,100,141,8,249
"102596",1102596,107,91,2,200
"102597",1102597,161,30,10,201
"102598",1102598,74,119,7,200
"102599",1102599,45,19,4,68
"102600",1102600,202,55,5,262
"102601",1102601,123,152,5,280
"102602",1102602,145,184,14,343
"102603",1102603,98,78,9,185
"102604",1102604,150,154,7,311
"102605",1102605,160,53,1,214
"102606",1102606,140,140,11,291
"102607",1102607,142,41,11,194
"102608",1102608,138,116,10,264
"102609",1102609,17,201,3,221
"102610",1102610,191,118,16,325
"102611",1102611,137,126,18,281
"102612",1102612,148,47,8,203
"102613",1102613,52,225,13,290
"102614",1102614,134,65,4,203
"102615",1102615,166,47,17,230
"102616",1102616,50,19,0,69
"102617",1102617,187,87,7,281
"102618",1102618,135,68,6,209
"102619",1102619,147,89,15,251
"102620",1102620,119,60,15,194
"102621",1102621,76,198,5,279
"102622",1102622,229,40,8,277
"102623",1102623,180,16,3,199
"102624",1102624,21,198,0,219
"102625",1102625,116,58,8,182
"102626",1102626,129,80,7,216
"102627",1102627,122,121,0,243
"102628",1102628,210,78,5,293
"102629",1102629,168,24,5,197
"102630",1102630,46,202,6,254
"102631",1102631,109,84,10,203
"102632",1102632,46,88,8,142
"102633",1102633,148,159,11,318
"102634",1102634,96,182,5,283
"102635",1102635,38,242,10,290
"102636",1102636,228,13,3,244
"102637",1102637,144,109,13,266
"102638",1102638,226,20,2,248
"102639",1102639,11,84,1,96
"102640",1102640,125,173,11,309
"102641",1102641,86,180,0,266
"102642",1102642,86,170,14,270
"102643",1102643,25,169,2,196
"102644",1102644,115,74,9,198
"102645",1102645,143,77,11,231
"102646",1102646,41,208,6,255
"102647",1102647,170,48,7,225
"102648",1102648,196,76,19,291
"102649",1102649,102,214,4,320
"102650",1102650,48,39,10,97
"102651",1102651,111,82,5,198
"102652",1102652,139,138,4,281
"102653",1102653,88,138,3,229
"102654",1102654,174,80,11,265
"102655",1102655,105,129,7,241
"102656",1102656,71,61,10,142
"102657",1102657,153,43,9,205
"102658",1102658,118,28,2,148
"102659",1102659,35,133,2,170
"102660",1102660,53,16,1,70
"102661",1102661,121,114,19,254
"102662",1102662,38,26,2,66
"102663",1102663,115,52,5,172
"102664",1102664,211,73,13,297
"102665",1102665,56,184,7,247
"102666",1102666,73,125,8,206
"102667",1102667,71,199,7,277
"102668",1102668,98,193,6,297
"102669",1102669,199,43,0,242
"102670",1102670,108,112,11,231
"102671",1102671,131,27,4,162
"102672",1102672,241,45,10,296
"102673",1102673,176,28,9,213
"102674",1102674,172,42,5,219
"102675",1102675,179,55,18,252
"102676",1102676,19,18,5,42
"102677",1102677,159,61,4,224
"102678",1102678,157,69,8,234
"102679",1102679,56,23,3,82
"102680",1102680,22,219,4,245
"102681",1102681,115,144,10,269
"102682",1102682,195,42,12,249
"102683",1102683,170,36,4,210
"102684",1102684,141,73,3,217
"102685",1102685,29,245,3,277
"102686",1102686,73,99,2,174
"102687",1102687,116,68,11,195
"102688",1102688,105,163,18,286
"102689",1102689,111,37,2,150
"102690",1102690,123,58,7,188
"102691",1102691,191,92,11,294
"102692",1102692,37,24,9,70
"102693",1102693,124,53,8,185
"102694",1102694,205,45,9,259
"102695",1102695,206,27,6,239
"102696",1102696,115,152,4,271
"102697",1102697,45,33,0,78
"102698",1102698,41,59,2,102
"102699",1102699,12,7,1,20
"102700",1102700,137,10,3,150
"102701",1102701,65,31,8,104
"102702",1102702,69,179,11,259
"102703",1102703,20,31,0,51
"102704",1102704,91,188,13,292
"102705",1102705,91,153,16,260
"102706",1102706,57,205,12,274
"102707",1102707,159,22,6,187
"102708",1102708,45,183,4,232
"102709",1102709,178,74,11,263
"102710",1102710,12,5,1,18
"102711",1102711,2,5,1,8
"102712",1102712,254,41,10,305
"102713",1102713,37,258,1,296
"102714",1102714,88,75,7,170
"102715",1102715,97,128,10,235
"102716",1102716,41,127,10,178
"102717",1102717,137,27,9,173
"102718",1102718,144,71,7,222
"102719",1102719,161,72,4,237
"102720",1102720,73,97,5,175
"102721",1102721,109,71,3,183
"102722",1102722,67,169,5,241
"102723",1102723,176,31,13,220
"102724",1102724,93,87,10,190
"102725",1102725,6,31,1,38
"102726",1102726,186,68,12,266
"102727",1102727,19,221,4,244
"102728",1102728,198,15,3,216
"102729",1102729,207,9,6,222
"102730",1102730,173,3,0,176
"102731",1102731,148,20,10,178
"102732",1102732,97,167,4,268
"102733",1102733,156,68,4,228
"102734",1102734,12,22,2,36
"102735",1102735,94,199,3,296
"102736",1102736,49,252,4,305
"102737",1102737,93,178,9,280
"102738",1102738,89,14,5,108
"102739",1102739,10,43,1,54
"102740",1102740,142,43,17,202
"102741",1102741,123,157,4,284
"102742",1102742,134,91,2,227
"102743",1102743,113,29,4,146
"102744",1102744,165,82,10,257
"102745",1102745,113,50,7,170
"102746",1102746,127,69,5,201
"102747",1102747,146,31,7,184
"102748",1102748,143,36,6,185
"102749",1102749,120,62,6,188
"102750",1102750,194,47,12,253
"102751",1102751,82,140,9,231
"102752",1102752,177,12,5,194
"102753",1102753,100,30,5,135
"102754",1102754,173,55,10,238
"102755",1102755,218,21,13,252
"102756",1102756,108,48,1,157
"102757",1102757,169,28,6,203
"102758",1102758,163,102,22,287
"102759",1102759,5,7,0,12
"102760",1102760,34,135,2,171
"102761",1102761,80,33,8,121
"102762",1102762,82,175,7,264
"102763",1102763,143,106,9,258
"102764",1102764,82,188,5,275
"102765",1102765,73,171,8,252
"102766",1102766,160,108,17,285
"102767",1102767,127,145,15,287
"102768",1102768,72,140,1,213
"102769",1102769,179,16,9,204
"102770",1102770,56,4,2,62
"102771",1102771,190,26,6,222
"102772",1102772,134,97,3,234
"102773",1102773,65,94,11,170
"102774",1102774,74,201,9,284
"102775",1102775,40,57,3,100
"102776",1102776,70,199,7,276
"102777",1102777,183,20,3,206
"102778",1102778,155,156,7,318
"102779",1102779,170,110,17,297
"102780",1102780,34,6,2,42
"102781",1102781,52,200,5,257
"102782",1102782,61,190,3,254
"102783",1102783,225,4,5,234
"102784",1102784,47,116,4,167
"102785",1102785,112,29,9,150
"102786",1102786,58,193,22,273
"102787",1102787,206,58,15,279
"102788",1102788,77,119,24,220
"102789",1102789,46,182,20,248
"102790",1102790,112,25,0,137
"102791",1102791,23,14,3,40
"102792",1102792,37,148,3,188
"102793",1102793,127,115,7,249
"102794",1102794,184,65,16,265
"102795",1102795,106,91,4,201
"102796",1102796,45,0,0,45
"102797",1102797,140,80,9,229
"102798",1102798,130,113,4,247
"102799",1102799,195,104,13,312
"102800",1102800,111,63,6,180
"102801",1102801,154,23,5,182
"102802",1102802,32,239,10,281
"102803",1102803,153,76,11,240
"102804",1102804,104,49,7,160
"102805",1102805,177,48,9,234
"102806",1102806,49,75,6,130
"102807",1102807,75,260,2,337
"102808",1102808,29,291,2,322
"102809",1102809,60,189,19,268
"102810",1102810,191,55,12,258
"102811",1102811,29,228,3,260
"102812",1102812,83,128,5,216
"102813",1102813,61,199,1,261
"102814",1102814,85,204,18,307
"102815",1102815,77,186,24,287
"102816",1102816,76,156,18,250
"102817",1102817,32,8,3,43
"102818",1102818,184,41,6,231
"102819",1102819,102,104,19,225
"102820",1102820,5,5,1,11
"102821",1102821,72,138,3,213
"102822",1102822,140,19,3,162
"102823",1102823,21,50,1,72
"102824",1102824,124,77,4,205
"102825",1102825,17,24,2,43
"102826",1102826,190,113,15,318
"102827",1102827,110,62,18,190
"102828",1102828,163,61,16,240
"102829",1102829,245,94,9,348
"102830",1102830,122,81,4,207
"102831",1102831,164,40,4,208
"102832",1102832,161,11,4,176
"102833",1102833,142,11,5,158
"102834",1102834,175,70,6,251
"102835",1102835,107,72,10,189
"102836",1102836,61,219,3,283
"102837",1102837,109,120,1,230
"102838",1102838,112,161,12,285
"102839",1102839,4,14,1,19
"102840",1102840,123,102,12,237
"102841",1102841,8,103,3,114
"102842",1102842,102,202,13,317
"102843",1102843,135,54,10,199
"102844",1102844,41,84,3,128
"102845",1102845,137,82,0,219
"102846",1102846,164,53,5,222
"102847",1102847,62,180,8,250
"102848",1102848,84,145,2,231
"102849",1102849,148,103,4,255
"102850",1102850,172,42,1,215
"102851",1102851,190,85,4,279
"102852",1102852,114,54,11,179
"102853",1102853,97,155,4,256
"102854",1102854,32,25,2,59
"102855",1102855,30,223,3,256
"102856",1102856,204,39,6,249
"102857",1102857,210,61,6,277
"102858",1102858,147,115,11,273
"102859",1102859,168,57,4,229
"102860",1102860,88,124,14,226
"102861",1102861,113,11,3,127
"102862",1102862,149,128,14,291
"102863",1102863,109,184,11,304
"102864",1102864,121,21,2,144
"102865",1102865,28,303,1,332
"102866",1102866,145,83,6,234
"102867",1102867,315,83,4,402
"102868",1102868,85,154,10,249
"102869",1102869,98,99,6,203
"102870",1102870,97,205,11,313
"102871",1102871,51,127,2,180
"102872",1102872,182,35,10,227
"102873",1102873,164,57,12,233
"102874",1102874,55,159,10,224
"102875",1102875,114,99,5,218
"102876",1102876,148,82,10,240
"102877",1102877,233,7,7,247
"102878",1102878,73,112,3,188
"102879",1102879,124,88,14,226
"102880",1102880,151,109,8,268
"102881",1102881,151,85,14,250
"102882",1102882,19,181,5,205
"102883",1102883,157,57,8,222
"102884",1102884,20,65,2,87
"102885",1102885,85,15,4,104
"102886",1102886,87,195,10,292
"102887",1102887,46,225,10,281
"102888",1102888,109,162,5,276
"102889",1102889,207,43,13,263
"102890",1102890,97,92,8,197
"102891",1102891,44,170,7,221
"102892",1102892,187,91,9,287
"102893",1102893,55,186,6,247
"102894",1102894,121,53,11,185
"102895",1102895,57,65,4,126
"102896",1102896,73,200,10,283
"102897",1102897,40,141,2,183
"102898",1102898,49,156,14,219
"102899",1102899,88,13,2,103
"102900",1102900,115,177,6,298
"102901",1102901,15,87,11,113
"102902",1102902,170,115,8,293
"102903",1102903,137,77,5,219
"102904",1102904,194,79,5,278
"102905",1102905,98,39,3,140
"102906",1102906,50,254,2,306
"102907",1102907,18,101,0,119
"102908",1102908,163,73,10,246
"102909",1102909,156,17,4,177
"102910",1102910,9,9,0,18
"102911",1102911,92,143,1,236
"102912",1102912,206,29,20,255
"102913",1102913,214,28,9,251
"102914",1102914,134,50,3,187
"102915",1102915,142,90,2,234
"102916",1102916,55,114,2,171
"102917",1102917,87,118,8,213
"102918",1102918,16,206,3,225
"102919",1102919,27,224,5,256
"102920",1102920,181,80,10,271
"102921",1102921,151,14,1,166
"102922",1102922,49,33,2,84
"102923",1102923,47,197,6,250
"102924",1102924,147,106,4,257
"102925",1102925,126,56,12,194
"102926",1102926,115,104,5,224
"102927",1102927,45,149,13,207
"102928",1102928,223,60,13,296
"102929",1102929,90,47,3,140
"102930",1102930,123,189,20,332
"102931",1102931,100,146,10,256
"102932",1102932,14,20,1,35
"102933",1102933,7,54,2,63
"102934",1102934,115,133,7,255
"102935",1102935,46,67,2,115
"102936",1102936,139,54,6,199
"102937",1102937,146,49,6,201
"102938",1102938,181,8,6,195
"102939",1102939,87,100,7,194
"102940",1102940,228,14,2,244
"102941",1102941,114,18,8,140
"102942",1102942,170,63,7,240
"102943",1102943,171,16,11,198
"102944",1102944,153,226,35,414
"102945",1102945,13,11,2,26
"102946",1102946,78,28,8,114
"102947",1102947,90,164,6,260
"102948",1102948,70,124,13,207
"102949",1102949,8,92,0,100
"102950",1102950,243,37,9,289
"102951",1102951,40,275,1,316
"102952",1102952,32,11,3,46
"102953",1102953,67,238,5,310
"102954",1102954,229,42,6,277
"102955",1102955,113,27,3,143
"102956",1102956,185,55,5,245
"102957",1102957,69,96,4,169
"102958",1102958,126,87,3,216
"102959",1102959,112,172,8,292
"102960",1102960,73,110,5,188
"102961",1102961,202,31,3,236
"102962",1102962,106,29,4,139
"102963",1102963,169,44,6,219
"102964",1102964,113,203,12,328
"102965",1102965,19,21,8,48
"102966",1102966,84,83,2,169
"102967",1102967,82,24,4,110
"102968",1102968,88,15,7,110
"102969",1102969,93,86,3,182
"102970",1102970,219,42,17,278
"102971",1102971,55,13,2,70
"102972",1102972,55,186,7,248
"102973",1102973,137,137,13,287
"102974",1102974,8,21,1,30
"102975",1102975,162,75,12,249
"102976",1102976,24,3,0,27
"102977",1102977,31,17,0,48
"102978",1102978,54,52,2,108
"102979",1102979,194,76,10,280
"102980",1102980,12,68,0,80
"102981",1102981,148,121,3,272
"102982",1102982,51,99,3,153
"102983",1102983,87,201,4,292
"102984",1102984,97,48,8,153
"102985",1102985,174,48,10,232
"102986",1102986,33,49,5,87
"102987",1102987,79,153,11,243
"102988",1102988,40,99,1,140
"102989",1102989,113,167,12,292
"102990",1102990,41,42,1,84
"102991",1102991,30,205,11,246
"102992",1102992,225,62,9,296
"102993",1102993,167,50,5,222
"102994",1102994,162,44,13,219
"102995",1102995,156,108,1,265
"102996",1102996,133,162,7,302
"102997",1102997,87,35,5,127
"102998",1102998,21,117,3,141
"102999",1102999,123,102,14,239
"103000",1103000,66,7,1,74
"103001",1103001,190,86,7,283
"103002",1103002,65,163,9,237
"103003",1103003,168,111,20,299
"103004",1103004,136,153,9,298
"103005",1103005,9,107,4,120
"103006",1103006,35,167,4,206
"103007",1103007,128,82,4,214
"103008",1103008,52,113,9,174
"103009",1103009,89,53,1,143
"103010",1103010,40,277,2,319
"103011",1103011,74,110,1,185
"103012",1103012,107,26,1,134
"103013",1103013,86,189,4,279
"103014",1103014,68,172,3,243
"103015",1103015,23,258,3,284
"103016",1103016,54,14,3,71
"103017",1103017,185,62,9,256
"103018",1103018,57,69,7,133
"103019",1103019,48,39,5,92
"103020",1103020,67,188,2,257
"103021",1103021,54,2,0,56
"103022",1103022,118,85,6,209
"103023",1103023,194,31,6,231
"103024",1103024,23,217,3,243
"103025",1103025,71,166,12,249
"103026",1103026,109,47,2,158
"103027",1103027,66,94,7,167
"103028",1103028,222,165,8,395
"103029",1103029,193,20,3,216
"103030",1103030,90,193,17,300
"103031",1103031,29,208,4,241
"103032",1103032,153,39,5,197
"103033",1103033,185,49,3,237
"103034",1103034,113,62,17,192
"103035",1103035,9,263,3,275
"103036",1103036,9,12,0,21
"103037",1103037,113,99,16,228
"103038",1103038,47,197,13,257
"103039",1103039,38,235,5,278
"103040",1103040,189,79,8,276
"103041",1103041,78,80,9,167
"103042",1103042,1,70,1,72
"103043",1103043,159,51,9,219
"103044",1103044,152,92,6,250
"103045",1103045,41,25,1,67
"103046",1103046,21,251,5,277
"103047",1103047,162,49,6,217
"103048",1103048,75,161,9,245
"103049",1103049,35,31,7,73
"103050",1103050,183,94,11,288
"103051",1103051,116,127,9,252
"103052",1103052,55,179,18,252
"103053",1103053,154,119,19,292
"103054",1103054,201,31,15,247
"103055",1103055,15,3,0,18
"103056",1103056,238,66,16,320
"103057",1103057,153,74,21,248
"103058",1103058,135,148,12,295
"103059",1103059,62,127,6,195
"103060",1103060,175,75,6,256
"103061",1103061,59,199,7,265
"103062",1103062,253,11,9,273
"103063",1103063,140,121,9,270
"103064",1103064,52,23,2,77
"103065",1103065,187,113,17,317
"103066",1103066,197,92,4,293
"103067",1103067,54,117,5,176
"103068",1103068,130,65,12,207
"103069",1103069,18,91,3,112
"103070",1103070,4,78,1,83
"103071",1103071,53,108,8,169
"103072",1103072,43,16,0,59
"103073",1103073,190,112,12,314
"103074",1103074,97,105,15,217
"103075",1103075,209,28,5,242
"103076",1103076,201,49,5,255
"103077",1103077,96,157,32,285
"103078",1103078,48,204,2,254
"103079",1103079,38,70,2,110
"103080",1103080,139,52,0,191
"103081",1103081,10,4,5,19
"103082",1103082,47,111,3,161
"103083",1103083,150,22,7,179
"103084",1103084,132,55,3,190
"103085",1103085,154,91,13,258
"103086",1103086,52,160,17,229
"103087",1103087,181,25,5,211
"103088",1103088,146,33,6,185
"103089",1103089,134,135,8,277
"103090",1103090,51,44,5,100
"103091",1103091,139,20,5,164
"103092",1103092,137,62,5,204
"103093",1103093,50,132,3,185
"103094",1103094,38,225,8,271
"103095",1103095,6,85,1,92
"103096",1103096,71,154,11,236
"103097",1103097,88,163,7,258
"103098",1103098,144,60,8,212
"103099",1103099,156,75,20,251
"103100",1103100,199,62,17,278
"103101",1103101,106,132,5,243
"103102",1103102,100,132,11,243
"103103",1103103,158,19,11,188
"103104",1103104,92,177,23,292
"103105",1103105,33,10,1,44
"103106",1103106,108,132,6,246
"103107",1103107,86,227,10,323
"103108",1103108,15,239,4,258
"103109",1103109,44,23,2,69
"103110",1103110,131,123,9,263
"103111",1103111,135,24,4,163
"103112",1103112,118,174,21,313
"103113",1103113,173,56,11,240
"103114",1103114,54,74,11,139
"103115",1103115,38,129,7,174
"103116",1103116,94,139,8,241
"103117",1103117,277,25,9,311
"103118",1103118,202,13,6,221
"103119",1103119,101,211,5,317
"103120",1103120,81,169,12,262
"103121",1103121,62,253,2,317
"103122",1103122,117,104,5,226
"103123",1103123,135,18,2,155
"103124",1103124,154,56,7,217
"103125",1103125,155,80,4,239
"103126",1103126,68,135,4,207
"103127",1103127,164,74,24,262
"103128",1103128,90,82,7,179
"103129",1103129,104,119,6,229
"103130",1103130,166,37,15,218
"103131",1103131,50,129,7,186
"103132",1103132,133,145,7,285
"103133",1103133,22,336,2,360
"103134",1103134,51,29,4,84
"103135",1103135,200,85,10,295
"103136",1103136,70,125,10,205
"103137",1103137,183,61,15,259
"103138",1103138,154,40,2,196
"103139",1103139,83,212,4,299
"103140",1103140,51,172,6,229
"103141",1103141,87,72,10,169
"103142",1103142,127,23,5,155
"103143",1103143,60,247,1,308
"103144",1103144,190,36,3,229
"103145",1103145,38,233,7,278
"103146",1103146,196,53,22,271
"103147",1103147,81,186,10,277
"103148",1103148,160,112,11,283
"103149",1103149,93,147,4,244
"103150",1103150,95,47,2,144
"103151",1103151,193,32,8,233
"103152",1103152,130,104,15,249
"103153",1103153,172,114,20,306
"103154",1103154,87,182,3,272
"103155",1103155,58,156,8,222
"103156",1103156,47,187,7,241
"103157",1103157,137,136,12,285
"103158",1103158,47,8,4,59
"103159",1103159,188,122,7,317
"103160",1103160,19,251,3,273
"103161",1103161,61,152,8,221
"103162",1103162,65,69,10,144
"103163",1103163,183,96,10,289
"103164",1103164,161,42,8,211
"103165",1103165,87,39,2,128
"103166",1103166,224,0,1,225
"103167",1103167,91,69,3,163
"103168",1103168,169,28,7,204
"103169",1103169,5,143,2,150
"103170",1103170,127,148,16,291
"103171",1103171,159,65,10,234
"103172",1103172,249,54,5,308
"103173",1103173,65,191,8,264
"103174",1103174,166,7,4,177
"103175",1103175,172,42,7,221
"103176",1103176,109,29,10,148
"103177",1103177,161,97,18,276
"103178",1103178,99,104,8,211
"103179",1103179,151,54,10,215
"103180",1103180,75,171,9,255
"103181",1103181,115,47,9,171
"103182",1103182,132,100,10,242
"103183",1103183,49,54,5,108
"103184",1103184,72,230,1,303
"103185",1103185,116,110,2,228
"103186",1103186,34,20,3,57
"103187",1103187,68,182,13,263
"103188",1103188,74,58,3,135
"103189",1103189,188,112,6,306
"103190",1103190,274,10,15,299
"103191",1103191,123,177,6,306
"103192",1103192,21,254,5,280
"103193",1103193,10,15,2,27
"103194",1103194,52,234,5,291
"103195",1103195,183,56,21,260
"103196",1103196,11,6,1,18
"103197",1103197,195,32,5,232
"103198",1103198,33,103,3,139
"103199",1103199,39,22,1,62
"103200",1103200,70,105,16,191
"103201",1103201,179,109,16,304
"103202",1103202,12,220,6,238
"103203",1103203,85,163,10,258
"103204",1103204,223,36,12,271
"103205",1103205,111,106,12,229
"103206",1103206,166,87,6,259
"103207",1103207,43,15,2,60
"103208",1103208,161,52,9,222
"103209",1103209,203,55,7,265
"103210",1103210,87,225,5,317
"103211",1103211,233,72,7,312
"103212",1103212,210,67,16,293
"103213",1103213,232,35,4,271
"103214",1103214,138,114,12,264
"103215",1103215,69,202,12,283
"103216",1103216,102,162,7,271
"103217",1103217,174,71,3,248
"103218",1103218,52,206,11,269
"103219",1103219,67,228,8,303
"103220",1103220,261,61,2,324
"103221",1103221,53,82,3,138
"103222",1103222,19,213,1,233
"103223",1103223,51,210,5,266
"103224",1103224,18,128,4,150
"103225",1103225,47,37,5,89
"103226",1103226,57,111,7,175
"103227",1103227,90,176,13,279
"103228",1103228,38,224,5,267
"103229",1103229,87,68,4,159
"103230",1103230,69,191,14,274
"103231",1103231,143,91,16,250
"103232",1103232,120,164,7,291
"103233",1103233,21,59,1,81
"103234",1103234,161,3,0,164
"103235",1103235,30,194,8,232
"103236",1103236,264,7,3,274
"103237",1103237,137,121,17,275
"103238",1103238,120,55,10,185
"103239",1103239,228,17,8,253
"103240",1103240,52,227,10,289
"103241",1103241,74,160,28,262
"103242",1103242,211,24,7,242
"103243",1103243,28,204,10,242
"103244",1103244,85,157,14,256
"103245",1103245,60,219,8,287
"103246",1103246,212,5,8,225
"103247",1103247,173,133,9,315
"103248",1103248,90,85,5,180
"103249",1103249,70,56,3,129
"103250",1103250,96,131,2,229
"103251",1103251,56,117,8,181
"103252",1103252,36,214,14,264
"103253",1103253,57,90,4,151
"103254",1103254,21,148,4,173
"103255",1103255,180,68,9,257
"103256",1103256,168,95,9,272
"103257",1103257,53,93,5,151
"103258",1103258,140,81,4,225
"103259",1103259,40,228,4,272
"103260",1103260,84,164,11,259
"103261",1103261,188,59,8,255
"103262",1103262,188,85,12,285
"103263",1103263,7,23,2,32
"103264",1103264,179,146,8,333
"103265",1103265,202,31,7,240
"103266",1103266,161,61,13,235
"103267",1103267,151,30,5,186
"103268",1103268,48,83,3,134
"103269",1103269,101,171,5,277
"103270",1103270,27,4,1,32
"103271",1103271,66,154,5,225
"103272",1103272,75,39,6,120
"103273",1103273,115,154,18,287
"103274",1103274,29,58,5,92
"103275",1103275,75,89,3,167
"103276",1103276,15,17,0,32
"103277",1103277,47,161,4,212
"103278",1103278,136,59,6,201
"103279",1103279,85,60,4,149
"103280",1103280,125,132,5,262
"103281",1103281,82,78,5,165
"103282",1103282,45,231,11,287
"103283",1103283,6,6,1,13
"103284",1103284,114,71,6,191
"103285",1103285,61,211,5,277
"103286",1103286,67,242,14,323
"103287",1103287,133,141,21,295
"103288",1103288,39,5,0,44
"103289",1103289,81,203,9,293
"103290",1103290,66,154,12,232
"103291",1103291,141,104,11,256
"103292",1103292,87,192,18,297
"103293",1103293,217,54,8,279
"103294",1103294,93,170,2,265
"103295",1103295,145,72,10,227
"103296",1103296,206,26,9,241
"103297",1103297,114,154,15,283
"103298",1103298,16,61,4,81
"103299",1103299,142,127,16,285
"103300",1103300,161,34,7,202
"103301",1103301,97,183,24,304
"103302",1103302,74,103,6,183
"103303",1103303,114,159,5,278
"103304",1103304,158,52,4,214
"103305",1103305,149,110,13,272
"103306",1103306,94,148,10,252
"103307",1103307,102,196,10,308
"103308",1103308,85,161,11,257
"103309",1103309,104,124,4,232
"103310",1103310,176,109,12,297
"103311",1103311,13,9,2,24
"103312",1103312,185,46,7,238
"103313",1103313,43,279,10,332
"103314",1103314,77,201,13,291
"103315",1103315,161,61,11,233
"103316",1103316,14,21,3,38
"103317",1103317,56,235,7,298
"103318",1103318,43,178,9,230
"103319",1103319,149,90,14,253
"103320",1103320,68,29,4,101
"103321",1103321,147,77,2,226
"103322",1103322,59,161,2,222
"103323",1103323,86,163,11,260
"103324",1103324,39,247,11,297
"103325",1103325,226,27,6,259
"103326",1103326,189,47,22,258
"103327",1103327,96,198,5,299
"103328",1103328,96,71,5,172
"103329",1103329,93,216,19,328
"103330",1103330,116,38,3,157
"103331",1103331,7,5,0,12
"103332",1103332,70,167,12,249
"103333",1103333,35,249,2,286
"103334",1103334,185,59,8,252
"103335",1103335,175,67,8,250
"103336",1103336,58,161,2,221
"103337",1103337,48,52,4,104
"103338",1103338,93,99,13,205
"103339",1103339,44,75,2,121
"103340",1103340,114,115,6,235
"103341",1103341,42,95,3,140
"103342",1103342,76,210,6,292
"103343",1103343,4,3,1,8
"103344",1103344,153,73,6,232
"103345",1103345,68,1,0,69
"103346",1103346,55,127,12,194
"103347",1103347,49,206,8,263
"103348",1103348,125,163,6,294
"103349",1103349,89,160,9,258
"103350",1103350,10,1,1,12
"103351",1103351,168,39,5,212
"103352",1103352,84,46,2,132
"103353",1103353,218,62,10,290
"103354",1103354,71,90,4,165
"103355",1103355,86,153,14,253
"103356",1103356,72,209,12,293
"103357",1103357,199,130,5,334
"103358",1103358,21,302,1,324
"103359",1103359,140,34,7,181
"103360",1103360,67,104,7,178
"103361",1103361,86,69,6,161
"103362",1103362,96,172,34,302
"103363",1103363,56,93,6,155
"103364",1103364,124,83,6,213
